ibge,anomes,cadunico_tot_fam,cadunico_tot_pes,cadunico_tot_fam_rpc_ate_meio_sm,cadunico_tot_pes_rpc_ate_meio_sm,cadunico_tot_fam_pob,cadunico_tot_pes_pob,cadunico_tot_fam_ext_pob,cadunico_tot_pes_ext_pob,cadunico_tot_fam_pob_e_ext_pob,cadunico_tot_pes_pob_e_ext_pob
110001,202311,4978,12757,2886,8590,771,2489,722,1965,1493,4454
110002,202311,19112,44321,11575,30371,2904,8033,3368,8190,6272,16223
110003,202311,975,2623,587,1805,169,521,102,290,271,811
110004,202311,18422,42724,10005,26809,2254,6270,3270,8140,5524,14410
110005,202311,3239,7813,1884,5295,573,1594,505,1428,1078,3022
110006,202311,1870,4889,982,2982,204,665,200,514,404,1179
110007,202311,1469,3526,717,2082,179,524,124,356,303,880
110008,202311,4442,10315,2959,8062,669,1616,1477,4446,2146,6062
110009,202311,5733,14822,3090,9605,676,2192,794,2274,1470,4466
110010,202311,10468,28388,7273,22569,1994,5494,3047,10774,5041,16268
110011,202311,10003,24042,5902,16196,1651,4724,1226,3022,2877,7746
110012,202311,23589,53941,13008,34533,3455,8990,3470,8649,6925,17639
110013,202311,7943,20439,4698,13901,1744,5330,673,1972,2417,7302
110014,202311,4597,11238,2621,7295,547,1586,926,2500,1473,4086
110015,202311,7878,18374,4290,11490,1046,3092,1251,2691,2297,5783
110018,202311,5972,13926,2989,8040,723,2011,694,1627,1417,3638
110020,202311,124716,259169,82375,194091,17580,42869,41530,94777,59110,137646
110025,202311,6012,13533,3428,8772,602,1683,1590,3661,2192,5344
110026,202311,752,1865,427,1238,103,319,114,329,217,648
110028,202311,9717,22780,4876,13494,1278,3869,461,1113,1739,4982
110029,202311,1981,4591,966,2690,209,577,370,1002,579,1579
110030,202311,19082,41754,9544,25306,2973,8308,1314,3228,4287,11536
110032,202311,4793,12108,2402,7119,758,2290,379,1126,1137,3416
110033,202311,6068,16333,4215,12742,1281,3905,1415,4409,2696,8314
110034,202311,3986,8877,2272,6114,856,2444,477,1332,1333,3776
110037,202311,1859,5227,1107,3673,297,1011,215,680,512,1691
110040,202311,3806,9681,2289,6715,674,2115,429,1128,1103,3243
110045,202311,5760,15142,3579,10854,1095,3468,954,2759,2049,6227
110050,202311,2125,5340,1100,3331,360,1203,102,216,462,1419
110060,202311,1198,3242,633,1912,185,545,114,320,299,865
110070,202311,1828,5183,1164,3707,332,1111,231,618,563,1729
110080,202311,8208,18109,5369,13717,1382,3592,2418,6127,3800,9719
110090,202311,763,1948,440,1313,128,421,119,328,247,749
110092,202311,1818,4757,1095,3292,269,864,503,1422,772,2286
110094,202311,3848,10034,2449,7287,765,2322,447,1368,1212,3690
110100,202311,2174,5732,1521,4488,552,1682,413,1195,965,2877
110110,202311,2338,5819,1375,4040,407,1268,200,619,607,1887
110120,202311,1717,4420,1002,2957,283,851,261,731,544,1582
110130,202311,3309,7590,1685,4563,509,1445,200,527,709,1972
110140,202311,3207,8200,2099,5971,461,1397,901,2430,1362,3827
110143,202311,1784,4489,1131,3223,347,1051,355,946,702,1997
110145,202311,1165,2810,600,1700,192,513,190,564,382,1077
110146,202311,694,1721,378,1099,143,404,82,260,225,664
110147,202311,1007,2352,517,1376,64,173,251,590,315,763
110148,202311,1239,3098,489,1461,125,402,48,93,173,495
110149,202311,4388,10438,2610,7269,854,2464,578,1604,1432,4068
110150,202311,2852,7324,1544,4920,594,2018,121,330,715,2348
110155,202311,1082,2889,643,1840,133,419,226,578,359,997
110160,202311,1908,5139,1127,3424,410,1294,138,408,548,1702
110170,202311,2529,5949,1451,3923,283,822,739,1800,1022,2622
110175,202311,2784,7048,1624,4680,335,992,648,1756,983,2748
110180,202311,1649,4093,984,2792,276,806,256,707,532,1513
120001,202311,4551,11286,3274,9202,503,1563,2018,5395,2521,6958
120005,202311,2625,8685,2235,8009,263,958,1534,5566,1797,6524
120010,202311,7994,18833,6496,16470,636,1521,4818,12137,5454,13658
120013,202311,3285,9082,2617,8009,1011,3037,897,2954,1908,5991
120017,202311,3873,9231,2871,7614,437,1118,1773,4833,2210,5951
120020,202311,20124,60735,17340,55247,1373,4391,12687,39943,14060,44334
120025,202311,4860,10914,3707,9399,667,1642,2210,5810,2877,7452
120030,202311,7817,27711,6807,25697,584,2308,4660,17690,5244,19998
120032,202311,2205,8584,2011,8156,102,628,1640,6449,1742,7077
120033,202311,5663,16192,5072,15126,142,544,4284,12435,4426,12979
120034,202311,3740,11159,3057,9946,162,658,2417,7613,2579,8271
120035,202311,5256,16284,4683,15266,239,879,3976,12658,4215,13537
120038,202311,4247,10823,3337,9264,632,1792,1826,5086,2458,6878
120039,202311,2596,9607,2305,8982,175,874,1736,6570,1911,7444
120040,202311,81833,194640,62459,161568,8773,22670,37091,92423,45864,115093
120042,202311,4283,13082,3707,11941,156,622,3001,9443,3157,10065
120043,202311,1845,6480,1504,5920,71,428,1170,4439,1241,4867
120045,202311,7224,16350,5412,13818,718,1888,3464,8662,4182,10550
120050,202311,12512,36566,10860,33796,497,1793,8581,26292,9078,28085
120060,202311,12519,40936,10889,38173,582,2589,8694,29711,9276,32300
120070,202311,4634,12423,3653,10827,841,2333,1898,5963,2739,8296
120080,202311,7125,16244,5983,14486,675,1549,4414,10573,5089,12122
130002,202311,4500,13910,3852,12984,463,1266,3012,10593,3475,11859
130006,202311,3303,10031,2587,8842,429,1345,1654,5953,2083,7298
130008,202311,3345,9957,2764,9031,230,712,2192,7311,2422,8023
130010,202311,5521,12936,4562,11724,177,442,3981,10110,4158,10552
130014,202311,5006,12544,3351,9832,752,2226,1641,4988,2393,7214
130020,202311,3454,12174,2812,11018,220,1228,1946,7203,2166,8431
130030,202311,19900,41240,17449,38291,275,714,16306,35378,16581,36092
130040,202311,5073,13749,3947,12228,641,1842,2648,8515,3289,10357
130050,202311,8810,29263,7109,26575,722,2584,5062,18960,5784,21544
130060,202311,9161,32669,7596,30278,365,1961,6092,23745,6457,25706
130063,202311,8293,23210,7071,21661,251,1038,6247,18689,6498,19727
130068,202311,4886,13481,3954,12167,253,825,3213,9847,3466,10672
130070,202311,8977,23511,6993,20981,907,2258,4851,15115,5758,17373
130080,202311,9647,28035,7956,25877,314,1008,6711,21806,7025,22814
130083,202311,3791,10318,3118,9422,251,758,2473,7684,2724,8442
130090,202311,5110,12545,4303,11505,114,324,3659,9904,3773,10228
130100,202311,9065,25666,7298,23558,296,1010,6017,19504,6313,20514
130110,202311,11061,26420,8187,22332,1831,4477,4423,13153,6254,17630
130115,202311,6401,17186,5115,15417,174,499,4282,12937,4456,13436
130120,202311,21062,57952,17474,52780,1880,5936,13165,39545,15045,45481
130130,202311,7232,19388,5383,16789,763,2302,3562,11645,4325,13947
130140,202311,9159,27604,7672,25645,360,1448,6367,21106,6727,22554
130150,202311,5076,14780,4482,13889,241,1003,3481,10491,3722,11494
130160,202311,7225,21003,6474,19793,197,799,5679,17043,5876,17842
130165,202311,4320,13645,3875,12964,110,414,3311,10976,3421,11390
130170,202311,18467,41212,14513,36312,625,1555,12376,30431,13001,31986
130180,202311,5514,15442,5088,14893,61,326,4737,13634,4798,13960
130185,202311,25924,54110,20033,47152,1577,2581,16284,39485,17861,42066
130190,202311,27454,75822,21358,66319,2698,7734,14892,46732,17590,54466
130195,202311,3095,10147,2565,9400,141,586,2031,7524,2172,8110
130200,202311,3751,8984,2864,7719,243,745,2078,5414,2321,6159
130210,202311,2056,6823,1733,6320,220,976,1142,3899,1362,4875
130220,202311,3430,9053,2726,8164,135,390,2341,7049,2476,7439
130230,202311,6558,22512,5643,21187,188,1004,4938,18383,5126,19387
130240,202311,18401,40688,14779,36092,213,842,13395,31755,13608,32597
130250,202311,32724,86206,26252,77531,1785,4435,20421,61157,22206,65592
130255,202311,6232,16392,4922,14100,298,716,3817,10831,4115,11547
130260,202311,513506,1118210,392250,936985,72408,180149,242926,558351,315334,738500
130270,202311,12878,38127,10069,33575,2086,6072,6092,21211,8178,27283
130280,202311,4703,15287,4148,14566,198,843,3580,12425,3778,13268
130290,202311,22098,52819,18642,48517,710,2237,16423,42012,17133,44249
130300,202311,6340,17744,5241,16109,249,925,4108,12274,4357,13199
130310,202311,10570,25237,8760,22819,576,1619,7024,17850,7600,19469
130320,202311,4365,12846,3341,11196,502,1629,1996,6718,2498,8347
130330,202311,5761,15787,4431,13994,259,822,3488,11100,3747,11922
130340,202311,31877,80722,25729,72772,1841,4360,20432,59162,22273,63522
130350,202311,4653,15201,4039,14300,187,816,3376,11759,3563,12575
130353,202311,9241,23037,6854,19475,1344,3568,3955,11540,5299,15108
130356,202311,7081,19029,5479,16397,1376,3774,2725,8582,4101,12356
130360,202311,3595,10854,2707,9602,238,979,2126,7369,2364,8348
130370,202311,6490,25338,5238,23233,705,3716,3028,13320,3733,17036
130380,202311,10450,39812,9343,37755,825,3559,6956,27809,7781,31368
130390,202311,9416,31540,7767,28785,489,2412,6222,22334,6711,24746
130395,202311,3203,8653,2497,7470,157,540,1997,5797,2154,6337
130400,202311,3708,9733,2934,8622,99,323,2505,7236,2604,7559
130406,202311,15060,46173,12293,42352,3675,11078,6403,23728,10078,34806
130410,202311,5743,17172,4676,15439,1293,4213,2545,8699,3838,12912
130420,202311,20122,57513,16452,52601,2692,7546,10880,36175,13572,43721
130423,202311,5428,15718,4525,14514,332,1363,3664,11445,3996,12808
130426,202311,3969,12240,3471,11619,131,409,2985,10420,3116,10829
130430,202311,6294,13921,5066,12266,251,673,4201,9869,4452,10542
130440,202311,7357,17305,6024,15607,179,524,5449,13917,5628,14441
140002,202311,3099,8207,2467,7359,432,1042,1601,5124,2033,6166
140005,202311,4346,11493,3439,10224,2131,6400,642,1998,2773,8398
140010,202311,76498,196734,55912,161409,15189,45370,18409,53093,33598,98463
140015,202311,8056,15920,6268,13951,278,594,5510,12135,5788,12729
140017,202311,7373,16936,5712,14677,455,1051,4290,11135,4745,12186
140020,202311,7194,17765,5657,15635,768,1984,3622,10278,4390,12262
140023,202311,3663,9228,2708,7765,363,1100,1870,5318,2233,6418
140028,202311,2546,6021,1966,5211,147,378,1461,3900,1608,4278
140030,202311,7962,16629,6360,14624,355,748,5287,12020,5642,12768
140040,202311,3737,13110,3346,12569,159,854,2782,10243,2941,11097
140045,202311,6703,20542,5611,18888,1935,5637,2774,10427,4709,16064
140047,202311,7895,20187,6102,17274,978,2701,3571,10256,4549,12957
140050,202311,2407,6001,1827,5062,357,866,1029,2914,1386,3780
140060,202311,2965,6330,2423,5572,229,443,1865,4281,2094,4724
140070,202311,2565,11944,2408,11602,168,1056,1833,8655,2001,9711
150010,202311,66079,135973,53143,117748,1503,3132,45707,98569,47210,101701
150013,202311,2764,5643,2110,4843,72,160,1789,4033,1861,4193
150020,202311,19621,49229,16799,45003,1830,3962,12792,34868,14622,38830
150030,202311,11864,36847,10214,34595,858,2237,7870,28259,8728,30496
150034,202311,5371,11596,3741,9212,266,663,2788,6691,3054,7354
150040,202311,20374,47757,16415,42745,1073,1935,13969,37268,15042,39203
150050,202311,10017,26589,8556,24455,294,949,7459,21330,7753,22279
150060,202311,31437,75277,22759,61012,3853,9966,13029,35143,16882,45109
150070,202311,10983,31093,9122,28607,314,1290,7899,24284,8213,25574
150080,202311,117788,248771,82505,193752,22972,52278,28108,71343,51080,123621
150085,202311,12501,28870,10234,25797,230,672,9145,22546,9375,23218
150090,202311,16196,40582,14208,37250,579,1459,12096,30993,12675,32452
150095,202311,9402,19953,7514,17431,796,1334,5821,13796,6617,15130
150100,202311,3905,11515,3202,10318,183,565,2624,8343,2807,8908
150110,202311,6039,19605,5447,18849,172,673,4839,16690,5011,17363
150120,202311,10290,26932,8837,24718,422,984,7427,20764,7849,21748
150125,202311,1194,2772,794,2152,100,291,474,1243,574,1534
150130,202311,32804,81660,24992,68171,5039,12423,14295,40168,19334,52591
150140,202311,394940,744219,294987,599409,25744,52183,214567,416127,240311,468310
150145,202311,5420,15173,3905,12496,1559,4943,827,3257,2386,8200
150150,202311,23690,51115,17430,41856,1961,4383,11530,27153,13491,31536
150157,202311,4514,11115,3224,9107,526,1544,1797,5088,2323,6632
150160,202311,5273,10861,4391,9504,302,707,3486,7156,3788,7863
150170,202311,36664,91257,30457,80353,5860,13192,18539,51891,24399,65083
150172,202311,7413,16300,5499,13463,457,1091,4073,9870,4530,10961
150175,202311,2648,6330,2050,5329,174,570,1533,3765,1707,4335
150178,202311,16339,33883,11617,28050,1074,1586,8892,22760,9966,24346
150180,202311,36881,92985,31593,86453,3022,5179,24581,72587,27603,77766
150190,202311,9927,24001,8294,21789,221,721,6959,17732,7180,18453
150195,202311,6660,17592,5787,16253,188,550,5140,14248,5328,14798
150200,202311,7471,18645,6348,17189,95,289,5622,15095,5717,15384
150210,202311,42652,107868,38017,101180,1260,3045,33194,87922,34454,90967
150215,202311,15304,38811,11194,30599,1857,5290,6307,16497,8164,21787
150220,202311,18414,42997,14305,36319,988,2141,10404,25878,11392,28019
150230,202311,18658,42985,15456,38171,2178,4599,10797,26933,12975,31532
150240,202311,46881,113381,34778,90848,7736,20022,14917,36916,22653,56938
150250,202311,5589,18083,5041,17397,374,1247,4305,14945,4679,16192
150260,202311,3961,9975,3157,8658,117,363,2526,6653,2643,7016
150270,202311,11334,28844,6809,20026,1911,5688,1656,4964,3567,10652
150275,202311,10056,24728,8635,22650,251,824,7356,18598,7607,19422
150276,202311,3071,7592,2418,6645,292,758,1581,4508,1873,5266
150277,202311,7126,15642,4749,12215,737,1733,2934,7426,3671,9159
150280,202311,9636,30365,8843,29042,829,2224,6935,23548,7764,25772
150285,202311,4498,13007,3675,11527,241,714,2771,8508,3012,9222
150290,202311,14264,32630,11839,29545,444,942,10156,25372,10600,26314
150293,202311,12062,26611,8473,21277,1028,2661,5430,13001,6458,15662
150295,202311,9439,22438,5633,16482,1867,5259,1871,5990,3738,11249
150300,202311,4240,8688,3622,7914,58,143,3337,7203,3395,7346
150304,202311,5586,14359,4263,12151,910,2437,2426,7063,3336,9500
150307,202311,7302,20041,6131,18012,253,742,4762,13793,5015,14535
150309,202311,8053,20599,5773,16462,1045,2915,3144,9037,4189,11952
150310,202311,9246,31185,8376,29848,554,2305,6800,24229,7354,26534
150320,202311,12250,28053,9955,24320,1407,2917,6602,16264,8009,19181
150330,202311,19931,51489,17160,47350,3077,7091,10917,32827,13994,39918
150340,202311,3070,8042,2439,6985,267,673,1673,4764,1940,5437
150345,202311,11810,27801,9763,24965,474,1291,8127,20336,8601,21627
150350,202311,12925,26405,10595,23227,1027,1718,8408,18591,9435,20309
150360,202311,32908,80522,23566,66637,2284,5068,16823,48262,19107,53330
150370,202311,14551,37063,10874,31460,1576,4066,7283,21900,8859,25966
150375,202311,5082,18328,4355,17011,304,1266,3370,12826,3674,14092
150380,202311,12829,28586,9293,23409,485,1235,7225,17648,7710,18883
150390,202311,10281,35990,8426,32390,2065,6544,4523,19292,6588,25836
150400,202311,8295,25474,7505,24062,178,530,6301,20523,6479,21053
150405,202311,11343,25636,8797,22035,864,1550,6535,16939,7399,18489
150410,202311,2427,6445,1907,5558,167,448,1298,3737,1465,4185
150420,202311,62230,147815,43414,117306,9763,27452,20707,54785,30470,82237
150430,202311,10399,25781,8476,22825,821,1658,6289,16869,7110,18527
150440,202311,8831,20228,7343,18057,595,1364,5899,14356,6494,15720
150442,202311,39829,79662,29221,64697,1801,3975,21936,46362,23737,50337
150445,202311,10218,23992,8445,21400,203,558,7422,18517,7625,19075
150450,202311,8267,24511,7525,23467,258,1245,6780,20418,7038,21663
150460,202311,11488,29809,9922,27608,539,1142,8236,23402,8775,24544
150470,202311,25544,61949,20636,54962,693,2476,17195,43741,17888,46217
150475,202311,7202,19196,5502,16238,1018,2675,3234,9926,4252,12601
150480,202311,18493,48590,15639,44152,4566,11197,8491,26162,13057,37359
150490,202311,10259,31410,8775,28989,928,2469,6398,21945,7326,24414
150495,202311,6843,18373,5946,16983,204,736,5057,14012,5261,14748
150497,202311,3440,9470,2356,7455,441,1423,1206,3810,1647,5233
150500,202311,3857,9159,2990,7650,191,512,2229,5438,2420,5950
150503,202311,7825,18352,4979,14213,1643,4178,1716,5439,3359,9617
150506,202311,17764,43504,14178,38161,2338,5975,9481,26421,11819,32396
150510,202311,16703,42898,13292,36926,1213,2817,10138,28166,11351,30983
150520,202311,10972,31563,10055,30220,136,699,9261,27318,9397,28017
150530,202311,16673,48925,13558,43998,1486,4072,9825,32348,11311,36420
150540,202311,6616,14856,5345,12904,392,877,4243,10106,4635,10983
150543,202311,9144,23346,6635,19324,726,2223,4338,12486,5064,14709
150548,202311,13432,35370,11182,31844,559,1465,9258,26267,9817,27732
150549,202311,2381,5873,1842,5031,129,387,1370,3675,1499,4062
150550,202311,26128,67973,18146,52621,5495,15929,5899,17044,11394,32973
150553,202311,53768,131025,34753,95329,10422,28323,12739,34738,23161,63061
150555,202311,2671,6232,1836,4882,199,521,1228,3253,1427,3774
150560,202311,2609,6219,2016,5159,187,477,1323,3270,1510,3747
150563,202311,3523,9116,2584,7423,625,1837,1270,3560,1895,5397
150565,202311,5803,16280,4602,14063,206,624,3545,10765,3751,11389
150570,202311,10031,23581,8618,21539,202,557,7606,18508,7808,19065
150580,202311,15251,50981,12524,47528,1753,5578,8817,35201,10570,40779
150590,202311,10788,30654,8650,27737,499,1653,6879,21973,7378,23626
150600,202311,13464,34980,11727,32487,517,1422,10091,27849,10608,29271
150610,202311,4144,9176,3397,8026,142,373,2811,6385,2953,6758
150611,202311,4104,9623,3244,8292,107,315,2654,6480,2761,6795
150613,202311,18837,46935,12423,35225,2818,8536,5144,13701,7962,22237
150616,202311,4879,12108,3062,8610,686,1964,1447,3947,2133,5911
150618,202311,9541,23304,7043,19071,1201,3398,4122,10883,5323,14281
150619,202311,8248,20890,6210,17740,1243,3142,3654,10891,4897,14033
150620,202311,9899,28404,7886,24386,1971,5555,3695,11797,5666,17352
150630,202311,9326,19010,8032,17258,136,324,7255,15129,7391,15453
150635,202311,6954,16272,5146,13092,646,1508,3216,8083,3862,9591
150640,202311,2583,6803,2220,6307,63,195,1912,5393,1975,5588
150650,202311,15769,37439,12310,31486,3872,9651,4576,12318,8448,21969
150655,202311,7124,17347,5906,15444,151,527,4917,12365,5068,12892
150658,202311,5552,14718,3540,11044,1121,3652,1266,3838,2387,7490
150660,202311,7249,18200,5717,15629,1424,3797,2884,7733,4308,11530
150670,202311,12972,25462,9087,20406,1367,3246,5919,13010,7286,16256
150680,202311,102167,251135,72503,201327,17013,42945,35872,104873,52885,147818
150690,202311,3301,7099,2527,6013,154,340,2012,4726,2166,5066
150700,202311,9121,22300,7316,19536,1054,2151,4874,13505,5928,15656
150710,202311,4844,13486,3876,11737,934,2792,2018,6141,2952,8933
150715,202311,6804,15805,5042,13155,468,1239,3777,9587,4245,10826
150720,202311,10757,26076,9094,23514,370,1138,7616,18938,7986,20076
150730,202311,17873,46509,13695,39654,2560,7725,8312,24185,10872,31910
150740,202311,5184,12513,4040,10625,499,1091,2781,7357,3280,8448
150745,202311,7194,17423,5228,14363,731,2115,3379,9127,4110,11242
150746,202311,2221,5512,1770,4779,82,239,1380,3599,1462,3838
150747,202311,7184,16960,5813,14810,443,982,4530,11504,4973,12486
150750,202311,4930,12731,3626,10707,369,1089,2481,7418,2850,8507
150760,202311,14956,38067,12282,33703,2652,6638,6869,19581,9521,26219
150770,202311,9063,26493,8009,25098,259,607,7054,22597,7313,23204
150775,202311,1548,3556,1111,2946,113,351,748,1908,861,2259
150780,202311,6497,16976,5429,15564,232,685,4613,13213,4845,13898
150790,202311,8054,18592,6326,16470,594,1276,4224,12533,4818,13809
150795,202311,22113,55729,17773,48768,3518,9238,10239,28305,13757,37543
150796,202311,5123,10498,3950,8962,366,798,3094,6923,3460,7721
150797,202311,5848,14785,4529,12661,444,1199,3438,9471,3882,10670
150800,202311,19052,51431,15229,45091,3191,8741,8538,26102,11729,34843
150803,202311,11297,25263,9459,22578,280,792,8181,18769,8461,19561
150805,202311,4671,12572,3507,10644,565,1675,2177,6612,2742,8287
150808,202311,8422,22566,5480,17132,1854,6377,760,2316,2614,8693
150810,202311,27866,61442,19201,49360,4664,11712,9221,25231,13885,36943
150812,202311,8610,19383,6813,16293,520,1428,5027,11194,5547,12622
150815,202311,11953,31763,9351,28147,1898,5610,5869,17926,7767,23536
150820,202311,19224,39099,15325,33889,1492,2419,11834,26988,13326,29407
150830,202311,16796,45625,14757,42624,591,1559,12757,36787,13348,38346
150835,202311,4724,12396,3814,10908,449,1320,2576,7270,3025,8590
150840,202311,11173,27617,7910,21760,1099,3221,4626,12019,5725,15240
160005,202311,1851,3848,1476,3384,56,144,1237,2733,1293,2877
160010,202311,2805,6771,2379,6233,63,220,2118,5393,2181,5613
160015,202311,5151,10642,4296,9629,450,826,3579,8113,4029,8939
160020,202311,3278,8391,2677,7521,340,873,1896,5523,2236,6396
160021,202311,1659,5151,1336,4714,64,322,885,3179,949,3501
160023,202311,1797,5390,1461,4772,278,835,828,2809,1106,3644
160025,202311,2474,6349,2196,6007,307,539,1763,5120,2070,5659
160027,202311,14685,29969,12069,26445,1098,2214,9497,20788,10595,23002
160030,202311,119716,275329,90358,232494,16445,39490,51944,136833,68389,176323
160040,202311,7988,22699,6700,20773,567,1556,5294,16498,5861,18054
160050,202311,9043,21194,7266,18862,2572,5954,3560,10049,6132,16003
160053,202311,5839,14650,4726,12921,278,702,3742,10308,4020,11010
160055,202311,2228,4267,1961,3940,26,50,1817,3550,1843,3600
160060,202311,40081,84413,30755,72554,4365,8305,21494,52138,25859,60443
160070,202311,4253,12263,3476,11036,448,1230,2494,8249,2942,9479
160080,202311,4104,10494,3390,9642,68,221,2983,8489,3051,8710
170025,202311,790,1966,389,1183,101,306,87,249,188,555
170030,202311,1402,3813,881,2736,170,512,313,947,483,1459
170035,202311,1737,4103,1068,2872,117,331,586,1477,703,1808
170040,202311,2198,5447,1461,4205,265,735,703,2092,968,2827
170070,202311,2398,5074,1450,3620,148,437,815,1923,963,2360
170100,202311,3088,7526,2173,5888,327,792,1320,3586,1647,4378
170105,202311,760,2024,434,1347,110,345,107,279,217,624
170110,202311,1373,3478,873,2552,73,229,464,1276,537,1505
170130,202311,1797,4403,1164,3247,102,338,750,1993,852,2331
170190,202311,1877,4445,1267,3388,148,448,759,1877,907,2325
170200,202311,2382,5282,1267,3276,359,861,344,899,703,1760
170210,202311,34524,85302,21418,60308,5614,16304,4228,11744,9842,28048
170215,202311,1524,3647,994,2782,96,297,606,1609,702,1906
170220,202311,6990,19614,5131,16047,2512,7743,849,3084,3361,10827
170230,202311,1543,3936,1011,2863,178,521,478,1259,656,1780
170240,202311,3690,8354,2555,6428,275,707,1670,3989,1945,4696
170255,202311,4523,11925,2933,8870,576,1700,1338,3987,1914,5687
170270,202311,1009,2329,611,1643,64,175,356,898,420,1073
170290,202311,3805,9416,2974,8058,319,627,2129,5957,2448,6584
170300,202311,2583,5842,1779,4546,133,366,1242,2944,1375,3310
170305,202311,809,1990,521,1406,85,228,236,616,321,844
170307,202311,1366,3705,992,2961,111,364,621,1688,732,2052
170310,202311,1979,4388,1200,3084,210,514,565,1410,775,1924
170320,202311,1255,3049,779,2186,102,295,428,1152,530,1447
170330,202311,1261,3322,994,2852,55,228,721,1897,776,2125
170360,202311,720,1659,457,1218,40,102,263,631,303,733
170370,202311,1639,3677,958,2471,139,404,506,1154,645,1558
170380,202311,2274,5857,1518,4528,214,555,786,2400,1000,2955
170382,202311,568,1519,408,1215,19,75,248,651,267,726
170384,202311,2119,6359,1524,5095,315,992,702,2219,1017,3211
170386,202311,1167,2981,546,1678,66,221,199,547,265,768
170388,202311,844,2043,529,1468,92,258,284,737,376,995
170389,202311,999,2902,687,2293,115,409,352,1169,467,1578
170390,202311,2085,4303,1336,3248,60,184,1017,2394,1077,2578
170410,202311,722,1641,448,1141,28,76,300,704,328,780
170460,202311,511,1262,318,891,38,114,174,458,212,572
170510,202311,1076,2701,637,1838,39,140,400,1046,439,1186
170550,202311,8436,19963,5486,14789,1420,4082,1971,4907,3391,8989
170555,202311,1635,3919,1066,2888,155,399,504,1342,659,1741
170560,202311,1154,2920,758,2243,112,314,357,1076,469,1390
170600,202311,1698,4105,1105,3098,162,420,608,1655,770,2075
170610,202311,2001,4585,1235,3210,95,290,812,1937,907,2227
170625,202311,528,1275,283,757,55,123,116,290,171,413
170650,202311,1865,4550,1343,3668,147,445,860,2208,1007,2653
170700,202311,4361,11518,2790,8153,562,1688,1114,2994,1676,4682
170710,202311,2124,4599,1368,3398,133,358,902,2137,1035,2495
170720,202311,2217,4942,1430,3648,166,438,914,2203,1080,2641
170730,202311,1346,3190,840,2311,122,308,472,1276,594,1584
170740,202311,2500,7146,1835,5835,159,591,1267,3834,1426,4425
170755,202311,1001,2424,608,1705,123,358,262,650,385,1008
170765,202311,1350,3178,805,2175,156,383,377,997,533,1380
170770,202311,2263,5701,1632,4619,129,427,1175,3154,1304,3581
170820,202311,4781,12344,3038,8996,634,1904,1347,3746,1981,5650
170825,202311,1367,2866,910,2155,107,225,628,1448,735,1673
170830,202311,1641,3822,1061,2811,381,1045,328,739,709,1784
170900,202311,4077,10810,3210,9421,508,1232,2060,6250,2568,7482
170930,202311,5036,12201,3307,8818,764,2123,1212,2984,1976,5107
170950,202311,14602,37465,8127,24201,2412,7478,1017,2876,3429,10354
170980,202311,605,1452,325,918,50,142,145,376,195,518
171050,202311,2007,5583,1524,4680,149,446,1058,3256,1207,3702
171070,202311,1662,4051,1269,3416,269,602,635,1929,904,2531
171090,202311,1155,2839,800,2222,148,423,387,1032,535,1455
171110,202311,671,1700,382,1097,71,206,165,435,236,641
171150,202311,1134,2595,591,1646,113,362,262,617,375,979
171180,202311,745,2039,386,1249,71,236,135,425,206,661
171190,202311,2601,7157,2015,6069,326,1008,1132,3370,1458,4378
171195,202311,1026,2810,663,2052,87,281,375,1054,462,1335
171200,202311,731,1895,421,1288,103,336,103,279,206,615
171215,202311,518,1239,370,956,53,148,162,377,215,525
171240,202311,914,2650,597,2009,19,90,401,1244,420,1334
171245,202311,895,2404,557,1688,62,218,255,668,317,886
171250,202311,1109,2864,612,1862,94,291,226,672,320,963
171270,202311,591,1850,398,1414,68,271,181,596,249,867
171280,202311,1042,2802,725,2216,63,189,433,1309,496,1498
171320,202311,4816,12224,2986,8606,651,1876,1058,2970,1709,4846
171330,202311,3686,9016,2297,6381,644,1782,875,2333,1519,4115
171360,202311,1949,4713,1196,3483,147,391,660,2016,807,2407
171370,202311,824,1953,530,1474,79,242,277,713,356,955
171380,202311,1669,4084,1179,3279,168,403,683,1893,851,2296
171395,202311,1177,2797,726,2051,117,330,374,1018,491,1348
171420,202311,2435,5913,1522,4116,269,716,779,1998,1048,2714
171430,202311,1317,3436,887,2562,79,261,517,1348,596,1609
171488,202311,3042,7585,2026,5718,376,1097,973,2611,1349,3708
171500,202311,1043,2443,599,1596,92,280,301,754,393,1034
171510,202311,1034,2866,756,2303,66,275,499,1362,565,1637
171515,202311,581,1300,361,934,30,97,227,523,257,620
171525,202311,850,2079,511,1452,71,229,288,743,359,972
171550,202311,407,1061,258,808,32,132,107,279,139,411
171570,202311,1372,3520,997,2791,145,417,563,1496,708,1913
171575,202311,1778,4314,1109,3084,214,620,506,1324,720,1944
171610,202311,7394,19106,4404,13270,1199,3836,656,1978,1855,5814
171620,202311,3689,8183,2819,6820,224,495,2073,4893,2297,5388
171630,202311,1344,3222,889,2485,142,392,502,1399,644,1791
171650,202311,2857,7526,1776,5290,487,1546,326,931,813,2477
171660,202311,2770,6377,1638,4364,128,398,1102,2763,1230,3161
171665,202311,1564,3919,1030,2949,252,797,341,922,593,1719
171670,202311,2285,5418,1489,3973,328,923,635,1564,963,2487
171700,202311,1407,3536,897,2512,145,371,494,1352,639,1723
171720,202311,891,2052,545,1438,77,211,326,822,403,1033
171750,202311,1632,4539,974,3166,212,688,281,1030,493,1718
171780,202311,1527,3485,933,2454,94,295,562,1370,656,1665
171790,202311,1630,4794,1163,3795,178,580,598,1871,776,2451
171800,202311,860,2071,537,1468,65,172,302,757,367,929
171820,202311,14824,37435,8825,25871,2004,6068,2151,6192,4155,12260
171830,202311,1941,5390,1484,4490,394,1115,605,2025,999,3140
171840,202311,843,2023,512,1422,36,103,299,765,335,868
171845,202311,886,1948,537,1379,66,172,321,774,387,946
171850,202311,1282,3274,953,2612,44,161,733,1864,777,2025
171855,202311,1194,3308,791,2452,107,315,420,1227,527,1542
171865,202311,588,1527,407,1157,62,207,208,496,270,703
171870,202311,968,2429,559,1660,106,323,232,654,338,977
171875,202311,1786,4277,1301,3447,66,264,1002,2486,1068,2750
171880,202311,1809,4261,1357,3541,57,169,1055,2695,1112,2864
171884,202311,1391,3192,909,2338,148,369,520,1290,668,1659
171886,202311,1768,4373,1090,3207,334,1002,253,792,587,1794
171888,202311,658,1774,414,1272,39,136,231,635,270,771
171889,202311,517,1455,290,956,83,277,83,260,166,537
171890,202311,1593,4121,951,2864,122,405,535,1495,657,1900
171900,202311,725,2121,471,1578,64,217,214,698,278,915
172000,202311,670,1866,434,1353,80,233,134,398,214,631
172010,202311,1632,4364,1165,3461,105,276,749,2216,854,2492
172015,202311,444,1388,290,1045,49,185,116,366,165,551
172020,202311,3512,8895,2670,7499,358,970,1631,4665,1989,5635
172025,202311,873,2128,524,1480,44,127,343,887,387,1014
172030,202311,1490,3988,1048,3158,98,330,677,1923,775,2253
172049,202311,1405,3333,815,2380,108,330,421,1196,529,1526
172065,202311,1783,4114,1174,3175,171,402,574,1683,745,2085
172080,202311,2773,7349,1957,5765,139,437,1250,3569,1389,4006
172085,202311,493,1266,231,679,37,110,77,204,114,314
172090,202311,5017,10690,3547,8488,167,514,2709,6021,2876,6535
172093,202311,540,1471,347,1075,26,129,195,532,221,661
172097,202311,754,1829,383,1099,61,200,156,408,217,608
172100,202311,67033,150984,39888,102430,7626,20690,16439,39430,24065,60120
172110,202311,2157,6537,1614,5550,131,569,1139,3747,1270,4316
172120,202311,6381,16458,4239,12537,629,1708,2249,6595,2878,8303
172125,202311,495,1209,295,826,19,66,166,386,185,452
172130,202311,645,1546,399,1093,18,60,220,511,238,571
172208,202311,3028,6638,2033,5121,175,424,1397,3404,1572,3828
172210,202311,3290,7212,2207,5564,244,582,1478,3723,1722,4305
210005,202311,24920,62627,16139,46820,4693,13942,5725,16112,10418,30054
210010,202311,2702,6745,2353,6271,47,165,2083,5450,2130,5615
210015,202311,3879,10191,3094,8959,159,477,2503,7189,2662,7666
210020,202311,9538,18649,7450,15997,413,792,6243,13234,6656,14026
210030,202311,5614,16477,4743,15002,620,1997,3255,9985,3875,11982
210040,202311,2583,5132,2092,4500,92,236,1813,3804,1905,4040
210043,202311,6851,17568,5286,15129,363,1063,3897,10967,4260,12030
210047,202311,8620,22125,6261,18641,220,840,4851,13956,5071,14796
210050,202311,3035,8140,2235,6605,161,563,1594,4447,1755,5010
210055,202311,2631,6632,2119,5825,74,166,1751,4896,1825,5062
210060,202311,8914,29036,7389,26075,1129,3856,4557,16337,5686,20193
210070,202311,8106,18717,6962,17121,193,491,6193,15012,6386,15503
210080,202311,5399,14563,4769,13676,95,407,4242,11920,4337,12327
210083,202311,7165,16504,5796,14848,122,428,5254,13235,5376,13663
210087,202311,3150,8095,2491,7134,153,435,1996,5659,2149,6094
210090,202311,11052,29922,9521,27261,765,1638,7578,21854,8343,23492
210095,202311,7346,22895,6242,21070,757,2446,4359,15127,5116,17573
210100,202311,7774,20976,6061,17672,991,2700,3675,10669,4666,13369
210110,202311,3810,9216,3299,8519,56,201,2901,7308,2957,7509
210120,202311,35787,75833,26986,63336,1384,2836,21193,48554,22577,51390
210125,202311,5570,13091,4476,11635,945,1958,2872,7994,3817,9952
210130,202311,4995,11430,3766,9753,59,186,3301,8402,3360,8588
210135,202311,2179,4718,1673,3948,64,165,1452,3358,1516,3523
210140,202311,25934,61946,17535,48380,2795,7231,9570,25806,12365,33037
210150,202311,5604,12047,4438,10328,130,344,3699,8311,3829,8655
210160,202311,26951,60606,20734,51566,3242,6928,13503,33801,16745,40729
210170,202311,21428,54721,17943,49430,2604,6162,12178,34422,14782,40584
210173,202311,2620,8370,2347,7873,100,395,2049,6725,2149,7120
210177,202311,3847,9551,3094,8492,471,1185,2147,6020,2618,7205
210180,202311,1855,4105,1440,3508,31,109,1240,2968,1271,3077
210190,202311,6981,15149,5372,12746,113,248,4657,10780,4770,11028
210193,202311,1611,4049,1277,3499,111,279,903,2492,1014,2771
210197,202311,2397,6575,1994,5939,176,461,1491,4492,1667,4953
210200,202311,9809,26528,8036,23662,931,2693,5679,16462,6610,19155
210203,202311,8290,22038,6413,19312,826,2261,4397,13531,5223,15792
210207,202311,4589,10162,3320,8443,174,455,2461,6154,2635,6609
210210,202311,8955,24671,7638,22709,186,815,6277,18195,6463,19010
210215,202311,2919,8151,2402,7332,188,719,1893,5634,2081,6353
210220,202311,8773,23750,7846,22266,307,1249,6824,18587,7131,19836
210230,202311,6921,17309,5892,15615,325,716,5040,13351,5365,14067
210232,202311,15123,39771,11591,34085,1627,4380,7560,22428,9187,26808
210235,202311,4022,10695,3201,9316,147,492,2581,7356,2728,7848
210237,202311,5134,10890,4139,9660,89,251,3791,8712,3880,8963
210240,202311,3052,8122,2493,7124,138,331,1965,5602,2103,5933
210250,202311,7297,17561,6244,16127,144,474,5522,13935,5666,14409
210255,202311,3167,8613,2271,6725,316,948,1266,3537,1582,4485
210260,202311,6410,16643,5207,14729,592,1727,3887,10700,4479,12427
210270,202311,5721,13769,4656,12287,184,627,3792,9721,3976,10348
210275,202311,3962,9054,3092,7892,207,499,2453,6262,2660,6761
210280,202311,7670,17261,5853,14389,152,581,4612,10562,4764,11143
210290,202311,9911,21678,8326,19695,231,525,7504,17524,7735,18049
210300,202311,38267,97231,28221,80728,8813,25536,9060,28686,17873,54222
210310,202311,3623,8012,2934,6995,37,105,2638,6184,2675,6289
210312,202311,3443,7174,2873,6499,50,147,2532,5526,2582,5673
210315,202311,4321,9690,3673,8931,137,356,3338,8053,3475,8409
210317,202311,5193,14321,4503,13365,133,489,3929,11515,4062,12004
210320,202311,32077,67486,27726,61766,367,1204,25054,54335,25421,55539
210325,202311,4242,10859,3147,9209,580,1799,2031,5823,2611,7622
210330,202311,33953,77846,24732,65558,3354,7191,16246,46351,19600,53542
210340,202311,15252,33506,12394,29465,618,1308,9978,23701,10596,25009
210350,202311,11841,28180,9754,25179,228,703,8372,21103,8600,21806
210355,202311,4419,13300,3652,11920,87,402,2955,9473,3042,9875
210360,202311,14800,42485,11902,37036,572,2123,8284,24645,8856,26768
210370,202311,14626,27384,10295,22639,341,597,9267,20466,9608,21063
210375,202311,3886,9839,2475,7381,1106,3313,421,1240,1527,4553
210380,202311,6682,15387,5203,13309,312,753,4190,10503,4502,11256
210390,202311,3939,9835,3490,9104,111,379,3089,7895,3200,8274
210400,202311,5501,13813,4375,12207,288,679,3570,10007,3858,10686
210405,202311,9083,20810,6533,16871,969,2279,3940,10078,4909,12357
210407,202311,2469,6930,1894,5815,223,561,1311,4056,1534,4617
210408,202311,3287,10528,2910,9924,182,742,2280,7711,2462,8453
210409,202311,4621,13836,3811,12397,270,1051,2751,8843,3021,9894
210410,202311,4396,11338,3258,9067,90,324,2557,6752,2647,7076
210420,202311,4662,13248,3759,11547,252,744,2922,8832,3174,9576
210430,202311,2791,7120,2261,6286,207,557,1783,4893,1990,5450
210440,202311,5017,12252,3915,10620,200,489,3252,8704,3452,9193
210450,202311,2710,7095,2136,6128,314,718,1445,4269,1759,4987
210455,202311,5913,13677,4073,10931,1100,2973,1643,4312,2743,7285
210460,202311,3946,10336,2978,8823,165,535,2242,6442,2407,6977
210462,202311,2044,5468,1545,4616,85,250,1171,3481,1256,3731
210465,202311,3172,8110,2565,7173,137,435,2094,5712,2231,6147
210467,202311,7312,19013,5895,16889,996,2592,3938,11450,4934,14042
210470,202311,2056,5349,1446,4355,208,563,941,2859,1149,3422
210480,202311,20450,54709,15793,47929,2413,5658,10075,32949,12488,38607
210490,202311,3819,8699,2750,7181,125,312,2216,5725,2341,6037
210500,202311,7719,25087,6745,23245,442,1614,5326,17983,5768,19597
210510,202311,8417,20828,6932,18850,185,678,6091,16149,6276,16827
210515,202311,4380,11604,3488,10322,242,748,2727,8051,2969,8799
210520,202311,3123,8163,2504,7171,184,522,1936,5411,2120,5933
210530,202311,69716,155684,46059,116326,9839,25419,20619,51834,30458,77253
210535,202311,4602,12341,3904,11237,200,582,3273,9362,3473,9944
210540,202311,18301,47050,13807,39669,2542,6334,7816,23546,10358,29880
210542,202311,7717,16635,5283,13480,595,1524,3762,9406,4357,10930
210545,202311,2490,7057,2074,6252,64,250,1660,4853,1724,5103
210547,202311,4460,14089,3721,12728,331,966,2712,9584,3043,10550
210550,202311,6953,19255,4771,15322,743,2383,2568,8241,3311,10624
210560,202311,4428,12436,3597,10949,165,515,2913,8712,3078,9227
210565,202311,1806,4628,1350,3919,90,238,923,2659,1013,2897
210570,202311,12952,32367,10588,28883,1134,2889,8144,22176,9278,25065
210580,202311,3408,7918,2440,6510,253,641,1703,4710,1956,5351
210590,202311,4821,12943,3770,11388,91,372,3130,9231,3221,9603
210592,202311,3359,8235,2840,7312,61,215,2398,5962,2459,6177
210594,202311,2893,7556,2011,5999,225,641,1301,3888,1526,4529
210596,202311,3535,10471,2900,9312,352,1105,2102,6807,2454,7912
210598,202311,2389,5851,2007,5298,120,292,1649,4315,1769,4607
210600,202311,3575,8984,2643,7488,418,1071,1559,4438,1977,5509
210610,202311,3729,8637,2813,7295,65,221,2319,5808,2384,6029
210620,202311,3544,7790,2698,6662,145,320,2241,5460,2386,5780
210630,202311,3797,10625,3121,9331,284,880,2253,6582,2537,7462
210632,202311,7313,16744,6143,15110,176,478,5346,12834,5522,13312
210635,202311,1840,6025,1634,5597,229,682,1144,4040,1373,4722
210637,202311,3332,9028,2628,7908,211,659,2000,6047,2211,6706
210640,202311,5954,16679,5305,15827,80,370,4706,13737,4786,14107
210650,202311,8207,20590,6743,18411,142,432,5830,15687,5972,16119
210660,202311,9441,24517,7642,21390,176,737,6520,17506,6696,18243
210663,202311,3681,8213,3024,7343,330,592,2177,5614,2507,6206
210667,202311,2243,6370,1870,5754,89,323,1524,4637,1613,4960
210670,202311,7029,17418,5947,15678,149,470,5130,13117,5279,13587
210675,202311,6587,14456,5206,12597,759,1665,3768,9126,4527,10791
210680,202311,5948,11884,4749,10404,104,247,4347,9389,4451,9636
210690,202311,11379,25372,8795,21983,259,683,7714,18651,7973,19334
210700,202311,3224,7850,2417,6606,174,377,1807,4913,1981,5290
210710,202311,6429,16502,5287,14830,130,465,4577,12585,4707,13050
210720,202311,3705,10136,3014,9171,136,493,2529,7598,2665,8091
210725,202311,1555,4387,1122,3531,58,166,764,2411,822,2577
210730,202311,1762,3609,1345,3029,44,87,1179,2628,1223,2715
210735,202311,5339,13288,4144,11567,439,1039,3109,8962,3548,10001
210740,202311,6397,14235,4959,12361,146,314,4133,10131,4279,10445
210745,202311,4981,11972,4078,10640,115,401,3448,8745,3563,9146
210750,202311,32774,77762,25359,65757,4580,10252,14584,39083,19164,49335
210760,202311,7862,15987,6261,14115,142,331,5696,12800,5838,13131
210770,202311,7274,16167,5687,14092,95,337,5014,12114,5109,12451
210780,202311,8758,24068,6790,20475,531,1548,4876,14326,5407,15874
210790,202311,5214,14154,4273,12701,367,1048,3204,9687,3571,10735
210800,202311,5875,13823,4646,12017,89,352,4058,10111,4147,10463
210805,202311,5085,15496,4350,14189,255,877,3356,10827,3611,11704
210810,202311,6030,15536,5001,13980,670,1591,3637,10483,4307,12074
210820,202311,8511,22008,6447,18373,1303,3403,3219,9309,4522,12712
210825,202311,10765,23892,9235,21765,240,663,8329,19092,8569,19755
210830,202311,10758,24957,9089,22608,931,1691,7137,18409,8068,20100
210840,202311,6075,10524,5196,9395,44,136,4916,8659,4960,8795
210845,202311,7338,17409,5748,15308,170,465,5041,13279,5211,13744
210850,202311,8679,21977,6781,19005,486,1400,5222,14310,5708,15710
210860,202311,26242,57147,19682,48273,2170,4460,14101,35422,16271,39882
210870,202311,8841,19195,6547,16292,227,515,5529,13569,5756,14084
210880,202311,4988,13097,3934,11337,269,847,2854,8030,3123,8877
210890,202311,6118,13216,5167,11848,182,472,4526,10049,4708,10521
210900,202311,5936,15354,4055,11747,1497,4205,827,2720,2324,6925
210905,202311,2751,5628,2227,4940,63,140,2061,4522,2124,4662
210910,202311,8933,24922,6544,20417,1629,4769,3000,9307,4629,14076
210920,202311,3755,10275,3125,9305,93,374,2707,7866,2800,8240
210923,202311,2336,5240,1867,4497,79,165,1494,3484,1573,3649
210927,202311,5484,16384,4406,14626,881,2580,2442,8486,3323,11066
210930,202311,3503,9023,2873,7926,110,323,2389,6351,2499,6674
210940,202311,3988,10833,3349,9951,261,1113,2595,7118,2856,8231
210945,202311,10330,23271,8641,21077,642,1212,6798,16824,7440,18036
210950,202311,6461,15892,4575,13015,716,1648,2820,8466,3536,10114
210955,202311,1809,4864,1356,4058,164,476,862,2518,1026,2994
210960,202311,11154,29520,8322,24273,3639,10267,1861,6218,5500,16485
210970,202311,2115,4853,1596,3943,89,235,1254,2930,1343,3165
210975,202311,1980,5497,1647,4907,251,728,1068,3143,1319,3871
210980,202311,12718,24726,10733,22420,423,593,9611,20097,10034,20690
210990,202311,22037,53233,15791,43945,1922,4801,10312,29147,12234,33948
211000,202311,17404,44284,13249,38303,3540,8735,7409,23129,10949,31864
211003,202311,7648,17499,6045,15447,134,511,5098,12684,5232,13195
211010,202311,8520,23819,7271,22027,207,858,6319,18836,6526,19694
211020,202311,11597,26406,9577,23833,227,632,8326,20518,8553,21150
211023,202311,2486,7074,2101,6425,139,393,1594,4779,1733,5172
211027,202311,4790,11649,4251,10812,96,315,3836,9513,3932,9828
211030,202311,4582,11398,3778,10129,493,1260,2676,7286,3169,8546
211040,202311,5386,16547,4683,15315,141,623,4030,12906,4171,13529
211050,202311,10943,24754,9018,22098,209,604,7782,18669,7991,19273
211060,202311,9337,22472,7938,20392,314,982,6803,16966,7117,17948
211065,202311,2952,6822,2227,5796,122,305,1817,4673,1939,4978
211070,202311,10355,27304,8194,23819,430,1319,6570,18716,7000,20035
211080,202311,1574,3761,1134,3007,38,145,848,2057,886,2202
211085,202311,2755,6715,2037,5679,252,612,1434,4132,1686,4744
211090,202311,3714,9093,3097,8212,51,177,2765,7197,2816,7374
211100,202311,9079,18552,7873,17013,107,260,7212,15343,7319,15603
211102,202311,3941,11035,3328,10042,627,1905,2189,6532,2816,8437
211105,202311,2774,7668,2208,6640,120,360,1716,5023,1836,5383
211107,202311,5519,15523,4274,13411,223,691,3319,10523,3542,11214
211110,202311,7751,17849,5746,14651,553,1252,4326,10865,4879,12117
211120,202311,63201,137398,46654,113939,8372,18223,27470,68664,35842,86887
211125,202311,2145,5818,1612,4919,46,172,1289,3831,1335,4003
211130,202311,226560,485732,178288,410647,26905,54520,112409,260472,139314,314992
211140,202311,5705,14849,4430,12797,261,738,3453,9865,3714,10603
211150,202311,11683,27364,8929,23408,603,1228,6675,18083,7278,19311
211153,202311,3714,8875,2326,6931,485,1283,1229,3892,1714,5175
211157,202311,1543,4206,1219,3595,125,399,786,2233,911,2632
211160,202311,6612,14274,4859,11608,196,627,3781,8438,3977,9065
211163,202311,1731,4947,1446,4463,80,265,1152,3563,1232,3828
211167,202311,2013,5151,1718,4694,37,112,1458,3912,1495,4024
211170,202311,8870,17198,7549,15491,127,357,6921,13791,7048,14148
211172,202311,3018,7595,2292,6379,101,285,1842,4906,1943,5191
211174,202311,3613,8936,3087,8283,64,219,2803,7416,2867,7635
211176,202311,4995,12595,3590,10370,242,724,2750,7745,2992,8469
211178,202311,6633,12350,5447,11004,59,225,5141,10115,5200,10340
211180,202311,4952,14198,4185,12893,167,602,3327,10040,3494,10642
211190,202311,3838,9432,3056,8214,75,275,2632,6850,2707,7125
211195,202311,1876,4361,1478,3714,72,175,1219,3000,1291,3175
211200,202311,2495,6806,1705,5274,196,576,1084,3250,1280,3826
211210,202311,7200,20040,5892,17877,652,1895,4235,12797,4887,14692
211220,202311,53777,114430,40307,95429,3980,8673,28654,66258,32634,74931
211223,202311,6305,15409,4492,12531,711,1918,2481,6793,3192,8711
211227,202311,2009,5562,1632,4974,76,283,1301,3934,1377,4217
211230,202311,10637,25385,8441,22024,349,744,7020,18134,7369,18878
211240,202311,13038,28590,11756,26969,158,554,10986,24743,11144,25297
211245,202311,9052,18833,7411,16978,218,524,6773,15293,6991,15817
211250,202311,18496,47178,15630,42418,1475,3992,11752,31293,13227,35285
211260,202311,10068,27026,8110,24502,295,965,6896,20733,7191,21698
211270,202311,12024,33096,9688,29691,551,1561,7362,22646,7913,24207
211280,202311,19446,40950,16115,36389,362,914,14353,31555,14715,32469
211285,202311,2458,6857,2005,6091,202,659,1366,4048,1568,4707
211290,202311,8648,22789,6998,19962,458,1324,5250,14623,5708,15947
211300,202311,8441,22478,6645,19182,472,1421,4731,13226,5203,14647
211400,202311,13902,33967,10332,28441,1686,4182,6346,18066,8032,22248
220005,202311,2366,5342,1899,4584,97,233,1530,3544,1627,3777
220010,202311,1782,4394,1270,3447,78,173,931,2489,1009,2662
220020,202311,5738,11897,4495,10072,297,583,3738,8151,4035,8734
220025,202311,2743,5307,2104,4331,63,125,1759,3476,1822,3601
220027,202311,1692,3543,1281,2901,38,97,1076,2349,1114,2446
220030,202311,4796,9939,3927,8621,144,323,3412,7269,3556,7592
220040,202311,10470,27238,8184,22787,1883,4767,4182,11931,6065,16698
220045,202311,1982,4863,1469,3976,64,254,1145,2867,1209,3121
220050,202311,6855,14332,5317,12170,87,294,4691,10234,4778,10528
220060,202311,3449,5869,2650,4922,96,200,2381,4336,2477,4536
220070,202311,2803,6457,2090,5379,108,304,1574,3863,1682,4167
220080,202311,880,2255,654,1858,26,108,491,1292,517,1400
220090,202311,2039,4250,1470,3367,49,127,1189,2640,1238,2767
220095,202311,1279,2252,1050,1943,29,69,939,1664,968,1733
220100,202311,1694,3958,1163,3051,57,180,879,2139,936,2319
220105,202311,2398,6445,1840,5438,213,611,1237,3641,1450,4252
220110,202311,4249,9917,3271,8302,82,303,2662,6549,2744,6852
220115,202311,3573,8989,2886,7830,182,511,2180,5676,2362,6187
220117,202311,1594,3411,1132,2695,27,82,929,2113,956,2195
220120,202311,20937,39578,17316,34816,264,708,15815,30935,16079,31643
220130,202311,1317,3057,1002,2593,31,108,851,2092,882,2200
220140,202311,2828,5135,2072,4205,98,171,1708,3460,1806,3631
220150,202311,7983,19694,6452,16866,222,679,5137,12811,5359,13490
220155,202311,1434,3713,1028,2944,36,108,717,1973,753,2081
220157,202311,1296,2777,987,2313,48,105,735,1643,783,1748
220160,202311,3518,8249,2626,6631,71,211,2085,5033,2156,5244
220170,202311,1809,4360,1300,3542,47,151,1020,2674,1067,2825
220173,202311,2515,6352,1738,4868,77,231,1349,3650,1426,3881
220177,202311,2865,6174,2464,5652,46,174,2241,4991,2287,5165
220180,202311,1411,2867,1020,2183,18,52,867,1729,885,1781
220190,202311,10285,20407,7758,16933,765,1339,5377,11905,6142,13244
220191,202311,2058,5232,1696,4592,141,404,1229,3193,1370,3597
220192,202311,2403,5665,1587,4231,56,180,1248,3232,1304,3412
220194,202311,2314,5337,1773,4329,48,175,1443,3301,1491,3476
220196,202311,2574,5818,2110,5021,38,114,1697,3862,1735,3976
220198,202311,1551,3397,1222,2962,26,80,1055,2546,1081,2626
220200,202311,6139,15801,4971,13941,203,626,3858,10534,4061,11160
220202,202311,2592,6223,1979,5170,50,150,1640,4125,1690,4275
220205,202311,3317,7571,2658,6380,63,195,2165,4965,2228,5160
220207,202311,961,2494,721,2049,93,245,416,1171,509,1416
220208,202311,2168,5980,1628,4911,605,1941,459,1294,1064,3235
220209,202311,1880,4953,1391,3965,22,95,1122,3114,1144,3209
220210,202311,2294,4608,1723,3704,41,102,1467,3017,1508,3119
220211,202311,1941,4134,1565,3588,28,87,1316,2937,1344,3024
220213,202311,2144,4957,1539,3819,50,146,1173,2679,1223,2825
220217,202311,2933,6834,2513,6315,166,294,2154,5570,2320,5864
220220,202311,16908,33339,13170,27694,509,1179,10868,21900,11377,23079
220225,202311,1230,2637,915,2215,14,51,807,1876,821,1927
220230,202311,6997,15096,5308,12524,408,963,4103,9357,4511,10320
220240,202311,4039,9723,3038,7947,106,354,2382,5912,2488,6266
220245,202311,2470,4293,1698,3336,27,85,1524,2891,1551,2976
220250,202311,3684,8738,2916,7670,72,211,2504,6453,2576,6664
220253,202311,2043,4903,1534,4071,67,192,1204,3092,1271,3284
220255,202311,2453,5025,1921,4243,68,195,1622,3398,1690,3593
220260,202311,6354,15088,4906,12526,280,690,3806,9503,4086,10193
220265,202311,1932,4872,1611,4355,90,283,1272,3273,1362,3556
220270,202311,7492,21261,6463,19197,228,836,5248,14751,5476,15587
220271,202311,1813,3945,1430,3335,71,160,1170,2664,1241,2824
220272,202311,2075,5392,1646,4551,86,253,1192,3153,1278,3406
220273,202311,1500,3922,1090,3147,86,263,762,2156,848,2419
220275,202311,3145,5964,2233,4701,84,139,1906,3943,1990,4082
220277,202311,2823,5847,2073,4669,103,216,1696,3659,1799,3875
220280,202311,2412,4392,1838,3631,27,64,1648,3195,1675,3259
220285,202311,2044,4048,1596,3464,23,61,1426,2999,1449,3060
220290,202311,8512,20672,6018,16726,621,1535,3857,10759,4478,12294
220300,202311,2286,5890,1590,4804,91,332,1131,3268,1222,3600
220310,202311,3939,9024,2816,7493,98,283,2300,6001,2398,6284
220320,202311,3764,9400,2630,7358,66,265,2047,5461,2113,5726
220323,202311,2075,5071,1445,3979,66,205,1135,2955,1201,3160
220325,202311,1494,4007,1097,3247,41,133,806,2297,847,2430
220327,202311,2057,4929,1585,4113,59,195,1245,3010,1304,3205
220330,202311,6624,13220,5187,11372,150,430,4415,9284,4565,9714
220335,202311,2227,5473,1852,4875,142,348,1464,3787,1606,4135
220340,202311,2098,5233,1386,3914,228,617,672,1857,900,2474
220342,202311,1499,3667,1202,3166,105,189,898,2409,1003,2598
220345,202311,3609,7253,2475,5611,36,98,2127,4668,2163,4766
220350,202311,3927,9025,2726,6998,266,687,1771,4384,2037,5071
220360,202311,1622,3574,1134,2753,25,76,891,2044,916,2120
220370,202311,11107,27568,9139,24198,541,1460,7233,18674,7774,20134
220375,202311,2100,4818,1740,4338,37,128,1616,3957,1653,4085
220380,202311,1890,3784,1339,2970,39,82,1145,2515,1184,2597
220385,202311,1120,2196,791,1640,13,38,701,1386,714,1424
220390,202311,16574,34341,11715,26741,2474,5296,6064,13639,8538,18935
220400,202311,1824,3909,1192,2861,35,103,915,2028,950,2131
220410,202311,1447,3527,1016,2735,32,97,795,2021,827,2118
220415,202311,993,2337,713,1829,28,62,512,1277,540,1339
220420,202311,2230,5757,1553,4407,240,627,887,2426,1127,3053
220430,202311,3570,7622,2799,6499,81,186,2379,5389,2460,5575
220435,202311,2527,5367,1957,4426,62,161,1592,3461,1654,3622
220440,202311,3974,9041,3119,7723,77,307,2655,6211,2732,6518
220450,202311,3368,7383,2551,6180,64,223,2152,4998,2216,5221
220455,202311,1787,4214,1551,3876,24,77,1355,3344,1379,3421
220460,202311,1371,2782,1127,2414,29,54,953,1975,982,2029
220465,202311,3014,7929,2435,6931,196,479,1801,5023,1997,5502
220470,202311,4716,11187,3619,9221,212,475,2670,6592,2882,7067
220480,202311,3176,7497,2185,5784,266,542,1362,3616,1628,4158
220490,202311,2915,6398,2162,5279,33,100,1859,4402,1892,4502
220500,202311,4096,8716,2979,6879,198,333,2210,4952,2408,5285
220510,202311,3282,7572,2367,5931,205,495,1735,4367,1940,4862
220515,202311,2232,4535,1854,3953,65,96,1584,3331,1649,3427
220520,202311,6363,13938,5050,11825,160,442,4078,9165,4238,9607
220525,202311,1684,3565,1284,3034,38,83,1092,2576,1130,2659
220527,202311,2034,4284,1543,3490,81,174,1338,2978,1419,3152
220530,202311,2014,4007,1477,3293,191,387,1025,2328,1216,2715
220535,202311,934,2318,804,2085,25,71,611,1480,636,1551
220540,202311,3849,10645,3197,9364,263,721,2345,6796,2608,7517
220545,202311,1841,4689,1485,4086,86,283,1206,3210,1292,3493
220550,202311,10588,29897,8336,25239,666,2005,5432,15638,6098,17643
220551,202311,1770,4166,1378,3458,21,46,1142,2775,1163,2821
220552,202311,1888,4931,1382,3947,34,131,1068,2874,1102,3005
220553,202311,2619,5099,1987,4221,34,77,1765,3661,1799,3738
220554,202311,1185,2541,840,1999,74,153,612,1420,686,1573
220555,202311,4794,8844,3812,7575,77,233,3266,6373,3343,6606
220556,202311,1579,3883,1113,2942,40,146,758,1796,798,1942
220557,202311,2306,5971,1550,4422,106,335,1103,2964,1209,3299
220558,202311,1779,4069,1291,3313,44,132,1061,2611,1105,2743
220559,202311,2247,4773,1708,3869,72,136,1386,3097,1458,3233
220560,202311,2366,4531,1793,3794,40,109,1583,3258,1623,3367
220570,202311,9930,25489,8199,22516,881,2194,5633,15190,6514,17384
220580,202311,8085,19347,6608,16947,217,638,5591,14012,5808,14650
220585,202311,2530,6879,1827,5406,79,228,1339,3849,1418,4077
220590,202311,2057,4280,1531,3446,105,211,1188,2597,1293,2808
220595,202311,3381,8037,2697,6961,86,283,2179,5354,2265,5637
220600,202311,2219,3795,1676,3112,35,63,1530,2790,1565,2853
220605,202311,1698,4557,1300,3748,49,176,929,2538,978,2714
220610,202311,3590,8506,3056,7714,74,225,2718,6725,2792,6950
220620,202311,11033,26115,9190,23287,175,664,8056,19703,8231,20367
220630,202311,405,1094,281,860,29,100,165,449,194,549
220635,202311,2184,5601,1714,4653,52,133,1378,3634,1430,3767
220640,202311,2918,7161,2234,5968,84,256,1723,4407,1807,4663
220650,202311,3039,6672,2363,5602,76,188,1985,4649,2061,4837
220660,202311,3198,8508,2341,6896,102,389,1788,5024,1890,5413
220665,202311,1739,4228,1346,3568,41,149,1119,2822,1160,2971
220667,202311,1902,4972,1557,4327,77,231,1194,3192,1271,3423
220669,202311,1998,5235,1713,4731,47,153,1444,3873,1491,4026
220670,202311,2865,5959,2060,4790,47,122,1746,3948,1793,4070
220672,202311,4102,9102,3086,7705,110,316,2522,6033,2632,6349
220675,202311,1583,3850,1273,3265,116,302,899,2215,1015,2517
220680,202311,3782,7812,3291,7105,135,219,2944,6345,3079,6564
220690,202311,1892,4400,1398,3564,115,329,1007,2429,1122,2758
220695,202311,1102,2726,904,2372,35,93,733,1884,768,1977
220700,202311,15638,29741,11567,23958,453,989,9367,18382,9820,19371
220710,202311,1060,2558,682,1863,28,94,525,1360,553,1454
220720,202311,2718,5393,2181,4629,34,81,1868,3823,1902,3904
220730,202311,1744,3933,1325,3228,23,72,1119,2579,1142,2651
220735,202311,1220,2442,820,1790,46,94,620,1281,666,1375
220740,202311,1625,3751,1147,3034,83,192,865,2256,948,2448
220750,202311,5383,10983,4258,9391,243,399,3694,8153,3937,8552
220755,202311,1828,3695,1310,2914,49,100,1055,2288,1104,2388
220760,202311,4134,9103,3328,8037,59,168,2993,7089,3052,7257
220770,202311,36001,88671,27537,73107,9038,23294,9058,24671,18096,47965
220775,202311,1781,3683,1433,3229,41,121,1236,2713,1277,2834
220777,202311,1825,4087,1299,3234,35,79,917,2331,952,2410
220779,202311,1487,3570,1159,3037,190,314,810,2257,1000,2571
220780,202311,7388,15795,6083,13850,502,1062,4558,10279,5060,11341
220785,202311,1764,3512,1414,3040,24,57,1320,2789,1344,2846
220790,202311,12917,30751,10613,27114,363,1078,8491,21078,8854,22156
220793,202311,1197,2666,880,2139,25,85,743,1749,768,1834
220795,202311,1647,3771,1304,3246,64,195,1083,2600,1147,2795
220800,202311,26703,50335,20272,41029,2071,4203,14761,28403,16832,32606
220810,202311,3833,9091,2870,7468,92,231,2224,5754,2316,5985
220820,202311,7459,15452,6013,13262,364,638,4895,10727,5259,11365
220830,202311,9455,20980,7571,17933,423,919,5789,13172,6212,14091
220840,202311,17149,41540,13142,33808,1662,3934,8483,20937,10145,24871
220850,202311,3601,9638,2974,8669,67,272,2559,7302,2626,7574
220855,202311,1056,1962,848,1691,24,50,772,1520,796,1570
220860,202311,1510,2899,1183,2441,24,56,1058,2113,1082,2169
220865,202311,2705,6659,1835,4999,53,183,1309,3345,1362,3528
220870,202311,3999,8840,2940,7338,87,297,2421,5782,2508,6079
220880,202311,8321,14622,6595,12500,188,371,5822,10754,6010,11125
220885,202311,1841,4358,1414,3673,168,392,1024,2653,1192,3045
220887,202311,1999,3644,1488,2964,56,85,1341,2655,1397,2740
220890,202311,1680,4439,1261,3670,78,278,916,2588,994,2866
220900,202311,2646,5233,2011,4322,40,116,1731,3541,1771,3657
220910,202311,2173,4696,1659,3885,363,635,1041,2609,1404,3244
220915,202311,1088,2683,707,1960,45,136,509,1304,554,1440
220920,202311,2008,5015,1518,4188,128,326,1076,2875,1204,3201
220930,202311,2444,5094,1847,4265,49,145,1583,3657,1632,3802
220935,202311,1269,3319,887,2501,20,78,588,1547,608,1625
220937,202311,1772,4055,1289,3204,40,134,1033,2400,1073,2534
220940,202311,2314,4787,1703,3800,44,97,1377,2954,1421,3051
220945,202311,600,1826,415,1425,29,124,249,812,278,936
220950,202311,1653,3340,1008,2313,16,43,830,1789,846,1832
220955,202311,2060,4354,1508,3447,39,114,1227,2673,1266,2787
220960,202311,891,2094,560,1498,58,183,327,781,385,964
220965,202311,2287,5100,1808,4339,26,105,1566,3580,1592,3685
220970,202311,2615,4993,1796,3798,26,65,1553,3149,1579,3214
220975,202311,931,2149,677,1768,30,86,543,1361,573,1447
220980,202311,1639,3646,1348,3188,37,104,1131,2579,1168,2683
220985,202311,1815,3782,1388,3042,91,158,1065,2288,1156,2446
220987,202311,1858,4591,1490,3930,38,135,1235,3156,1273,3291
220990,202311,2008,4898,1552,4115,51,127,1265,3275,1316,3402
220995,202311,1729,3823,1306,3117,34,88,1089,2535,1123,2623
220997,202311,2916,7405,2416,6514,55,183,2031,5207,2086,5390
221000,202311,5994,13706,4590,11474,241,671,3528,8394,3769,9065
221005,202311,2008,4413,1646,3778,33,94,1391,3012,1424,3106
221010,202311,1334,2724,901,2146,28,88,733,1651,761,1739
221020,202311,1842,5011,1455,4252,43,149,1084,3084,1127,3233
221030,202311,2079,4181,1582,3468,34,93,1372,2934,1406,3027
221035,202311,1880,4142,1354,3334,62,147,1088,2645,1150,2792
221037,202311,847,2008,604,1528,23,47,444,1044,467,1091
221038,202311,625,1540,441,1211,57,139,263,693,320,832
221039,202311,993,2410,744,1993,41,123,562,1426,603,1549
221040,202311,5571,13723,4060,10980,317,847,2908,7608,3225,8455
221050,202311,5666,11081,4616,9622,106,256,4136,8432,4242,8688
221060,202311,12184,28590,8875,22768,782,1659,6366,16069,7148,17728
221062,202311,1661,4102,1286,3482,138,308,880,2406,1018,2714
221063,202311,1526,3529,1111,2772,50,153,875,2061,925,2214
221065,202311,3596,7573,2823,6323,56,122,2461,5349,2517,5471
221070,202311,4038,11074,2935,8802,569,1619,1554,4762,2123,6381
221080,202311,4461,9464,3339,7766,74,214,2707,5891,2781,6105
221090,202311,1708,3609,1292,2941,24,66,1116,2446,1140,2512
221093,202311,2110,4668,1685,3902,204,394,1155,2622,1359,3016
221095,202311,1081,2482,813,2069,69,158,602,1519,671,1677
221097,202311,998,2256,668,1681,23,62,492,1160,515,1222
221100,202311,192035,418782,144577,336778,12137,29032,99593,217193,111730,246225
221110,202311,14342,33500,11834,29827,458,1215,9739,23879,10197,25094
221120,202311,6195,15625,4888,13395,234,735,3801,10060,4035,10795
221130,202311,7316,15625,5087,11593,1461,2784,2404,5653,3865,8437
221135,202311,2421,5142,1923,4452,92,175,1605,3741,1697,3916
221140,202311,1934,3535,1447,2899,69,133,1209,2343,1278,2476
221150,202311,1359,3012,879,2194,33,84,664,1544,697,1628
221160,202311,911,1971,700,1636,43,72,527,1212,570,1284
221170,202311,1375,3022,1177,2678,37,96,1025,2271,1062,2367
230010,202311,3592,8440,2516,6474,254,563,1822,4571,2076,5134
230015,202311,4555,11815,3659,9955,233,649,2479,6558,2712,7207
230020,202311,18951,47986,16363,43590,1670,3635,12052,32262,13722,35897
230030,202311,15649,34390,11750,28475,795,1594,8651,21275,9446,22869
230040,202311,5720,12115,4406,10063,151,406,3323,7628,3474,8034
230050,202311,3039,8702,1991,6164,381,1075,848,2387,1229,3462
230060,202311,3048,7039,2105,5350,49,168,1670,4061,1719,4229
230070,202311,5553,12072,3752,8819,765,1673,2200,5073,2965,6746
230075,202311,12388,32553,10430,28989,1435,2898,7071,20074,8506,22972
230080,202311,3698,6843,2646,5505,21,52,2395,4869,2416,4921
230090,202311,5636,11646,4150,9219,187,377,3438,7349,3625,7726
230100,202311,28284,60131,22004,50375,2957,6170,14084,31865,17041,38035
230110,202311,17953,46228,13473,37208,3703,9135,5161,14396,8864,23531
230120,202311,9895,23022,7478,18867,1171,2670,4519,11264,5690,13934
230125,202311,3768,8853,2895,7363,168,392,2135,5186,2303,5578
230130,202311,7011,18655,5049,14549,581,1390,3242,9233,3823,10623
230140,202311,4335,11261,3197,8882,94,282,2362,6187,2456,6469
230150,202311,1924,5020,1427,3974,275,694,722,2042,997,2736
230160,202311,8909,17920,6867,14815,356,630,5538,11649,5894,12279
230170,202311,7592,19281,5435,14927,582,1445,3534,9408,4116,10853
230180,202311,2017,4770,1460,3712,27,77,1193,2888,1220,2965
230185,202311,5820,13376,4247,10718,619,1402,2615,6651,3234,8053
230190,202311,18704,50282,12757,37583,2533,6662,5728,16532,8261,23194
230195,202311,7198,18130,5869,15695,425,951,4357,11543,4782,12494
230200,202311,6046,14877,4593,12088,403,988,3194,8069,3597,9057
230205,202311,5712,13337,4681,11782,660,1257,3229,8351,3889,9608
230210,202311,13357,26947,10506,22828,416,844,8511,17708,8927,18552
230220,202311,19165,41337,15435,35762,1576,3105,11225,25585,12801,28690
230230,202311,8807,21885,7316,18936,905,1812,5056,13193,5961,15005
230240,202311,16985,37804,12880,30955,1075,1888,9172,21552,10247,23440
230250,202311,11885,28419,9789,24658,2745,5953,4400,11112,7145,17065
230260,202311,18813,47038,14604,39116,2265,5363,8631,22810,10896,28173
230270,202311,8717,20915,5903,15633,1150,2744,3039,8265,4189,11009
230280,202311,24909,56066,18810,45505,546,1731,14947,33487,15493,35218
230290,202311,5987,13581,4878,11611,248,550,3861,8878,4109,9428
230300,202311,6253,13939,5044,12159,89,279,4295,10036,4384,10315
230310,202311,5964,14881,4273,11578,187,539,3048,7828,3235,8367
230320,202311,9439,23890,7169,19833,260,887,5276,13850,5536,14737
230330,202311,5943,13949,4040,10302,260,551,2943,7263,3203,7814
230340,202311,4652,12921,3588,10637,388,1091,2244,6467,2632,7558
230350,202311,23669,54396,18578,45954,1537,3830,12691,30122,14228,33952
230360,202311,3760,8501,2668,6679,148,319,1938,4832,2086,5151
230365,202311,3787,7857,2969,6651,95,237,2553,5609,2648,5846
230370,202311,107498,223540,86684,191251,6793,14746,65199,137676,71992,152422
230380,202311,7493,18349,5321,14210,138,422,3988,10057,4126,10479
230390,202311,4136,10365,3281,8931,81,308,2529,6593,2610,6901
230393,202311,4271,10275,3092,8031,77,305,2433,5926,2510,6231
230395,202311,6939,16962,5112,13491,534,1358,3301,8278,3835,9636
230400,202311,7198,16748,5639,14084,167,513,4495,10531,4662,11044
230410,202311,16818,43625,12565,35738,1741,4403,7716,21649,9457,26052
230420,202311,39685,91976,28398,71322,3842,8922,16562,39530,20404,48452
230423,202311,5493,14484,4378,12179,364,976,3005,8092,3369,9068
230425,202311,7826,20396,6642,17962,837,2037,4407,11747,5244,13784
230426,202311,3340,7579,2139,5300,94,257,1570,3684,1664,3941
230427,202311,2198,5483,1305,3587,111,318,846,2141,957,2459
230428,202311,12833,30754,9847,25523,1714,4264,5041,12399,6755,16663
230430,202311,6011,15263,4196,11862,229,553,3053,8342,3282,8895
230435,202311,8027,17723,5440,13192,870,1965,2988,7052,3858,9017
230440,202311,637104,1279171,485483,1042239,41138,89598,340145,688873,381283,778471
230445,202311,5007,12291,3677,9820,474,1070,2213,5676,2687,6746
230450,202311,4695,11399,3610,9517,242,680,2539,6222,2781,6902
230460,202311,2743,6310,2193,5438,84,259,1761,4229,1845,4488
230465,202311,5066,12313,3736,9719,479,900,2534,6646,3013,7546
230470,202311,14596,40448,12155,35757,1436,3212,8123,23672,9559,26884
230480,202311,1924,4630,1367,3596,79,222,964,2360,1043,2582
230490,202311,3428,8371,2476,6522,251,633,1517,3665,1768,4298
230495,202311,7695,18261,5833,14775,1093,2419,3310,8177,4403,10596
230500,202311,11636,32714,9224,27985,853,2191,6472,19676,7325,21867
230510,202311,2193,5212,1560,3969,178,448,960,2284,1138,2732
230520,202311,5986,13958,4725,11732,375,862,3489,8364,3864,9226
230523,202311,21698,56231,13601,38421,3225,8637,3324,9681,6549,18318
230526,202311,4863,11476,3626,9314,259,489,2652,6872,2911,7361
230530,202311,6763,18895,5166,15726,1374,3977,2516,7748,3890,11725
230533,202311,6099,11402,4241,8655,105,273,3556,6816,3661,7089
230535,202311,5890,15199,4407,12455,439,1197,2661,7334,3100,8531
230540,202311,18792,45602,14342,37890,394,1225,11405,28798,11799,30023
230550,202311,28782,64102,20677,49856,3563,6601,12277,29706,15840,36307
230560,202311,9243,19303,6515,15044,735,997,4820,11765,5555,12762
230565,202311,3673,8880,2860,7407,142,356,2168,5380,2310,5736
230570,202311,4070,9301,3006,7520,90,274,2403,5733,2493,6007
230580,202311,15360,32686,11983,27487,1109,1865,9372,21485,10481,23350
230590,202311,11961,28733,8955,23353,850,1979,6166,15713,7016,17692
230600,202311,4695,10345,3354,8077,414,754,2076,5140,2490,5894
230610,202311,8464,20377,6781,17501,662,1510,4912,12571,5574,14081
230620,202311,2805,6158,1993,4660,71,208,1496,3183,1567,3391
230625,202311,13600,31622,10242,25223,2136,5273,5006,11583,7142,16856
230630,202311,14480,35646,11416,29927,1902,4158,6586,17492,8488,21650
230640,202311,32989,89940,26903,78434,2116,5882,19004,53185,21120,59067
230650,202311,6403,15004,4907,12416,432,867,3683,9103,4115,9970
230655,202311,12304,33811,10980,31387,936,2280,8536,24353,9472,26633
230660,202311,7321,18851,5428,15368,194,689,4111,11112,4305,11801
230670,202311,7185,15165,4669,11127,277,584,3615,8314,3892,8898
230680,202311,3502,8319,2456,6366,182,392,1669,4253,1851,4645
230690,202311,8645,22569,6235,17577,585,1566,3709,10214,4294,11780
230700,202311,13029,28290,9218,21352,347,979,7116,15516,7463,16495
230710,202311,8255,22963,6234,18312,757,2049,3789,10619,4546,12668
230720,202311,2345,6133,1635,4692,138,368,993,2710,1131,3078
230725,202311,6039,15360,5046,13556,909,2188,2843,7582,3752,9770
230730,202311,77368,177837,53500,138459,12447,30472,21621,56463,34068,86935
230740,202311,7358,18138,5547,15013,151,427,4182,11044,4333,11471
230750,202311,10365,24179,7197,18373,171,545,5790,13875,5961,14420
230760,202311,14706,33807,11130,27528,760,1847,7783,18133,8543,19980
230763,202311,5803,13761,4275,11047,99,350,3379,8141,3478,8491
230765,202311,60190,139463,45716,113478,4981,12482,29098,67959,34079,80441
230770,202311,36241,71255,27445,58697,1995,4225,20220,41269,22215,45494
230780,202311,8334,24632,6793,21005,1066,2887,3997,12415,5063,15302
230790,202311,3987,9480,3361,8440,161,408,2550,6078,2711,6486
230800,202311,11267,29867,8777,24609,1352,3331,5059,13679,6411,17010
230810,202311,13210,35443,10311,29596,1240,2785,6732,19180,7972,21965
230820,202311,4504,12688,3165,9690,482,1340,1715,5077,2197,6417
230830,202311,9173,21633,6804,17320,381,883,4984,12067,5365,12950
230835,202311,4951,10478,3438,8032,134,293,2883,6480,3017,6773
230837,202311,5137,11221,4149,9705,79,241,3649,8121,3728,8362
230840,202311,11761,30736,9195,25972,956,2487,6265,17462,7221,19949
230850,202311,12401,29784,9526,24564,662,1469,6944,17612,7606,19081
230860,202311,8023,14771,6135,12050,192,369,5405,10266,5597,10635
230870,202311,22792,44869,17159,35685,1241,2046,13292,26884,14533,28930
230880,202311,2391,6415,2009,5641,87,301,1512,3998,1599,4299
230890,202311,5699,15779,4692,13836,318,948,3220,9261,3538,10209
230900,202311,4164,10243,3144,8210,437,941,1922,4938,2359,5879
230910,202311,4250,9267,3083,7482,72,261,2560,5970,2632,6231
230920,202311,5822,14254,4167,11303,151,403,3120,8127,3271,8530
230930,202311,8469,20924,6079,16504,1162,2407,3304,9251,4466,11658
230940,202311,10283,22338,7926,18605,259,556,6595,15102,6854,15658
230945,202311,7915,19802,6189,16541,633,1352,4118,10731,4751,12083
230950,202311,7847,16776,6128,14160,241,618,5057,11335,5298,11953
230960,202311,15879,40836,11808,32381,2106,5462,5684,14770,7790,20232
230970,202311,20051,46549,15063,37833,2178,4966,8780,21448,10958,26414
230980,202311,4349,9282,3355,7594,318,586,2424,5435,2742,6021
230990,202311,2050,5057,1538,4085,87,292,1119,2767,1206,3059
231000,202311,3809,8206,2626,6139,84,213,2040,4515,2124,4728
231010,202311,4434,8993,3025,6730,79,175,2485,5286,2564,5461
231020,202311,11501,28601,9301,24345,1799,4075,5354,14175,7153,18250
231025,202311,10704,24311,8789,21138,647,1430,6656,15622,7303,17052
231030,202311,8847,23804,6050,18046,897,2572,3408,10026,4305,12598
231040,202311,3854,8741,3013,7257,142,337,2440,5600,2582,5937
231050,202311,14948,32514,10402,24392,674,1632,7982,17895,8656,19527
231060,202311,3607,8664,2896,7485,146,410,2241,5643,2387,6053
231070,202311,9871,25015,7827,21250,944,2170,4983,13317,5927,15487
231080,202311,4562,11391,3264,8947,272,691,2159,5765,2431,6456
231085,202311,9039,19220,6372,15344,438,912,4504,10444,4942,11356
231090,202311,5241,12221,3533,8971,220,535,2438,5898,2658,6433
231095,202311,2665,7272,1837,5471,173,506,1183,3390,1356,3896
231100,202311,3616,9222,2702,7491,164,478,1961,5202,2125,5680
231110,202311,4487,11852,3693,10194,1533,3657,1178,3415,2711,7072
231120,202311,2996,7274,2276,6012,129,265,1665,4280,1794,4545
231123,202311,2442,5580,1632,4084,122,296,1064,2504,1186,2800
231126,202311,6766,16219,4820,12595,461,989,3472,9018,3933,10007
231130,202311,31468,63078,23783,52185,1348,3147,18123,36701,19471,39848
231135,202311,5071,12585,3774,10059,284,656,2607,6778,2891,7434
231140,202311,21981,51712,16212,41468,2030,4664,10367,25478,12397,30142
231150,202311,7014,17215,4217,11468,821,2119,1579,4038,2400,6157
231160,202311,8779,22121,6973,18555,953,2164,4337,11367,5290,13531
231170,202311,5677,14385,4227,11550,353,924,2983,7785,3336,8709
231180,202311,19824,47551,14122,35968,2302,5438,7417,18083,9719,23521
231190,202311,5211,12406,3625,9514,108,337,2797,6929,2905,7266
231195,202311,6003,16360,4516,13412,335,939,3097,9171,3432,10110
231200,202311,10485,25220,8321,21119,138,470,7133,17085,7271,17555
231210,202311,5971,15062,4492,12406,138,491,3505,9140,3643,9631
231220,202311,16360,35089,11217,25883,969,1664,7948,17669,8917,19333
231230,202311,12255,34347,9858,29622,994,2889,6654,19592,7648,22481
231240,202311,14795,38982,11084,30973,1801,4532,6006,16250,7807,20782
231250,202311,2521,5340,1382,3050,130,256,976,2017,1106,2273
231260,202311,4109,9658,3109,7954,434,924,1955,5003,2389,5927
231270,202311,7841,17450,5594,13570,164,530,4278,9622,4442,10152
231280,202311,2317,6141,1800,5187,148,404,1185,3352,1333,3756
231290,202311,45424,119859,32228,91676,5285,13469,15798,43238,21083,56707
231300,202311,5140,12368,3470,9004,415,938,2022,5033,2437,5971
231310,202311,10853,22393,7575,16560,468,1201,5613,11415,6081,12616
231320,202311,7887,20310,5702,16106,404,807,4120,11602,4524,12409
231325,202311,2912,6736,1945,4966,130,275,1368,3411,1498,3686
231330,202311,14384,35090,10490,27822,1423,3435,6680,17323,8103,20758
231335,202311,6708,15606,5251,13369,175,486,4309,10670,4484,11156
231340,202311,22968,62095,18309,53265,1901,5415,12423,35837,14324,41252
231350,202311,19970,47362,16395,41679,658,1557,13514,33513,14172,35070
231355,202311,5544,14214,4485,12254,352,866,3381,8930,3733,9796
231360,202311,9908,26149,7661,21960,444,1319,5759,15921,6203,17240
231370,202311,2462,6078,1713,4646,87,289,1239,3204,1326,3493
231375,202311,5033,13525,4137,11882,206,568,3044,8701,3250,9269
231380,202311,7471,16765,6174,14938,203,449,5037,11959,5240,12408
231390,202311,4120,10692,3336,9219,100,345,2506,6549,2606,6894
231395,202311,5463,13479,4174,11163,260,647,2973,7700,3233,8347
231400,202311,12274,29645,9404,24344,404,1131,7018,17133,7422,18264
231410,202311,20295,50408,16736,44371,826,2112,13553,35062,14379,37174
240010,202311,3017,7043,1985,5059,327,818,928,2226,1255,3044
240020,202311,18069,41096,13342,32387,920,2521,9147,20416,10067,22937
240030,202311,4896,8978,3862,7469,115,279,3309,5999,3424,6278
240040,202311,948,2441,671,1916,25,72,454,1224,479,1296
240050,202311,4242,9970,2985,7664,91,220,2147,5260,2238,5480
240060,202311,1819,4165,1278,3198,42,90,975,2356,1017,2446
240070,202311,3374,8262,2444,6146,246,599,1605,3702,1851,4301
240080,202311,3517,8505,2401,6383,162,458,1564,3882,1726,4340
240090,202311,2840,5822,2087,4588,50,92,1747,3755,1797,3847
240100,202311,13540,27919,9542,20931,323,869,7445,15050,7768,15919
240110,202311,6326,15450,4555,11943,314,865,3106,7529,3420,8394
240120,202311,4138,10415,3079,8582,330,911,1915,5054,2245,5965
240130,202311,4929,8417,3691,6768,54,137,3336,5921,3390,6058
240140,202311,2191,6030,1594,4773,189,620,901,2443,1090,3063
240145,202311,8725,21579,6338,17184,617,1698,3965,10197,4582,11895
240150,202311,1343,3078,980,2400,67,167,676,1546,743,1713
240160,202311,1815,4556,1317,3617,44,149,969,2501,1013,2650
240165,202311,1174,2835,823,2128,27,93,648,1568,675,1661
240170,202311,3496,8002,2592,6361,323,765,1643,3844,1966,4609
240180,202311,3700,9675,2676,7533,532,1420,1272,3562,1804,4982
240185,202311,1792,4738,1465,4113,40,150,1153,3065,1193,3215
240190,202311,1394,3262,1003,2588,38,119,739,1790,777,1909
240200,202311,16536,34565,11601,25961,1988,3958,6358,13744,8346,17702
240210,202311,4229,8493,3148,6725,58,184,2622,5241,2680,5425
240220,202311,8756,23325,7118,20308,586,1877,4974,13540,5560,15417
240230,202311,6980,15581,5021,12239,435,816,3380,8323,3815,9139
240240,202311,2188,5757,1349,3904,253,755,463,1112,716,1867
240250,202311,3696,8183,2724,6521,72,230,2119,4709,2191,4939
240260,202311,20498,51847,16149,44087,4655,12015,6178,18230,10833,30245
240270,202311,3103,7821,2178,6037,140,410,1393,3795,1533,4205
240280,202311,1911,4399,1398,3505,69,146,1043,2544,1112,2690
240290,202311,1345,3475,991,2687,26,87,655,1630,681,1717
240300,202311,2645,6062,1759,4492,128,342,1087,2618,1215,2960
240310,202311,10588,25192,7321,18935,1404,3339,3256,8181,4660,11520
240320,202311,2275,5678,1403,3958,111,317,904,2358,1015,2675
240325,202311,49518,110620,35738,86165,5080,11868,20450,46114,25530,57982
240330,202311,2186,5295,1481,3958,88,277,985,2453,1073,2730
240340,202311,2480,4869,1740,3677,51,122,1414,2799,1465,2921
240350,202311,3108,6417,2525,5659,99,275,2132,4617,2231,4892
240360,202311,16800,39217,13260,33004,1987,4747,7978,19099,9965,23846
240370,202311,2689,5701,1796,4057,155,343,1224,2551,1379,2894
240375,202311,1161,2461,836,1897,37,106,609,1263,646,1369
240380,202311,2817,6942,1971,5189,261,652,1141,2831,1402,3483
240390,202311,1143,2580,684,1717,32,69,402,924,434,993
240400,202311,1674,3802,1145,2892,53,135,764,1781,817,1916
240410,202311,718,1912,502,1476,67,219,250,644,317,863
240420,202311,6497,18579,5139,15497,428,1404,3311,9271,3739,10675
240430,202311,4248,9504,3039,7310,159,400,2242,5043,2401,5443
240440,202311,3444,6860,2579,5506,218,473,1942,3965,2160,4438
240450,202311,5047,12329,3525,9309,232,685,2257,5311,2489,5996
240460,202311,4221,9776,3370,8350,311,721,2429,5808,2740,6529
240470,202311,4125,11231,2672,8011,865,2252,891,2895,1756,5147
240480,202311,668,1686,366,1032,21,46,166,459,187,505
240485,202311,2490,6367,1743,4864,153,456,995,2670,1148,3126
240490,202311,2019,4379,1386,3244,90,168,1020,2292,1110,2460
240500,202311,2645,6277,2042,5164,121,304,1577,3841,1698,4145
240510,202311,2053,4866,1553,3964,117,350,1138,2673,1255,3023
240520,202311,1985,3977,1350,3059,119,228,1040,2278,1159,2506
240530,202311,2878,6836,2321,5899,188,345,1754,4404,1942,4749
240540,202311,2757,5873,2185,4970,58,187,1866,4083,1924,4270
240550,202311,1061,2347,843,1964,133,251,595,1416,728,1667
240560,202311,4791,10079,3895,8794,188,348,3189,7072,3377,7420
240570,202311,3385,8115,1878,4827,308,765,688,1511,996,2276
240580,202311,10789,26480,8544,22280,656,1717,6443,16088,7099,17805
240590,202311,1124,2173,806,1673,40,110,616,1175,656,1285
240600,202311,2121,5056,1376,3580,53,146,948,2297,1001,2443
240610,202311,5537,12510,4292,10196,369,854,2881,6504,3250,7358
240615,202311,1580,3513,1122,2727,76,192,785,1768,861,1960
240620,202311,2408,5705,1844,4689,53,164,1497,3610,1550,3774
240630,202311,2948,6334,2410,5470,255,433,1748,3999,2003,4432
240640,202311,1076,2564,750,1982,38,100,554,1383,592,1483
240650,202311,4827,12929,3520,10185,418,1095,2101,6007,2519,7102
240660,202311,5383,9650,4274,8274,122,289,3673,6862,3795,7151
240670,202311,3174,7652,2105,5434,222,535,1283,3056,1505,3591
240680,202311,1929,4453,1372,3457,126,307,965,2324,1091,2631
240690,202311,1490,3127,1062,2404,22,70,882,1858,904,1928
240700,202311,2845,7416,2075,5965,121,308,1457,4051,1578,4359
240710,202311,25490,52239,19524,42514,2466,5056,12838,27096,15304,32152
240720,202311,6329,14467,4637,11509,800,1992,2616,6252,3416,8244
240725,202311,1306,3371,909,2617,65,180,572,1561,637,1741
240730,202311,2688,6639,1942,5222,79,258,1395,3543,1474,3801
240740,202311,2286,5671,1616,4311,125,390,1079,2619,1204,3009
240750,202311,2779,7826,2182,6548,247,756,1336,3789,1583,4545
240760,202311,2065,4133,1313,2999,115,242,907,2116,1022,2358
240770,202311,4051,9462,3104,7976,111,356,2450,5947,2561,6303
240780,202311,6671,15742,5018,12813,740,1701,3042,7474,3782,9175
240790,202311,1076,2645,753,2022,20,72,518,1263,538,1335
240800,202311,75015,149943,51602,110939,6875,13608,30955,62104,37830,75712
240810,202311,142575,299337,112423,248988,12209,25547,75755,160293,87964,185840
240820,202311,8284,21288,6513,17831,1231,3129,3586,9651,4817,12780
240830,202311,10714,25995,8447,22198,499,1319,6386,16218,6885,17537
240840,202311,1300,2930,896,2203,48,105,606,1411,654,1516
240850,202311,1666,4131,1016,2720,101,234,574,1462,675,1696
240860,202311,1869,3969,1313,3008,34,97,1104,2393,1138,2490
240870,202311,1267,2852,854,2105,204,470,412,1004,616,1474
240880,202311,1569,4425,1237,3728,96,311,801,2280,897,2591
240890,202311,6781,14817,4667,10959,486,1198,2926,6108,3412,7306
240895,202311,3683,9690,3050,8590,391,1091,2047,5700,2438,6791
240910,202311,4170,10110,3165,8326,80,257,2395,5959,2475,6216
240920,202311,1322,2840,896,2147,97,194,577,1363,674,1557
240930,202311,4399,8869,3077,6958,313,509,1958,4694,2271,5203
240933,202311,1925,4384,1463,3663,49,170,1161,2749,1210,2919
240940,202311,9051,18863,6360,14223,962,1857,3853,8366,4815,10223
240950,202311,1329,3569,987,2848,52,187,674,1807,726,1994
240960,202311,851,2077,685,1717,20,80,520,1214,540,1294
240970,202311,2414,5104,1743,3986,74,200,1395,3040,1469,3240
240980,202311,4922,11026,4028,9530,106,387,3302,7313,3408,7700
240990,202311,3665,8243,2827,6638,277,665,1944,4179,2221,4844
241000,202311,1321,2780,914,2034,14,51,777,1636,791,1687
241010,202311,3939,9964,3165,8435,132,433,2409,5981,2541,6414
241020,202311,2568,6046,1774,4506,105,310,1226,2827,1331,3137
241025,202311,2000,5052,1352,3720,65,233,903,2277,968,2510
241030,202311,3116,8448,2261,6676,233,718,1546,4359,1779,5077
241040,202311,2756,7469,2118,6306,203,584,1459,4242,1662,4826
241050,202311,1739,4275,1245,3314,63,159,867,2251,930,2410
241060,202311,1005,2387,745,1845,37,86,532,1222,569,1308
241070,202311,870,2021,642,1629,21,61,494,1174,515,1235
241080,202311,1304,3287,931,2542,43,148,643,1635,686,1783
241090,202311,2526,6207,1809,4949,69,259,1317,3352,1386,3611
241100,202311,1398,3463,961,2590,127,235,553,1508,680,1743
241105,202311,1484,3790,1072,3000,167,469,537,1363,704,1832
241110,202311,1071,2747,689,1930,43,142,434,1101,477,1243
241120,202311,9412,23628,7220,19614,795,2094,4656,12169,5451,14263
241140,202311,3935,9470,2649,6900,285,635,1652,4244,1937,4879
241142,202311,883,2192,523,1413,55,141,274,658,329,799
241150,202311,7245,16692,5608,13870,266,652,4322,10342,4588,10994
241160,202311,1321,3392,799,2308,119,332,388,1021,507,1353
241170,202311,1609,3553,1206,2812,38,124,975,2144,1013,2268
241180,202311,1238,2797,812,1994,60,175,474,1104,534,1279
241190,202311,1428,3205,1013,2425,53,143,703,1572,756,1715
241200,202311,33577,70290,26311,58087,3365,7367,17142,35551,20507,42918
241210,202311,2047,4514,1296,3098,241,478,714,1716,955,2194
241220,202311,12626,31074,9882,25949,2641,6511,4342,11558,6983,18069
241230,202311,3563,8187,2706,6741,238,471,1988,4849,2226,5320
241240,202311,1488,3773,765,2166,123,373,268,676,391,1049
241250,202311,7909,18228,5657,14114,148,485,4401,10204,4549,10689
241255,202311,3418,8894,2630,7340,285,785,1670,4473,1955,5258
241260,202311,5844,13492,4207,10618,163,487,3101,7277,3264,7764
241270,202311,1918,5007,1432,4021,153,397,903,2417,1056,2814
241280,202311,3212,6244,2519,5062,88,173,2188,4237,2276,4410
241290,202311,3781,8304,2565,6351,97,269,1955,4600,2052,4869
241300,202311,1918,4469,1338,3390,61,181,932,2204,993,2385
241310,202311,2770,5694,2086,4704,60,156,1690,3645,1750,3801
241320,202311,1153,3356,865,2747,126,353,426,1334,552,1687
241330,202311,2066,4633,1506,3814,45,138,1263,3089,1308,3227
241335,202311,4645,11344,3550,9246,142,444,2662,6504,2804,6948
241340,202311,2092,4874,1458,3654,264,675,722,1645,986,2320
241350,202311,2571,6108,2012,5117,115,291,1476,3589,1591,3880
241355,202311,1688,3943,1214,3045,60,155,885,2104,945,2259
241360,202311,2515,5707,1609,3952,85,226,1170,2690,1255,2916
241370,202311,1643,3889,1164,2968,53,152,827,1952,880,2104
241380,202311,900,2035,631,1555,107,219,360,894,467,1113
241390,202311,3430,8641,2662,7345,215,528,1849,4991,2064,5519
241400,202311,4455,10665,3529,9073,280,733,2547,6223,2827,6956
241410,202311,3081,8150,2282,6512,271,778,1433,3950,1704,4728
241415,202311,2286,5402,1734,4371,148,293,1238,3006,1386,3299
241420,202311,4053,10250,3263,8790,667,1675,1682,4534,2349,6209
241430,202311,873,1916,521,1243,19,43,357,767,376,810
241440,202311,10593,27324,8808,23939,307,947,6984,18183,7291,19130
241445,202311,1660,3378,1284,2833,36,97,1117,2371,1153,2468
241450,202311,3850,7642,2799,5964,172,335,2208,4543,2380,4878
241460,202311,4808,11518,3204,8127,392,912,1977,4651,2369,5563
241470,202311,1771,4048,1269,3288,44,158,1010,2493,1054,2651
241475,202311,1425,3427,947,2528,21,61,699,1733,720,1794
241480,202311,3835,10402,2848,8322,931,2675,913,2743,1844,5418
241490,202311,904,1830,569,1298,27,83,443,942,470,1025
241500,202311,977,2425,787,2145,35,106,588,1541,623,1647
250010,202311,3239,8229,2378,6466,72,227,1770,4546,1842,4773
250020,202311,1926,4475,1285,3270,278,546,755,1997,1033,2543
250030,202311,8639,20542,6830,17482,1297,3111,4185,10460,5482,13571
250040,202311,5576,14567,4365,12297,1005,2678,2217,6090,3222,8768
250050,202311,4502,10511,3601,9151,203,482,2733,6888,2936,7370
250053,202311,1576,3957,1306,3463,139,292,871,2267,1010,2559
250057,202311,904,2448,801,2289,18,67,692,1946,710,2013
250060,202311,7561,16865,5822,14014,1007,1961,3524,8553,4531,10514
250070,202311,4911,11828,3741,9724,83,276,2909,7190,2992,7466
250073,202311,971,2248,709,1783,11,35,575,1389,586,1424
250077,202311,3273,6846,2329,5309,32,92,1981,4348,2013,4440
250080,202311,7502,14279,5798,12103,87,254,5234,10625,5321,10879
250090,202311,4718,8831,3739,7449,175,259,3170,6193,3345,6452
250100,202311,4250,11321,3435,9719,230,604,2502,6821,2732,7425
250110,202311,6048,14873,5043,13266,401,1000,3595,9118,3996,10118
250115,202311,927,1905,597,1368,47,93,458,1037,505,1130
250120,202311,2209,5754,1807,5034,33,122,1401,3725,1434,3847
250130,202311,7412,15663,5863,13392,297,484,4786,10836,5083,11320
250135,202311,1700,3985,1374,3404,260,649,924,2231,1184,2880
250140,202311,2937,7402,2385,6559,263,731,1621,4370,1884,5101
250150,202311,5744,15798,4695,13788,197,643,3495,9744,3692,10387
250153,202311,1649,3976,1250,3310,55,136,951,2462,1006,2598
250157,202311,2722,6222,2161,5251,60,143,1779,4162,1839,4305
250160,202311,4462,9871,3336,8088,74,192,2820,6668,2894,6860
250170,202311,2207,5180,1821,4595,52,159,1443,3480,1495,3639
250180,202311,31763,61381,24684,51293,2993,5457,17005,33699,19998,39156
250190,202311,5229,12035,4034,10066,482,1104,2588,6167,3070,7271
250200,202311,3081,5905,2353,4869,267,516,1861,3732,2128,4248
250205,202311,1003,2792,747,2280,36,138,534,1565,570,1703
250210,202311,1697,4473,1336,3787,118,362,936,2542,1054,2904
250215,202311,1912,4674,1313,3515,80,235,734,1945,814,2180
250220,202311,826,2023,585,1579,30,92,393,982,423,1074
250230,202311,1939,3931,1220,2828,30,83,950,2086,980,2169
250240,202311,3815,8218,3078,6981,123,268,2585,5683,2708,5951
250250,202311,6098,13970,4813,11976,390,690,3628,9347,4018,10037
250260,202311,1871,4798,1410,3929,97,249,962,2631,1059,2880
250270,202311,1410,3783,1148,3309,101,269,711,2123,812,2392
250280,202311,4982,10489,4020,9064,406,671,2883,6653,3289,7324
250290,202311,2369,4736,1831,3886,49,105,1471,2982,1520,3087
250300,202311,7394,15874,5850,13628,309,838,4485,9956,4794,10794
250310,202311,1519,3878,1099,3086,144,338,684,1919,828,2257
250320,202311,18804,34623,14744,29545,395,1092,12342,23394,12737,24486
250330,202311,3187,7260,2439,6049,90,269,1946,4520,2036,4789
250340,202311,1559,3190,1223,2689,26,65,1069,2291,1095,2356
250350,202311,4617,11973,3498,9907,285,666,2528,7249,2813,7915
250355,202311,2835,6478,2276,5724,44,188,2019,4931,2063,5119
250360,202311,2137,4953,1758,4356,147,384,1298,3058,1445,3442
250370,202311,21175,41813,16808,35211,363,1024,14312,28505,14675,29529
250375,202311,1549,3293,1124,2746,31,62,984,2417,1015,2479
250380,202311,2224,4626,1870,4121,128,288,1526,3212,1654,3500
250390,202311,2360,5170,1830,4297,110,268,1441,3284,1551,3552
250400,202311,96153,213051,63195,156854,20003,51880,17570,39699,37573,91579
250403,202311,3002,6073,2356,5236,48,196,1964,3979,2012,4175
250407,202311,1919,3761,1247,2731,131,203,864,1990,995,2193
250410,202311,867,1997,685,1676,27,73,564,1309,591,1382
250415,202311,2481,5703,1996,4917,41,119,1723,4128,1764,4247
250420,202311,1749,3576,1440,3112,33,96,1237,2556,1270,2652
250430,202311,9555,18611,7239,15197,337,772,5773,11333,6110,12105
250435,202311,2006,4990,1367,3807,68,182,987,2638,1055,2820
250440,202311,5387,12870,4322,11200,116,336,3674,9252,3790,9588
250450,202311,2185,4932,1671,4159,92,171,1291,3230,1383,3401
250460,202311,9871,23719,7612,19892,550,1588,5372,13259,5922,14847
250470,202311,2231,4621,1686,3756,81,203,1340,2809,1421,3012
250480,202311,4812,11361,3733,9817,372,773,2784,7393,3156,8166
250485,202311,857,1770,534,1220,49,74,390,885,439,959
250490,202311,6922,13631,5535,11808,146,375,4586,9403,4732,9778
250500,202311,2476,6036,1973,5144,49,149,1529,3847,1578,3996
250510,202311,7137,14713,5532,12308,554,830,4080,9332,4634,10162
250520,202311,2230,5405,1718,4573,76,233,1281,3231,1357,3464
250523,202311,2645,5649,2089,4808,164,353,1566,3455,1730,3808
250527,202311,2133,4536,1823,4136,23,80,1635,3639,1658,3719
250530,202311,827,1871,636,1553,17,37,491,1137,508,1174
250535,202311,1667,4255,1354,3647,22,72,1106,2860,1128,2932
250540,202311,4018,7364,3019,6133,321,377,2390,5074,2711,5451
250550,202311,953,2755,761,2359,59,193,510,1504,569,1697
250560,202311,2108,5040,1633,4256,121,291,1174,2918,1295,3209
250570,202311,3347,8674,2682,7442,185,503,1926,5205,2111,5708
250580,202311,1244,2896,1007,2511,74,171,763,1835,837,2006
250590,202311,1254,2651,1028,2295,30,90,857,1807,887,1897
250600,202311,9170,22485,6778,18485,378,995,4872,12779,5250,13774
250610,202311,3453,8809,2743,7575,152,452,2076,5573,2228,6025
250620,202311,1141,2385,868,1922,32,78,694,1464,726,1542
250625,202311,2748,7201,2288,6364,52,186,1909,5140,1961,5326
250630,202311,15844,34303,12326,28464,1102,2573,8649,18800,9751,21373
250640,202311,4581,10528,3614,8989,119,421,2822,6567,2941,6988
250650,202311,1283,2704,903,2154,15,61,747,1708,762,1769
250660,202311,1882,4162,1321,3280,78,192,1047,2455,1125,2647
250670,202311,3020,7666,2564,6784,56,201,2141,5412,2197,5613
250680,202311,7635,14515,5854,12252,153,458,4925,9726,5078,10184
250690,202311,8908,17307,6639,14205,171,370,5600,11513,5771,11883
250700,202311,5816,14307,4526,11875,752,1894,2766,6927,3518,8821
250710,202311,5427,13876,4168,11770,493,1213,2699,7588,3192,8801
250720,202311,3555,8353,2757,7060,78,265,2249,5484,2327,5749
250730,202311,5469,12309,4367,10578,422,796,3236,7654,3658,8450
250740,202311,2510,5449,1864,4456,121,255,1339,3099,1460,3354
250750,202311,170256,353343,130380,290398,9635,23049,94072,194901,103707,217950
250760,202311,3693,6878,3021,5889,51,138,2718,5114,2769,5252
250770,202311,4948,13285,3920,11437,509,1230,2456,7128,2965,8358
250780,202311,2275,5215,1715,4192,53,148,1389,3251,1442,3399
250790,202311,3177,7922,2490,6661,106,378,1736,4205,1842,4583
250800,202311,2932,6888,2269,5719,159,314,1711,4247,1870,4561
250810,202311,1767,3834,1252,2997,147,233,834,2075,981,2308
250820,202311,2555,5907,2181,5391,53,157,1825,4400,1878,4557
250830,202311,7412,19431,5489,15481,256,825,3810,9982,4066,10807
250840,202311,877,2515,690,2107,35,112,502,1520,537,1632
250850,202311,2196,5570,1753,4748,30,118,1425,3683,1455,3801
250855,202311,1445,3424,1162,2939,40,126,956,2306,996,2432
250860,202311,4359,11194,3214,9092,471,1340,1790,4766,2261,6106
250870,202311,1293,2949,970,2373,52,123,716,1668,768,1791
250880,202311,1948,4423,1448,3590,134,324,1020,2444,1154,2768
250890,202311,14826,30421,11735,26171,329,890,9647,20089,9976,20979
250900,202311,3972,9096,3066,7490,119,356,2512,5818,2631,6174
250905,202311,3140,7613,2670,6934,93,301,2300,5831,2393,6132
250910,202311,9070,17295,7126,14778,126,375,6292,12578,6418,12953
250915,202311,2710,5371,1756,4173,53,133,1477,3402,1530,3535
250920,202311,4863,10243,3835,8569,742,1098,2381,5618,3123,6716
250930,202311,2858,6926,2210,5939,159,505,1597,4019,1756,4524
250933,202311,1529,3984,1194,3342,61,208,874,2299,935,2507
250937,202311,980,2272,757,1899,43,85,555,1387,598,1472
250939,202311,2545,5576,1970,4639,48,132,1623,3644,1671,3776
250940,202311,4812,11175,3734,9514,95,311,3026,7473,3121,7784
250950,202311,2063,4799,1511,3959,44,124,1172,2905,1216,3029
250960,202311,1392,3513,1115,2988,43,147,840,2109,883,2256
250970,202311,11668,25251,9047,20712,528,1087,7068,15655,7596,16742
250980,202311,2814,6661,2262,5730,41,131,1902,4616,1943,4747
250990,202311,2568,6786,2010,5758,96,271,1417,3869,1513,4140
251000,202311,2324,5936,1775,4937,45,129,1366,3697,1411,3826
251010,202311,2998,7363,2436,6452,92,315,1938,4916,2030,5231
251020,202311,1909,4652,1469,3856,48,167,1132,2783,1180,2950
251030,202311,1216,2916,905,2350,60,158,563,1436,623,1594
251040,202311,2201,5309,1671,4384,23,76,1382,3474,1405,3550
251050,202311,1157,3041,861,2397,51,169,573,1469,624,1638
251060,202311,1380,2751,889,2014,49,87,654,1473,703,1560
251065,202311,564,1421,373,1042,93,191,167,494,260,685
251070,202311,912,1971,669,1570,21,79,538,1176,559,1255
251080,202311,27173,57975,20438,47059,4273,9211,10918,25284,15191,34495
251090,202311,3505,8805,2701,7360,68,225,2203,5788,2271,6013
251100,202311,947,2698,717,2203,62,149,461,1329,523,1478
251110,202311,2246,5165,1677,4084,345,613,1012,2569,1357,3182
251120,202311,10066,22767,7692,19144,374,1073,5726,13418,6100,14491
251130,202311,6108,10385,5063,9118,58,112,4659,8151,4717,8263
251140,202311,4849,12444,3961,10936,185,569,2909,7830,3094,8399
251150,202311,3419,8530,2888,7593,81,326,2227,5505,2308,5831
251160,202311,2958,6916,2406,6019,44,173,2069,4975,2113,5148
251170,202311,2299,4893,1860,4269,39,117,1636,3609,1675,3726
251180,202311,3342,7654,2531,6391,394,786,1526,4015,1920,4801
251190,202311,7065,13779,5794,12043,186,397,4930,9820,5116,10217
251200,202311,5757,13721,4666,12111,215,543,3706,9478,3921,10021
251203,202311,1272,3537,953,2794,75,231,604,1644,679,1875
251207,202311,1353,3199,887,2326,27,78,621,1552,648,1630
251210,202311,9945,22010,7218,17661,721,1415,4762,11798,5483,13213
251220,202311,1622,3397,1092,2621,65,136,822,1936,887,2072
251230,202311,5694,14279,4529,12000,144,415,3402,8557,3546,8972
251240,202311,4459,11484,3203,8975,362,972,1976,5352,2338,6324
251250,202311,15219,34577,11688,28161,1377,3089,7878,18308,9255,21397
251260,202311,651,1496,512,1249,9,22,401,928,410,950
251270,202311,5523,14320,4520,12633,335,882,3355,9326,3690,10208
251272,202311,1748,3918,1468,3498,30,111,1285,2904,1315,3015
251274,202311,1028,2603,725,2017,80,216,382,997,462,1213
251275,202311,1976,4166,1452,3302,92,202,1127,2426,1219,2628
251276,202311,1612,3954,1277,3415,30,107,958,2429,988,2536
251278,202311,820,1904,626,1542,37,86,476,1103,513,1189
251280,202311,3389,6926,2805,6039,66,164,2372,4797,2438,4961
251290,202311,10218,18188,8292,15696,277,591,7083,12794,7360,13385
251300,202311,944,2445,743,2054,14,45,618,1673,632,1718
251310,202311,3452,8532,2711,7264,52,208,2090,5334,2142,5542
251315,202311,2294,6193,1910,5412,125,317,1447,4000,1572,4317
251320,202311,1930,4578,1387,3595,53,173,1019,2490,1072,2663
251330,202311,2563,5190,1856,4225,69,191,1522,3328,1591,3519
251335,202311,1394,3386,1145,2968,13,44,1010,2537,1023,2581
251340,202311,4593,9767,3281,7760,262,572,2362,5360,2624,5932
251350,202311,1339,3332,1056,2818,114,205,757,2045,871,2250
251360,202311,2253,5368,1569,4222,27,75,1218,3175,1245,3250
251365,202311,930,2237,605,1582,26,78,439,1111,465,1189
251370,202311,37051,83589,27883,68636,6256,14031,13018,32388,19274,46419
251380,202311,1891,3972,1448,3238,59,152,1182,2514,1241,2666
251385,202311,932,2170,631,1588,30,74,446,1037,476,1111
251390,202311,9843,22237,8093,19398,652,1500,5864,13600,6516,15100
251392,202311,1294,3062,983,2549,39,101,739,1882,778,1983
251394,202311,835,2123,618,1718,64,177,395,1051,459,1228
251396,202311,870,2130,628,1647,37,107,450,1092,487,1199
251398,202311,1222,2871,733,1955,17,50,537,1344,554,1394
251400,202311,1776,3469,1266,2688,72,130,974,1978,1046,2108
251410,202311,1901,3843,1369,3021,32,122,1142,2347,1174,2469
251420,202311,2585,5671,1939,4768,51,121,1536,3626,1587,3747
251430,202311,1845,4827,1466,4091,61,190,1164,3131,1225,3321
251440,202311,1330,3188,1002,2608,114,255,678,1778,792,2033
251445,202311,2074,4881,1682,4263,41,152,1317,3143,1358,3295
251450,202311,5727,14077,4499,11734,122,376,3606,8953,3728,9329
251455,202311,1043,2737,832,2323,40,126,636,1692,676,1818
251460,202311,1194,2929,888,2378,95,255,617,1611,712,1866
251465,202311,614,1499,460,1198,11,37,333,813,344,850
251470,202311,1323,3396,921,2547,166,479,465,1146,631,1625
251480,202311,1294,2957,889,2219,35,111,649,1505,684,1616
251490,202311,2416,5432,1826,4520,171,334,1307,3228,1478,3562
251500,202311,2674,6012,2173,5249,136,304,1663,3813,1799,4117
251510,202311,3135,8626,2282,6834,184,514,1372,3920,1556,4434
251520,202311,1219,2873,839,2187,53,117,567,1406,620,1523
251530,202311,19173,38796,14807,33073,235,727,12569,26746,12804,27473
251540,202311,3674,9352,2893,7871,101,368,2235,5756,2336,6124
251550,202311,5430,10100,3994,8119,182,373,3332,6566,3514,6939
251560,202311,671,1850,537,1588,36,118,385,1043,421,1161
251570,202311,1092,2788,771,2116,42,98,550,1448,592,1546
251580,202311,2871,5478,2243,4532,41,96,1905,3617,1946,3713
251590,202311,1978,4191,1488,3459,55,147,1260,2799,1315,2946
251593,202311,1168,3126,945,2710,109,281,585,1618,694,1899
251597,202311,2870,6441,2402,5742,31,103,2103,4891,2134,4994
251600,202311,7680,18961,6136,16374,559,1271,4459,11776,5018,13047
251610,202311,4267,10267,3341,8508,490,1074,2153,5372,2643,6446
251615,202311,1626,3498,1141,2670,55,168,958,2149,1013,2317
251620,202311,24402,47721,17847,39192,429,1023,14826,31975,15255,32998
251630,202311,6492,12694,4857,10226,309,689,3778,7469,4087,8158
251640,202311,2661,6235,2151,5426,48,160,1758,4210,1806,4370
251650,202311,5167,11519,3972,9737,107,309,3256,7599,3363,7908
251660,202311,4544,11255,3552,9344,92,360,2850,7103,2942,7463
251670,202311,5790,12469,4722,10926,143,463,4005,8884,4148,9347
251675,202311,1140,2380,929,2043,30,62,801,1710,831,1772
251680,202311,3166,7186,2343,5869,129,302,1791,4425,1920,4727
251690,202311,4032,9842,2990,7820,220,612,2150,5357,2370,5969
251700,202311,2873,6807,2197,5724,68,249,1742,4244,1810,4493
251710,202311,968,2184,591,1426,39,103,396,862,435,965
251720,202311,1547,3915,1103,3085,36,119,787,2089,823,2208
251740,202311,818,1955,595,1546,24,81,443,1085,467,1166
260005,202311,38797,73469,28291,58283,2038,4088,21246,41694,23284,45782
260010,202311,12886,29763,9478,23669,710,1817,5968,14090,6678,15907
260020,202311,8383,16696,5908,13141,109,354,4718,9842,4827,10196
260030,202311,10368,19995,8130,16805,142,462,6937,13639,7079,14101
260040,202311,8902,19889,6504,16080,360,1003,4690,11029,5050,12032
260050,202311,17872,37817,14487,33604,298,789,12964,29533,13262,30322
260060,202311,5254,11148,3965,9027,507,820,2706,6440,3213,7260
260070,202311,14766,29201,11476,24332,267,782,9471,18921,9738,19703
260080,202311,8563,16163,6856,13837,129,297,5803,11233,5932,11530
260090,202311,6880,14583,5495,12494,620,1104,3876,8877,4496,9981
260100,202311,4068,8529,3184,7193,54,191,2676,5711,2730,5902
260105,202311,6390,14578,5091,12446,120,428,4101,9477,4221,9905
260110,202311,26314,66963,20974,57974,1422,3795,15429,41288,16851,45083
260120,202311,20326,43947,15983,37137,1993,3961,10940,25286,12933,29247
260130,202311,4063,8878,3210,7576,69,187,2543,5658,2612,5845
260140,202311,16791,31786,12845,26478,466,1039,10467,20526,10933,21565
260150,202311,4535,8710,3675,7575,140,222,3135,6313,3275,6535
260160,202311,9230,17710,7396,15327,186,482,6526,13033,6712,13515
260170,202311,27451,55484,20935,45763,1388,2900,15598,32790,16986,35690
260180,202311,4465,9839,3401,8230,106,322,2710,6195,2816,6517
260190,202311,27628,44594,21089,36555,288,562,18860,31451,19148,32013
260200,202311,13481,28997,10736,25148,532,1037,9007,20752,9539,21789
260210,202311,13631,33901,10638,28800,643,1485,7984,21325,8627,22810
260220,202311,15144,28415,12598,25057,297,562,10872,20933,11169,21495
260230,202311,16658,30895,13319,26475,365,683,11276,21777,11641,22460
260240,202311,3466,8785,2696,7306,52,183,2093,5392,2145,5575
260250,202311,2998,6464,2316,5338,94,230,1778,3880,1872,4110
260260,202311,18131,39698,14816,34673,1595,3122,10231,24463,11826,27585
260270,202311,6232,11675,4955,10055,124,326,4242,8277,4366,8603
260280,202311,17020,39948,14167,35418,337,1146,12104,28847,12441,29993
260290,202311,58196,127100,43874,102650,4232,10077,29836,65250,34068,75327
260300,202311,13631,28608,10702,24246,336,931,8791,18822,9127,19753
260310,202311,8305,16503,6834,14426,460,781,5527,11513,5987,12294
260320,202311,8941,23332,6729,19376,176,549,5319,14945,5495,15494
260330,202311,2832,7824,2240,6628,131,361,1625,4657,1756,5018
260340,202311,2672,6034,2118,5139,54,175,1702,3885,1756,4060
260345,202311,40310,85204,30554,69261,3560,7775,19738,42194,23298,49969
260350,202311,8278,14541,6460,12392,36,120,5843,10840,5879,10960
260360,202311,2942,6723,2175,5279,79,232,1585,3633,1664,3865
260370,202311,7053,16514,5443,13676,198,548,4336,10301,4534,10849
260380,202311,6230,15725,4767,13145,219,514,3498,9356,3717,9870
260390,202311,5787,15265,4020,11514,276,720,2591,7195,2867,7915
260392,202311,5225,12432,4397,11250,62,299,3797,9384,3859,9683
260400,202311,28657,53072,22399,43841,455,1202,18560,33815,19015,35017
260410,202311,108787,227657,79551,182873,16259,36758,39085,88592,55344,125350
260415,202311,6121,12905,4718,10767,81,264,3980,8719,4061,8983
260420,202311,16538,28007,12581,23456,220,605,11114,20058,11334,20663
260430,202311,3314,9269,2540,7665,204,627,1623,4723,1827,5350
260440,202311,5333,10818,4093,9060,97,311,3384,7113,3481,7424
260450,202311,7143,15912,5798,13872,367,749,4592,10903,4959,11652
260460,202311,7147,17137,5394,13798,390,1100,3615,8512,4005,9612
260470,202311,6174,12805,4836,11160,152,378,4120,9589,4272,9967
260480,202311,4542,10351,3382,8427,328,852,2263,5357,2591,6209
260490,202311,7158,13365,5599,11246,95,313,4842,9195,4937,9508
260500,202311,7729,16721,6049,14114,863,1777,3878,9028,4741,10805
260510,202311,14407,27959,11340,23488,273,715,9736,19422,10009,20137
260515,202311,5682,13012,4101,10095,134,359,2927,6571,3061,6930
260520,202311,20415,41282,15682,34208,1076,2270,11826,24453,12902,26723
260530,202311,12810,29466,10193,25316,167,636,8720,20669,8887,21305
260540,202311,9763,17340,8126,15292,110,237,7366,13529,7476,13766
260545,202311,193,473,118,318,21,54,40,84,61,138
260550,202311,3884,9329,2722,7171,195,573,1737,4169,1932,4742
260560,202311,6970,15844,5209,12973,174,544,4037,9510,4211,10054
260570,202311,11704,23304,9419,20194,215,625,8106,16547,8321,17172
260580,202311,6503,12045,5490,10665,113,208,4882,9268,4995,9476
260590,202311,9283,16654,7090,13984,126,338,6049,11458,6175,11796
260600,202311,45061,95877,34037,77928,1830,4442,25590,54466,27420,58908
260610,202311,9929,22745,7507,18963,325,927,5745,13926,6070,14853
260620,202311,28862,56689,22195,46400,1692,3647,16598,32616,18290,36263
260630,202311,2832,6737,2206,5680,65,194,1766,4373,1831,4567
260640,202311,33870,61419,26049,51244,1763,2898,20451,39413,22214,42311
260650,202311,7567,16872,5574,14097,428,821,4371,10907,4799,11728
260660,202311,9665,19969,7587,17027,275,721,6450,13849,6725,14570
260670,202311,2819,6322,2060,4987,82,255,1555,3521,1637,3776
260680,202311,40473,82383,29648,65071,2707,5574,20914,43742,23621,49316
260690,202311,4287,9592,3106,7656,78,246,2476,5825,2554,6071
260700,202311,9573,19083,8423,17745,124,357,7842,16240,7966,16597
260710,202311,1675,3857,1205,3074,50,129,892,2161,942,2290
260720,202311,40676,78490,30364,63857,1631,3884,23463,46615,25094,50499
260730,202311,10332,25376,8379,22319,271,785,6956,17914,7227,18699
260740,202311,1641,3885,1205,3133,39,158,911,2236,950,2394
260750,202311,9805,21216,7299,17933,213,504,6192,15152,6405,15656
260760,202311,8756,16686,7040,14482,131,335,6050,11892,6181,12227
260765,202311,10814,26049,8498,22129,809,2119,5515,13573,6324,15692
260770,202311,4948,10696,3688,8645,128,362,2977,6688,3105,7050
260775,202311,7947,17379,6332,14560,227,651,4904,10452,5131,11103
260780,202311,4777,11901,3467,9269,286,871,2149,5085,2435,5956
260790,202311,204250,375630,155770,306088,19645,38646,106778,199418,126423,238064
260795,202311,4565,8662,3432,7156,146,395,2613,5060,2759,5455
260800,202311,8037,14395,6785,12648,297,482,5903,10693,6200,11175
260805,202311,4833,10894,3653,8757,127,407,2914,6522,3041,6929
260810,202311,8455,19206,6611,15723,403,948,4925,11017,5328,11965
260820,202311,6154,11455,4828,9789,119,334,4015,7863,4134,8197
260825,202311,3548,9308,2815,7954,138,481,2056,5541,2194,6022
260830,202311,5357,13518,4124,11292,436,1016,2770,7564,3206,8580
260840,202311,5862,11948,4739,10325,203,477,3988,8340,4191,8817
260845,202311,5729,12909,4463,10682,206,597,3319,7380,3525,7977
260850,202311,6138,14286,4430,10961,514,1112,2718,6415,3232,7527
260860,202311,4081,10451,3101,8588,249,591,2222,5996,2471,6587
260870,202311,5791,11127,4685,9674,126,238,4026,8106,4152,8344
260875,202311,10995,21469,7866,16921,685,1510,5326,10957,6011,12467
260880,202311,14529,31983,11741,27387,731,1442,9102,20724,9833,22166
260890,202311,16909,36696,13003,30166,1989,4189,7359,16956,9348,21145
260900,202311,6987,17279,5278,14469,682,1748,2859,7596,3541,9344
260910,202311,4293,9518,3502,8275,216,399,2630,6132,2846,6531
260915,202311,7445,15163,6215,13499,90,217,5699,12138,5789,12355
260920,202311,4395,8322,3358,7041,150,399,2681,5396,2831,5795
260930,202311,5254,13022,3955,10690,182,513,3002,7667,3184,8180
260940,202311,20181,39891,15604,32841,1431,2952,11341,22755,12772,25707
260950,202311,9722,21318,6964,16345,391,1088,4804,10199,5195,11287
260960,202311,122463,219108,93279,178030,9295,16807,67712,122725,77007,139532
260970,202311,7056,15951,5329,13235,367,664,3837,9450,4204,10114
260980,202311,6036,14190,4848,12507,124,402,4050,10133,4174,10535
260990,202311,20760,51013,15859,43251,1153,2821,11439,30265,12592,33086
261000,202311,21683,41535,16029,33609,849,1855,12402,24495,13251,26350
261010,202311,2687,5951,2124,5130,88,212,1741,4097,1829,4309
261020,202311,8680,18835,6878,15792,267,721,5475,11782,5742,12503
261030,202311,5179,12768,4027,10611,169,482,3018,7493,3187,7975
261040,202311,6801,16374,5097,13288,204,641,3792,9257,3996,9898
261050,202311,10092,21915,8052,18683,211,511,6442,14276,6653,14787
261060,202311,19296,40519,15182,34675,409,1174,12194,26383,12603,27557
261070,202311,98445,187277,71875,147459,8950,17077,48773,96382,57723,113459
261080,202311,9127,18051,7539,15918,89,226,6960,14306,7049,14532
261090,202311,26119,50014,20512,42153,1142,2026,16377,32508,17519,34534
261100,202311,11216,26004,8843,22131,515,1265,6644,15982,7159,17247
261110,202311,101936,237153,74251,184769,9206,23639,42761,99218,51967,122857
261120,202311,4976,9922,3948,8405,160,337,3311,6773,3471,7110
261130,202311,9902,19773,7877,16801,239,454,6612,13721,6851,14175
261140,202311,4916,9436,3604,7483,289,449,2614,5277,2903,5726
261150,202311,7004,14763,5469,12449,237,570,4265,9336,4502,9906
261153,202311,2361,6168,1704,4828,88,261,1149,3172,1237,3433
261160,202311,327625,646741,240112,515482,75203,153367,83169,189376,158372,342743
261170,202311,10295,19219,8233,16346,351,644,7019,13425,7370,14069
261180,202311,11869,25307,9049,20843,465,1122,6852,15011,7317,16133
261190,202311,6853,15002,5338,12440,188,622,4220,9100,4408,9722
261200,202311,4463,8624,3425,7129,155,324,2744,5529,2899,5853
261210,202311,2302,4930,1775,4091,144,215,1366,3128,1510,3343
261220,202311,19452,43973,14685,35389,1206,2984,10183,22694,11389,25678
261230,202311,4773,11677,3612,9870,83,314,2785,7321,2868,7635
261240,202311,8005,15414,6537,13230,222,417,5629,11049,5851,11466
261245,202311,4907,11394,3661,9293,93,349,2813,6615,2906,6964
261247,202311,3877,10039,2874,8147,344,905,1804,5010,2148,5915
261250,202311,39106,73032,31210,62851,6334,12028,19448,39805,25782,51833
261255,202311,4918,12547,3476,9696,157,539,2428,6272,2585,6811
261260,202311,20464,40017,16333,34611,382,1052,14263,28843,14645,29895
261270,202311,6748,12446,5426,10684,220,384,4713,9024,4933,9408
261280,202311,3310,7754,2664,6656,127,374,2033,4780,2160,5154
261290,202311,3775,7924,2814,6668,65,171,2256,5209,2321,5380
261300,202311,17700,38998,13541,32050,504,1377,10440,23155,10944,24532
261310,202311,13066,26913,10273,22620,857,1827,7670,16155,8527,17982
261320,202311,7568,18153,5990,15460,154,429,4757,11758,4911,12187
261330,202311,8070,15774,6687,13876,178,387,5812,11667,5990,12054
261340,202311,7902,15549,6358,13427,370,697,5200,10670,5570,11367
261350,202311,10493,27174,8027,22440,405,1110,5827,15767,6232,16877
261360,202311,11367,22010,8888,18303,716,1279,6768,13533,7484,14812
261370,202311,33932,71395,25312,57809,2183,4889,17796,38396,19979,43285
261380,202311,5591,13239,4508,11399,530,1199,2875,7185,3405,8384
261390,202311,23328,56243,16998,45207,1936,4689,10653,27191,12589,31880
261400,202311,6269,15310,4949,12811,197,682,3757,9015,3954,9697
261410,202311,12799,26132,9499,21104,252,674,7739,16058,7991,16732
261420,202311,11193,26171,8844,22480,590,1591,6638,15998,7228,17589
261430,202311,5579,11160,4432,9446,65,211,3894,7895,3959,8106
261440,202311,1680,4488,1262,3670,53,219,876,2396,929,2615
261450,202311,19257,42778,15302,36463,732,1672,11693,27356,12425,29028
261460,202311,9800,22761,7554,19026,299,762,5716,13923,6015,14685
261470,202311,4713,10318,3574,8500,64,207,2940,6615,3004,6822
261480,202311,6936,17577,5387,14792,281,884,3894,9892,4175,10776
261485,202311,7451,17527,5780,14700,436,1233,4132,9949,4568,11182
261500,202311,8931,19213,7146,16486,970,1750,4719,11255,5689,13005
261510,202311,2244,5869,1757,4948,72,261,1321,3614,1393,3875
261520,202311,2974,7514,2313,6135,139,412,1625,4015,1764,4427
261530,202311,15567,38237,11225,30132,797,2405,6768,16332,7565,18737
261540,202311,12384,30496,10550,27533,2946,6874,4848,13911,7794,20785
261550,202311,4659,10678,3545,8704,295,745,2417,5522,2712,6267
261560,202311,12174,27249,9883,23684,356,941,7987,18259,8343,19200
261570,202311,4626,10990,3231,8463,317,883,2065,5095,2382,5978
261580,202311,9192,19468,7280,16650,100,353,6474,14260,6574,14613
261590,202311,3428,7360,2614,6080,58,176,2091,4580,2149,4756
261600,202311,7702,14676,6240,12574,159,372,5292,10145,5451,10517
261610,202311,2786,7095,2051,5683,272,707,1186,3265,1458,3972
261618,202311,3597,6833,2838,5772,105,200,2349,4609,2454,4809
261620,202311,6231,14365,5370,13025,704,1522,3677,9148,4381,10670
261630,202311,7420,18677,5548,14850,406,1135,3440,8407,3846,9542
261640,202311,49553,94342,37067,77049,2768,4717,27024,55533,29792,60250
261650,202311,5588,11171,4173,9265,350,643,3196,7110,3546,7753
270010,202311,5167,15195,3927,12661,132,576,2745,8367,2877,8943
270020,202311,5244,10591,4038,8909,166,409,3254,6660,3420,7069
270030,202311,47761,113165,37411,95732,2614,6841,27328,67028,29942,73869
270040,202311,12116,28685,9044,24153,908,2576,6075,15473,6983,18049
270050,202311,6742,13749,5253,11931,214,521,4431,9822,4645,10343
270060,202311,2773,6384,2047,5246,139,348,1455,3519,1594,3867
270070,202311,6617,14538,5333,12627,176,573,4474,10104,4650,10677
270080,202311,1846,4270,1312,3357,78,179,949,2341,1027,2520
270090,202311,2275,5851,1876,5147,99,305,1510,4036,1609,4341
270100,202311,8985,16552,7192,14103,198,437,6272,11923,6470,12360
270110,202311,3929,8497,2783,6886,172,343,2059,5050,2231,5393
270120,202311,3051,7539,2445,6597,119,342,1792,4660,1911,5002
270130,202311,6141,13951,4724,11870,207,656,3797,9082,4004,9738
270135,202311,2412,5134,1871,4455,51,169,1576,3602,1627,3771
270140,202311,10351,22996,7035,17578,518,1305,4812,11211,5330,12516
270150,202311,3859,8806,3347,8068,85,255,3005,7115,3090,7370
270160,202311,6134,15371,4844,13445,193,655,3976,10586,4169,11241
270170,202311,3801,9998,2861,8332,181,609,1872,5026,2053,5635
270180,202311,2917,7609,2406,6844,87,343,1954,5349,2041,5692
270190,202311,3049,6056,2573,5436,41,119,2293,4683,2334,4802
270200,202311,3436,8825,2620,7332,584,1345,1497,4349,2081,5694
270210,202311,7090,14389,5665,12601,193,609,4822,10314,5015,10923
270220,202311,2101,4491,1504,3519,127,303,1101,2428,1228,2731
270230,202311,12783,30223,9716,24992,1001,2669,6917,16937,7918,19606
270235,202311,7787,20724,6091,17644,307,906,4543,12697,4850,13603
270240,202311,14440,34023,10719,27890,1016,2678,7402,18364,8418,21042
270250,202311,4255,8358,3299,6978,166,392,2627,5231,2793,5623
270255,202311,5258,13473,3838,10835,177,533,2860,7741,3037,8274
270260,202311,6696,18308,5499,16089,147,508,4412,12474,4559,12982
270270,202311,1234,2916,905,2440,109,298,645,1697,754,1995
270280,202311,4534,9635,3176,7804,211,460,2226,5501,2437,5961
270290,202311,9825,26959,8321,24337,237,869,6866,19613,7103,20482
270300,202311,4844,11440,3425,9435,215,625,2443,6517,2658,7142
270310,202311,7941,20153,6135,17073,194,641,4687,12530,4881,13171
270320,202311,6706,17629,5025,14164,356,1173,3361,8711,3717,9884
270330,202311,5376,14544,4382,12926,194,720,3589,10191,3783,10911
270340,202311,1971,4619,1521,3888,109,179,1226,3151,1335,3330
270350,202311,2258,4563,1635,3752,240,378,955,2383,1195,2761
270360,202311,4361,8326,3646,7463,76,215,3288,6523,3364,6738
270370,202311,1604,4479,1313,3917,38,157,1051,3027,1089,3184
270375,202311,4850,8753,3712,7439,105,254,3118,6038,3223,6292
270380,202311,7034,15822,5323,13409,654,1420,3760,9518,4414,10938
270390,202311,1534,3354,1086,2788,16,66,889,2231,905,2297
270400,202311,7731,18476,5639,14935,423,1088,3828,9765,4251,10853
270410,202311,6484,15794,5140,13625,175,569,4139,10529,4314,11098
270420,202311,8494,19692,7195,17635,200,593,6038,14185,6238,14778
270430,202311,227302,453712,163527,360506,20667,44543,101673,213454,122340,257997
270440,202311,5636,13552,4433,11732,214,699,3341,8534,3555,9233
270450,202311,11459,23795,9287,20892,499,993,7400,16465,7899,17458
270460,202311,4696,9369,3408,7622,243,540,2570,5436,2813,5976
270470,202311,15012,35821,11699,30358,745,2088,8661,21401,9406,23489
270480,202311,3763,8497,2811,7062,220,531,2070,4958,2290,5489
270490,202311,1078,2671,847,2317,44,125,640,1676,684,1801
270500,202311,5858,15509,4928,13790,283,763,3893,10643,4176,11406
270510,202311,7757,17045,5834,14256,291,833,4486,10345,4777,11178
270520,202311,4986,12175,3390,9283,682,1786,1616,4352,2298,6138
270530,202311,1647,4216,1233,3458,86,201,841,2331,927,2532
270540,202311,2624,6397,2006,5468,78,226,1668,4403,1746,4629
270550,202311,8039,18319,5733,15252,681,1606,3715,9938,4396,11544
270560,202311,3668,8107,2749,6729,187,560,2028,4629,2215,5189
270570,202311,6822,14506,5376,12236,461,1165,4205,8976,4666,10141
270580,202311,2976,7146,2452,6315,111,295,2037,5085,2148,5380
270590,202311,1709,4595,1464,4192,93,281,1193,3352,1286,3633
270600,202311,3381,8910,2870,8028,144,494,2294,6270,2438,6764
270610,202311,4324,10322,3454,8986,221,536,2539,6367,2760,6903
270620,202311,1421,3892,1191,3451,67,206,925,2592,992,2798
270630,202311,24015,48740,19186,41717,676,1800,16112,33050,16788,34850
270640,202311,6851,16913,5323,14357,152,525,4048,10368,4200,10893
270642,202311,3189,8714,2550,7490,223,659,1730,4792,1953,5451
270644,202311,4775,10625,3704,9092,334,826,2699,6476,3033,7302
270650,202311,4594,10586,3690,9231,250,681,2782,6538,3032,7219
270660,202311,2375,5228,1903,4518,98,193,1417,3250,1515,3443
270670,202311,23570,45724,17804,37762,1442,2558,13535,27731,14977,30289
270680,202311,7712,14495,6387,12880,268,449,5581,11167,5849,11616
270690,202311,12896,27514,9675,22740,341,979,7601,16910,7942,17889
270700,202311,714,1829,567,1562,84,226,362,947,446,1173
270710,202311,7207,18845,5697,16162,410,1138,4190,11561,4600,12699
270720,202311,4505,11264,3616,9686,142,453,2898,7440,3040,7893
270730,202311,9388,19016,6920,16015,703,1226,4997,11956,5700,13182
270740,202311,2821,6779,2198,5830,135,408,1643,4133,1778,4541
270750,202311,6849,15301,5579,13383,122,414,4944,11422,5066,11836
270760,202311,4017,9660,3085,8242,81,316,2453,6287,2534,6603
270770,202311,30008,65610,21120,51550,3078,7158,12887,30198,15965,37356
270780,202311,2505,5396,2075,4769,88,227,1752,3885,1840,4112
270790,202311,2230,5026,1692,4166,103,247,1318,3095,1421,3342
270800,202311,14698,32801,11765,28173,755,1848,8852,20292,9607,22140
270810,202311,4239,10009,3053,8099,507,1081,1898,5014,2405,6095
270820,202311,1939,5140,1528,4443,105,331,1139,3197,1244,3528
270830,202311,6334,13480,4653,11140,497,959,3335,7941,3832,8900
270840,202311,9863,26598,7717,22775,457,1793,5571,15392,6028,17185
270850,202311,10860,22000,8359,18769,623,1420,6537,14260,7160,15680
270860,202311,17917,35949,12500,28587,922,2239,9243,20352,10165,22591
270870,202311,2899,7413,2023,5792,203,639,1226,3268,1429,3907
270880,202311,9701,25767,7713,22112,260,929,6027,16617,6287,17546
270890,202311,4296,10354,3173,8338,603,1564,1583,3993,2186,5557
270895,202311,4691,11135,3902,9951,154,419,3167,7795,3321,8214
270900,202311,1792,4290,1304,3498,56,187,963,2439,1019,2626
270910,202311,5701,13836,4428,11749,337,811,3258,8375,3595,9186
270915,202311,11556,28559,8181,22198,828,2450,5052,12599,5880,15049
270920,202311,7518,18653,6023,16282,117,429,4953,13013,5070,13442
270930,202311,22266,45167,15679,36399,2319,5011,9826,22360,12145,27371
270940,202311,7313,17354,5491,14740,172,629,4131,10393,4303,11022
280010,202311,669,1766,476,1368,25,82,294,757,319,839
280020,202311,6611,14042,5075,11587,515,1078,3659,8012,4174,9090
280030,202311,130250,252411,96161,199649,19238,36098,51279,105672,70517,141770
280040,202311,3802,8622,2941,7198,222,531,2177,5102,2399,5633
280050,202311,5272,13281,3776,10374,889,2373,1715,4447,2604,6820
280060,202311,10185,21405,7322,16791,1242,2784,4169,9050,5411,11834
280067,202311,8907,18341,6721,14811,628,1050,4817,10437,5445,11487
280070,202311,2241,5916,1883,5303,127,383,1367,3626,1494,4009
280100,202311,5487,12199,4173,9990,748,1516,2326,5702,3074,7218
280110,202311,2038,4237,1598,3594,41,123,1378,2972,1419,3095
280120,202311,10131,23916,8148,20566,1146,2597,5372,13665,6518,16262
280130,202311,10579,22345,7900,18459,773,1760,5541,12641,6314,14401
280140,202311,7689,14934,6247,12751,1077,1580,4132,8856,5209,10436
280150,202311,4855,11045,3367,8353,586,1142,2003,4924,2589,6066
280160,202311,1628,3871,1216,3116,122,259,798,1911,920,2170
280170,202311,7204,15158,5615,12745,248,629,4421,9562,4669,10191
280190,202311,1977,3407,1587,2883,32,72,1386,2419,1418,2491
280200,202311,1522,3607,1058,2844,71,269,713,1714,784,1983
280210,202311,22894,47553,16894,37741,2550,5239,10523,22761,13073,28000
280220,202311,2076,4594,1589,3859,79,164,1225,2896,1304,3060
280230,202311,5072,11521,3590,9052,224,449,2408,5866,2632,6315
280240,202311,3931,9252,3138,7957,41,177,2645,6394,2686,6571
280250,202311,1383,2541,887,1741,41,92,716,1318,757,1410
280260,202311,3117,6060,2430,5124,62,161,2150,4375,2212,4536
280270,202311,3128,7167,2504,6203,119,356,2086,4889,2205,5245
280280,202311,4732,12364,3693,10510,509,1137,2389,6949,2898,8086
280290,202311,27940,59947,20847,48444,2657,6647,11962,27446,14619,34093
280300,202311,16616,32356,13429,28461,1281,1824,10249,22566,11530,24390
280310,202311,1689,3797,1252,3061,50,138,963,2226,1013,2364
280320,202311,11758,26285,9087,21797,969,2193,6384,14546,7353,16739
280330,202311,5585,12324,3915,9548,307,759,2711,6244,3018,7003
280340,202311,6422,11896,4628,9655,194,375,3805,7698,3999,8073
280350,202311,40448,75092,31346,61801,5633,7926,19976,41250,25609,49176
280360,202311,7307,17645,5138,13627,681,1719,3079,7681,3760,9400
280370,202311,2886,5966,2127,4706,245,414,1473,3290,1718,3704
280380,202311,1323,2996,993,2435,130,316,647,1540,777,1856
280390,202311,5057,10284,3770,8222,341,622,2874,6138,3215,6760
280400,202311,5194,10696,3812,8624,329,707,2841,6244,3170,6951
280410,202311,3552,8270,2606,6530,559,1220,1431,3528,1990,4748
280420,202311,5678,12459,4646,11021,122,284,4002,9348,4124,9632
280430,202311,3005,5899,2387,5016,95,234,1937,3844,2032,4078
280440,202311,5684,12246,4412,10171,420,869,3319,7330,3739,8199
280445,202311,2606,6276,2223,5569,223,377,1565,3911,1788,4288
280450,202311,12221,27050,9475,22621,2937,6453,4290,10691,7227,17144
280460,202311,8818,17990,7072,15419,620,1328,5275,10991,5895,12319
280470,202311,2055,5047,1515,3997,249,557,958,2487,1207,3044
280480,202311,66244,133346,50281,108290,6880,13834,32233,66669,39113,80503
280490,202311,4144,10816,3128,8859,314,722,2005,5481,2319,6203
280500,202311,1311,2630,931,2082,33,94,737,1595,770,1689
280510,202311,4589,7661,3680,6450,361,493,3021,5290,3382,5783
280520,202311,2360,4798,1862,4064,178,346,1357,2876,1535,3222
280530,202311,2864,6416,2145,5237,115,283,1654,3876,1769,4159
280540,202311,10552,24889,8729,21965,408,1040,7240,17812,7648,18852
280550,202311,8386,16757,6324,13656,197,522,5161,10405,5358,10927
280560,202311,9392,21723,8045,19520,216,639,6904,16240,7120,16879
280570,202311,8773,17801,6561,14582,367,795,4976,10405,5343,11200
280580,202311,7832,16151,6189,13524,490,891,4758,10029,5248,10920
280590,202311,3356,7027,2350,5529,162,407,1650,3610,1812,4017
280600,202311,5328,11321,4227,9404,1145,1962,2236,5338,3381,7300
280610,202311,3571,6975,2706,5697,127,278,2197,4400,2324,4678
280620,202311,7899,16071,5987,13285,445,745,4428,9865,4873,10610
280630,202311,5254,11512,4211,9845,375,759,2988,6850,3363,7609
280640,202311,3112,6660,2337,5613,92,248,1990,4636,2082,4884
280650,202311,1394,3309,984,2579,125,312,569,1375,694,1687
280660,202311,4774,8953,3581,7345,332,608,2777,5595,3109,6203
280670,202311,26186,53697,19443,43421,4151,8213,10460,23471,14611,31684
280680,202311,3554,7522,2688,6142,259,481,1791,4138,2050,4619
280690,202311,1340,2635,997,2132,57,130,790,1614,847,1744
280700,202311,1475,3026,1127,2471,22,57,935,1972,957,2029
280710,202311,18993,36059,14124,29786,809,1527,11489,23636,12298,25163
280720,202311,3102,6271,2170,4969,39,120,1744,3881,1783,4001
280730,202311,1261,2890,934,2316,111,266,623,1511,734,1777
280740,202311,21300,40038,16565,32891,903,1934,13207,24720,14110,26654
280750,202311,4143,10419,3191,8622,370,841,2121,5713,2491,6554
280760,202311,9317,19625,7074,16227,694,1395,5084,11534,5778,12929
290010,202311,3764,6787,2396,4736,37,87,2035,3770,2072,3857
290020,202311,7275,15072,6027,13350,461,725,4756,10469,5217,11194
290030,202311,5424,11136,4049,9336,491,958,2786,6614,3277,7572
290035,202311,6167,11777,4748,9818,200,347,3809,7680,4009,8027
290040,202311,7249,12289,5743,10415,217,373,4991,8886,5208,9259
290050,202311,2543,7159,1852,5565,149,484,1194,3333,1343,3817
290060,202311,1940,3651,1270,2701,138,268,925,1883,1063,2151
290070,202311,53315,100725,39552,80520,3815,6964,28450,56115,32265,63079
290080,202311,8861,19881,6903,16694,837,2051,4579,10705,5416,12756
290090,202311,2773,4378,1908,3435,38,70,1718,3024,1756,3094
290100,202311,12246,27696,8432,21153,1930,4383,3511,9287,5441,13670
290110,202311,6924,15736,4905,11923,1012,2084,2441,5938,3453,8022
290115,202311,4938,13013,3802,10836,406,1126,2799,7809,3205,8935
290120,202311,8404,17560,6304,14357,270,619,5181,11344,5451,11963
290130,202311,5539,11525,3779,8913,282,554,2574,6235,2856,6789
290135,202311,5688,11554,3945,8490,386,780,2819,5756,3205,6536
290140,202311,5279,12136,3642,9589,224,581,2816,7209,3040,7790
290150,202311,4270,7915,3081,6334,139,345,2406,4634,2545,4979
290160,202311,4578,8627,3676,7278,271,437,3016,5897,3287,6334
290170,202311,4695,9286,3549,7824,161,331,2997,6456,3158,6787
290180,202311,3647,8531,2795,7092,115,351,2263,5525,2378,5876
290190,202311,6247,13012,5183,11474,130,332,4412,9455,4542,9787
290195,202311,3340,6750,2398,5492,163,323,1888,4283,2051,4606
290200,202311,5071,12478,3443,9419,228,510,2389,6394,2617,6904
290205,202311,4728,9822,3549,7829,157,384,2751,5694,2908,6078
290210,202311,18043,39802,14371,33811,1965,3927,9969,23506,11934,27433
290220,202311,4253,7781,3371,6620,111,283,2838,5352,2949,5635
290225,202311,3774,6617,2635,5324,68,175,2245,4325,2313,4500
290230,202311,3911,7506,3359,6805,195,293,2661,5466,2856,5759
290240,202311,5088,10078,3876,8503,192,428,3178,6776,3370,7204
290250,202311,5199,12169,3737,9825,217,479,2886,7545,3103,8024
290260,202311,6581,13976,5039,11524,304,670,4072,8896,4376,9566
290265,202311,3789,10298,2715,8059,416,1224,1522,4323,1938,5547
290270,202311,13319,39693,10973,34888,954,2892,7717,24034,8671,26926
290280,202311,7432,20447,5574,16288,840,2471,3215,8873,4055,11344
290290,202311,12109,31492,8240,23851,1117,3296,4552,12391,5669,15687
290300,202311,5001,12160,3325,8898,227,688,2316,5882,2543,6570
290310,202311,2882,5006,2156,4129,30,78,1933,3603,1963,3681
290320,202311,38950,85609,27456,66211,5244,12724,14588,33493,19832,46217
290323,202311,4667,11286,3516,9229,134,371,2683,6905,2817,7276
290327,202311,5246,13104,3751,9921,440,1020,2355,6067,2795,7087
290330,202311,3199,5104,2370,4172,66,169,2093,3576,2159,3745
290340,202311,8000,16128,5800,13174,477,1093,4372,9570,4849,10663
290350,202311,5877,14608,4413,11938,311,891,3140,8179,3451,9070
290360,202311,6635,13720,5146,11518,238,628,4308,9244,4546,9872
290370,202311,5686,12388,3620,9325,208,535,2503,6371,2711,6906
290380,202311,7350,15378,5473,12573,169,376,4562,10310,4731,10686
290390,202311,18957,47229,13820,37849,1418,3760,8983,23874,10401,27634
290395,202311,3691,8819,2582,6806,112,338,1919,4793,2031,5131
290400,202311,4536,11107,3112,8483,150,448,2298,5961,2448,6409
290405,202311,5508,14138,4220,11700,598,1601,2528,7062,3126,8663
290410,202311,6961,16045,4751,12375,181,649,3507,8621,3688,9270
290420,202311,3764,9091,2724,7294,152,369,1949,5177,2101,5546
290430,202311,4637,9712,3534,8032,175,458,2788,5988,2963,6446
290440,202311,3470,7687,2286,5725,196,468,1561,3845,1757,4313
290450,202311,5234,10036,3698,7707,83,233,3197,6281,3280,6514
290460,202311,15914,40460,10651,29303,2539,7086,3790,9837,6329,16923
290470,202311,6173,12149,4124,9145,369,769,2813,6048,3182,6817
290475,202311,8151,19864,6094,16275,154,550,4941,12641,5095,13191
290480,202311,2341,4944,1653,3769,60,177,1219,2484,1279,2661
290485,202311,5722,14278,4541,12346,263,764,3375,8985,3638,9749
290490,202311,12180,23525,9848,20092,588,1150,7716,15233,8304,16383
290500,202311,5250,13850,3455,9927,863,2474,1172,3245,2035,5719
290510,202311,4452,9182,3405,7719,106,258,2868,6401,2974,6659
290515,202311,4235,10339,3216,8597,106,414,2505,6313,2611,6727
290520,202311,15330,37467,10451,27631,617,1966,6884,16391,7501,18357
290530,202311,5899,15097,4494,12593,148,497,3593,9809,3741,10306
290540,202311,5187,11534,4308,10336,195,482,3561,8348,3756,8830
290550,202311,5456,11603,4293,10078,145,467,3615,8179,3760,8646
290560,202311,7706,17577,5200,13461,576,1523,3094,7388,3670,8911
290570,202311,78054,162175,61894,136796,6142,14646,45411,94880,51553,109526
290580,202311,11504,25942,9335,22691,922,2123,6708,16263,7630,18386
290590,202311,8449,23273,6564,19854,197,648,5071,15300,5268,15948
290600,202311,23562,57763,18110,48008,1466,3913,13401,34153,14867,38066
290610,202311,2948,8172,2090,6393,109,357,1443,4257,1552,4614
290620,202311,7298,18987,5584,15803,553,1508,4026,11201,4579,12709
290630,202311,13380,25144,10239,20974,756,1621,7880,15686,8636,17307
290640,202311,3287,6951,2201,5175,248,518,1512,3584,1760,4102
290650,202311,24441,46095,19879,39715,761,1926,17080,32517,17841,34443
290660,202311,4557,10650,3186,8158,212,607,2217,5518,2429,6125
290670,202311,10942,21318,8580,17809,208,552,7450,14875,7658,15427
290680,202311,13833,32311,10331,26629,377,1254,7897,19243,8274,20497
290682,202311,6747,13642,5357,11664,425,665,3872,8973,4297,9638
290685,202311,4372,8903,2847,6568,461,973,1646,3849,2107,4822
290687,202311,10589,22081,8096,18074,1260,2588,4996,11199,6256,13787
290689,202311,3443,8223,2263,6064,360,906,1325,3479,1685,4385
290690,202311,7082,16095,5032,12629,480,1123,3366,8188,3846,9311
290700,202311,3874,7716,3070,6625,115,305,2519,5238,2634,5543
290710,202311,11322,25269,8829,21577,279,741,7509,17884,7788,18625
290720,202311,26367,59408,20688,50320,1589,3606,14901,34572,16490,38178
290730,202311,8847,18642,6669,15571,700,1406,4367,10269,5067,11675
290740,202311,1344,3036,941,2392,86,181,706,1787,792,1968
290750,202311,18064,34570,13225,26163,446,1111,10716,19702,11162,20813
290755,202311,2387,6155,1702,4878,217,494,1031,3000,1248,3494
290760,202311,4575,11662,3386,9383,200,466,2331,6444,2531,6910
290770,202311,3973,8881,3310,7909,81,273,2752,6287,2833,6560
290780,202311,9511,21251,6843,16836,817,1435,4491,11289,5308,12724
290790,202311,6303,14943,4874,12628,299,798,3703,9375,4002,10173
290800,202311,8223,14716,5403,11110,577,929,3737,7862,4314,8791
290810,202311,6927,14894,5047,11954,237,601,3827,8829,4064,9430
290820,202311,6896,15099,5124,12007,278,656,3652,8159,3930,8815
290830,202311,5165,11582,3801,9065,158,534,2703,5730,2861,6264
290840,202311,22928,53259,17053,42948,2183,4711,9951,26219,12134,30930
290850,202311,11583,21060,8639,17199,641,1176,6483,12526,7124,13702
290860,202311,8180,19080,6585,16838,369,838,5355,13669,5724,14507
290870,202311,5906,14315,3893,10273,393,891,2525,6477,2918,7368
290880,202311,1733,3772,1201,2988,263,574,574,1557,837,2131
290890,202311,12314,21334,9373,17758,326,703,7967,14588,8293,15291
290900,202311,2791,6755,1795,4788,323,818,936,2434,1259,3252
290910,202311,6283,12819,4308,9797,97,250,3683,8154,3780,8404
290920,202311,6346,13769,5085,12105,214,464,4084,10106,4298,10570
290930,202311,8674,22200,6234,17661,305,943,4301,11630,4606,12573
290940,202311,4161,10448,3109,8642,264,716,2221,5998,2485,6714
290950,202311,1714,3822,1202,2976,116,272,755,1887,871,2159
290960,202311,7530,16136,5990,13849,518,866,4663,10874,5181,11740
290970,202311,3703,10221,2685,8123,221,645,1852,5437,2073,6082
290980,202311,18937,37783,14236,30019,915,2196,9958,19274,10873,21470
290990,202311,12133,28091,9720,23951,533,1437,7596,17739,8129,19176
291000,202311,4004,8944,2838,7337,216,575,2069,5268,2285,5843
291005,202311,22179,46539,17081,38521,1080,2708,13070,27702,14150,30410
291010,202311,3638,10211,2495,7564,197,582,1521,4402,1718,4984
291020,202311,1545,3438,1087,2608,40,116,765,1653,805,1769
291030,202311,3079,6458,1978,4550,258,525,1151,2530,1409,3055
291040,202311,6561,15580,4806,12879,286,755,3545,9393,3831,10148
291050,202311,14984,29160,11671,24035,1505,2899,8238,16569,9743,19468
291060,202311,11348,24237,8872,20566,1327,2395,5892,13797,7219,16192
291070,202311,22904,48584,17822,40449,493,1264,14955,32615,15448,33879
291072,202311,36767,77399,23539,54897,3780,8451,12490,27977,16270,36428
291075,202311,6491,14490,5283,12399,137,356,4229,9413,4366,9769
291077,202311,2053,4833,1408,3689,94,195,919,2413,1013,2608
291080,202311,175276,364824,121866,279361,24493,56361,59730,130282,84223,186643
291085,202311,6934,15368,5028,12285,280,842,3842,8923,4122,9765
291090,202311,2570,4421,1641,3301,52,126,1335,2579,1387,2705
291100,202311,3917,7221,2589,5502,111,218,2021,4151,2132,4369
291110,202311,7151,19423,5159,15469,292,959,3611,10127,3903,11086
291120,202311,10350,20628,7920,17202,595,1179,5844,12328,6439,13507
291125,202311,2820,4399,1957,3412,85,123,1685,2884,1770,3007
291130,202311,3843,9580,2461,6790,137,438,1697,4345,1834,4783
291140,202311,5796,14069,3575,9632,707,1652,1902,5207,2609,6859
291150,202311,3386,5819,2397,4664,118,231,1996,3851,2114,4082
291160,202311,6220,15265,4331,11807,636,1673,2374,6028,3010,7701
291165,202311,2515,6325,1504,4250,40,148,953,2530,993,2678
291170,202311,27927,62980,19690,47689,1823,4227,12359,28264,14182,32491
291180,202311,9565,16649,6742,12924,395,684,5593,10462,5988,11146
291185,202311,4315,9383,3452,7994,190,377,2733,6259,2923,6636
291190,202311,9355,19965,7082,16783,409,906,5099,12103,5508,13009
291200,202311,3260,8162,2109,5838,130,413,1297,3282,1427,3695
291210,202311,9818,17296,6646,13430,368,708,5225,10268,5593,10976
291220,202311,6137,14415,4718,11868,644,1500,2834,6881,3478,8381
291230,202311,6011,10230,4277,8184,90,168,3813,7138,3903,7306
291240,202311,5073,11754,3884,9731,121,333,3203,7764,3324,8097
291250,202311,3949,10598,2804,8404,273,692,1536,4743,1809,5435
291260,202311,1845,3672,1323,2948,27,64,1079,2323,1106,2387
291270,202311,6886,14887,4940,12064,689,1617,3264,7927,3953,9544
291280,202311,3430,7375,2095,5058,151,379,1422,3147,1573,3526
291290,202311,6703,15741,4408,11807,467,1277,2793,7118,3260,8395
291300,202311,4724,11101,3407,8781,278,573,2379,6055,2657,6628
291310,202311,6403,14738,4884,12007,141,375,4059,9602,4200,9977
291320,202311,8040,19076,5689,14870,1497,3654,2748,7310,4245,10964
291330,202311,2248,5181,1652,4143,84,225,1201,2879,1285,3104
291340,202311,5173,11817,3689,9236,322,726,2339,5766,2661,6492
291345,202311,3600,8751,2958,7689,229,594,2181,5566,2410,6160
291350,202311,8587,17689,6188,14391,427,957,4628,10406,5055,11363
291360,202311,56538,107558,39570,84519,6287,12615,23145,49267,29432,61882
291370,202311,10284,24048,8122,20279,1326,2813,5038,12332,6364,15145
291380,202311,5964,11833,4581,9908,137,411,3794,7753,3931,8164
291390,202311,16990,30723,11709,24003,986,1600,8980,18002,9966,19602
291400,202311,21099,42184,15447,33206,2399,4325,9454,20921,11853,25246
291410,202311,3663,8413,2479,6208,58,182,1865,4422,1923,4604
291420,202311,2248,4858,1615,3988,24,86,1384,3330,1408,3416
291430,202311,3177,7737,2372,6277,185,459,1708,4324,1893,4783
291440,202311,8307,20168,6406,16906,511,1246,4467,11831,4978,13077
291450,202311,13966,25052,10619,20986,328,603,9255,18148,9583,18751
291460,202311,23350,49901,17772,40387,2239,4580,11802,25818,14041,30398
291465,202311,10547,22923,7733,19309,388,1189,5954,14183,6342,15372
291470,202311,26282,47465,19124,37772,1201,2131,14016,26234,15217,28365
291480,202311,52810,104612,37295,80197,4886,10276,21685,44127,26571,54403
291490,202311,9596,18566,7874,16455,544,1107,6314,12848,6858,13955
291500,202311,6842,12863,5228,10789,130,377,4520,8919,4650,9296
291510,202311,5984,11351,4251,9047,109,316,3593,7342,3702,7658
291520,202311,5700,11439,3718,8572,237,560,2778,6076,3015,6636
291530,202311,2768,5645,1733,4163,165,420,1126,2585,1291,3005
291535,202311,4770,11405,3624,9468,223,570,2781,7167,3004,7737
291540,202311,2731,5125,1775,3874,104,204,1399,2980,1503,3184
291550,202311,8354,15252,5702,11588,410,752,4200,8320,4610,9072
291560,202311,21879,47620,13694,34654,3695,9043,4889,12164,8584,21207
291570,202311,2846,5701,2000,4681,61,137,1647,3766,1708,3903
291580,202311,7750,17161,5274,13334,494,1142,3556,8631,4050,9773
291590,202311,3529,6424,2732,5408,86,204,2340,4386,2426,4590
291600,202311,6828,13660,4677,10327,543,1284,2923,6198,3466,7482
291610,202311,8675,16696,6878,14344,743,1095,5080,10738,5823,11833
291620,202311,3575,7010,2418,5523,192,394,1692,3887,1884,4281
291630,202311,4302,7782,2916,6042,500,810,2004,4300,2504,5110
291640,202311,23334,46275,15422,34063,1191,2832,10056,20779,11247,23611
291650,202311,12681,25687,10174,22231,735,1285,7758,16762,8493,18047
291660,202311,2377,5175,1607,3947,167,401,1034,2349,1201,2750
291670,202311,2424,5764,1788,4737,334,775,990,2716,1324,3491
291680,202311,5075,10935,3601,8661,849,1916,1846,4517,2695,6433
291685,202311,5697,12873,4111,10296,407,891,2834,7031,3241,7922
291690,202311,5560,9825,3678,7197,179,346,3125,5903,3304,6249
291700,202311,12060,27647,9869,24015,290,848,8412,19714,8702,20562
291710,202311,6834,13140,4649,10010,403,849,3342,6791,3745,7640
291720,202311,5431,14583,4000,11618,1114,3169,1780,5098,2894,8267
291730,202311,9902,18404,7998,15887,494,986,6503,12588,6997,13574
291733,202311,3634,7987,2680,6554,141,371,1940,4770,2081,5141
291735,202311,3155,7975,2136,5991,139,357,1430,4005,1569,4362
291740,202311,5038,11657,2946,7738,132,292,2001,5121,2133,5413
291750,202311,27566,56416,20258,44516,3060,5868,12834,28079,15894,33947
291760,202311,13914,34623,9405,26696,3364,10303,1353,3652,4717,13955
291770,202311,9599,22308,6814,16875,499,1374,4836,10999,5335,12373
291780,202311,6555,14601,5508,13016,224,520,4531,10423,4755,10943
291790,202311,3815,8174,3165,7232,534,809,2057,4998,2591,5807
291800,202311,45907,94851,32315,73697,5720,11796,17741,38644,23461,50440
291810,202311,13556,27942,10333,23405,647,1175,7897,17861,8544,19036
291820,202311,4823,10965,3771,9335,163,369,2930,7098,3093,7467
291830,202311,6125,11537,4548,9381,575,767,3233,6885,3808,7652
291835,202311,7938,21187,5822,17142,1360,3724,2869,8623,4229,12347
291840,202311,68787,157136,53653,131561,7545,17699,34217,81009,41762,98708
291845,202311,4237,8180,3130,6699,423,778,2035,4451,2458,5229
291850,202311,5671,13100,4329,10909,147,402,3585,8926,3732,9328
291855,202311,2891,4715,2101,3821,90,174,1825,3258,1915,3432
291860,202311,2578,6244,1521,4077,83,224,972,2483,1055,2707
291870,202311,1559,3556,882,2341,89,254,506,1249,595,1503
291875,202311,3589,9700,2739,7849,112,404,1916,5199,2028,5603
291880,202311,6904,16488,5318,13716,462,1119,3757,9655,4219,10774
291890,202311,2119,3778,1182,2598,189,377,687,1429,876,1806
291900,202311,1651,3427,1147,2632,46,111,897,1922,943,2033
291905,202311,2515,6210,1810,4935,114,334,1310,3363,1424,3697
291910,202311,4580,8474,3474,7014,97,240,2967,5833,3064,6073
291915,202311,8954,22455,6567,18129,271,731,4430,12127,4701,12858
291920,202311,48178,101475,37331,84803,1984,5378,27872,58864,29856,64242
291930,202311,3471,7516,2686,6330,358,736,1817,4312,2175,5048
291940,202311,4520,10392,2621,6999,349,866,1485,3889,1834,4755
291950,202311,11043,30653,8151,24588,619,1788,5112,15087,5731,16875
291955,202311,27445,58169,21159,48585,1512,3698,15297,33364,16809,37062
291960,202311,4766,9484,3585,7840,384,571,2689,6086,3073,6657
291970,202311,6196,12465,4830,10634,220,515,3763,7941,3983,8456
291980,202311,12393,30957,8791,24240,949,2384,5514,15091,6463,17475
291990,202311,2784,6271,2128,5402,103,375,1756,4277,1859,4652
291992,202311,5794,11585,4275,9190,176,437,3425,6964,3601,7401
291995,202311,2882,6367,2068,4997,107,332,1567,3519,1674,3851
292000,202311,3408,6719,2617,5730,89,221,2178,4664,2267,4885
292010,202311,7218,14281,5369,11445,122,334,4562,9321,4684,9655
292020,202311,5856,13789,4445,11231,132,409,3575,8545,3707,8954
292030,202311,2697,6724,2014,5413,261,734,1160,2950,1421,3684
292040,202311,5832,12151,4237,9821,190,349,3409,7781,3599,8130
292045,202311,5503,11055,4018,8976,74,200,3600,7926,3674,8126
292050,202311,8007,19387,5552,14665,408,1010,3538,8888,3946,9898
292060,202311,16349,30873,13897,27635,819,1514,11504,22124,12323,23638
292070,202311,9101,17967,7402,15753,594,1258,5965,12333,6559,13591
292080,202311,4725,8850,3681,7491,62,170,3282,6467,3344,6637
292090,202311,5311,10037,3399,7573,155,364,2602,5596,2757,5960
292100,202311,16733,35198,11887,27560,1926,4423,6817,15061,8743,19484
292105,202311,3945,9126,2895,7395,93,316,2229,5446,2322,5762
292110,202311,8350,16430,5535,12392,990,2175,3127,6797,4117,8972
292120,202311,8791,19461,6428,15239,889,1763,4111,9894,5000,11657
292130,202311,4050,8596,2927,6967,361,700,1858,4355,2219,5055
292140,202311,7280,13963,5544,11404,206,438,4754,9453,4960,9891
292145,202311,3266,7727,2400,6165,156,292,1749,4567,1905,4859
292150,202311,20386,43607,16002,36400,419,1061,13199,28571,13618,29632
292160,202311,3528,7445,2377,5850,55,160,1851,4677,1906,4837
292170,202311,10600,25157,7745,20281,648,1783,5290,13094,5938,14877
292180,202311,3490,8752,2295,6385,224,616,1406,3690,1630,4306
292190,202311,3863,8705,2776,6838,340,786,1761,4240,2101,5026
292200,202311,11729,26033,7178,18218,1937,4996,2535,6285,4472,11281
292205,202311,4785,11308,3712,9517,151,404,3055,7642,3206,8046
292210,202311,8277,15587,6462,13222,115,291,5818,11568,5933,11859
292220,202311,2820,5647,2066,4419,165,335,1519,3036,1684,3371
292225,202311,3866,9950,3011,8467,86,289,2423,6557,2509,6846
292230,202311,10894,22463,8186,18403,392,1044,6141,12925,6533,13969
292240,202311,6346,15683,4925,12963,400,1045,3359,8677,3759,9722
292250,202311,7867,16958,6223,14309,528,1144,4621,10309,5149,11453
292260,202311,4247,9813,3377,8561,119,301,2834,7107,2953,7408
292265,202311,4635,10498,3593,8787,101,297,2957,6961,3058,7258
292270,202311,6125,11295,4541,9240,273,484,3527,6955,3800,7439
292273,202311,3444,6697,2453,5348,158,340,1758,3908,1916,4248
292275,202311,2256,4951,1737,4185,57,145,1366,3113,1423,3258
292280,202311,3407,6880,2534,5793,109,245,2104,4800,2213,5045
292285,202311,3191,6424,2294,5155,148,289,1788,4055,1936,4344
292290,202311,9319,20377,6842,16593,636,1157,5096,12395,5732,13552
292300,202311,13251,29428,8920,22414,1715,4203,4681,11510,6396,15713
292303,202311,4213,9305,3321,7817,95,250,2794,6356,2889,6606
292305,202311,2836,6525,2350,5760,137,329,1915,4578,2052,4907
292310,202311,8544,17925,6709,15298,185,485,5683,12413,5868,12898
292320,202311,7057,16644,5101,13210,190,507,3915,9791,4105,10298
292330,202311,3947,6667,3012,5542,168,255,2476,4565,2644,4820
292335,202311,6311,14501,5007,12366,453,1041,3750,9193,4203,10234
292340,202311,6478,16486,4672,12814,565,1375,2961,8020,3526,9395
292350,202311,3488,7899,2750,6801,186,436,2144,5184,2330,5620
292360,202311,6095,14353,4480,11441,322,819,3109,7651,3431,8470
292370,202311,13461,27160,10610,23192,177,615,9514,20106,9691,20721
292380,202311,8363,20438,6638,17130,561,1330,4798,11993,5359,13323
292390,202311,5937,9377,4282,7411,176,270,3793,6479,3969,6749
292400,202311,30367,71342,22950,58010,2862,6786,14722,36154,17584,42940
292405,202311,5554,11885,4144,9534,189,452,3163,7229,3352,7681
292410,202311,3090,5677,2344,4703,126,226,1975,3899,2101,4125
292420,202311,6329,12073,5194,10504,160,285,4593,9043,4753,9328
292430,202311,6077,16088,3924,11691,308,917,2520,7144,2828,8061
292440,202311,11635,29257,9984,26681,155,640,8661,22524,8816,23164
292450,202311,5107,12708,3342,9197,220,601,2289,5995,2509,6596
292460,202311,8057,16318,6257,13507,385,979,5028,10301,5413,11280
292465,202311,3186,6971,2350,5619,97,234,1626,4011,1723,4245
292467,202311,2695,6161,2194,5400,303,653,1452,3704,1755,4357
292470,202311,3348,7972,2191,5976,161,436,1507,4043,1668,4479
292480,202311,8155,15060,6324,12728,308,500,5408,10818,5716,11318
292490,202311,3621,6817,2539,5323,63,148,2049,4050,2112,4198
292500,202311,9097,19709,6409,15136,379,798,4804,10982,5183,11780
292510,202311,17717,39636,12324,30545,1879,3686,7749,19541,9628,23227
292520,202311,9461,20634,7119,16518,464,1211,5330,11700,5794,12911
292525,202311,8225,16664,6184,14047,186,467,5271,11654,5457,12121
292530,202311,49496,109120,34839,84582,6891,17422,17591,39931,24482,57353
292540,202311,5053,8579,3651,7017,282,524,2990,5722,3272,6246
292550,202311,10766,25662,7336,20694,735,2065,4453,12602,5188,14667
292560,202311,5652,12400,4138,10021,179,510,3168,7290,3347,7800
292570,202311,4538,10425,3337,8300,102,340,2623,6182,2725,6522
292575,202311,8387,21295,7019,18966,1516,3845,4211,11634,5727,15479
292580,202311,9728,19945,7482,16562,350,583,6061,13129,6411,13712
292590,202311,9045,21194,6859,17165,571,1364,5298,12904,5869,14268
292593,202311,3613,7844,2461,5802,117,291,1861,4186,1978,4477
292595,202311,6930,15538,5558,13512,312,679,4340,10480,4652,11159
292600,202311,13996,32785,10981,27878,830,1805,8317,21061,9147,22866
292610,202311,5640,12199,4157,9677,267,620,3140,6992,3407,7612
292620,202311,8188,18553,6144,15764,208,676,5035,12561,5243,13237
292630,202311,11759,24210,8402,18671,1853,3905,4947,10679,6800,14584
292640,202311,9816,24968,7146,19917,684,1752,4428,12371,5112,14123
292650,202311,5070,11329,4061,9835,122,430,3504,8196,3626,8626
292660,202311,13340,32896,10197,27523,583,1501,7344,19525,7927,21026
292665,202311,2527,6368,1957,5489,120,276,1461,4141,1581,4417
292670,202311,4091,10348,2844,7906,333,975,1730,4518,2063,5493
292680,202311,4708,10999,3410,8645,143,356,2525,6070,2668,6426
292690,202311,2890,6956,1806,5120,274,711,1012,2934,1286,3645
292700,202311,13072,29553,9797,23910,994,1983,6763,16346,7757,18329
292710,202311,4430,9137,3911,8447,119,310,3531,7413,3650,7723
292720,202311,10496,21643,7844,17977,606,1205,5606,12979,6212,14184
292730,202311,6998,13265,5666,11297,309,519,4723,9331,5032,9850
292740,202311,583193,1113622,461494,926662,59223,112822,310005,595434,369228,708256
292750,202311,9380,19187,7209,16103,354,812,5793,12525,6147,13337
292760,202311,4787,11955,3689,9901,187,506,2735,7132,2922,7638
292770,202311,10322,21585,7591,17568,1113,2668,4788,10708,5901,13376
292780,202311,2552,4360,1738,3353,79,158,1399,2546,1478,2704
292790,202311,4723,8616,3129,6665,310,542,2296,4820,2606,5362
292800,202311,14931,31588,11550,26126,1431,2702,8022,18438,9453,21140
292805,202311,4630,9177,3391,7496,203,461,2647,5600,2850,6061
292810,202311,17097,32984,12611,26133,398,1053,10289,19800,10687,20853
292820,202311,8060,20790,5403,15928,904,2295,3139,9220,4043,11515
292830,202311,3664,7514,2839,6428,164,368,2197,4930,2361,5298
292840,202311,12813,25519,9900,21393,210,595,8616,17808,8826,18403
292850,202311,3239,7326,2411,5978,169,385,1713,4047,1882,4432
292860,202311,22556,42470,17187,34852,542,1350,14046,26738,14588,28088
292870,202311,30031,61035,22047,47860,3091,5487,13331,28089,16422,33576
292880,202311,14166,35032,9972,27016,464,1455,6588,16074,7052,17529
292890,202311,11085,23783,8646,19995,299,813,6896,15027,7195,15840
292895,202311,4140,7529,2912,5672,266,510,2165,4092,2431,4602
292900,202311,3756,8033,2967,6724,56,190,2330,4889,2386,5079
292905,202311,5532,12322,3945,9727,410,911,2658,6309,3068,7220
292910,202311,7265,15689,5809,13388,204,388,4741,10610,4945,10998
292920,202311,12809,28829,9988,23807,435,1308,7794,17485,8229,18793
292925,202311,6290,16256,4422,12392,467,1143,2816,7778,3283,8921
292930,202311,9001,22974,6507,17711,1083,2720,3157,8251,4240,10971
292935,202311,3302,6137,2435,5046,41,108,2122,4338,2163,4446
292937,202311,3295,7679,2543,6571,511,1359,1153,3215,1664,4574
292940,202311,3784,8258,2732,6573,531,1157,1578,3870,2109,5027
292950,202311,11253,26093,7868,19679,688,1685,5271,12259,5959,13944
292960,202311,6937,14279,5182,11611,243,543,3910,8360,4153,8903
292970,202311,5030,12179,4102,10704,161,438,3203,8252,3364,8690
292975,202311,5241,10518,4158,9061,130,307,3506,7349,3636,7656
292980,202311,4856,9128,3664,7379,72,166,3204,6218,3276,6384
292990,202311,14013,34766,10525,28355,765,2287,7429,18757,8194,21044
293000,202311,3235,7123,2314,5531,280,492,1476,3590,1756,4082
293010,202311,24205,52304,17457,41217,3174,7089,10231,23674,13405,30763
293015,202311,10607,28307,7609,22408,749,2098,4954,14345,5703,16443
293020,202311,12791,30159,10663,26769,204,623,9333,22793,9537,23416
293030,202311,6286,14958,4290,11532,320,611,2731,7513,3051,8124
293040,202311,5433,12165,3880,9812,159,359,3066,7600,3225,7959
293050,202311,32593,63264,25014,51145,2023,3734,18652,36655,20675,40389
293060,202311,4689,10993,3358,8482,259,680,2387,5709,2646,6389
293070,202311,43780,82272,33794,67155,2232,4575,25580,48123,27812,52698
293075,202311,4488,11901,3570,10302,82,330,2961,8375,3043,8705
293076,202311,4203,8789,3464,7782,128,240,2922,6575,3050,6815
293077,202311,8504,19487,5823,14774,1041,2202,3054,8174,4095,10376
293080,202311,5358,14058,4105,11634,109,389,3215,8692,3324,9081
293090,202311,3832,10153,2522,7567,268,765,1607,4655,1875,5420
293100,202311,7256,16858,5255,13216,597,1287,3661,9127,4258,10414
293105,202311,4797,13325,3735,11147,375,1031,2429,7187,2804,8218
293110,202311,3239,6510,2403,5223,178,343,1859,3969,2037,4312
293120,202311,6548,13535,5358,11686,504,815,4035,8876,4539,9691
293130,202311,4642,10568,3691,9167,118,348,3161,7611,3279,7959
293135,202311,40816,87577,24988,61683,5728,15110,8699,20066,14427,35176
293140,202311,3632,6026,2749,4900,134,213,2253,3859,2387,4072
293150,202311,6366,16613,4384,12360,634,1436,2661,7327,3295,8763
293160,202311,5032,10295,4187,9240,539,786,3096,7336,3635,8122
293170,202311,6805,10907,4853,8529,124,258,4136,6884,4260,7142
293180,202311,5766,13544,4347,11025,154,436,3427,8316,3581,8752
293190,202311,21668,42649,17905,37188,221,749,15870,31480,16091,32229
293200,202311,11654,22975,8638,18343,600,1116,6756,14108,7356,15224
293210,202311,7020,15112,5254,12252,599,1241,3597,8291,4196,9532
293220,202311,7627,15147,5193,11284,849,1677,3258,6862,4107,8539
293230,202311,6104,11741,4183,9202,483,961,2841,6254,3324,7215
293240,202311,5551,12229,4128,9860,194,368,2990,7309,3184,7677
293245,202311,4902,11450,3927,9766,257,649,2930,6862,3187,7511
293250,202311,7032,15013,4842,11469,586,1315,3113,7034,3699,8349
293260,202311,6032,13247,4173,10053,278,690,2828,6710,3106,7400
293270,202311,9346,17926,6772,14921,527,876,5274,12028,5801,12904
293280,202311,5999,12663,4672,10607,303,685,3711,8099,4014,8784
293290,202311,22785,53974,18145,45977,1785,4513,12600,30674,14385,35187
293300,202311,8535,17207,6417,13702,957,1675,4223,8808,5180,10483
293305,202311,5786,11380,4036,8946,114,329,3457,7352,3571,7681
293310,202311,2801,6146,2076,4947,46,119,1699,3871,1745,3990
293315,202311,5781,11088,4347,9042,411,644,3368,7086,3779,7730
293317,202311,3433,7151,2712,5957,488,937,1709,3776,2197,4713
293320,202311,18668,34591,15014,30053,296,727,13219,25363,13515,26090
293325,202311,2356,4924,1628,3902,186,443,1020,2331,1206,2774
293330,202311,104738,234310,72746,175332,11021,25780,40875,91700,51896,117480
293340,202311,2709,6624,1930,5164,183,446,1275,3359,1458,3805
293345,202311,4841,10937,3310,8419,856,2084,1362,3804,2218,5888
293350,202311,7312,17555,5814,15361,380,944,4564,11985,4944,12929
293360,202311,19454,40511,15038,34566,609,1425,12460,28185,13069,29610
310010,202311,1243,2574,759,1833,141,366,318,646,459,1012
310020,202311,4247,9874,2691,6842,467,1298,1203,2667,1670,3965
310030,202311,2540,6247,1806,4837,261,718,1119,2816,1380,3534
310040,202311,1056,2464,680,1734,79,235,341,742,420,977
310050,202311,2182,5247,1572,4123,180,517,924,2228,1104,2745
310060,202311,3834,9205,2824,7556,406,1071,1660,4499,2066,5570
310070,202311,427,946,261,660,20,45,174,425,194,470
310080,202311,911,2314,578,1649,78,235,252,680,330,915
310090,202311,6789,14121,5027,11317,240,625,3906,8257,4146,8882
310100,202311,4814,10586,3522,8458,101,333,2755,6169,2856,6502
310110,202311,6089,14217,4037,10368,567,1588,2266,5419,2833,7007
310120,202311,888,1930,501,1303,86,277,205,422,291,699
310130,202311,513,1195,421,1024,39,135,311,686,350,821
310140,202311,469,1189,317,909,65,197,135,334,200,531
310150,202311,8316,18100,5265,12529,471,1287,3111,6598,3582,7885
310160,202311,14377,30901,9196,21698,2207,5021,3856,8344,6063,13365
310163,202311,1531,4135,948,2799,266,815,221,506,487,1321
310170,202311,12556,26856,9080,21233,1138,2401,5930,13493,7068,15894
310180,202311,2621,5530,1654,3901,180,466,1062,2328,1242,2794
310190,202311,3405,8744,2079,5954,545,1682,426,1033,971,2715
310200,202311,2533,6397,1696,4766,517,1593,563,1249,1080,2842
310205,202311,1519,3701,1068,2920,162,435,627,1675,789,2110
310210,202311,2981,7206,2064,5343,177,382,1380,3452,1557,3834
310220,202311,1433,3575,947,2629,98,311,570,1449,668,1760
310230,202311,3102,7125,2166,5270,420,958,1117,2516,1537,3474
310240,202311,1323,3342,929,2523,130,375,523,1326,653,1701
310250,202311,1577,3246,1102,2451,40,124,836,1721,876,1845
310260,202311,5145,12210,2867,7633,636,1930,948,1923,1584,3853
310270,202311,3641,6827,2537,5296,108,250,2001,3979,2109,4229
310280,202311,3735,7210,2410,5145,183,393,1640,3151,1823,3544
310285,202311,2279,6335,1587,4875,218,676,875,2609,1093,3285
310290,202311,2137,5019,1529,3788,245,666,832,1786,1077,2452
310300,202311,2143,5300,1246,3412,130,378,583,1335,713,1713
310310,202311,417,871,234,559,43,112,119,250,162,362
310320,202311,602,1386,318,847,34,88,172,427,206,515
310330,202311,644,1398,306,748,62,161,127,276,189,437
310340,202311,10491,23538,6340,15687,1126,2553,2797,6832,3923,9385
310350,202311,18253,40429,10987,27442,1851,4992,5291,11736,7142,16728
310360,202311,838,1591,593,1213,27,75,453,862,480,937
310370,202311,1578,4449,1186,3667,333,1062,329,1051,662,2113
310375,202311,1139,2551,673,1753,263,658,172,438,435,1096
310380,202311,444,991,199,533,17,54,116,276,133,330
310390,202311,820,2247,601,1787,92,303,296,778,388,1081
310400,202311,16651,37234,10052,25355,1270,3477,5357,12225,6627,15702
310410,202311,1355,3544,633,1852,82,253,248,581,330,834
310420,202311,6395,15400,3635,9518,466,1277,1792,4040,2258,5317
310430,202311,2278,5631,1310,3611,255,723,572,1336,827,2059
310440,202311,859,1967,447,1167,87,201,173,412,260,613
310445,202311,1660,4176,1096,2990,99,252,751,1948,850,2200
310450,202311,6020,12691,3759,8918,345,926,2465,5358,2810,6284
310460,202311,2246,5449,1323,3556,300,767,289,679,589,1446
310470,202311,4091,8618,2876,6847,731,1562,1476,3594,2207,5156
310480,202311,1264,2971,795,2116,81,254,431,1004,512,1258
310490,202311,3761,9051,2484,6618,419,1122,1126,2677,1545,3799
310500,202311,1958,4481,1413,3537,210,539,815,1882,1025,2421
310510,202311,3174,7201,1923,4755,360,962,793,1748,1153,2710
310520,202311,1523,3557,836,2186,133,373,341,836,474,1209
310530,202311,1072,2552,609,1593,73,217,220,436,293,653
310540,202311,3703,9665,2237,6350,417,1220,781,1874,1198,3094
310550,202311,1585,3441,994,2388,122,287,547,1193,669,1480
310560,202311,23058,53698,13862,34876,1748,4875,7098,14819,8846,19694
310570,202311,1568,3329,1056,2540,47,131,792,1755,839,1886
310590,202311,5450,12520,3322,7992,230,671,2044,4344,2274,5015
310600,202311,1868,4641,1174,3056,134,337,618,1431,752,1768
310610,202311,618,1575,322,1001,76,241,62,171,138,412
310620,202311,317892,698363,203963,476442,24375,62438,114340,231753,138715,294191
310630,202311,6077,14784,3458,9040,556,1408,1794,4329,2350,5737
310640,202311,2078,4576,1364,3246,98,302,931,1958,1029,2260
310650,202311,2948,7065,1789,4729,124,359,1074,2660,1198,3019
310660,202311,1780,4101,1343,3444,44,156,1082,2658,1126,2814
310665,202311,1759,3743,1276,3009,89,277,994,2252,1083,2529
310670,202311,89653,198198,59711,140448,7579,18825,35063,74992,42642,93817
310680,202311,1003,2061,733,1631,33,94,540,1111,573,1205
310690,202311,3464,7080,2181,5039,349,695,1252,2710,1601,3405
310700,202311,657,1225,443,932,14,36,337,667,351,703
310710,202311,8266,20945,4631,13720,1208,3637,779,2041,1987,5678
310720,202311,1511,3049,1062,2368,50,130,801,1648,851,1778
310730,202311,13176,29905,9295,22816,710,1955,6369,14432,7079,16387
310740,202311,9199,22018,5628,14415,666,1939,2828,6225,3494,8164
310750,202311,1778,3743,1127,2582,183,452,589,1166,772,1618
310760,202311,965,2176,606,1550,73,173,363,900,436,1073
310770,202311,1382,3393,818,2294,113,346,389,943,502,1289
310780,202311,5006,10487,3395,7907,350,861,2190,4804,2540,5665
310790,202311,2424,6847,1801,5396,434,1424,428,1049,862,2473
310800,202311,2951,8036,1622,4972,329,1076,113,269,442,1345
310810,202311,1940,4087,1386,3094,132,301,957,2011,1089,2312
310820,202311,1520,3427,718,1949,182,480,197,498,379,978
310825,202311,3355,8122,2343,6402,66,270,1821,4652,1887,4922
310830,202311,2957,7051,1839,4852,359,1016,899,2028,1258,3044
310840,202311,2874,7007,1716,4684,375,1103,562,1229,937,2332
310850,202311,1726,4142,1169,3189,143,380,715,1845,858,2225
310855,202311,4279,9811,2720,6931,299,739,1647,3926,1946,4665
310860,202311,8520,21750,6081,17005,993,2431,3144,8763,4137,11194
310870,202311,1216,2647,856,2064,80,200,608,1363,688,1563
310880,202311,1093,2937,699,2063,109,318,347,954,456,1272
310890,202311,2770,7295,1472,4449,278,884,197,476,475,1360
310900,202311,5718,14577,3450,9350,676,1958,1377,3182,2053,5140
310910,202311,2799,6316,1550,4066,243,704,365,823,608,1527
310920,202311,2351,5467,1516,3978,286,724,784,2010,1070,2734
310925,202311,1364,3080,902,2263,71,178,602,1420,673,1598
310930,202311,7037,16260,4100,11261,952,2447,1576,4499,2528,6946
310940,202311,8835,18239,5930,13592,281,775,4447,9514,4728,10289
310945,202311,1873,4116,1158,2855,156,405,640,1447,796,1852
310950,202311,2317,6330,1249,3893,210,701,327,779,537,1480
310960,202311,869,2195,400,1126,59,163,124,304,183,467
310970,202311,1464,4103,851,2671,220,707,152,385,372,1092
310980,202311,464,974,221,519,16,48,126,257,142,305
310990,202311,1921,4430,1284,3248,156,444,731,1604,887,2048
311000,202311,5494,13438,3586,9666,847,2263,1543,3759,2390,6022
311010,202311,1242,3013,922,2424,232,614,414,1067,646,1681
311020,202311,1462,3351,784,2055,67,192,429,1011,496,1203
311030,202311,2429,5467,1449,3719,422,1179,472,1073,894,2252
311040,202311,379,1069,242,742,84,283,56,138,140,421
311050,202311,3605,8123,2378,5941,354,1034,1299,2796,1653,3830
311060,202311,4897,11127,2780,6901,336,899,1333,2808,1669,3707
311070,202311,3214,6981,1923,4715,257,726,998,2124,1255,2850
311080,202311,1442,2809,999,2153,50,139,753,1472,803,1611
311090,202311,2939,8121,1888,5767,438,1326,545,1569,983,2895
311100,202311,3205,8134,1926,5602,370,1187,520,1253,890,2440
311110,202311,4687,9438,1901,4728,484,1201,260,580,744,1781
311115,202311,1697,3245,1191,2522,29,90,931,1944,960,2034
311120,202311,9585,22268,5764,14359,925,2451,2597,5369,3522,7820
311130,202311,2398,5785,1491,4085,177,533,808,1965,985,2498
311140,202311,2075,4684,1235,3176,292,687,534,1336,826,2023
311150,202311,1804,5175,1241,3918,200,671,558,1558,758,2229
311160,202311,5376,13616,3216,9254,570,1795,1234,3109,1804,4904
311170,202311,1259,2894,872,2262,91,245,529,1387,620,1632
311180,202311,2075,4292,1026,2544,164,403,435,964,599,1367
311190,202311,1047,2711,656,1872,82,241,272,653,354,894
311200,202311,3020,7146,1841,4688,415,1115,731,1559,1146,2674
311205,202311,1140,2978,808,2306,58,167,447,1170,505,1337
311210,202311,1306,3424,1040,2962,142,349,663,1978,805,2327
311220,202311,1135,2453,871,1918,22,59,709,1453,731,1512
311230,202311,9772,26887,6194,18813,1554,4712,1613,4768,3167,9480
311240,202311,1537,3396,1016,2471,126,360,608,1258,734,1618
311250,202311,1829,4552,1105,3014,221,614,443,1045,664,1659
311260,202311,3323,7497,1639,4172,225,592,718,1538,943,2130
311265,202311,1739,3659,1105,2619,69,162,787,1716,856,1878
311270,202311,3880,9932,2797,7814,219,772,1767,4426,1986,5198
311280,202311,1692,4000,864,2360,247,649,195,480,442,1129
311290,202311,2237,6266,1786,5285,173,499,1077,3118,1250,3617
311300,202311,5429,13125,4116,10853,271,726,2987,7500,3258,8226
311310,202311,648,1633,427,1138,47,128,262,652,309,780
311320,202311,3808,10586,2592,7566,410,1223,1158,2952,1568,4175
311330,202311,8082,17334,5042,12178,892,2291,2079,4981,2971,7272
311340,202311,13961,34772,8947,24423,2194,5949,2516,6291,4710,12240
311350,202311,2830,6394,1645,4103,400,923,564,1262,964,2185
311360,202311,1464,3275,847,2221,199,523,347,850,546,1373
311370,202311,5674,12751,3494,8907,521,1443,1613,3627,2134,5070
311380,202311,501,1409,342,1048,47,153,184,541,231,694
311390,202311,2122,5823,1423,4407,383,1178,335,888,718,2066
311400,202311,2138,5121,1203,3088,227,605,456,929,683,1534
311410,202311,2431,6613,1620,4865,270,881,622,1600,892,2481
311420,202311,2106,5470,1271,3634,265,790,365,841,630,1631
311430,202311,5821,13881,3218,8493,541,1449,1254,3005,1795,4454
311440,202311,3957,9981,2343,6616,515,1606,334,652,849,2258
311450,202311,3281,8714,1812,5407,436,1476,460,1028,896,2504
311455,202311,1353,2852,724,1754,75,214,448,974,523,1188
311460,202311,773,2103,390,1220,73,236,95,242,168,478
311470,202311,592,1647,344,1095,82,286,44,114,126,400
311480,202311,1471,2918,1092,2318,109,204,825,1692,934,1896
311490,202311,367,983,229,659,43,143,97,226,140,369
311500,202311,666,1532,398,1036,32,92,203,472,235,564
311510,202311,4567,9857,2778,6688,509,1162,1347,3009,1856,4171
311520,202311,864,2057,617,1564,86,205,370,912,456,1117
311530,202311,12237,25527,6865,16391,1959,5257,1979,3847,3938,9104
311535,202311,1351,3152,682,1768,81,232,339,763,420,995
311540,202311,679,1770,530,1481,82,231,307,841,389,1072
311545,202311,2558,6394,1957,5344,137,360,1378,3629,1515,3989
311547,202311,2229,4367,1610,3376,89,191,1335,2706,1424,2897
311550,202311,3707,8877,2548,6600,492,1311,1065,2344,1557,3655
311560,202311,368,746,177,413,30,83,67,128,97,211
311570,202311,1650,3567,971,2515,70,203,595,1531,665,1734
311580,202311,2740,4953,1597,3352,180,360,1026,2046,1206,2406
311590,202311,796,1863,580,1515,65,180,322,776,387,956
311600,202311,1792,4161,1359,3506,196,594,889,2207,1085,2801
311610,202311,2901,7492,1835,5231,139,429,1119,2939,1258,3368
311615,202311,4659,10442,3321,8198,167,462,2448,5662,2615,6124
311620,202311,755,1851,458,1296,49,155,235,612,284,767
311630,202311,1560,3991,1054,2894,168,415,522,1417,690,1832
311640,202311,1013,2412,608,1632,97,268,322,791,419,1059
311650,202311,2301,5114,1568,3870,324,763,784,1830,1108,2593
311660,202311,4248,10894,2447,6781,370,1107,832,1803,1202,2910
311670,202311,2085,4602,1267,3043,185,443,603,1316,788,1759
311680,202311,2903,6738,1967,5039,159,352,1314,3306,1473,3658
311690,202311,747,1491,433,1024,48,106,232,522,280,628
311700,202311,2477,5365,1664,4054,36,95,1349,3172,1385,3267
311710,202311,2002,5341,1266,3816,356,1159,296,786,652,1945
311720,202311,546,1450,398,1139,57,177,237,662,294,839
311730,202311,6313,13762,3761,9004,745,2030,1849,3954,2594,5984
311740,202311,1210,2989,914,2505,81,227,608,1674,689,1901
311750,202311,4875,12877,3137,8991,328,968,1809,4635,2137,5603
311760,202311,943,2377,619,1660,113,351,249,511,362,862
311770,202311,2807,7088,1744,4911,397,1097,519,1291,916,2388
311780,202311,2008,5017,1154,3204,231,622,406,946,637,1568
311783,202311,2885,6518,1995,4908,64,205,1555,3567,1619,3772
311787,202311,1019,2688,598,1680,84,248,195,447,279,695
311790,202311,2023,5105,1163,3257,333,992,324,772,657,1764
311800,202311,7003,18568,3799,10575,943,2680,828,1704,1771,4384
311810,202311,1272,3067,932,2419,70,196,689,1662,759,1858
311820,202311,1376,2877,827,1946,74,191,532,1147,606,1338
311830,202311,12049,30364,7490,20409,2140,6023,1389,3416,3529,9439
311840,202311,5039,11069,3463,8600,363,935,2184,5283,2547,6218
311850,202311,445,1000,315,766,17,62,219,459,236,521
311860,202311,105062,226523,69331,159949,7945,20268,41566,86012,49511,106280
311870,202311,2276,5561,1326,3683,233,763,553,1282,786,2045
311880,202311,7633,17891,5528,14429,449,1105,3723,9488,4172,10593
311890,202311,2383,4818,1664,3678,68,200,1239,2494,1307,2694
311900,202311,799,1997,519,1517,105,293,217,616,322,909
311910,202311,5456,12293,3797,9593,773,1946,1904,4532,2677,6478
311920,202311,2695,5929,1964,4723,155,340,1341,3120,1496,3460
311930,202311,6211,12580,3907,8814,794,1846,1925,3932,2719,5778
311940,202311,19912,46551,10957,27876,1748,4646,4514,10115,6262,14761
311950,202311,2981,6850,1903,4832,164,430,1125,2706,1289,3136
311960,202311,609,1425,356,934,52,150,136,302,188,452
311970,202311,500,1492,315,1023,46,176,67,163,113,339
311980,202311,575,1407,251,744,44,141,87,221,131,362
311990,202311,653,1480,325,882,64,183,126,279,190,462
311995,202311,1196,3195,380,1125,54,169,78,151,132,320
312000,202311,998,2079,650,1520,30,78,464,995,494,1073
312010,202311,1477,3251,960,2286,54,128,662,1487,716,1615
312015,202311,1720,4006,1305,3288,68,201,990,2350,1058,2551
312020,202311,2481,6690,1454,4221,267,786,370,895,637,1681
312030,202311,2660,5323,1934,4338,65,226,1581,3358,1646,3584
312040,202311,1053,2808,588,1744,124,378,215,550,339,928
312050,202311,1490,4143,1088,3295,202,694,364,923,566,1617
312060,202311,1228,2799,699,1910,183,518,189,452,372,970
312070,202311,1131,2965,662,1867,27,83,407,1062,434,1145
312080,202311,3795,8229,2532,5992,178,487,1643,3343,1821,3830
312083,202311,1370,2872,985,2281,49,125,733,1572,782,1697
312087,202311,3063,6846,2177,5344,136,407,1653,3869,1789,4276
312090,202311,15431,35227,10213,25752,1123,3228,5630,12489,6753,15717
312100,202311,2056,5028,1332,3571,102,313,813,2003,915,2316
312110,202311,1242,3471,905,2691,163,578,452,1131,615,1709
312120,202311,1388,3455,799,2290,226,684,211,465,437,1149
312125,202311,2654,5670,1870,4422,129,290,1316,2965,1445,3255
312130,202311,1540,3218,932,2118,65,174,586,1123,651,1297
312140,202311,956,2565,661,1904,196,567,169,423,365,990
312150,202311,708,1695,509,1302,58,124,310,736,368,860
312160,202311,12783,29345,8110,20202,1113,2908,4036,8856,5149,11764
312170,202311,1068,2456,713,1761,65,156,433,1032,498,1188
312180,202311,1757,4092,1142,2861,119,303,667,1495,786,1798
312190,202311,1040,2444,668,1693,97,254,306,678,403,932
312200,202311,5833,14261,3931,10810,926,3016,1889,4323,2815,7339
312210,202311,1791,3344,1178,2450,134,234,832,1652,966,1886
312220,202311,2053,5522,1516,4433,184,566,911,2561,1095,3127
312230,202311,29195,65254,17393,42313,3436,8962,6478,12916,9914,21878
312235,202311,2815,5712,1949,4369,277,473,1342,2930,1619,3403
312240,202311,997,2811,619,1953,139,440,180,493,319,933
312245,202311,4083,7518,3198,6255,61,164,2905,5496,2966,5660
312247,202311,1248,2614,683,1644,94,227,388,859,482,1086
312250,202311,1157,2798,582,1620,113,343,147,325,260,668
312260,202311,1271,2952,899,2226,66,163,648,1514,714,1677
312270,202311,978,2372,644,1658,21,75,391,869,412,944
312280,202311,543,1483,384,1123,94,304,135,335,229,639
312290,202311,1257,3235,851,2413,169,504,261,607,430,1111
312300,202311,1572,4172,989,2807,235,694,243,541,478,1235
312310,202311,1337,3514,829,2320,110,346,418,1011,528,1357
312320,202311,2721,6122,1492,3709,246,615,541,1143,787,1758
312330,202311,1188,2935,843,2256,169,502,426,1033,595,1535
312340,202311,294,692,180,467,25,74,94,213,119,287
312350,202311,284,561,184,415,10,30,120,223,130,253
312352,202311,1824,5282,1426,4437,321,1063,605,1985,926,3048
312360,202311,4669,11589,2843,7769,506,1446,1200,2813,1706,4259
312370,202311,2768,5999,1911,4584,247,702,1149,2491,1396,3193
312380,202311,2591,5266,1773,3993,56,181,1381,2939,1437,3120
312385,202311,1607,3836,1077,2826,429,1097,331,891,760,1988
312390,202311,2440,6238,1462,4043,245,750,407,922,652,1672
312400,202311,3964,10167,2776,7883,1025,3186,406,1053,1431,4239
312410,202311,21120,47419,14535,35299,2015,4995,8548,19225,10563,24220
312420,202311,5238,12584,3764,10001,979,2828,1433,3528,2412,6356
312430,202311,11095,24203,7779,18299,519,1446,5364,11524,5883,12970
312440,202311,1395,3934,1046,3197,572,1819,162,458,734,2277
312450,202311,1810,4731,1119,3310,328,1024,346,948,674,1972
312460,202311,630,1343,390,957,27,68,267,611,294,679
312470,202311,589,1308,303,768,45,109,89,171,134,280
312480,202311,1272,2957,776,2018,70,192,399,963,469,1155
312490,202311,3314,6601,2174,4742,259,573,1287,2616,1546,3189
312500,202311,1349,2838,949,2187,45,131,672,1448,717,1579
312510,202311,6967,16979,3156,8638,539,1478,843,1890,1382,3368
312520,202311,464,1066,296,760,50,138,167,393,217,531
312530,202311,964,1938,699,1560,40,103,509,1080,549,1183
312540,202311,1856,4531,1138,3042,173,435,629,1572,802,2007
312550,202311,1018,2307,594,1439,31,74,392,848,423,922
312560,202311,2217,5182,1580,4124,98,290,1077,2682,1175,2972
312570,202311,3522,7322,2220,5316,407,971,1065,2438,1472,3409
312580,202311,831,2028,459,1232,63,198,216,501,279,699
312590,202311,1832,4754,1293,3599,281,805,543,1346,824,2151
312595,202311,2723,6899,1988,5623,461,1318,812,2368,1273,3686
312600,202311,1629,3744,837,2038,134,364,291,625,425,989
312610,202311,9214,21644,4953,12927,1059,2862,1387,3052,2446,5914
312620,202311,3095,6775,2021,5089,75,268,1578,3741,1653,4009
312630,202311,421,1066,264,761,57,187,98,224,155,411
312640,202311,640,1608,431,1197,66,194,206,498,272,692
312650,202311,2535,5597,1453,3514,55,161,1082,2357,1137,2518
312660,202311,1668,3526,1082,2502,87,216,741,1558,828,1774
312670,202311,7557,16151,5499,12761,208,631,4257,9153,4465,9784
312675,202311,1407,3237,1041,2637,73,198,742,1773,815,1971
312680,202311,2001,4276,1581,3625,90,260,1263,2724,1353,2984
312690,202311,3696,6857,2342,4959,244,452,1629,3337,1873,3789
312695,202311,1290,2948,956,2354,58,126,773,1840,831,1966
312700,202311,2691,6505,1574,4255,201,618,824,1952,1025,2570
312705,202311,2197,3914,1718,3237,38,98,1555,2805,1593,2903
312707,202311,1684,4258,997,2888,38,140,654,1707,692,1847
312710,202311,10097,21545,5418,13549,1552,3891,1300,3172,2852,7063
312720,202311,1299,3099,886,2320,107,257,511,1223,618,1480
312730,202311,1982,4263,1242,3107,128,314,783,1867,911,2181
312733,202311,1671,4010,1036,2796,47,160,649,1549,696,1709
312735,202311,1016,2338,618,1533,71,193,384,845,455,1038
312737,202311,1027,2074,628,1456,62,168,423,909,485,1077
312738,202311,1069,2362,648,1595,65,182,391,852,456,1034
312740,202311,525,1316,285,820,68,185,72,159,140,344
312750,202311,1755,4438,1053,2987,187,554,405,1030,592,1584
312760,202311,2238,5968,1371,4079,272,779,470,1308,742,2087
312770,202311,58768,129169,32127,80353,5906,15406,12471,27597,18377,43003
312780,202311,3357,8312,2497,6694,424,1065,1319,3415,1743,4480
312790,202311,290,655,109,314,6,16,31,59,37,75
312800,202311,7768,17990,5253,13077,381,1148,3259,7208,3640,8356
312810,202311,1944,4984,1122,3327,365,1093,299,739,664,1832
312820,202311,2147,5050,1445,3726,116,263,944,2327,1060,2590
312825,202311,1947,3734,1375,2900,54,133,1093,2218,1147,2351
312830,202311,3444,8681,1687,4847,485,1304,515,1232,1000,2536
312840,202311,1843,4232,1225,3093,162,419,565,1221,727,1640
312850,202311,1474,2748,875,1776,44,147,623,1096,667,1243
312860,202311,1330,3230,745,2104,194,536,214,528,408,1064
312870,202311,7670,18682,3778,10595,624,1761,1105,2690,1729,4451
312880,202311,1946,4205,1269,2991,204,459,681,1561,885,2020
312890,202311,2866,6280,1703,4162,170,410,957,2177,1127,2587
312900,202311,1681,3876,1071,2787,316,828,380,896,696,1724
312910,202311,1768,3144,883,1915,125,242,480,1004,605,1246
312920,202311,1206,2950,698,1951,94,310,224,468,318,778
312930,202311,3138,6767,1911,4651,296,759,995,2373,1291,3132
312940,202311,1229,3000,807,2234,65,184,428,1071,493,1255
312950,202311,4388,9432,2665,6484,460,1145,1414,3135,1874,4280
312960,202311,2162,5098,1595,4142,158,394,1031,2698,1189,3092
312965,202311,1988,4822,1386,3740,210,498,757,2061,967,2559
312970,202311,2291,5517,1493,4057,155,515,818,1953,973,2468
312980,202311,34081,83470,21616,56971,4451,11615,7819,18909,12270,30524
312990,202311,636,1454,364,990,72,208,136,343,208,551
313000,202311,622,1561,417,1180,32,106,235,574,267,680
313005,202311,2980,7723,2137,6096,139,385,1510,4141,1649,4526
313010,202311,7894,18884,5334,13941,827,2390,2752,6470,3579,8860
313020,202311,1282,3493,873,2595,194,618,145,331,339,949
313030,202311,1500,3104,813,1960,150,334,427,941,577,1275
313040,202311,1182,3210,822,2418,64,245,427,1104,491,1349
313050,202311,2298,5861,1398,4177,252,781,306,760,558,1541
313055,202311,2276,5538,1714,4554,735,2173,565,1276,1300,3449
313060,202311,1322,3012,809,2049,164,490,211,416,375,906
313065,202311,2127,5136,1672,4266,45,192,1339,3207,1384,3399
313070,202311,1056,2627,674,1828,198,547,193,469,391,1016
313080,202311,497,1229,288,777,51,163,112,245,163,408
313090,202311,7156,15926,4845,11720,249,669,3485,7968,3734,8637
313100,202311,1647,3807,1129,2830,62,188,790,1809,852,1997
313110,202311,1922,4573,1137,3026,157,436,521,1222,678,1658
313115,202311,3618,8879,2334,6171,241,693,1283,2959,1524,3652
313120,202311,4595,10192,2925,7541,724,1890,1416,3463,2140,5353
313130,202311,42752,97213,24621,61102,3228,8519,12974,28680,16202,37199
313140,202311,1036,2004,599,1370,69,152,381,811,450,963
313150,202311,1744,4515,1022,2986,269,873,141,299,410,1172
313160,202311,1869,4140,1151,2884,90,238,711,1694,801,1932
313170,202311,14931,38314,8602,23741,1437,4060,3206,7570,4643,11630
313180,202311,3248,7425,2175,5315,250,557,1382,3213,1632,3770
313190,202311,6015,15163,3473,9561,622,1784,1327,3019,1949,4803
313200,202311,1446,3141,988,2280,41,125,766,1631,807,1756
313210,202311,5483,12333,3873,9552,363,1001,2529,5674,2892,6675
313220,202311,2500,6050,1380,3663,239,656,544,1228,783,1884
313230,202311,3435,8481,2559,7155,80,290,1945,5235,2025,5525
313240,202311,14743,32461,8904,22033,1240,3293,4352,9459,5592,12752
313250,202311,8086,20907,5335,14848,1217,3368,2195,5550,3412,8918
313260,202311,979,2237,572,1525,67,227,279,593,346,820
313270,202311,8289,16223,5782,12557,580,1261,4137,8507,4717,9768
313280,202311,592,1406,351,942,45,127,165,386,210,513
313290,202311,1346,3923,934,3025,202,692,348,1012,550,1704
313300,202311,2439,5998,1511,4066,321,921,599,1394,920,2315
313310,202311,1960,5147,1261,3459,274,799,389,833,663,1632
313320,202311,2440,5848,1530,4241,367,1120,444,1174,811,2294
313330,202311,5333,12034,3333,8593,302,793,2007,4917,2309,5710
313340,202311,2294,4634,1425,3175,119,316,975,1935,1094,2251
313350,202311,3814,9437,2102,5506,323,931,886,1941,1209,2872
313360,202311,2265,5014,1254,3172,206,582,593,1273,799,1855
313370,202311,2168,5277,1172,3125,247,647,376,790,623,1437
313375,202311,2382,5730,1109,3058,253,726,267,602,520,1328
313380,202311,8693,19896,5329,13066,904,2436,2246,4612,3150,7048
313390,202311,1038,2801,754,2193,50,181,493,1316,543,1497
313400,202311,4737,10357,3106,7642,171,443,2218,5233,2389,5676
313410,202311,1843,4184,1179,3027,285,715,589,1391,874,2106
313420,202311,20507,42438,9618,23653,2327,5945,2644,5706,4971,11651
313430,202311,1595,3580,1125,2630,72,225,845,1763,917,1988
313440,202311,9653,17633,6044,12557,244,657,4552,8775,4796,9432
313450,202311,921,2287,508,1404,86,252,175,379,261,631
313460,202311,3175,7891,2291,6279,410,1201,971,2435,1381,3636
313470,202311,3435,7673,2447,6056,196,524,1774,4184,1970,4708
313480,202311,1531,4001,817,2393,144,412,312,790,456,1202
313490,202311,3998,9603,1619,4646,311,926,417,972,728,1898
313500,202311,714,1684,384,1006,92,201,128,342,220,543
313505,202311,13390,30391,9522,24008,627,1693,6697,16186,7324,17879
313507,202311,1624,3705,1089,2794,49,162,770,1834,819,1996
313510,202311,20124,47319,12883,32500,1503,3816,6808,15493,8311,19309
313520,202311,20450,45991,15070,37044,821,2107,11183,25903,12004,28010
313530,202311,738,2018,396,1166,81,254,145,350,226,604
313535,202311,2799,7069,1938,5355,228,574,1091,2870,1319,3444
313540,202311,1152,2905,664,1752,87,259,344,763,431,1022
313545,202311,1428,4149,981,3098,154,463,454,1325,608,1788
313550,202311,2766,6972,2000,5278,259,674,1284,3286,1543,3960
313560,202311,3718,6007,2561,4595,60,115,2171,3766,2231,3881
313570,202311,1228,3147,838,2381,189,555,345,842,534,1397
313580,202311,7852,16142,5574,12356,307,749,4057,8366,4364,9115
313590,202311,1474,3446,943,2500,154,427,471,1152,625,1579
313600,202311,5572,11516,4201,9379,112,277,3505,7405,3617,7682
313610,202311,1223,2744,825,1960,79,211,511,1085,590,1296
313620,202311,7514,17860,5159,13227,561,1640,2918,6668,3479,8308
313630,202311,11305,25033,7101,17785,756,2182,4144,9385,4900,11567
313640,202311,1672,3112,1057,2253,86,202,763,1571,849,1773
313650,202311,1983,5444,1369,4221,155,510,748,2188,903,2698
313652,202311,1108,2822,831,2226,92,234,528,1321,620,1555
313655,202311,1460,3118,967,2365,79,205,609,1394,688,1599
313657,202311,1296,3091,903,2374,35,143,618,1460,653,1603
313660,202311,1529,3517,1104,2758,97,316,714,1585,811,1901
313665,202311,7556,17180,4955,12070,613,1570,2820,6127,3433,7697
313670,202311,76456,167816,45629,112669,6360,16496,21934,48289,28294,64785
313680,202311,1382,3112,933,2291,41,112,610,1363,651,1475
313690,202311,1326,3643,834,2586,178,595,150,390,328,985
313695,202311,2119,5087,1350,3677,148,390,791,2128,939,2518
313700,202311,3710,9880,2780,8249,280,776,1943,5652,2223,6428
313710,202311,1774,3715,1025,2482,184,522,565,1205,749,1727
313720,202311,8648,21284,5088,13429,751,2052,2373,5466,3124,7518
313730,202311,1663,3282,1061,2358,83,175,723,1575,806,1750
313740,202311,2139,6918,1525,5246,345,1255,396,1182,741,2437
313750,202311,3072,7024,2117,5214,297,865,1246,2756,1543,3621
313753,202311,2564,5870,1424,3770,441,1223,279,680,720,1903
313760,202311,8458,20964,5615,14986,1005,2803,2478,5737,3483,8540
313770,202311,5295,13455,3741,10680,859,2384,2063,5884,2922,8268
313780,202311,5184,12192,3043,8164,945,2365,733,2006,1678,4371
313790,202311,776,1969,550,1485,60,171,327,802,387,973
313800,202311,1678,3505,1025,2443,155,373,496,1087,651,1460
313810,202311,2384,4919,1608,3659,68,189,1210,2523,1278,2712
313820,202311,22060,52055,10904,27321,2010,4961,3319,7093,5329,12054
313830,202311,505,1339,338,972,72,211,109,275,181,486
313835,202311,1182,2871,681,1876,53,161,339,826,392,987
313840,202311,10836,25125,6723,17536,1765,4475,1664,4247,3429,8722
313850,202311,1258,2618,832,1916,131,304,435,879,566,1183
313860,202311,3794,8611,2469,6085,385,1001,1203,2624,1588,3625
313862,202311,1401,2973,558,1496,64,168,255,637,319,805
313865,202311,3253,7406,2320,5821,95,281,1621,3702,1716,3983
313867,202311,1611,4713,1222,3870,390,1238,394,1267,784,2505
313868,202311,2076,5586,1448,4326,86,324,1027,2825,1113,3149
313870,202311,1363,3214,729,1919,151,395,267,623,418,1018
313880,202311,2970,6844,1830,4544,346,1017,882,1763,1228,2780
313890,202311,2946,5205,2096,4090,65,143,1657,3033,1722,3176
313900,202311,7317,18233,4053,11213,1127,3158,1135,2543,2262,5701
313910,202311,976,2578,591,1720,132,389,147,384,279,773
313920,202311,3530,9263,2641,7486,571,1558,1157,3261,1728,4819
313925,202311,1950,4436,1265,3144,261,520,673,1653,934,2173
313930,202311,6559,15498,4450,11619,383,916,2863,7138,3246,8054
313940,202311,13191,35086,8302,25188,2182,7239,1592,4826,3774,12065
313950,202311,7087,13801,4813,10522,313,814,3478,7109,3791,7923
313960,202311,7272,15841,4219,10456,570,1600,1941,4108,2511,5708
313970,202311,2065,4715,1440,3508,42,111,983,2192,1025,2303
313980,202311,1860,4456,1181,3272,208,575,415,1061,623,1636
313990,202311,2926,7427,1931,5345,322,1015,1054,2586,1376,3601
314000,202311,13925,30888,8748,21078,701,2018,5300,11715,6001,13733
314010,202311,1659,3607,1093,2687,91,228,696,1554,787,1782
314015,202311,3168,7627,2105,5484,276,805,1138,2622,1414,3427
314020,202311,701,1697,352,1068,128,451,12,26,140,477
314030,202311,1094,2767,633,1735,107,306,245,601,352,907
314040,202311,774,1954,570,1558,70,225,357,892,427,1117
314050,202311,2773,6363,1799,4463,131,378,1140,2530,1271,2908
314053,202311,2682,6727,1866,5112,343,902,1016,2816,1359,3718
314055,202311,2963,6399,2259,5346,77,204,1781,4063,1858,4267
314060,202311,1598,3717,999,2584,49,118,693,1710,742,1828
314070,202311,6412,15032,4283,10719,631,1628,2137,4785,2768,6413
314080,202311,2556,6040,1574,4147,166,464,812,1911,978,2375
314085,202311,2914,7079,2024,5540,240,655,1199,3142,1439,3797
314090,202311,6303,14842,4526,11720,494,1320,2616,6603,3110,7923
314100,202311,3596,8033,2470,6262,145,389,1718,4254,1863,4643
314110,202311,6454,16147,4118,10880,766,2122,1792,4156,2558,6278
314120,202311,964,2072,316,844,65,192,110,254,175,446
314130,202311,890,2083,565,1439,18,55,387,908,405,963
314140,202311,5764,13735,3890,10069,465,1275,2261,5336,2726,6611
314150,202311,1771,3986,1060,2719,193,491,538,1318,731,1809
314160,202311,2946,6640,1749,4454,208,526,707,1663,915,2189
314170,202311,1200,2909,724,1844,79,240,424,913,503,1153
314180,202311,6880,16748,4410,11986,752,2109,1888,4835,2640,6944
314190,202311,775,1769,511,1292,85,248,262,557,347,805
314200,202311,3789,9328,2677,7234,262,671,1627,4191,1889,4862
314210,202311,2380,5622,1474,3796,321,885,426,948,747,1833
314220,202311,2273,5521,1535,4160,292,839,582,1394,874,2233
314225,202311,1276,3336,846,2446,219,601,340,935,559,1536
314230,202311,1121,2711,646,1788,137,351,237,600,374,951
314240,202311,1372,3459,903,2564,194,558,350,960,544,1518
314250,202311,513,1366,285,854,58,181,95,224,153,405
314260,202311,1345,3217,897,2447,326,910,173,379,499,1289
314270,202311,4059,9993,2909,7903,126,337,1996,5273,2122,5610
314280,202311,4485,9726,2623,6598,293,821,1420,3235,1713,4056
314290,202311,5653,12717,4033,9672,258,644,2917,6563,3175,7207
314300,202311,2476,6417,1287,3729,368,1103,298,718,666,1821
314310,202311,4575,11215,2608,7397,714,2309,325,654,1039,2963
314315,202311,1251,3364,886,2591,60,191,585,1619,645,1810
314320,202311,4338,10330,2469,6558,391,1181,1073,2409,1464,3590
314330,202311,74742,189957,47528,134783,12000,33002,12418,32888,24418,65890
314340,202311,3499,8010,2099,5331,371,1136,959,1959,1330,3095
314345,202311,2037,4847,1401,3642,189,440,865,2094,1054,2534
314350,202311,1289,3304,642,1898,109,308,157,341,266,649
314360,202311,721,1874,372,1115,53,142,106,292,159,434
314370,202311,943,2102,625,1550,70,157,409,951,479,1108
314380,202311,1580,3929,936,2651,222,647,302,788,524,1435
314390,202311,20746,45780,12220,30239,2084,5578,5227,10952,7311,16530
314400,202311,5004,13746,3403,10455,1273,4116,740,2256,2013,6372
314410,202311,3853,10039,2220,6465,596,2066,393,832,989,2898
314420,202311,952,2137,567,1462,27,92,359,870,386,962
314430,202311,9936,21081,5828,13972,980,2436,2509,5554,3489,7990
314435,202311,2344,5649,1359,3675,268,685,574,1427,842,2112
314437,202311,1122,2545,727,1840,75,203,461,1099,536,1302
314440,202311,794,2050,479,1384,95,334,164,368,259,702
314450,202311,1816,4327,1144,2947,173,492,566,1264,739,1756
314460,202311,4500,11869,2964,8463,700,2142,1190,2867,1890,5009
314465,202311,2922,7095,2156,5616,193,424,1475,3669,1668,4093
314467,202311,1205,2852,858,2262,153,444,472,1179,625,1623
314470,202311,3034,7587,1960,5178,409,1151,835,1875,1244,3026
314480,202311,11761,28861,7226,18880,1178,3200,3053,6855,4231,10055
314490,202311,1308,3053,860,2211,106,271,505,1214,611,1485
314500,202311,2706,5872,1434,3739,533,1317,184,506,717,1823
314505,202311,2933,5738,2080,4451,130,228,1514,3146,1644,3374
314510,202311,2853,6961,1944,5531,749,2319,410,1046,1159,3365
314520,202311,11098,29493,7557,21733,1601,4811,1651,4197,3252,9008
314530,202311,6710,18165,5159,15025,712,1771,3068,8644,3780,10415
314535,202311,3618,7544,2590,5904,149,387,2015,4391,2164,4778
314537,202311,1496,3745,1015,2816,92,237,632,1651,724,1888
314540,202311,532,1193,319,817,22,67,171,380,193,447
314545,202311,2353,5007,1577,3805,68,223,1114,2480,1182,2703
314550,202311,922,2051,495,1240,56,158,237,522,293,680
314560,202311,6542,16446,3983,10520,483,1463,1991,4356,2474,5819
314570,202311,420,1070,272,789,51,150,123,343,174,493
314580,202311,639,1654,393,1130,90,250,121,310,211,560
314585,202311,953,2532,554,1581,47,144,268,667,315,811
314587,202311,2849,6799,1947,5184,739,2027,745,1830,1484,3857
314590,202311,5516,13091,3481,8913,538,1400,1516,3477,2054,4877
314600,202311,2429,6097,1301,3842,285,888,158,371,443,1259
314610,202311,12730,28822,7806,19313,1022,2751,3557,8079,4579,10830
314620,202311,3106,6110,2275,4946,161,313,1753,3792,1914,4105
314625,202311,1999,4350,1375,3378,59,228,1020,2280,1079,2508
314630,202311,6081,13818,4274,10940,217,662,3064,7345,3281,8007
314640,202311,1097,2099,751,1534,29,99,579,1061,608,1160
314650,202311,1041,2341,548,1412,69,199,256,551,325,750
314655,202311,1825,4467,1104,3115,273,667,478,1386,751,2053
314660,202311,462,886,297,599,17,30,220,406,237,436
314670,202311,1861,3896,1117,2722,64,185,754,1708,818,1893
314675,202311,2046,4712,1555,3859,119,263,1121,2688,1240,2951
314690,202311,2650,6683,1773,5067,472,1366,457,1208,929,2574
314700,202311,15716,37849,9009,24318,1346,3910,4073,9780,5419,13690
314710,202311,10480,26342,6267,16692,1048,2928,2373,5263,3421,8191
314720,202311,3034,8213,1623,4941,333,1083,267,569,600,1652
314730,202311,3448,8171,1756,4630,348,971,606,1285,954,2256
314740,202311,4265,10566,2867,7829,565,1678,1275,3080,1840,4758
314750,202311,367,887,231,589,22,59,123,279,145,338
314760,202311,2448,6427,1324,3841,247,751,330,682,577,1433
314770,202311,1270,3464,608,1855,78,231,109,263,187,494
314780,202311,465,1041,289,732,19,48,181,411,200,459
314790,202311,16269,38889,9622,25659,1904,5377,3775,8862,5679,14239
314795,202311,1844,4148,1337,3268,81,189,918,2081,999,2270
314800,202311,15688,36639,8986,23386,1437,4048,3772,8308,5209,12356
314810,202311,14225,33712,8720,23030,2204,5809,3026,7377,5230,13186
314820,202311,1567,3460,995,2494,73,210,616,1379,689,1589
314830,202311,2329,5601,1617,4223,148,397,960,2253,1108,2650
314840,202311,1108,2995,799,2381,87,312,507,1383,594,1695
314850,202311,3509,5887,2562,4688,50,128,2264,4022,2314,4150
314860,202311,4213,10196,3108,8136,144,409,2220,5471,2364,5880
314870,202311,8819,16727,5824,12643,335,755,4295,9116,4630,9871
314875,202311,2189,6034,1718,5176,322,881,994,2992,1316,3873
314880,202311,956,2143,579,1471,48,123,326,769,374,892
314890,202311,602,1721,346,1069,85,300,94,203,179,503
314900,202311,1166,2549,722,1728,84,227,441,936,525,1163
314910,202311,2052,5405,1237,3761,251,872,490,1283,741,2155
314915,202311,2611,6871,1808,5328,234,662,961,2746,1195,3408
314920,202311,764,1648,446,1122,44,123,255,614,299,737
314930,202311,8674,21373,5365,14111,1034,2873,2243,4989,3277,7862
314940,202311,535,1128,353,816,42,110,203,429,245,539
314950,202311,881,1983,476,1263,63,213,234,514,297,727
314960,202311,1236,2654,834,1954,74,174,529,1169,603,1343
314970,202311,1608,4258,1048,3080,203,643,394,934,597,1577
314980,202311,2859,6547,1874,4727,192,517,1146,2667,1338,3184
314990,202311,3583,9386,1983,5575,359,992,477,1097,836,2089
314995,202311,2172,5260,1379,3652,95,310,775,1783,870,2093
315000,202311,1324,3045,850,2265,103,301,521,1286,624,1587
315010,202311,530,1263,378,1003,33,91,234,571,267,662
315015,202311,3075,7427,2376,6149,231,690,1572,3775,1803,4465
315020,202311,998,2564,547,1543,59,182,267,610,326,792
315030,202311,916,2115,515,1352,154,388,134,303,288,691
315040,202311,1260,2905,940,2302,143,386,580,1321,723,1707
315050,202311,1411,3308,810,2154,89,257,362,873,451,1130
315053,202311,1552,3465,967,2396,141,319,502,1182,643,1501
315057,202311,2320,5691,1587,4411,152,395,902,2564,1054,2959
315060,202311,948,2515,591,1722,114,364,159,386,273,750
315070,202311,1194,2291,764,1618,151,324,461,934,612,1258
315080,202311,4352,10129,2753,7038,151,403,1886,4463,2037,4866
315090,202311,1029,2724,681,1996,127,374,295,749,422,1123
315100,202311,1849,4920,993,2897,199,597,374,902,573,1499
315110,202311,2959,6191,1756,4157,146,359,1026,2301,1172,2660
315120,202311,16221,34355,9933,23765,1508,3490,5124,11632,6632,15122
315130,202311,2327,5567,1587,4049,199,537,800,1776,999,2313
315140,202311,4327,10554,3049,7948,520,1451,1676,3992,2196,5443
315150,202311,6009,14180,3516,9414,634,1757,1394,3325,2028,5082
315160,202311,2623,5594,1441,3473,201,535,781,1669,982,2204
315170,202311,1858,5337,1152,3618,212,700,328,929,540,1629
315180,202311,22601,51889,10506,27496,1829,4910,3586,7852,5415,12762
315190,202311,2704,5523,1841,4264,378,762,1116,2631,1494,3393
315200,202311,6132,14881,3994,10904,1361,3842,1059,2417,2420,6259
315210,202311,10677,25850,5893,15425,747,2079,2551,5622,3298,7701
315213,202311,1272,3049,965,2513,29,89,760,1871,789,1960
315217,202311,3271,8269,2132,6185,854,2447,630,1683,1484,4130
315220,202311,10981,26949,7072,19388,846,2054,3459,9572,4305,11626
315230,202311,3715,7161,2637,5570,169,309,1893,3880,2062,4189
315240,202311,3183,7915,2211,6074,575,1679,813,2100,1388,3779
315250,202311,20293,48870,11826,31143,1935,5343,5113,11484,7048,16827
315260,202311,1188,2945,603,1707,114,319,164,385,278,704
315270,202311,1329,3368,875,2403,114,338,413,909,527,1247
315280,202311,4458,10116,2486,6349,638,1666,823,1904,1461,3570
315290,202311,1534,3450,787,2108,140,410,320,736,460,1146
315300,202311,813,1838,527,1371,34,89,341,851,375,940
315310,202311,1611,3596,1029,2485,82,215,696,1508,778,1723
315320,202311,766,2043,459,1371,69,199,158,411,227,610
315330,202311,884,2597,455,1455,64,215,176,466,240,681
315340,202311,3407,7902,1825,4916,504,1282,511,1338,1015,2620
315350,202311,2422,5404,1796,4350,218,574,1185,2688,1403,3262
315360,202311,2081,5354,1334,3712,207,602,559,1364,766,1966
315370,202311,781,1863,475,1264,73,194,185,422,258,616
315380,202311,277,725,167,486,44,130,16,34,60,164
315390,202311,1660,4141,1104,2961,119,393,592,1322,711,1715
315400,202311,5136,12289,3417,9029,465,1290,1819,4402,2284,5692
315410,202311,2288,5025,1395,3466,367,997,334,699,701,1696
315415,202311,1928,4906,1255,3542,375,1243,205,451,580,1694
315420,202311,1956,5005,1172,3379,334,979,253,626,587,1605
315430,202311,4345,9957,2567,6922,489,1414,1066,2605,1555,4019
315440,202311,1278,2972,810,2096,114,317,463,1066,577,1383
315445,202311,2881,5589,1871,4108,162,319,1392,3003,1554,3322
315450,202311,2698,6679,1774,4857,201,547,1094,2797,1295,3344
315460,202311,63885,148483,45624,113065,5038,14091,27297,60582,32335,74673
315470,202311,864,2191,485,1283,63,178,211,482,274,660
315480,202311,2038,4943,1188,3055,165,439,572,1264,737,1703
315490,202311,3588,8255,1929,5088,339,887,631,1520,970,2407
315500,202311,664,1611,342,902,21,50,216,513,237,563
315510,202311,1715,3768,1241,3041,35,144,965,2133,1000,2277
315520,202311,1410,3090,1053,2500,46,101,837,1884,883,1985
315530,202311,1093,2388,801,1829,64,171,594,1241,658,1412
315540,202311,2102,4979,1145,3076,139,376,462,1084,601,1460
315550,202311,2263,5638,1235,3501,205,633,374,994,579,1627
315560,202311,8333,21362,6207,17074,606,1575,4084,10761,4690,12336
315570,202311,3239,7359,1805,4551,330,942,842,1753,1172,2695
315580,202311,4222,8769,2701,6113,361,916,1241,2474,1602,3390
315590,202311,1657,3009,1289,2448,32,99,1044,1773,1076,1872
315600,202311,3084,8263,1895,5818,571,1693,595,1922,1166,3615
315610,202311,1276,2880,762,1867,86,258,378,748,464,1006
315620,202311,667,1575,415,1137,39,125,221,579,260,704
315630,202311,1608,3819,1045,2659,185,489,458,1009,643,1498
315640,202311,521,1144,360,884,33,89,209,462,242,551
315645,202311,1245,2940,778,2089,172,512,301,689,473,1201
315650,202311,2301,4563,1607,3441,86,199,1267,2581,1353,2780
315660,202311,2597,6070,1698,4375,322,797,810,2018,1132,2815
315670,202311,21850,51355,14292,36194,2858,7219,6073,13902,8931,21121
315680,202311,3971,9770,2531,6962,383,1119,1174,3028,1557,4147
315690,202311,4951,11363,2321,6299,487,1310,649,1794,1136,3104
315700,202311,11126,26397,7332,18730,839,2225,4028,9323,4867,11548
315710,202311,2151,4657,1300,3272,92,224,808,1890,900,2114
315720,202311,5789,13723,3796,9630,215,681,2438,5515,2653,6196
315725,202311,2979,6658,2029,5073,328,771,1238,3112,1566,3883
315727,202311,827,1878,555,1408,66,203,300,674,366,877
315730,202311,801,2142,524,1512,105,308,191,451,296,759
315733,202311,1931,4408,1240,3085,259,629,498,1107,757,1736
315737,202311,1451,3503,893,2385,45,151,625,1546,670,1697
315740,202311,1096,2779,762,2042,72,211,481,1155,553,1366
315750,202311,1600,3650,1117,2895,114,274,663,1746,777,2020
315760,202311,1480,3041,972,2255,37,108,746,1624,783,1732
315765,202311,2523,5313,1972,4597,35,125,1720,3907,1755,4032
315770,202311,1705,4281,1074,3038,286,807,320,868,606,1675
315780,202311,41762,100252,28888,73645,2685,7562,16912,38973,19597,46535
315790,202311,4336,12127,3358,10184,612,1832,1608,5112,2220,6944
315800,202311,1704,4813,1100,3311,117,403,495,1226,612,1629
315810,202311,1796,3713,1296,2882,76,179,977,2016,1053,2195
315820,202311,3723,7990,2629,6220,369,742,1607,3726,1976,4468
315830,202311,1634,4287,788,2265,115,335,222,501,337,836
315840,202311,1192,2568,669,1600,71,182,366,733,437,915
315850,202311,1478,3723,1018,2860,214,622,496,1295,710,1917
315860,202311,649,1744,409,1267,73,227,110,278,183,505
315870,202311,588,1441,418,1127,43,127,282,716,325,843
315880,202311,1461,3201,875,2089,129,349,466,929,595,1278
315890,202311,2273,5676,1698,4723,591,1855,495,1236,1086,3091
315895,202311,8281,20378,4666,12541,608,1770,2099,4972,2707,6742
315900,202311,1161,2737,840,2159,122,316,483,1178,605,1494
315910,202311,833,1842,654,1552,40,110,501,1126,541,1236
315920,202311,1652,3835,797,2136,163,509,311,683,474,1192
315930,202311,1414,2819,822,1891,73,175,514,1098,587,1273
315935,202311,1543,3951,1034,2889,154,442,498,1296,652,1738
315940,202311,743,1796,491,1337,58,179,245,599,303,778
315950,202311,1603,3846,1244,3226,164,420,822,2092,986,2512
315960,202311,6661,17363,3317,9600,760,2273,676,1430,1436,3703
315970,202311,676,1711,473,1361,67,204,252,663,319,867
315980,202311,5351,10882,2551,5870,381,914,1307,2648,1688,3562
315990,202311,4370,10208,2707,6877,506,1324,1224,2784,1730,4108
316000,202311,985,2121,659,1608,64,196,393,850,457,1046
316010,202311,814,2144,525,1476,85,241,207,484,292,725
316020,202311,1187,2832,842,2161,90,215,528,1260,618,1475
316030,202311,3339,8219,2193,6030,522,1418,974,2759,1496,4177
316040,202311,3345,8873,1887,5760,337,1145,519,1229,856,2374
316045,202311,2791,5771,2248,4990,165,349,1818,3956,1983,4305
316050,202311,550,1281,362,936,37,93,223,517,260,610
316060,202311,879,1857,543,1347,33,95,336,747,369,842
316070,202311,7824,18560,5304,13303,1051,2469,2280,5284,3331,7753
316080,202311,1082,2851,711,2019,106,325,316,766,422,1091
316090,202311,689,1677,416,1046,43,151,226,469,269,620
316095,202311,1569,4409,1016,3074,267,859,259,700,526,1559
316100,202311,3081,7828,1886,5232,333,1030,758,1776,1091,2806
316105,202311,904,2153,613,1639,48,138,356,914,404,1052
316110,202311,18365,43055,13564,34588,952,2833,9633,22828,10585,25661
316120,202311,1518,3798,751,2052,146,444,231,486,377,930
316130,202311,1578,3285,826,1920,106,271,436,883,542,1154
316140,202311,1303,3186,674,1941,174,504,176,464,350,968
316150,202311,2784,5780,1586,3600,206,453,881,1830,1087,2283
316160,202311,1209,2827,823,2086,23,67,571,1346,594,1413
316165,202311,1088,2363,704,1722,67,174,451,1017,518,1191
316170,202311,1830,3717,1208,2707,57,146,853,1733,910,1879
316180,202311,2071,5227,1100,3056,195,547,381,895,576,1442
316190,202311,3385,8807,1398,3920,172,525,628,1411,800,1936
316200,202311,4966,11905,3218,8493,450,1291,1648,3812,2098,5103
316210,202311,7585,19816,4088,11446,1260,3679,484,1087,1744,4766
316220,202311,972,2725,495,1624,103,375,112,333,215,708
316225,202311,1989,4082,1351,3071,55,187,992,1968,1047,2155
316230,202311,638,1499,426,1116,100,285,216,537,316,822
316240,202311,7090,17760,5400,14488,464,1312,3804,9581,4268,10893
316245,202311,3945,10873,3125,9348,240,901,1995,5386,2235,6287
316250,202311,15312,33067,9378,22021,1954,4707,3565,7587,5519,12294
316255,202311,3581,9459,2703,7795,368,991,1689,4870,2057,5861
316257,202311,2028,4126,1298,2944,127,274,825,1765,952,2039
316260,202311,3350,6701,2250,4895,240,474,1427,3007,1667,3481
316265,202311,1341,3216,894,2379,31,71,667,1689,698,1760
316270,202311,4809,12726,3577,10008,523,1495,1845,4628,2368,6123
316280,202311,3873,9152,2749,6993,402,1050,1423,3378,1825,4428
316290,202311,5435,12752,3238,8285,423,1100,1346,3015,1769,4115
316292,202311,8077,19205,5401,14057,651,1887,3246,7652,3897,9539
316294,202311,1246,3407,758,2389,188,646,228,600,416,1246
316295,202311,4791,11827,3055,8220,353,988,1591,3787,1944,4775
316300,202311,1398,3211,995,2550,55,166,706,1677,761,1843
316310,202311,924,2407,543,1532,93,284,163,395,256,679
316320,202311,855,2182,513,1447,79,262,174,443,253,705
316330,202311,1302,2976,873,2208,38,100,646,1525,684,1625
316340,202311,1302,3142,879,2281,142,376,447,1010,589,1386
316350,202311,1829,4189,1400,3428,157,360,977,2268,1134,2628
316360,202311,793,1888,564,1494,96,245,348,909,444,1154
316370,202311,8049,18316,5111,12712,665,1904,2617,5387,3282,7291
316380,202311,2177,4579,1424,3332,99,238,960,2130,1059,2368
316390,202311,938,2315,603,1684,232,712,135,317,367,1029
316400,202311,1553,3996,751,2252,100,309,246,614,346,923
316410,202311,1552,3479,1159,2787,32,95,892,2011,924,2106
316420,202311,2282,5544,1708,4598,72,214,1232,3131,1304,3345
316430,202311,1180,2814,675,1855,135,431,272,630,407,1061
316440,202311,1095,3159,613,2004,103,334,147,439,250,773
316443,202311,733,1824,411,1166,87,266,155,391,242,657
316447,202311,2753,6004,2120,4973,212,344,1604,3777,1816,4121
316450,202311,2593,6750,1684,4851,218,607,943,2589,1161,3196
316460,202311,1777,4224,1147,2998,96,290,656,1534,752,1824
316470,202311,9697,24679,5921,16342,967,2710,2358,5492,3325,8202
316480,202311,285,650,209,512,31,74,121,258,152,332
316490,202311,420,1081,236,684,51,159,77,181,128,340
316500,202311,1776,4837,1057,3118,246,746,337,828,583,1574
316510,202311,1023,2908,713,2215,113,340,320,948,433,1288
316520,202311,1719,3775,1082,2561,211,541,348,678,559,1219
316530,202311,1576,3478,1019,2451,112,302,601,1277,713,1579
316540,202311,1457,3222,946,2335,182,468,355,786,537,1254
316550,202311,1902,4495,1471,3739,56,186,1162,2791,1218,2977
316553,202311,6500,16762,3735,10079,543,1588,1786,4084,2329,5672
316555,202311,3291,8405,2543,7251,112,442,1946,5239,2058,5681
316556,202311,709,1493,452,999,39,88,292,553,331,641
316557,202311,1611,4299,1232,3589,440,1340,414,1123,854,2463
316560,202311,504,1402,283,902,50,175,66,179,116,354
316570,202311,1920,4711,1219,3300,302,729,384,1055,686,1784
316580,202311,447,955,222,542,35,95,83,165,118,260
316590,202311,1621,3620,951,2273,107,214,598,1350,705,1564
316600,202311,1300,3248,992,2598,140,435,628,1487,768,1922
316610,202311,782,2005,538,1536,65,179,307,807,372,986
316620,202311,2903,6433,2109,4996,177,397,1548,3502,1725,3899
316630,202311,1941,5199,1486,4256,465,1298,506,1635,971,2933
316640,202311,232,569,158,420,47,138,49,100,96,238
316650,202311,1440,3507,1028,2774,88,216,651,1648,739,1864
316660,202311,206,487,88,237,8,20,30,67,38,87
316670,202311,2014,4491,1265,3216,412,1035,307,684,719,1719
316680,202311,2946,7010,1800,4662,208,570,974,2378,1182,2948
316690,202311,1670,4436,860,2576,158,474,135,289,293,763
316695,202311,1200,3168,801,2346,21,81,515,1381,536,1462
316700,202311,681,1156,504,927,12,26,422,722,434,748
316710,202311,4585,12096,3168,8980,450,1328,1716,4329,2166,5657
316720,202311,31039,74074,20248,51939,3108,8446,10033,23047,13141,31493
316730,202311,701,1506,473,1082,48,98,262,562,310,660
316740,202311,1129,2694,763,2025,98,299,474,1131,572,1430
316750,202311,532,1330,342,969,82,247,134,348,216,595
316760,202311,5042,13773,3810,11308,1332,4446,1346,3659,2678,8105
316770,202311,1934,3931,1283,2969,49,130,984,2211,1033,2341
316780,202311,767,2039,533,1567,189,571,65,139,254,710
316790,202311,942,2300,571,1559,106,307,168,424,274,731
316800,202311,8581,21131,5868,15916,1008,2946,2682,6591,3690,9537
316805,202311,1511,2766,1065,2191,38,92,863,1693,901,1785
316810,202311,1006,2451,620,1658,50,145,403,1008,453,1153
316820,202311,496,944,243,530,9,25,160,309,169,334
316830,202311,1193,2667,766,1891,118,286,416,971,534,1257
316840,202311,3847,8343,2673,6402,122,361,2013,4463,2135,4824
316850,202311,3047,6549,1908,4517,172,484,1213,2536,1385,3020
316860,202311,30840,67255,20295,49393,3052,8216,10483,23105,13535,31321
316870,202311,11728,27568,6991,17722,886,2430,3532,7569,4418,9999
316880,202311,1507,3473,1069,2671,173,439,536,1197,709,1636
316890,202311,1438,3084,805,2144,110,330,440,1059,550,1389
316900,202311,4041,9071,2546,6207,462,1177,1178,2551,1640,3728
316905,202311,620,1664,406,1214,244,739,68,212,312,951
316910,202311,1361,3233,789,2129,175,507,232,543,407,1050
316920,202311,2579,5200,1679,3731,346,618,966,2058,1312,2676
316930,202311,12619,31235,8051,21891,1738,4947,2856,6597,4594,11544
316935,202311,5786,13589,3594,9299,642,1739,1634,3735,2276,5474
316940,202311,7864,20622,5318,14959,1043,2972,2093,5059,3136,8031
316950,202311,2522,5003,1741,3889,141,320,1314,2817,1455,3137
316960,202311,7191,13957,4242,9527,331,831,2889,6101,3220,6932
316970,202311,5531,13062,3662,9307,770,2019,1519,3308,2289,5327
316980,202311,1170,2938,811,2300,230,706,313,773,543,1479
316990,202311,17349,41252,10371,26584,2669,7001,2590,5701,5259,12702
317000,202311,3525,8218,2734,6971,130,335,2199,5426,2329,5761
317005,202311,3285,8331,2178,6027,469,1340,950,2404,1419,3744
317010,202311,40344,87839,24155,60029,3644,9743,12612,28498,16256,38241
317020,202311,102414,224646,54488,135153,11116,28886,19220,41457,30336,70343
317030,202311,836,2008,608,1636,24,82,414,1036,438,1118
317040,202311,15206,35048,7957,21504,2137,5976,1549,4047,3686,10023
317043,202311,1179,2239,661,1451,30,74,498,1029,528,1103
317047,202311,1350,2883,781,1874,56,163,495,1046,551,1209
317050,202311,1503,4410,807,2551,120,381,240,580,360,961
317052,202311,3049,7124,2053,5397,303,735,1169,2921,1472,3656
317057,202311,2870,5296,1897,3829,42,105,1532,2907,1574,3012
317060,202311,644,1564,304,857,67,213,113,269,180,482
317065,202311,1391,3586,964,2636,58,196,615,1477,673,1673
317070,202311,11176,28190,7603,20870,1224,3657,3312,7827,4536,11484
317075,202311,1433,3217,945,2282,155,380,521,1160,676,1540
317080,202311,8603,18351,5522,12860,1117,2754,2551,5576,3668,8330
317090,202311,5934,14885,4592,12513,517,1257,3058,8219,3575,9476
317100,202311,3284,7248,1737,4325,424,1023,632,1403,1056,2426
317103,202311,3114,6547,2186,5018,194,436,1516,3285,1710,3721
317107,202311,1856,4270,1193,2966,66,165,761,1631,827,1796
317110,202311,856,1835,426,1113,83,232,193,445,276,677
317115,202311,1459,3657,1049,2864,161,483,576,1492,737,1975
317120,202311,26704,61086,18172,44784,1779,4880,10996,24286,12775,29166
317130,202311,14782,31601,8546,20258,1404,3328,3211,7022,4615,10350
317140,202311,1242,2662,763,1842,162,364,421,1009,583,1373
317150,202311,1325,2642,896,2021,31,105,704,1454,735,1559
317160,202311,4163,9354,2286,6030,380,908,992,2822,1372,3730
317170,202311,2673,5964,1846,4386,124,354,1252,2581,1376,2935
317180,202311,2264,6351,1280,3981,281,857,178,511,459,1368
317190,202311,1364,3375,890,2499,176,527,422,1070,598,1597
317200,202311,8558,20646,4760,12451,997,2701,1188,2651,2185,5352
317210,202311,1540,3272,982,2353,43,141,658,1465,701,1606
317220,202311,446,1070,320,834,53,175,185,414,238,589
320010,202311,6169,16690,3928,11789,1005,3202,1103,3162,2108,6364
320013,202311,2649,6519,1547,4268,368,1088,644,1740,1012,2828
320016,202311,3578,8478,2330,6251,411,1106,1347,3472,1758,4578
320020,202311,6639,14799,4302,10496,644,1781,2327,5090,2971,6871
320030,202311,2356,5780,1353,3686,212,648,590,1359,802,2007
320035,202311,2506,5983,1746,4554,273,759,1008,2512,1281,3271
320040,202311,5980,14880,4080,10875,615,1647,2056,4932,2671,6579
320050,202311,2516,5088,1718,3788,215,585,1143,2248,1358,2833
320060,202311,20556,50107,12129,32438,2534,7091,4930,11729,7464,18820
320070,202311,2604,6198,1554,3993,197,557,808,1829,1005,2386
320080,202311,7324,16958,4377,10967,754,1992,2014,4494,2768,6486
320090,202311,10764,26300,5897,16083,1256,3667,2030,4750,3286,8417
320100,202311,4588,10345,3219,7861,434,1171,1952,4365,2386,5536
320110,202311,3350,6705,2040,4616,416,869,1083,2249,1499,3118
320115,202311,2827,8159,2140,6762,765,2536,529,1617,1294,4153
320120,202311,36187,81245,20953,51879,3010,7685,10371,23036,13381,30721
320130,202311,82549,189016,55974,138396,7758,20301,31777,72302,39535,92603
320140,202311,5530,13389,3250,8545,749,2015,1341,3208,2090,5223
320150,202311,19017,44176,10698,27758,2831,7885,1475,2819,4306,10704
320160,202311,8937,21393,5633,14917,901,2549,2908,7062,3809,9611
320170,202311,2399,6133,1496,4284,418,1218,428,1293,846,2511
320180,202311,973,2741,668,2107,237,820,107,287,344,1107
320190,202311,4219,11845,2702,8432,589,2014,478,1230,1067,3244
320200,202311,1755,4382,1046,2987,244,759,280,734,524,1493
320210,202311,5900,13569,3927,9932,678,1836,1826,4188,2504,6024
320220,202311,5015,11198,3028,7513,665,1690,1282,2934,1947,4624
320225,202311,2093,5747,1281,3927,388,1291,261,726,649,2017
320230,202311,7480,17689,4719,12469,1296,3529,1181,3138,2477,6667
320240,202311,23443,54059,14741,38475,4234,11509,3385,8159,7619,19668
320245,202311,4226,11507,2643,8012,654,2084,270,729,924,2813
320250,202311,3932,9114,2027,4986,331,901,968,2037,1299,2938
320255,202311,2861,7523,2183,6184,402,1230,1322,3642,1724,4872
320260,202311,1890,4813,995,2865,274,789,257,617,531,1406
320265,202311,3029,8516,1955,6171,584,2006,136,337,720,2343
320270,202311,2936,7364,1819,5075,503,1542,568,1466,1071,3008
320280,202311,12067,26667,8459,20287,929,2511,5589,12209,6518,14720
320290,202311,1681,4623,956,2904,253,859,244,688,497,1547
320300,202311,5903,15493,4108,11816,1279,4090,1020,2688,2299,6778
320305,202311,7299,17990,4853,13212,871,2560,2300,5781,3171,8341
320310,202311,2772,6748,1648,4356,308,835,761,1803,1069,2638
320313,202311,3410,7618,1740,4233,346,920,626,1216,972,2136
320316,202311,2028,5285,1330,3929,263,795,606,1782,869,2577
320320,202311,27963,68664,17079,47475,4808,13642,3950,10310,8758,23952
320330,202311,3803,8965,2589,6826,448,1159,1403,3661,1851,4820
320332,202311,11468,26524,7907,19891,1983,4913,3763,8942,5746,13855
320334,202311,2697,6737,1463,4168,240,806,340,709,580,1515
320335,202311,2470,6526,1361,4004,300,1011,402,987,702,1998
320340,202311,7687,15732,5263,11778,488,1087,3552,7550,4040,8637
320350,202311,6796,14715,4074,9685,535,1400,2215,4773,2750,6173
320360,202311,1772,4140,1045,2729,129,360,529,1258,658,1618
320370,202311,3940,10458,2693,7755,725,2334,941,2428,1666,4762
320380,202311,4107,8813,2984,6722,250,689,2113,4333,2363,5022
320390,202311,10934,25754,6600,16821,1476,3958,2584,6020,4060,9978
320400,202311,4230,10882,2630,7473,956,2798,768,2052,1724,4850
320405,202311,6985,15987,4319,10935,717,1819,2244,5341,2961,7160
320410,202311,5989,14443,3830,10438,797,2127,1587,4259,2384,6386
320420,202311,5943,12973,3869,9381,976,2491,1527,3500,2503,5991
320425,202311,2755,5842,1808,4165,143,359,1215,2584,1358,2943
320430,202311,4061,9409,2581,6576,404,1022,1417,3373,1821,4395
320435,202311,3242,9034,2366,7113,849,2753,542,1576,1391,4329
320440,202311,1970,4882,1210,3324,224,679,491,1140,715,1819
320450,202311,2883,6842,2024,5168,310,995,1159,2555,1469,3550
320455,202311,6068,16799,3549,10982,876,2969,870,2234,1746,5203
320460,202311,2760,7445,1683,5040,487,1551,434,1114,921,2665
320465,202311,2171,5500,1264,3597,341,1028,493,1334,834,2362
320470,202311,5887,14232,3624,9690,748,2111,1134,2660,1882,4771
320480,202311,3668,7687,2375,5389,332,705,1434,3001,1766,3706
320490,202311,35605,79552,21200,52401,4059,9865,9355,22359,13414,32224
320495,202311,1832,4565,1141,3121,304,944,136,237,440,1181
320500,202311,97070,222576,65231,161808,8935,23487,36050,81101,44985,104588
320501,202311,6538,16941,3758,11074,945,2832,895,2398,1840,5230
320503,202311,3463,8989,1943,5768,577,1868,489,1227,1066,3095
320506,202311,3924,10383,2329,6588,738,2185,622,1487,1360,3672
320510,202311,16682,39309,10674,27714,2254,5520,4505,11284,6759,16804
320515,202311,2363,5901,1432,3907,455,1327,395,978,850,2305
320517,202311,3085,8106,2218,6301,643,1977,864,2333,1507,4310
320520,202311,68338,152933,44225,108330,7041,18153,21327,47138,28368,65291
320530,202311,49598,110294,32424,77831,2908,8133,20050,42194,22958,50327
330010,202311,39082,84563,28121,64953,2341,5982,19689,42120,22030,48102
330015,202311,2479,5144,1672,3759,271,645,931,1890,1202,2535
330020,202311,33458,70190,25181,57026,2481,6369,18018,38155,20499,44524
330022,202311,2667,6545,1616,4534,336,994,578,1488,914,2482
330023,202311,10370,21628,7084,16105,1035,2551,4148,8502,5183,11053
330025,202311,10854,21604,6479,14217,904,2232,3454,6778,4358,9010
330030,202311,16654,36519,11380,27355,1072,2780,7197,15612,8269,18392
330040,202311,27126,59521,19187,44932,1085,3103,13792,29410,14877,32513
330045,202311,150573,282816,115858,234819,7681,15199,91751,181365,99432,196564
330050,202311,5375,11600,3773,8886,550,1547,2301,4761,2851,6308
330060,202311,8994,19471,5489,13303,1129,2891,2027,4405,3156,7296
330070,202311,48812,100687,36497,81678,4692,10965,23241,49851,27933,60816
330080,202311,15559,31256,11731,25302,1475,3107,8149,16877,9624,19984
330090,202311,4744,8786,2995,6207,328,513,1891,3941,2219,4454
330093,202311,4284,8724,2679,6153,168,478,1977,4189,2145,4667
330095,202311,2175,5074,1330,3414,134,381,775,1779,909,2160
330100,202311,109613,237478,86723,199809,6889,15647,63615,139308,70504,154955
330110,202311,3445,7897,2574,6332,218,636,1741,3899,1959,4535
330115,202311,4114,8548,2432,5692,419,1036,1307,2675,1726,3711
330120,202311,4898,9321,3223,6938,174,429,2413,4829,2587,5258
330130,202311,8542,19407,6288,15603,861,2169,3788,8844,4649,11013
330140,202311,6367,12391,4783,10116,244,667,3828,7594,4072,8261
330150,202311,3960,8740,2603,6381,428,1081,1378,3127,1806,4208
330160,202311,2410,5505,1744,4289,269,765,973,2082,1242,2847
330170,202311,243187,462972,185630,379183,21978,45954,132529,260063,154507,306017
330180,202311,3276,6335,2308,4839,88,247,1738,3288,1826,3535
330185,202311,17832,34463,13304,27797,533,1420,10621,20610,11154,22030
330187,202311,9079,18626,6112,13693,848,1983,3676,7449,4524,9432
330190,202311,70786,135958,54202,110810,2989,6908,42678,82202,45667,89110
330200,202311,30031,61747,22374,50382,2781,6425,15470,33445,18251,39870
330205,202311,3084,6812,1942,4767,200,516,1211,2655,1411,3171
330210,202311,4784,10281,3100,7357,561,1289,1418,3010,1979,4299
330220,202311,21325,45149,13404,30987,2516,5906,6407,13302,8923,19208
330225,202311,6761,14508,4544,10760,339,927,2960,6332,3299,7259
330227,202311,29876,58946,23444,49678,641,1758,19931,39805,20572,41563
330230,202311,2514,5310,1382,3439,195,453,608,1429,803,1882
330240,202311,43909,93728,32698,73995,4003,9308,21441,45919,25444,55227
330245,202311,2358,5292,1265,3289,284,782,527,1165,811,1947
330250,202311,75074,147872,57802,122057,6328,13524,41920,85252,48248,98776
330260,202311,10542,20728,7697,16612,394,1040,5984,12194,6378,13234
330270,202311,51683,108815,28692,68909,3980,10005,14718,32390,18698,42395
330280,202311,4321,8891,2925,6549,347,767,1828,3800,2175,4567
330285,202311,47342,89229,35475,71431,2139,4801,28127,53103,30266,57904
330290,202311,7096,13509,5104,10708,368,1003,3809,7315,4177,8318
330300,202311,8374,16849,5481,12471,444,1090,3844,8326,4288,9416
330310,202311,3904,7978,2612,5798,141,360,1931,3987,2072,4347
330320,202311,28109,55119,19427,42676,2839,6098,12695,26515,15534,32613
330330,202311,81854,153700,59484,120737,5313,11192,44079,84781,49392,95973
330340,202311,30128,61956,19825,44836,2802,7347,11332,22675,14134,30022
330350,202311,261617,485212,201662,403135,10431,22065,167125,320543,177556,342608
330360,202311,11431,22426,8705,18238,426,957,6945,13605,7371,14562
330370,202311,8495,19959,5775,14848,986,2776,2888,6820,3874,9596
330380,202311,11148,23546,7845,17770,500,1382,5641,11728,6141,13110
330385,202311,6623,15249,4837,12269,906,2440,2354,5539,3260,7979
330390,202311,55356,118009,37405,86054,3428,9327,24873,50984,28301,60311
330395,202311,5431,11047,3917,8736,179,532,2939,6027,3118,6559
330400,202311,5320,11736,3987,9436,262,773,2749,5803,3011,6576
330410,202311,5004,10548,3376,7779,370,1034,2305,4797,2675,5831
330411,202311,4193,9893,2726,7046,170,529,1751,4076,1921,4605
330412,202311,2578,5852,1871,4565,165,462,1260,2777,1425,3239
330414,202311,38258,81238,28680,66073,2499,5966,20835,45730,23334,51696
330415,202311,6492,15301,4034,10615,467,1293,2287,5510,2754,6803
330420,202311,19505,42658,12513,29938,1559,3959,7059,15254,8618,19213
330430,202311,16388,31117,12449,25233,635,1426,9843,18802,10478,20228
330440,202311,4592,10086,2869,6887,328,862,1862,3999,2190,4861
330450,202311,2186,5147,1492,3812,121,347,935,2188,1056,2535
330452,202311,31967,67789,23588,53653,2097,5440,16647,35070,18744,40510
330455,202311,1148038,2177631,863795,1752637,95908,201111,603910,1163634,699818,1364745
330460,202311,1764,4069,1231,3171,182,455,638,1595,820,2050
330470,202311,9133,19010,5641,13187,1404,3492,2239,4689,3643,8181
330475,202311,13906,29867,10451,24809,1611,4139,6586,14854,8197,18993
330480,202311,8203,18165,6175,14616,575,1456,4014,8682,4589,10138
330490,202311,181717,355885,132200,279934,11834,26084,94992,190596,106826,216680
330500,202311,12709,26430,8900,20271,601,1499,6409,13650,7010,15149
330510,202311,79565,162795,58618,131254,5341,12741,42285,88858,47626,101599
330513,202311,1955,4248,1315,3202,203,513,667,1550,870,2063
330515,202311,4007,9345,2820,7324,595,1622,1056,2500,1651,4122
330520,202311,22516,47931,16881,38671,1852,4662,11014,23539,12866,28201
330530,202311,2354,5053,1486,3601,290,725,689,1596,979,2321
330540,202311,4579,10294,3101,7637,604,1568,1595,3635,2199,5203
330550,202311,32106,62160,20513,44224,2878,6516,12214,24814,15092,31330
330555,202311,32811,56227,24483,45176,919,2032,20344,35911,21263,37943
330560,202311,6087,13177,4349,10271,722,1685,2626,5820,3348,7505
330570,202311,4507,10000,3554,8499,612,1580,2237,5149,2849,6729
330575,202311,9504,19544,7436,15940,366,948,5904,11747,6270,12695
330580,202311,36752,78602,26547,60175,4095,9558,15493,32278,19588,41836
330590,202311,2248,4996,1712,4181,278,672,895,2158,1173,2830
330600,202311,19777,42782,13684,31846,925,2563,9517,20082,10442,22645
330610,202311,14878,31856,10790,24860,1277,3072,7006,15008,8283,18080
330615,202311,3126,7064,2334,5884,413,897,1434,3716,1847,4613
330620,202311,6835,15782,4829,12226,763,1974,2637,6095,3400,8069
330630,202311,48576,100112,31363,70234,1702,4745,22545,45570,24247,50315
350010,202311,3243,7692,1563,4077,261,728,379,819,640,1547
350020,202311,861,2116,428,1188,65,193,158,361,223,554
350030,202311,5374,12859,3573,9334,760,2084,1744,4114,2504,6198
350040,202311,1010,2643,521,1557,78,251,159,345,237,596
350050,202311,2070,4649,1123,2881,198,574,353,673,551,1247
350055,202311,1264,2809,822,2006,111,273,466,987,577,1260
350060,202311,450,969,179,431,39,93,71,148,110,241
350070,202311,4665,11105,2799,7457,456,1301,1123,2516,1579,3817
350075,202311,887,2284,492,1444,152,429,67,180,219,609
350080,202311,897,2173,462,1247,58,178,235,534,293,712
350090,202311,824,1654,432,960,59,149,264,505,323,654
350100,202311,3532,8032,2115,5288,145,421,1415,3134,1560,3555
350110,202311,690,1480,421,957,16,54,304,627,320,681
350115,202311,1440,3909,931,2673,161,465,365,937,526,1402
350120,202311,692,1543,346,913,42,109,189,453,231,562
350130,202311,4666,11075,3037,7694,449,1267,1680,3716,2129,4983
350140,202311,933,2308,479,1334,54,174,251,611,305,785
350150,202311,594,1657,306,936,75,238,82,190,157,428
350160,202311,17636,40941,10629,26535,1544,4225,5842,12977,7386,17202
350170,202311,4118,9877,2763,6774,516,1320,1439,3094,1955,4414
350180,202311,1282,2804,676,1626,77,185,378,812,455,997
350190,202311,5567,14065,3350,8613,416,1226,1808,3845,2224,5071
350200,202311,746,1731,479,1207,58,163,260,586,318,749
350210,202311,9211,19125,5470,12503,425,1176,3682,7425,4107,8601
350220,202311,4377,10794,2567,6822,472,1333,1154,2576,1626,3909
350230,202311,1582,3476,1031,2605,136,394,624,1431,760,1825
350240,202311,825,2145,371,1088,83,248,71,177,154,425
350250,202311,5017,12168,3112,8558,805,2212,796,2019,1601,4231
350260,202311,1082,2400,520,1341,85,211,230,538,315,749
350270,202311,5860,13715,3936,9925,594,1535,2138,4908,2732,6443
350275,202311,4338,9856,3001,7371,203,630,2111,4658,2314,5288
350280,202311,26171,55417,14739,34853,2183,5426,7443,15530,9626,20956
350290,202311,4729,11802,2904,7861,590,1706,1182,2715,1772,4421
350300,202311,1083,2314,619,1467,94,264,412,870,506,1134
350310,202311,1298,3291,771,2141,107,335,355,837,462,1172
350315,202311,930,1992,482,1198,26,99,296,637,322,736
350320,202311,24523,57032,15523,38971,2736,7438,7559,16281,10295,23719
350330,202311,18439,41278,11280,27039,1140,3043,7248,15607,8388,18650
350335,202311,475,1242,278,814,36,112,116,325,152,437
350340,202311,1796,4322,929,2486,138,418,439,977,577,1395
350350,202311,944,2150,635,1610,97,219,361,882,458,1101
350360,202311,1609,4055,928,2453,149,393,387,914,536,1307
350370,202311,942,2143,555,1327,155,349,213,452,368,801
350380,202311,6774,17114,3779,10261,888,2448,1273,3037,2161,5485
350390,202311,16372,37540,10546,26206,1547,4179,6109,13671,7656,17850
350395,202311,515,1221,200,575,24,76,80,206,104,282
350400,202311,12125,27760,7207,18324,1914,5104,2264,5197,4178,10301
350410,202311,15191,38402,9306,26117,1896,5585,3260,8308,5156,13893
350420,202311,1700,3966,961,2440,202,498,296,631,498,1129
350430,202311,886,2122,617,1648,106,320,284,658,390,978
350440,202311,2837,6358,1809,4391,234,591,1112,2503,1346,3094
350450,202311,10342,25702,6856,18688,1516,4477,2942,6982,4458,11459
350460,202311,3433,8079,1902,5050,300,865,884,2062,1184,2927
350470,202311,343,759,222,538,13,40,168,372,181,412
350480,202311,1163,2725,689,1851,185,565,132,270,317,835
350490,202311,2803,6207,1703,4245,256,736,870,1800,1126,2536
350500,202311,802,2013,481,1349,90,281,178,434,268,715
350510,202311,1616,3591,1009,2395,114,286,631,1357,745,1643
350520,202311,3397,8874,2229,6369,356,1064,1053,2674,1409,3738
350530,202311,4202,9620,2582,6223,203,571,1626,3480,1829,4051
350535,202311,1993,4711,1441,3712,205,584,905,2187,1110,2771
350540,202311,2580,5286,1757,3985,234,676,1190,2366,1424,3042
350550,202311,14054,31361,8525,21037,1014,2786,4464,9632,5478,12418
350560,202311,6562,14420,4714,11032,185,556,3606,7846,3791,8402
350570,202311,45500,110069,30319,79018,5742,15276,13880,32506,19622,47782
350580,202311,2954,7036,1463,3912,388,1051,314,608,702,1659
350590,202311,7284,17370,4668,11626,739,2076,2692,5896,3431,7972
350600,202311,46971,103821,25579,64194,4681,12447,10880,23801,15561,36248
350610,202311,9738,23811,5954,15746,695,2041,3306,7655,4001,9696
350620,202311,523,1237,258,689,28,73,135,317,163,390
350630,202311,2396,5079,1431,3345,92,252,953,2011,1045,2263
350635,202311,16337,34397,11027,25309,1100,2719,7540,16111,8640,18830
350640,202311,1164,2904,509,1477,85,260,146,342,231,602
350650,202311,12060,29251,7337,19275,1434,3913,2931,6688,4365,10601
350660,202311,6692,15222,4557,11443,788,1825,2519,6076,3307,7901
350670,202311,2487,6094,1513,4145,263,717,709,1756,972,2473
350680,202311,1640,3929,970,2558,143,412,512,1206,655,1618
350690,202311,1979,4711,1149,3121,206,602,511,1228,717,1830
350700,202311,7515,16882,4953,12221,1244,3241,2299,4933,3543,8174
350710,202311,4444,10226,2992,7398,560,1508,1529,3371,2089,4879
350715,202311,931,2460,671,1902,118,379,329,757,447,1136
350720,202311,215,496,94,246,15,42,34,69,49,111
350730,202311,838,2226,479,1408,51,148,245,618,296,766
350740,202311,2104,5082,1210,3200,226,616,408,910,634,1526
350745,202311,812,1959,372,1019,27,84,190,445,217,529
350750,202311,16489,38711,11242,28466,2081,5631,4859,10855,6940,16486
350760,202311,25646,55692,15667,36940,2116,5671,8356,17041,10472,22712
350770,202311,1379,3034,782,1938,94,261,502,1137,596,1398
350775,202311,955,2004,482,1160,74,196,252,534,326,730
350780,202311,3117,7011,1980,5191,582,1479,654,1753,1236,3232
350790,202311,2525,6182,1314,3723,318,937,287,654,605,1591
350800,202311,4840,11980,3600,9600,563,1491,2043,5025,2606,6516
350810,202311,3801,8321,2373,5782,554,1423,1057,2347,1611,3770
350820,202311,1252,2656,642,1501,52,140,402,836,454,976
350830,202311,1125,2749,531,1451,104,287,182,409,286,696
350840,202311,4522,12224,2946,8725,642,2044,1138,2857,1780,4901
350850,202311,11843,28974,8038,21334,1394,3871,3990,9657,5384,13528
350860,202311,5545,12459,4131,10021,496,1248,2619,5955,3115,7203
350870,202311,3528,8781,2148,6212,485,1380,802,2177,1287,3557
350880,202311,2309,5528,1571,3999,401,1057,695,1482,1096,2539
350890,202311,654,1600,281,752,64,180,101,221,165,401
350900,202311,13684,32120,8265,20512,1289,3355,4408,9750,5697,13105
350910,202311,1264,2685,868,1984,116,229,564,1242,680,1471
350920,202311,17719,40741,11780,29173,1010,2802,7694,17369,8704,20171
350925,202311,6052,14199,3928,10232,636,1858,2099,4616,2735,6474
350930,202311,1917,4550,899,2347,81,208,491,1158,572,1366
350940,202311,3812,8474,2642,6394,295,797,1731,3780,2026,4577
350945,202311,1284,3219,785,2143,153,416,316,754,469,1170
350950,202311,143387,325051,91705,221516,13085,33491,51051,111134,64136,144625
350960,202311,10753,25151,6915,17270,1089,3006,3609,7835,4698,10841
350970,202311,5357,13470,2976,8116,690,2101,976,2019,1666,4120
350980,202311,1044,2376,775,1865,113,297,458,1018,571,1315
350990,202311,2992,6909,2103,5367,520,1499,1000,2294,1520,3793
350995,202311,1176,3136,875,2416,60,204,572,1425,632,1629
351000,202311,3963,10232,2137,6121,453,1397,478,1154,931,2551
351010,202311,568,1345,281,754,44,131,126,316,170,447
351015,202311,1340,3562,807,2241,135,413,351,836,486,1249
351020,202311,11089,26538,6843,17948,1509,3882,2775,6394,4284,10276
351030,202311,4230,11167,2810,8017,688,2094,1087,2747,1775,4841
351040,202311,8027,16824,5397,12223,485,1242,3704,7602,4189,8844
351050,202311,25327,56677,16616,41188,3298,8357,8033,18260,11331,26617
351060,202311,71061,158466,45678,111123,4850,13057,28641,64149,33491,77206
351070,202311,1990,4567,974,2690,270,778,161,376,431,1154
351080,202311,3856,8345,2498,6193,344,900,1342,2960,1686,3860
351090,202311,453,1103,283,769,53,124,129,327,182,451
351100,202311,4000,9614,2039,5330,339,932,830,1922,1169,2854
351110,202311,8054,19189,5061,13340,1017,2754,2197,5162,3214,7916
351120,202311,1035,2455,545,1403,99,285,206,429,305,714
351130,202311,1582,4098,604,1804,109,346,122,303,231,649
351140,202311,3060,7624,1877,5135,440,1297,629,1391,1069,2688
351150,202311,3626,9475,2002,5772,342,1079,475,1149,817,2228
351160,202311,1994,5488,1148,3464,208,624,193,451,401,1075
351170,202311,2257,5233,1601,3921,139,403,1088,2420,1227,2823
351190,202311,1300,3331,704,1988,181,511,174,442,355,953
351200,202311,2002,4644,1195,3133,158,428,522,1140,680,1568
351210,202311,1928,4314,1047,2603,88,258,680,1525,768,1783
351220,202311,5305,12203,3657,9070,490,1191,2140,4936,2630,6127
351230,202311,3182,7273,1973,4930,332,892,956,2048,1288,2940
351240,202311,3096,7726,1351,3739,227,627,155,291,382,918
351250,202311,1309,3283,580,1638,94,272,206,512,300,784
351260,202311,1053,2393,628,1596,132,351,244,526,376,877
351270,202311,703,1740,404,1085,52,148,196,437,248,585
351280,202311,5282,12867,3248,8551,843,2290,1036,2469,1879,4759
351290,202311,2003,4283,1125,2655,85,233,792,1734,877,1967
351300,202311,33284,79801,21082,55598,3862,10707,9596,22820,13458,33527
351310,202311,5450,11835,3466,8127,352,863,2192,4666,2544,5529
351320,202311,1049,2799,599,1803,82,249,147,394,229,643
351330,202311,374,913,180,501,24,58,75,179,99,237
351340,202311,11526,25578,8656,20017,1909,4569,4713,9757,6622,14326
351350,202311,19311,42634,13066,30427,1422,3528,8838,18816,10260,22344
351360,202311,5292,12140,3891,9726,854,2237,1734,3850,2588,6087
351370,202311,2713,6994,1453,4201,324,1003,297,633,621,1636
351380,202311,64686,140178,38368,91265,4424,11137,23318,51189,27742,62326
351385,202311,487,1200,158,452,34,99,57,132,91,231
351390,202311,1925,4344,1166,3142,98,285,811,2048,909,2333
351400,202311,1608,3940,963,2497,246,556,375,957,621,1513
351410,202311,3612,8920,2181,5876,469,1297,847,2023,1316,3320
351420,202311,633,1443,330,859,63,149,171,419,234,568
351430,202311,1351,3088,828,2023,103,258,511,1109,614,1367
351440,202311,5086,11937,2801,7058,525,1362,1028,2152,1553,3514
351450,202311,2354,5547,1195,3182,236,733,402,849,638,1582
351460,202311,1430,3291,912,2302,182,456,511,1186,693,1642
351470,202311,1599,3686,962,2409,87,252,587,1317,674,1569
351480,202311,3185,8116,2128,6090,389,1150,962,2481,1351,3631
351490,202311,3088,7597,2113,5572,116,392,1496,3648,1612,4040
351492,202311,495,1151,325,774,17,52,245,535,262,587
351495,202311,297,735,166,447,19,40,93,222,112,262
351500,202311,62883,132989,41307,94611,6456,15261,25233,53051,31689,68312
351510,202311,19132,41036,12182,28219,1481,3786,7611,16343,9092,20129
351512,202311,604,1499,329,886,56,147,102,225,158,372
351515,202311,4231,9459,2110,5329,424,1162,516,1209,940,2371
351518,202311,2573,6359,1485,4151,278,833,543,1243,821,2076
351519,202311,838,2150,350,1061,63,192,73,183,136,375
351520,202311,1315,3038,559,1539,71,211,280,682,351,893
351530,202311,449,1066,217,557,38,107,91,178,129,285
351535,202311,2108,4895,1260,3292,225,643,545,1296,770,1939
351540,202311,3596,7935,2103,5179,258,758,1086,2261,1344,3019
351550,202311,10169,22963,5733,14279,957,2503,2782,6110,3739,8613
351560,202311,731,1899,430,1219,80,234,184,465,264,699
351565,202311,375,881,235,609,24,72,133,302,157,374
351570,202311,33431,76939,22450,54678,2046,5648,14580,32525,16626,38173
351580,202311,280,717,137,403,26,85,56,169,82,254
351590,202311,506,1111,222,583,28,90,100,220,128,310
351600,202311,1723,4205,1025,2672,188,496,432,976,620,1472
351610,202311,862,1877,427,1043,60,111,238,549,298,660
351620,202311,34923,83814,21755,58458,3344,9887,9916,23227,13260,33114
351630,202311,40811,92385,27120,66356,2565,7052,17820,39567,20385,46619
351640,202311,28866,64227,19416,46295,1587,4367,13098,28274,14685,32641
351650,202311,501,1303,184,578,29,95,45,132,74,227
351660,202311,778,2053,466,1339,79,247,126,298,205,545
351670,202311,8281,20555,4216,11154,908,2373,1790,4084,2698,6457
351680,202311,546,1394,308,900,55,158,114,290,169,448
351685,202311,705,1744,393,1065,81,214,149,340,230,554
351690,202311,1539,3642,760,2077,137,421,257,584,394,1005
351700,202311,1861,4051,1116,2647,172,450,646,1332,818,1782
351710,202311,1051,2476,591,1533,56,178,330,729,386,907
351720,202311,2012,4823,1139,3056,189,504,523,1269,712,1773
351730,202311,1360,3043,848,2107,77,200,528,1172,605,1372
351740,202311,4367,9979,3049,7410,405,1064,1742,3811,2147,4875
351750,202311,2644,6422,1343,3665,202,579,645,1557,847,2136
351760,202311,4354,10723,2839,7606,620,1824,1136,2648,1756,4472
351770,202311,2805,6666,2024,5068,505,1268,1012,2302,1517,3570
351780,202311,1389,3201,666,1722,86,235,313,729,399,964
351790,202311,2052,4423,1319,3167,251,592,676,1538,927,2130
351800,202311,524,1163,230,598,33,97,81,157,114,254
351810,202311,1515,3569,964,2492,241,678,424,951,665,1629
351820,202311,4286,10209,2601,6630,613,1616,997,2217,1610,3833
351830,202311,7046,15602,4430,10684,370,1064,2837,6051,3207,7115
351840,202311,13541,32801,9293,24337,862,2567,5825,13787,6687,16354
351850,202311,1864,4926,987,2969,200,671,280,631,480,1302
351860,202311,3816,9670,2511,6917,929,2536,757,1838,1686,4374
351870,202311,42782,96719,30045,73365,5694,14063,15631,36210,21325,50273
351880,202311,244514,531001,162343,379706,23376,63264,98552,205699,121928,268963
351885,202311,1399,3091,961,2322,53,136,708,1618,761,1754
351890,202311,1033,2500,513,1475,104,324,136,333,240,657
351900,202311,1712,4139,1117,3031,137,352,660,1739,797,2091
351905,202311,833,2182,490,1356,67,191,208,492,275,683
351907,202311,32724,76951,20749,52775,2728,7695,11699,26580,14427,34275
351910,202311,2382,5403,1371,3298,157,453,848,1764,1005,2217
351920,202311,1189,2824,767,1965,155,360,276,630,431,990
351925,202311,1352,3217,868,2195,110,336,483,1061,593,1397
351930,202311,6255,13640,4725,10779,685,1519,3016,6355,3701,7874
351940,202311,1463,3435,896,2341,179,477,346,858,525,1335
351950,202311,2129,4089,1354,2870,72,193,1008,1980,1080,2173
351960,202311,7704,17470,4763,11819,1220,3091,1766,3890,2986,6981
351970,202311,15560,35772,11457,28494,1634,4548,7198,16210,8832,20758
351980,202311,1443,3196,725,1855,148,411,297,654,445,1065
351990,202311,1854,4060,1023,2491,50,149,618,1284,668,1433
352000,202311,3791,9091,2641,6579,260,740,1732,3874,1992,4614
352010,202311,3251,7638,2131,5542,606,1600,553,1351,1159,2951
352020,202311,2320,5377,1544,3903,281,749,775,1774,1056,2523
352030,202311,8525,18821,5966,14189,785,2143,3833,8212,4618,10355
352040,202311,6442,14727,3998,9876,802,2105,1654,3574,2456,5679
352042,202311,5396,11319,3129,7504,378,942,1865,4185,2243,5127
352044,202311,2780,6801,1367,3830,228,707,326,671,554,1378
352050,202311,19207,46727,10334,27734,2927,8268,2219,4501,5146,12769
352060,202311,1038,2443,657,1689,133,383,310,704,443,1087
352070,202311,1225,2430,648,1487,107,252,330,674,437,926
352080,202311,586,1405,253,666,37,97,100,222,137,319
352090,202311,2112,5425,1389,3798,189,553,698,1619,887,2172
352100,202311,5370,13639,3416,9541,765,2195,1367,3451,2132,5646
352110,202311,1022,2557,598,1604,108,305,268,620,376,925
352115,202311,628,1608,463,1332,144,445,170,409,314,854
352120,202311,1096,2824,762,2102,65,170,464,1161,529,1331
352130,202311,2510,6562,1326,3583,221,607,578,1354,799,1961
352140,202311,1937,4672,1133,2935,224,585,435,1023,659,1608
352150,202311,1133,2772,726,1977,126,356,406,1057,532,1413
352160,202311,1246,2855,702,1799,69,183,347,814,416,997
352170,202311,3850,9614,2463,6610,523,1511,972,2197,1495,3708
352180,202311,3800,9470,2520,6886,518,1546,1029,2440,1547,3986
352190,202311,2270,5152,1575,3918,240,649,847,1954,1087,2603
352200,202311,443,1295,254,821,40,128,86,232,126,360
352210,202311,33102,65640,23712,51581,1522,3826,18018,36625,19540,40451
352215,202311,813,2019,565,1544,133,351,257,664,390,1015
352220,202311,41185,86237,26964,60322,3752,9378,16723,33288,20475,42666
352230,202311,21357,54484,13887,38582,3857,10902,4468,10533,8325,21435
352240,202311,14516,34316,10000,26121,2399,6478,4640,10711,7039,17189
352250,202311,36247,91162,25870,71290,3851,11414,14574,37000,18425,48414
352260,202311,6811,15635,3969,9687,748,1994,1762,3497,2510,5491
352265,202311,1130,3032,918,2646,251,782,389,1042,640,1824
352270,202311,2988,7527,2077,5549,434,1188,865,2107,1299,3295
352280,202311,3230,7037,2245,5394,526,1330,1070,2289,1596,3619
352290,202311,2083,5193,1219,3272,219,593,519,1189,738,1782
352300,202311,1237,2884,592,1508,73,202,291,635,364,837
352310,202311,67885,157726,46828,118779,8333,20732,27711,66748,36044,87480
352320,202311,9340,21024,6470,15516,987,2516,3722,7805,4709,10321
352330,202311,3568,7796,2518,6119,241,754,1659,3572,1900,4326
352340,202311,11519,27276,7084,17988,1088,3082,3654,8035,4742,11117
352350,202311,3420,8291,2184,5628,180,555,1295,2965,1475,3520
352360,202311,2107,4851,1409,3472,204,547,796,1716,1000,2263
352370,202311,1382,3413,988,2659,92,289,660,1622,752,1911
352380,202311,1291,2983,760,1936,148,389,254,570,402,959
352390,202311,20893,47501,12610,31413,1875,5209,6886,15094,8761,20303
352400,202311,5496,14162,3386,9498,801,2311,1030,2490,1831,4801
352410,202311,5236,11607,3405,8192,600,1451,1662,3678,2262,5129
352420,202311,1094,2588,605,1595,99,253,273,623,372,876
352430,202311,12185,25665,7658,17307,1018,2549,4336,8885,5354,11434
352440,202311,27214,66224,17010,44912,4082,10651,5514,13447,9596,24098
352450,202311,1053,2475,485,1369,73,227,207,495,280,722
352460,202311,3222,8080,2236,6156,433,1281,984,2423,1417,3704
352470,202311,3865,9516,2487,6724,311,976,1312,3143,1623,4119
352480,202311,6201,13427,3345,8056,538,1358,1526,3222,2064,4580
352490,202311,1137,2833,682,1845,131,353,269,671,400,1024
352500,202311,16236,38207,8636,22821,2835,7798,1360,2367,4195,10165
352510,202311,6410,15065,4307,10948,526,1378,2678,6335,3204,7713
352520,202311,3842,9496,2404,6617,464,1339,1097,2608,1561,3947
352530,202311,16306,37577,9326,23460,2269,6083,2983,6095,5252,12178
352540,202311,754,1895,483,1307,60,168,239,574,299,742
352550,202311,1477,3608,901,2546,194,618,305,688,499,1306
352560,202311,908,2150,576,1420,32,98,387,839,419,937
352570,202311,2894,7363,1726,5023,489,1497,230,458,719,1955
352580,202311,1032,2322,724,1728,110,296,430,917,540,1213
352585,202311,511,1288,260,736,42,123,89,187,131,310
352590,202311,17496,42978,10530,28651,1982,5985,4811,11070,6793,17055
352600,202311,2613,6335,1762,4585,355,1011,891,1973,1246,2984
352610,202311,3988,9389,2711,7094,459,1309,1325,3125,1784,4434
352620,202311,8194,17942,5354,13150,1526,3559,2242,5390,3768,8949
352630,202311,1098,2437,704,1785,110,320,326,730,436,1050
352640,202311,4588,10591,2807,6942,299,801,1532,3305,1831,4106
352650,202311,718,1870,397,1145,66,209,158,384,224,593
352660,202311,1498,3837,1032,2799,80,267,685,1668,765,1935
352670,202311,14572,34390,8913,22460,1685,4457,4123,9062,5808,13519
352680,202311,4485,11805,2862,7991,560,1782,1254,2717,1814,4499
352690,202311,36494,83481,23625,58301,1485,4420,16349,36730,17834,41150
352700,202311,1104,2555,680,1746,91,265,346,780,437,1045
352710,202311,7555,17640,4643,11965,1513,3923,1440,3160,2953,7083
352720,202311,14289,31723,9863,23115,1301,3288,6003,12834,7304,16122
352725,202311,671,1446,298,779,22,74,158,341,180,415
352730,202311,4512,12195,3207,8967,528,1574,1386,3090,1914,4664
352740,202311,3053,6910,1778,4470,276,767,819,1745,1095,2512
352750,202311,567,1305,250,679,34,100,105,232,139,332
352760,202311,1847,4593,1272,3396,208,576,646,1561,854,2137
352770,202311,1225,2891,746,1911,92,237,413,980,505,1217
352780,202311,847,2230,418,1226,108,266,116,318,224,584
352790,202311,526,1274,305,784,53,138,128,277,181,415
352800,202311,1810,4888,932,2770,156,452,231,518,387,970
352810,202311,2154,4647,1426,3238,169,401,926,1981,1095,2382
352820,202311,549,1443,316,951,60,182,74,189,134,371
352830,202311,690,1634,262,698,40,107,83,187,123,294
352840,202311,5219,13388,3488,9723,811,2325,1298,3278,2109,5603
352850,202311,18345,38861,11526,27108,1855,4685,6385,13424,8240,18109
352860,202311,1559,3895,890,2440,176,468,310,771,486,1239
352870,202311,1045,2520,576,1485,80,204,302,706,382,910
352880,202311,2282,5033,1224,2885,213,528,511,1031,724,1559
352885,202311,464,1155,294,796,32,95,163,390,195,485
352890,202311,900,1911,482,1056,54,126,333,660,387,786
352900,202311,26695,62722,15356,39545,2688,7117,5984,13930,8672,21047
352910,202311,442,1083,208,605,15,45,86,212,101,257
352920,202311,3722,8618,2416,6054,164,499,1694,3862,1858,4361
352930,202311,7957,18674,5382,13262,948,2618,2640,5538,3588,8156
352940,202311,40356,95940,28540,70920,4448,11715,16256,36808,20704,48523
352950,202311,688,1773,359,1088,74,229,113,284,187,513
352960,202311,928,2257,439,1182,65,178,142,314,207,492
352965,202311,318,806,160,478,40,117,40,110,80,227
352970,202311,5276,9773,3813,7522,132,329,3110,5750,3242,6079
352980,202311,2077,4526,1388,3400,377,979,627,1376,1004,2355
352990,202311,5941,13591,3939,9947,734,1891,2063,4901,2797,6792
353000,202311,555,1371,266,739,36,103,94,227,130,330
353010,202311,3646,8147,2012,4917,347,916,944,1992,1291,2908
353020,202311,3791,8992,2047,5408,384,1117,844,1971,1228,3088
353030,202311,6437,15076,3611,9720,908,2540,927,2219,1835,4759
353040,202311,983,2154,612,1494,57,142,407,913,464,1055
353050,202311,6982,17811,4313,12034,757,2307,2046,4986,2803,7293
353060,202311,70545,157774,50610,121656,4037,11333,35373,77547,39410,88880
353070,202311,15852,39359,9561,25049,1697,4765,4367,9784,6064,14549
353080,202311,6942,16443,4337,11147,842,2366,1805,3853,2647,6219
353090,202311,760,2066,461,1385,54,171,236,621,290,792
353100,202311,406,981,152,441,29,84,54,128,83,212
353110,202311,11612,26174,8378,21020,1909,4731,4026,10006,5935,14737
353120,202311,687,1598,441,1114,80,234,209,425,289,659
353130,202311,4229,9259,2327,5534,514,1305,972,1870,1486,3175
353140,202311,4281,9319,2669,6353,474,1285,1424,2990,1898,4275
353150,202311,2315,5306,1410,3575,280,718,656,1489,936,2207
353160,202311,798,1922,423,1140,47,138,187,421,234,559
353170,202311,948,2151,627,1617,60,188,382,865,442,1053
353180,202311,13319,30746,8243,20815,1937,5110,3394,7598,5331,12708
353190,202311,4811,11384,2938,7324,395,1033,1673,3776,2068,4809
353200,202311,2345,5780,1235,3395,173,543,515,1236,688,1779
353205,202311,636,1647,394,1049,44,130,223,501,267,631
353210,202311,1165,2303,619,1392,23,63,463,959,486,1022
353215,202311,508,1235,309,794,53,138,127,284,180,422
353220,202311,999,2520,500,1382,105,294,175,416,280,710
353230,202311,1131,2879,795,2278,212,679,178,449,390,1128
353240,202311,3480,8118,2506,6366,366,1073,1446,3316,1812,4389
353250,202311,1797,3625,1033,2325,122,285,637,1307,759,1592
353260,202311,1559,3365,771,2003,172,500,310,700,482,1200
353270,202311,1132,2576,753,1796,107,296,430,893,537,1189
353280,202311,988,2388,597,1627,133,364,200,491,333,855
353282,202311,2074,5452,1455,4105,174,551,751,1847,925,2398
353284,202311,466,1057,208,545,15,50,86,188,101,238
353286,202311,204,514,91,276,24,62,13,37,37,99
353290,202311,1695,4105,714,1930,195,482,192,486,387,968
353300,202311,2962,7206,1699,4441,358,1016,730,1599,1088,2615
353310,202311,506,1110,309,702,23,61,218,454,241,515
353320,202311,858,2119,493,1335,83,255,239,559,322,814
353325,202311,1051,2674,532,1462,86,257,238,570,324,827
353330,202311,832,1888,391,997,48,111,189,409,237,520
353340,202311,4413,10842,3006,7868,563,1592,1434,3194,1997,4786
353350,202311,6066,13462,3545,8571,1018,2567,903,1874,1921,4441
353360,202311,926,2353,603,1623,48,134,357,866,405,1000
353370,202311,813,2106,553,1627,75,219,295,796,370,1015
353380,202311,401,1010,266,724,34,109,147,333,181,442
353390,202311,8554,19630,4941,12597,517,1496,2794,6293,3311,7789
353400,202311,779,1893,479,1252,79,213,203,417,282,630
353410,202311,693,1637,421,1078,143,375,142,284,285,659
353420,202311,675,1585,394,1012,90,261,123,263,213,524
353430,202311,3043,7700,1966,5440,480,1346,737,1847,1217,3193
353440,202311,112625,265752,72031,181878,10606,28425,40340,90749,50946,119174
353450,202311,483,1167,268,757,49,126,90,229,139,355
353460,202311,4330,10749,2254,6214,470,1419,567,1224,1037,2643
353470,202311,12890,30157,7857,20093,1476,3986,3436,7584,4912,11570
353475,202311,2050,4731,1016,2604,167,466,375,797,542,1263
353480,202311,2104,4781,1433,3515,97,248,945,2148,1042,2396
353490,202311,1431,3314,881,2208,124,350,501,1100,625,1450
353500,202311,1667,3731,1071,2614,235,565,482,1095,717,1660
353510,202311,1370,3467,736,1917,141,387,301,636,442,1023
353520,202311,1368,3274,742,2029,155,411,253,576,408,987
353530,202311,3345,7684,2276,5496,253,686,1445,3109,1698,3795
353540,202311,3018,7065,2047,5251,307,841,1229,2900,1536,3741
353550,202311,8364,18558,5353,12716,797,2034,3155,6674,3952,8708
353560,202311,3165,7624,2109,5713,618,1815,617,1286,1235,3101
353570,202311,831,2078,393,1128,65,200,132,293,197,493
353580,202311,3300,7917,2163,5574,426,1067,1084,2619,1510,3686
353590,202311,951,2222,582,1502,87,218,310,756,397,974
353600,202311,2013,4798,1149,3062,208,582,484,1175,692,1757
353610,202311,1141,3015,671,1974,96,299,283,721,379,1020
353620,202311,3890,9019,2322,6100,565,1528,684,1504,1249,3032
353625,202311,833,1876,395,1031,47,149,209,465,256,614
353630,202311,2173,5639,1541,4226,223,651,796,1891,1019,2542
353640,202311,1841,4358,1165,2996,162,405,689,1672,851,2077
353650,202311,9397,23388,5867,15833,939,2747,3013,7162,3952,9909
353657,202311,473,1163,248,679,27,84,109,256,136,340
353660,202311,1763,3421,1100,2429,154,373,718,1472,872,1845
353670,202311,6015,14731,3593,9422,723,2094,1420,3124,2143,5218
353680,202311,961,2213,606,1616,110,322,294,701,404,1023
353690,202311,535,1374,192,574,32,96,46,110,78,206
353700,202311,3003,6770,1983,4936,202,521,1193,2722,1395,3243
353710,202311,5394,11607,3251,7481,599,1448,1716,3332,2315,4780
353715,202311,534,1338,250,703,27,74,117,283,144,357
353720,202311,2533,5996,1661,4371,407,1115,659,1589,1066,2704
353730,202311,7204,16627,4974,12342,751,2069,2842,6327,3593,8396
353740,202311,2969,7045,1896,4912,385,1078,870,1913,1255,2991
353750,202311,1207,3250,689,2127,171,527,101,269,272,796
353760,202311,20400,40230,13902,30590,2971,6675,7107,14746,10078,21421
353770,202311,833,2229,393,1236,69,230,38,98,107,328
353780,202311,9647,22437,6842,16790,1445,3841,3570,7859,5015,11700
353790,202311,3607,9788,2247,6658,568,1757,433,984,1001,2741
353800,202311,25971,60576,17837,45221,2618,7057,10517,24454,13135,31511
353810,202311,1717,4135,979,2497,201,496,380,914,581,1410
353820,202311,2592,6124,1446,3837,434,1151,385,896,819,2047
353830,202311,788,1814,461,1215,59,177,240,545,299,722
353850,202311,2132,5185,1398,3700,260,713,615,1453,875,2166
353860,202311,3783,9067,2606,6939,636,1905,1017,2196,1653,4101
353870,202311,40196,97011,24471,64210,4615,12440,9713,22505,14328,34945
353880,202311,3967,9629,2831,7334,228,675,1824,4318,2052,4993
353890,202311,4410,8298,2682,5587,230,587,1855,3414,2085,4001
353900,202311,990,2503,545,1488,93,289,201,463,294,752
353910,202311,4301,9962,3050,7626,264,737,1962,4430,2226,5167
353920,202311,2632,6541,1559,4289,460,1381,302,565,762,1946
353930,202311,7687,18062,4855,12411,919,2530,2086,4595,3005,7125
353940,202311,1815,4685,986,2779,221,616,309,722,530,1338
353950,202311,4714,11325,3018,7802,1035,2672,708,1726,1743,4398
353960,202311,972,2350,522,1421,119,318,77,178,196,496
353970,202311,918,1901,591,1368,55,141,420,896,475,1037
353980,202311,24574,53543,16387,38337,901,2624,12110,25817,13011,28441
353990,202311,1305,2786,772,1813,115,310,466,982,581,1292
354000,202311,3427,7805,1503,3775,252,662,670,1464,922,2126
354010,202311,436,1038,272,731,50,144,155,384,205,528
354020,202311,5513,12842,3524,8552,865,2201,1345,2914,2210,5115
354025,202311,933,2396,499,1399,99,293,156,387,255,680
354030,202311,682,1437,272,666,45,123,137,301,182,424
354040,202311,985,2107,525,1305,63,175,302,662,365,837
354050,202311,1404,3586,851,2511,197,638,293,760,490,1398
354060,202311,5765,14165,3561,9192,569,1634,1815,3970,2384,5604
354070,202311,5543,12800,3234,8082,617,1555,1199,2581,1816,4136
354075,202311,3886,9554,2798,7461,661,1807,1387,3300,2048,5107
354080,202311,2052,5123,1233,3387,179,494,585,1397,764,1891
354085,202311,536,983,325,648,3,9,256,470,259,479
354090,202311,2304,5628,1688,4293,109,292,1190,2799,1299,3091
354100,202311,36624,88930,24817,66899,4826,14063,11925,28871,16751,42934
354105,202311,1465,3530,805,2198,131,371,372,892,503,1263
354110,202311,643,1589,363,1016,51,147,161,390,212,537
354120,202311,1904,4648,1041,2733,231,627,373,841,604,1468
354130,202311,8136,19136,4499,11571,1266,3310,1132,2460,2398,5770
354140,202311,26119,60197,15816,39361,2563,6694,7895,17167,10458,23861
354150,202311,3724,8226,2494,6027,669,1586,679,1635,1348,3221
354160,202311,3645,9401,2613,7148,664,1850,1080,2653,1744,4503
354165,202311,949,2410,633,1723,80,250,387,937,467,1187
354170,202311,2666,6605,1527,4071,325,981,665,1432,990,2413
354180,202311,601,1555,346,951,41,117,156,372,197,489
354190,202311,2024,5131,1185,3290,83,268,699,1722,782,1990
354200,202311,1210,2766,732,1843,114,318,396,873,510,1191
354210,202311,1491,3477,893,2193,98,260,562,1258,660,1518
354220,202311,4213,10049,2651,6841,605,1652,958,2150,1563,3802
354230,202311,1064,2400,769,1929,68,189,501,1149,569,1338
354240,202311,2424,6104,1362,3735,270,762,529,1231,799,1993
354250,202311,938,2176,495,1321,119,333,158,381,277,714
354260,202311,12334,27717,8141,19870,1451,3605,3722,8477,5173,12082
354270,202311,1300,3436,861,2420,132,363,407,984,539,1347
354280,202311,1037,2348,710,1734,65,179,465,1015,530,1194
354290,202311,1274,3554,880,2593,148,457,429,1129,577,1586
354300,202311,4337,11415,3262,9236,941,2733,1198,3027,2139,5760
354310,202311,1094,2738,747,2010,96,289,445,1066,541,1355
354320,202311,1206,2686,644,1636,129,339,293,636,422,975
354323,202311,564,1251,286,725,38,104,150,333,188,437
354325,202311,1661,4742,774,2433,172,566,104,240,276,806
354330,202311,13842,31115,8209,19522,1226,3132,4568,9759,5794,12891
354340,202311,60587,137029,38607,96322,6956,17852,19262,43800,26218,61652
354350,202311,1529,3457,1116,2707,177,477,633,1354,810,1831
354360,202311,857,1848,459,1137,120,296,160,348,280,644
354370,202311,1209,2989,836,2295,148,431,447,1126,595,1557
354380,202311,655,1665,413,1211,59,214,139,320,198,534
354390,202311,21538,46730,12529,29607,1929,4822,6627,13815,8556,18637
354400,202311,2150,6178,1331,4141,225,738,403,1112,628,1850
354410,202311,9816,21788,6303,14649,1136,2734,3401,7168,4537,9902
354420,202311,1838,4391,1091,2875,195,575,489,1146,684,1721
354425,202311,3858,8416,2331,5574,373,937,1294,2853,1667,3790
354430,202311,2340,5358,1490,3733,137,375,930,2111,1067,2486
354440,202311,744,1789,329,843,43,122,175,393,218,515
354450,202311,678,1672,317,890,42,122,126,290,168,412
354460,202311,903,2302,562,1599,166,517,120,259,286,776
354470,202311,496,1244,204,554,15,43,83,174,98,217
354480,202311,1826,3824,1013,2387,86,250,642,1343,728,1593
354490,202311,1072,2885,640,1853,147,404,262,697,409,1101
354500,202311,3236,7831,2177,5790,555,1569,736,1748,1291,3317
354510,202311,968,2463,559,1514,81,229,247,545,328,774
354515,202311,572,1540,307,922,53,166,80,188,133,354
354520,202311,11665,28203,7075,18239,1022,2889,3803,8474,4825,11363
354530,202311,7306,17529,4667,11925,1242,3189,1825,4192,3067,7381
354540,202311,1654,3979,998,2677,183,517,438,1045,621,1562
354550,202311,757,1889,461,1265,68,208,231,534,299,742
354560,202311,2835,6316,1279,3234,179,421,691,1620,870,2041
354570,202311,1103,2557,369,1048,58,167,51,131,109,298
354580,202311,11340,28229,6722,18486,1065,3120,3255,8005,4320,11125
354600,202311,2817,6820,1749,4615,339,858,839,2078,1178,2936
354610,202311,601,1494,259,731,26,77,114,289,140,366
354620,202311,642,1652,337,999,34,116,174,450,208,566
354625,202311,396,1041,178,535,19,66,58,125,77,191
354630,202311,3450,8600,2414,6370,843,2114,624,1529,1467,3643
354640,202311,5127,12730,3372,9031,527,1494,1640,3905,2167,5399
354650,202311,1121,2651,614,1525,185,414,270,655,455,1069
354660,202311,4402,9701,2089,5530,304,886,836,1899,1140,2785
354670,202311,1597,3975,999,2702,204,590,340,769,544,1359
354680,202311,8969,19901,6073,14663,966,2443,3497,7716,4463,10159
354690,202311,693,1934,383,1165,63,197,145,368,208,565
354700,202311,1227,2871,717,1816,106,296,385,867,491,1163
354710,202311,604,1487,305,824,32,81,145,331,177,412
354720,202311,396,882,165,439,60,146,38,82,98,228
354730,202311,15932,41153,10404,29243,1640,4695,5250,13199,6890,17894
354740,202311,384,991,134,411,30,93,16,35,46,128
354750,202311,3140,7386,1760,4527,282,748,813,1792,1095,2540
354760,202311,3045,7156,1802,4704,344,933,720,1580,1064,2513
354765,202311,438,1095,151,450,13,46,45,103,58,149
354770,202311,3292,7465,2017,4888,431,1166,961,2021,1392,3187
354780,202311,89751,195203,58553,132949,4389,11838,40559,82038,44948,93876
354790,202311,1175,3027,861,2471,87,261,477,1279,564,1540
354800,202311,3667,8672,2170,5728,508,1355,693,1589,1201,2944
354805,202311,1852,3957,1095,2596,80,211,726,1524,806,1735
354810,202311,661,1863,373,1229,92,321,92,252,184,573
354820,202311,1252,3335,777,2331,161,498,212,507,373,1005
354830,202311,694,1535,313,793,60,173,121,238,181,411
354840,202311,924,2118,490,1293,47,123,268,625,315,748
354850,202311,33115,72857,21477,51423,1963,5445,14400,30688,16363,36133
354860,202311,2155,5223,1219,3346,175,520,518,1237,693,1757
354870,202311,99201,219254,62632,146348,5869,15309,39747,82136,45616,97445
354880,202311,8741,20161,4110,10182,602,1625,1904,3728,2506,5353
354890,202311,26547,58513,17679,41735,2529,6366,9698,20599,12227,26965
354900,202311,493,1154,272,741,80,220,70,161,150,381
354910,202311,8469,20357,4402,12189,955,2800,1385,3220,2340,6020
354920,202311,605,1556,206,608,26,83,57,134,83,217
354925,202311,337,902,139,445,14,52,29,58,43,110
354930,202311,444,1020,208,510,21,54,122,272,143,326
354940,202311,3912,10194,2546,7075,719,2065,1001,2371,1720,4436
354950,202311,2039,4528,1323,3216,69,214,928,2048,997,2262
354960,202311,1068,2579,671,1863,76,249,328,784,404,1033
354970,202311,6010,14483,4008,10750,308,958,2526,6125,2834,7083
354980,202311,50355,109336,30755,73175,4145,11100,18248,38274,22393,49374
354990,202311,111991,246592,68352,163524,5379,15239,44348,93901,49727,109140
354995,202311,4649,8661,3142,6443,183,428,2466,4716,2649,5144
355000,202311,1990,4550,1238,3231,235,672,531,1210,766,1882
355010,202311,5561,13533,2970,7908,891,2285,832,1961,1723,4246
355020,202311,3968,10701,2891,8624,791,2532,823,2032,1614,4564
355030,202311,1885213,4200573,1145554,2711840,184425,463434,603811,1285289,788236,1748723
355040,202311,4967,10556,3351,8025,514,1312,2082,4564,2596,5876
355050,202311,1521,3282,923,2250,224,578,321,696,545,1274
355060,202311,9615,23326,6084,16112,1024,2879,2973,6916,3997,9795
355070,202311,15834,35255,10999,26190,1364,3542,6785,14460,8149,18002
355080,202311,1296,3384,639,1976,174,534,94,256,268,790
355090,202311,1849,4450,1206,3149,207,549,616,1406,823,1955
355100,202311,47556,105575,35771,84725,3336,8898,25373,55371,28709,64269
355110,202311,1367,3413,792,2319,157,467,54,136,211,603
355120,202311,927,2205,522,1463,80,231,243,581,323,812
355130,202311,1135,2268,512,1101,23,57,379,761,402,818
355140,202311,3047,5591,2265,4439,113,267,1830,3348,1943,3615
355150,202311,7032,15996,4829,11751,657,1670,2903,6519,3560,8189
355160,202311,3338,8112,1904,5247,410,1171,556,1292,966,2463
355170,202311,17434,39031,11399,27559,1931,4993,6312,13819,8243,18812
355180,202311,3826,8696,2530,6503,684,1831,1053,2475,1737,4306
355190,202311,2482,6075,1467,3982,557,1463,282,797,839,2260
355200,202311,1220,3265,886,2637,238,771,305,785,543,1556
355210,202311,4374,10638,2699,7070,809,2059,881,2096,1690,4155
355220,202311,77537,178737,52673,127591,6738,18576,31075,66463,37813,85039
355230,202311,1546,3725,643,1734,142,408,265,601,407,1009
355240,202311,35023,83351,21394,54857,2691,7483,12704,29440,15395,36923
355250,202311,58035,137297,37720,95065,10045,24537,16637,39373,26682,63910
355255,202311,861,1957,362,941,46,137,163,348,209,485
355260,202311,2040,4339,1203,2814,124,350,788,1662,912,2012
355270,202311,1706,4459,1101,3093,274,713,395,1038,669,1751
355280,202311,46623,104651,28289,68513,3763,9827,15714,34302,19477,44129
355290,202311,1366,3226,811,2136,164,410,372,891,536,1301
355300,202311,1931,4966,1360,3748,242,705,574,1344,816,2049
355310,202311,1175,2935,717,1997,92,285,363,919,455,1204
355320,202311,729,1802,409,1098,89,270,148,319,237,589
355330,202311,4193,9432,2676,6470,148,448,1945,4257,2093,4705
355340,202311,5351,11306,3187,7571,701,1674,1235,2960,1936,4634
355350,202311,1862,4734,1221,3399,254,793,550,1342,804,2135
355360,202311,1662,3840,1050,2724,165,463,516,1115,681,1578
355365,202311,434,986,171,473,41,95,51,132,92,227
355370,202311,7794,17649,5063,12647,1080,2362,2415,5968,3495,8330
355380,202311,3914,9479,2482,6560,456,1287,874,1903,1330,3190
355385,202311,1814,4289,1169,2988,127,346,646,1434,773,1780
355390,202311,928,2320,592,1597,107,308,271,584,378,892
355395,202311,2258,6076,1154,3446,192,634,454,1137,646,1771
355400,202311,13538,33996,9385,24988,1798,5302,4323,9662,6121,14964
355410,202311,33941,84361,20662,56073,4047,11507,8726,21018,12773,32525
355420,202311,760,2193,518,1631,124,418,141,387,265,805
355430,202311,4766,11070,2955,7350,567,1500,1537,3585,2104,5085
355440,202311,886,2178,422,1147,92,273,138,306,230,579
355450,202311,5097,11875,2740,6889,365,1017,1330,2759,1695,3776
355460,202311,614,1412,350,914,53,157,159,362,212,519
355465,202311,578,1347,386,1004,67,181,204,486,271,667
355470,202311,1565,3653,718,1941,200,576,238,577,438,1153
355475,202311,455,986,275,664,23,58,177,385,200,443
355480,202311,5627,14223,3890,10977,645,1934,2103,5458,2748,7392
355490,202311,1149,2911,515,1531,70,229,213,559,283,788
355495,202311,1328,3147,783,2147,105,340,361,787,466,1127
355500,202311,9584,22043,5110,12892,675,1900,2388,5154,3063,7054
355510,202311,1874,4291,1024,2632,182,489,464,1015,646,1504
355520,202311,396,898,178,512,24,61,30,83,54,144
355530,202311,375,811,149,379,8,24,91,199,99,223
355535,202311,721,1782,466,1258,106,336,197,405,303,741
355540,202311,18821,40477,13912,32469,1482,3735,9508,20648,10990,24383
355550,202311,835,2236,570,1669,75,241,284,723,359,964
355560,202311,1385,3358,670,1905,190,580,25,75,215,655
355570,202311,399,967,177,497,39,97,73,189,112,286
355580,202311,1551,3521,700,1850,129,357,122,276,251,633
355590,202311,199,492,128,355,15,42,67,156,82,198
355600,202311,1664,3961,949,2560,126,378,276,624,402,1002
355610,202311,2705,6154,1465,3734,325,834,613,1377,938,2211
355620,202311,7370,17401,4638,11672,643,1838,2623,5712,3266,7550
355630,202311,3504,8513,2110,5564,275,786,1237,2937,1512,3723
355635,202311,1416,3633,796,2251,114,341,324,790,438,1131
355640,202311,4593,11711,2657,7695,793,2312,456,1329,1249,3641
355645,202311,4764,12257,2820,8152,415,1294,1304,3330,1719,4624
355650,202311,11497,27225,7359,18677,1295,3400,3468,7873,4763,11273
355660,202311,1690,4306,780,2387,163,479,138,344,301,823
355670,202311,6527,15490,3711,9227,502,1435,1901,3978,2403,5413
355680,202311,3221,8393,1204,3598,313,991,131,349,444,1340
355690,202311,929,2544,526,1628,196,591,16,37,212,628
355695,202311,329,828,157,455,20,57,37,79,57,136
355700,202311,12675,31068,8952,22813,1118,3223,5134,11570,6252,14793
355710,202311,13661,30023,7744,18111,1257,3184,3881,7752,5138,10936
355715,202311,627,1592,282,797,69,189,88,205,157,394
355720,202311,1963,4809,1287,3457,259,701,609,1446,868,2147
355730,202311,1461,3539,921,2431,87,262,545,1298,632,1560
410010,202311,1524,3955,932,2611,215,596,220,543,435,1139
410020,202311,1492,3797,906,2514,277,761,233,565,510,1326
410030,202311,2263,5459,1566,4149,266,764,806,2039,1072,2803
410040,202311,20327,50485,12095,33442,2602,7434,3592,8833,6194,16267
410045,202311,882,2191,529,1430,132,362,142,329,274,691
410050,202311,2672,6601,1517,4249,269,837,411,965,680,1802
410060,202311,2627,6743,1759,4968,426,1318,581,1413,1007,2731
410070,202311,2482,5836,1275,3382,215,567,459,1058,674,1625
410080,202311,1777,4335,1060,2895,291,831,266,625,557,1456
410090,202311,1441,3150,947,2240,263,621,282,722,545,1343
410100,202311,2664,6953,1244,3575,211,670,81,218,292,888
410105,202311,762,1718,374,964,57,131,175,388,232,519
410110,202311,4068,8960,2504,6017,390,989,1420,3050,1810,4039
410115,202311,671,1626,376,1018,49,147,123,244,172,391
410120,202311,4363,9937,3311,8053,800,1623,1756,4256,2556,5879
410130,202311,1732,4061,1302,3181,265,719,718,1592,983,2311
410140,202311,23088,52017,12054,30722,2581,6824,3936,8749,6517,15573
410150,202311,20237,45156,8884,22446,1508,4156,3186,6705,4694,10861
410160,202311,3844,9948,2490,6984,587,1807,851,2113,1438,3920
410165,202311,781,1948,528,1385,96,289,245,562,341,851
410170,202311,3772,9002,1639,4260,330,882,406,917,736,1799
410180,202311,23620,59255,14152,38034,2638,7473,6205,14465,8843,21938
410185,202311,589,1562,350,1009,61,190,129,309,190,499
410190,202311,2781,6532,1501,3911,333,845,258,581,591,1426
410200,202311,7379,15733,3192,8090,783,2088,557,1103,1340,3191
410210,202311,3927,9320,1989,5515,351,1060,614,1384,965,2444
410220,202311,825,1976,372,937,87,219,115,247,202,466
410230,202311,2713,6558,1534,4003,243,665,671,1482,914,2147
410240,202311,6392,15842,3365,9376,764,2500,597,1394,1361,3894
410250,202311,2630,6001,1614,4089,234,620,713,1644,947,2264
410260,202311,2612,5926,1383,3578,305,805,622,1419,927,2224
410270,202311,639,1552,322,869,51,156,154,336,205,492
410275,202311,748,1922,389,1131,91,302,143,350,234,652
410280,202311,2918,7165,1527,4225,235,718,649,1514,884,2232
410290,202311,4158,10560,2400,6818,1001,2745,439,1217,1440,3962
410300,202311,870,1996,557,1395,70,215,276,579,346,794
410302,202311,410,972,212,598,36,106,83,210,119,316
410304,202311,1896,4140,1355,3169,182,435,702,1585,884,2020
410305,202311,2243,4988,1294,3372,187,535,752,1774,939,2309
410310,202311,4184,9482,2792,6799,218,675,1882,4107,2100,4782
410315,202311,892,1926,502,1246,141,356,153,335,294,691
410320,202311,1111,2991,525,1570,72,228,89,233,161,461
410322,202311,766,1968,278,817,40,110,78,171,118,281
410330,202311,1774,4142,943,2459,187,488,270,613,457,1101
410335,202311,1054,2648,593,1628,132,379,164,372,296,751
410337,202311,1006,2364,506,1301,76,207,179,388,255,595
410340,202311,595,1517,302,773,29,87,148,284,177,371
410345,202311,3681,8913,1731,4544,443,1136,617,1453,1060,2589
410347,202311,991,2382,536,1432,114,307,109,275,223,582
410350,202311,2063,4695,1154,3011,128,375,613,1362,741,1737
410360,202311,4933,11856,2758,7370,567,1581,733,1748,1300,3329
410370,202311,18836,46619,9297,23812,1349,3841,4023,8414,5372,12255
410380,202311,2250,5167,1135,2917,183,513,346,776,529,1289
410390,202311,3649,8014,2056,5130,438,1244,810,1663,1248,2907
410395,202311,1114,2962,729,2152,161,459,237,706,398,1165
410400,202311,10624,23931,6446,15622,684,1884,3929,8426,4613,10310
410405,202311,1160,2510,647,1656,78,247,323,732,401,979
410410,202311,2050,4828,1464,3721,135,373,936,2241,1071,2614
410420,202311,16959,40947,10157,26462,1833,5057,4473,10026,6306,15083
410425,202311,5069,12639,2898,7971,549,1567,989,2366,1538,3933
410430,202311,17476,39923,9379,23635,1587,4321,3719,8181,5306,12502
410440,202311,3110,7871,2303,6186,449,1163,1144,2857,1593,4020
410442,202311,3275,8728,2046,5883,526,1526,359,884,885,2410
410445,202311,2863,7473,1591,4836,390,1285,154,462,544,1747
410450,202311,2099,4792,1164,3087,221,613,312,695,533,1308
410460,202311,3418,7550,1933,4687,332,859,944,2011,1276,2870
410465,202311,3786,9959,2115,6093,574,1642,450,1050,1024,2692
410470,202311,3130,7917,1868,5459,702,2326,114,302,816,2628
410480,202311,54638,122097,24476,64838,4057,11457,7798,17482,11855,28939
410490,202311,15442,38287,9073,24121,1632,4681,4356,10138,5988,14819
410500,202311,2318,5607,1144,3183,227,598,185,407,412,1005
410510,202311,2281,5224,1221,3096,297,704,381,936,678,1640
410520,202311,3939,10799,3098,8998,973,2949,1109,3021,2082,5970
410530,202311,1847,4355,605,1633,74,210,163,350,237,560
410540,202311,3622,8777,2015,5401,402,1150,872,2040,1274,3190
410550,202311,9804,24446,5244,14099,915,2651,1622,3474,2537,6125
410560,202311,1869,4528,1013,2681,198,593,251,513,449,1106
410570,202311,3501,8539,1963,5556,695,2229,170,395,865,2624
410580,202311,38356,90072,23765,61373,4211,11378,10629,24493,14840,35871
410590,202311,2125,5468,1180,3257,199,578,323,702,522,1280
410600,202311,2328,5486,1563,4008,373,910,633,1509,1006,2419
410610,202311,886,2091,526,1367,52,153,265,608,317,761
410620,202311,3836,9304,2354,6101,560,1503,781,1867,1341,3370
410630,202311,2868,6947,1527,4157,317,948,222,426,539,1374
410640,202311,5788,12819,3373,8245,862,2197,643,1478,1505,3675
410645,202311,1808,4087,1222,3145,127,371,796,1938,923,2309
410650,202311,3436,8484,1767,4839,425,1150,618,1503,1043,2653
410655,202311,1089,2477,532,1358,148,359,159,369,307,728
410657,202311,746,1873,385,1042,62,192,189,420,251,612
410660,202311,4799,11014,2268,5682,377,1009,834,1790,1211,2799
410670,202311,1209,2871,539,1440,84,253,190,426,274,679
410680,202311,3076,8423,1905,5624,589,1718,515,1464,1104,3182
410685,202311,658,1581,396,1072,104,301,137,317,241,618
410690,202311,191003,430306,105979,259892,18445,48511,43623,90501,62068,139012
410700,202311,3106,7350,2011,5209,507,1343,693,1581,1200,2924
410710,202311,1138,2682,565,1520,157,446,207,470,364,916
410712,202311,1119,2853,543,1546,101,278,223,593,324,871
410715,202311,1091,2884,556,1659,76,245,226,620,302,865
410720,202311,5035,11572,3117,7793,534,1611,1110,2455,1644,4066
410725,202311,1483,3411,702,1876,168,459,166,393,334,852
410730,202311,1160,2726,602,1600,103,332,121,262,224,594
410740,202311,1068,2759,572,1664,51,171,309,835,360,1006
410750,202311,2489,5594,1508,3655,249,645,629,1384,878,2029
410752,202311,485,1129,194,538,79,196,23,62,102,258
410753,202311,432,1163,205,626,29,90,59,156,88,246
410754,202311,1497,3287,992,2427,95,260,684,1604,779,1864
410755,202311,670,1625,384,1032,57,177,168,379,225,556
410760,202311,4438,10841,2601,7191,845,2696,513,1196,1358,3892
410765,202311,25715,62633,16089,42279,3336,9464,5557,12219,8893,21683
410770,202311,1241,2829,672,1760,77,175,306,731,383,906
410773,202311,1672,3987,1151,2977,284,743,533,1216,817,1959
410775,202311,2111,4223,1533,3234,55,152,1189,2297,1244,2449
410780,202311,732,1724,397,1034,56,147,142,323,198,470
410785,202311,1058,2354,633,1619,117,350,325,756,442,1106
410790,202311,1547,4166,973,2843,208,664,231,567,439,1231
410800,202311,4368,8584,2447,5157,102,269,1776,3430,1878,3699
410810,202311,575,1439,331,920,40,102,150,378,190,480
410820,202311,1289,3350,531,1490,116,334,118,268,234,602
410830,202311,61586,132953,36547,86924,6022,15542,18321,38686,24343,54228
410832,202311,1380,3359,842,2232,98,296,447,1003,545,1299
410840,202311,11779,27782,5222,14146,1494,3965,858,1903,2352,5868
410845,202311,1539,3242,1012,2356,110,325,668,1410,778,1735
410850,202311,2676,6893,1908,5273,440,1264,811,2111,1251,3375
410855,202311,884,2086,473,1262,79,235,201,442,280,677
410860,202311,6316,13410,4140,9377,204,583,2903,5860,3107,6443
410865,202311,1800,4576,1303,3608,275,757,598,1701,873,2458
410870,202311,1458,3685,928,2636,148,472,455,1152,603,1624
410880,202311,6143,14974,3300,9345,545,1639,504,1481,1049,3120
410890,202311,1511,3753,964,2564,199,497,447,1093,646,1590
410895,202311,1243,3584,901,2793,255,861,261,710,516,1571
410900,202311,1097,2751,573,1654,118,384,108,239,226,623
410910,202311,547,1194,253,606,17,49,148,316,165,365
410920,202311,1189,2571,627,1492,52,144,404,877,456,1021
410930,202311,2269,5373,1217,3390,268,824,181,400,449,1224
410940,202311,33452,81816,19844,54128,4294,12725,7862,18930,12156,31655
410950,202311,2507,6198,2010,5285,209,484,1439,3622,1648,4106
410960,202311,11605,25620,7228,18038,2298,6023,2204,4855,4502,10878
410965,202311,1394,3361,647,1800,122,336,231,564,353,900
410970,202311,5540,13789,3055,8409,813,2613,565,1146,1378,3759
410975,202311,1889,4251,1013,2602,249,641,331,769,580,1410
410980,202311,9991,22675,5495,13942,683,1988,2767,5994,3450,7982
410990,202311,1988,4274,1199,2944,259,666,550,1282,809,1948
411000,202311,855,2176,467,1344,99,289,137,330,236,619
411005,202311,616,1430,271,705,39,99,104,219,143,318
411007,202311,3199,7677,1864,4977,376,1118,670,1511,1046,2629
411010,202311,6176,16073,3528,10112,927,2729,773,1784,1700,4513
411020,202311,2973,7550,1990,5598,586,1690,568,1515,1154,3205
411030,202311,844,1977,434,1106,47,125,186,390,233,515
411040,202311,1279,3030,508,1357,87,211,160,375,247,586
411050,202311,2580,7356,1669,5253,373,1234,257,641,630,1875
411060,202311,3018,7253,1509,3967,307,881,555,1169,862,2050
411065,202311,478,1144,223,605,20,57,91,222,111,279
411070,202311,10147,23098,6379,15870,1211,3121,2891,6437,4102,9558
411080,202311,2677,6372,1615,4238,392,1114,546,1195,938,2309
411090,202311,986,2542,452,1321,62,215,132,324,194,539
411095,202311,2963,6741,1180,3132,244,627,177,382,421,1009
411100,202311,1490,3575,776,2107,170,534,243,552,413,1086
411110,202311,779,1946,271,796,32,88,27,50,59,138
411120,202311,2185,5228,1259,3341,219,678,509,1134,728,1812
411125,202311,7067,18325,4792,13399,1471,4142,1491,3797,2962,7939
411130,202311,941,2292,503,1351,143,382,129,330,272,712
411140,202311,2718,7741,1775,5503,471,1476,445,1341,916,2817
411150,202311,5219,12236,2698,6949,594,1579,229,503,823,2082
411155,202311,1415,3224,761,1882,127,358,411,857,538,1215
411160,202311,514,1084,258,661,41,114,73,185,114,299
411170,202311,996,2573,655,1852,139,434,312,803,451,1237
411180,202311,7070,16309,4860,11933,773,2085,2557,5474,3330,7559
411190,202311,2827,6703,1566,4031,219,600,701,1579,920,2179
411200,202311,6489,15861,4056,10741,905,2651,1366,2947,2271,5598
411210,202311,4547,9684,2356,5499,265,740,1177,2329,1442,3069
411220,202311,1247,2856,658,1695,129,352,250,545,379,897
411230,202311,1047,2613,598,1663,122,336,141,346,263,682
411240,202311,1915,4245,1040,2576,236,604,338,737,574,1341
411250,202311,2883,6993,1627,4461,462,1296,383,891,845,2187
411260,202311,408,976,209,559,24,75,98,200,122,275
411270,202311,2610,6416,1517,4105,227,638,707,1694,934,2332
411275,202311,2090,4288,1164,2647,112,324,651,1225,763,1549
411280,202311,1976,4870,1107,2988,258,716,385,879,643,1595
411290,202311,1036,2489,553,1485,72,209,258,622,330,831
411295,202311,1625,3873,923,2430,187,484,313,705,500,1189
411300,202311,1235,2965,539,1440,69,216,201,400,270,616
411310,202311,1248,2540,727,1666,130,317,366,727,496,1044
411320,202311,7527,17158,4686,11539,772,2093,2133,4371,2905,6464
411325,202311,1951,4764,1400,3705,220,600,793,2044,1013,2644
411330,202311,4031,9943,2589,7198,718,2133,625,1601,1343,3734
411340,202311,987,2523,444,1248,78,211,162,396,240,607
411342,202311,1280,2947,556,1458,164,442,172,359,336,801
411345,202311,1497,3467,879,2288,76,207,554,1342,630,1549
411350,202311,3810,9514,1922,5462,446,1344,212,480,658,1824
411360,202311,851,1985,516,1292,82,239,206,451,288,690
411370,202311,77910,177647,45567,114331,4742,13146,25872,57593,30614,70739
411373,202311,1789,4066,1156,2915,209,513,470,1143,679,1656
411375,202311,1342,3156,655,1732,127,332,203,451,330,783
411380,202311,1505,3256,710,1636,44,119,449,913,493,1032
411390,202311,1953,4811,1168,2992,211,614,492,1031,703,1645
411400,202311,2988,6744,1797,4436,227,621,969,2131,1196,2752
411410,202311,3995,10391,2200,6286,592,1714,499,1178,1091,2892
411420,202311,5329,12343,2042,5561,329,973,391,751,720,1724
411430,202311,5448,12791,3483,8895,706,1998,1244,2604,1950,4602
411435,202311,553,1380,227,646,41,116,33,61,74,177
411440,202311,3503,8582,2070,5638,626,1619,464,1165,1090,2784
411450,202311,3163,7735,2049,5532,362,911,1090,2857,1452,3768
411460,202311,5865,14077,2689,7459,431,1313,729,1623,1160,2936
411470,202311,1204,2675,786,1930,59,196,519,1124,578,1320
411480,202311,7184,17563,3832,10542,770,2309,1138,2759,1908,5068
411490,202311,2165,4920,1348,3409,189,548,727,1635,916,2183
411500,202311,1751,4275,923,2405,201,563,273,534,474,1097
411510,202311,2829,6435,1699,4277,355,1038,437,1005,792,2043
411520,202311,48335,109931,22253,56047,2949,8380,10295,21832,13244,30212
411530,202311,1162,2786,512,1442,115,341,128,304,243,645
411535,202311,653,1812,312,986,39,131,78,206,117,337
411540,202311,3566,7898,1885,4632,199,542,1048,2355,1247,2897
411545,202311,1102,2901,802,2267,74,223,492,1343,566,1566
411550,202311,833,1955,538,1335,109,290,202,427,311,717
411560,202311,2396,6329,932,2836,148,482,66,156,214,638
411570,202311,10031,21472,5879,14373,1361,3512,2065,4550,3426,8062
411573,202311,982,2396,690,1813,98,318,388,894,486,1212
411575,202311,2612,6298,1565,4149,331,956,571,1358,902,2314
411580,202311,5581,12990,2598,7224,416,1307,488,978,904,2285
411585,202311,725,2040,258,822,32,101,24,47,56,148
411590,202311,608,1480,340,903,47,143,168,368,215,511
411600,202311,438,999,197,524,43,106,64,146,107,252
411605,202311,2036,4380,992,2514,119,373,489,1194,608,1567
411610,202311,3660,7394,2134,4597,88,245,1566,3009,1654,3254
411620,202311,3842,8915,2703,6837,621,1604,1079,2622,1700,4226
411630,202311,1098,2601,577,1556,75,240,266,590,341,830
411640,202311,571,1453,279,745,38,97,86,204,124,301
411650,202311,246,658,133,398,22,65,38,83,60,148
411660,202311,1055,2532,554,1463,94,273,217,468,311,741
411670,202311,1952,4291,1062,2617,135,360,539,1181,674,1541
411680,202311,1775,4274,1030,2758,211,590,380,928,591,1518
411690,202311,5152,11933,2903,7465,631,1612,988,2288,1619,3900
411695,202311,834,2269,451,1296,49,143,202,535,251,678
411700,202311,2038,4867,1079,2850,266,689,274,607,540,1296
411705,202311,3201,7803,2320,6134,402,1112,1339,3446,1741,4558
411710,202311,2758,6415,1449,3735,312,849,513,1090,825,1939
411720,202311,1274,2982,656,1724,115,298,187,432,302,730
411721,202311,1245,2910,758,1954,152,378,209,501,361,879
411722,202311,1254,3285,554,1628,95,269,169,422,264,691
411725,202311,1603,4232,828,2547,230,787,151,376,381,1163
411727,202311,1834,4672,1015,2898,236,693,122,217,358,910
411729,202311,725,1758,342,962,87,287,78,150,165,437
411730,202311,7283,17428,4482,11687,1167,3279,1523,3626,2690,6905
411740,202311,586,1428,262,739,76,195,43,99,119,294
411745,202311,942,2482,512,1485,77,247,122,290,199,537
411750,202311,8815,20823,4944,12926,729,2022,2260,5420,2989,7442
411760,202311,9823,22988,6014,15990,2025,5414,1210,3203,3235,8617
411770,202311,4005,10624,2372,6739,532,1606,536,1287,1068,2893
411780,202311,3171,8383,2251,6572,662,1959,458,1384,1120,3343
411790,202311,4164,9337,2072,5282,333,901,733,1522,1066,2423
411800,202311,1520,4041,874,2423,170,532,276,635,446,1167
411810,202311,1990,4742,1095,2781,234,597,403,913,637,1510
411820,202311,23433,54726,17338,43193,4066,9943,8686,20624,12752,30567
411830,202311,545,1355,309,843,64,163,71,159,135,322
411840,202311,16806,40167,8953,23472,1554,4249,3497,7760,5051,12009
411845,202311,819,2171,378,1137,73,244,84,211,157,455
411850,202311,10485,25018,5388,14613,1483,4313,831,1643,2314,5956
411860,202311,972,2538,565,1619,167,453,94,242,261,695
411870,202311,757,1985,465,1327,132,426,102,208,234,634
411880,202311,3097,6756,1816,4421,368,908,751,1607,1119,2515
411885,202311,1297,3216,650,1807,95,287,169,386,264,673
411890,202311,1888,4655,1108,3067,236,671,147,380,383,1051
411900,202311,1099,2820,497,1491,176,528,20,62,196,590
411910,202311,1464,3942,872,2614,181,614,293,733,474,1347
411915,202311,21647,49054,11972,29630,1869,4926,5229,10934,7098,15860
411920,202311,1538,3946,1034,2892,270,814,383,918,653,1732
411925,202311,623,1495,368,988,106,276,132,330,238,606
411930,202311,6670,17728,4786,13827,2451,7346,444,1355,2895,8701
411940,202311,4224,11038,2740,7665,663,1868,916,2205,1579,4073
411950,202311,20671,49921,14374,37311,1949,5459,7914,18545,9863,24004
411960,202311,7559,18161,4764,12325,1205,3271,1724,3828,2929,7099
411965,202311,656,1659,351,985,59,163,151,344,210,507
411970,202311,1465,2984,829,1917,154,292,357,882,511,1174
411980,202311,2175,4678,1210,2986,359,832,351,844,710,1676
411990,202311,53307,127016,29466,79441,5854,16560,11420,26965,17274,43525
411995,202311,6779,14939,4399,10833,1352,3599,1196,2688,2548,6287
412000,202311,2558,5264,1468,3218,67,200,1074,2074,1141,2274
412010,202311,792,2148,367,1055,40,131,124,283,164,414
412015,202311,629,1624,441,1248,130,371,157,441,287,812
412020,202311,574,1546,291,936,44,157,78,209,122,366
412030,202311,793,2056,509,1442,111,305,211,545,322,850
412033,202311,1137,2788,558,1505,69,201,244,573,313,774
412035,202311,866,2201,429,1289,102,289,145,401,247,690
412040,202311,897,2212,417,1132,63,175,163,372,226,547
412050,202311,1716,4071,999,2667,308,881,154,396,462,1277
412060,202311,9228,23792,6069,16991,1897,5721,1410,3329,3307,9050
412065,202311,765,1910,390,1101,71,215,103,248,174,463
412070,202311,1741,3987,1064,2609,120,325,536,1050,656,1375
412080,202311,3594,8448,2103,5276,294,754,1076,2284,1370,3038
412085,202311,433,1018,118,355,16,52,32,76,48,128
412090,202311,8388,19009,5054,12867,1172,3233,2046,4968,3218,8201
412100,202311,2421,5881,1452,4090,422,1260,252,711,674,1971
412110,202311,1201,2961,584,1610,87,260,161,359,248,619
412120,202311,3004,7561,1946,5444,432,1313,559,1299,991,2612
412125,202311,1033,2662,441,1298,71,215,107,269,178,484
412130,202311,981,2280,476,1264,115,314,126,309,241,623
412135,202311,669,1668,272,763,37,108,114,266,151,374
412140,202311,2621,5917,1395,3506,279,714,310,751,589,1465
412150,202311,3509,8198,2419,6044,763,1894,920,2032,1683,3926
412160,202311,1232,3557,399,1324,33,120,27,60,60,180
412170,202311,5945,14415,4262,11160,909,2476,1987,4606,2896,7082
412175,202311,1629,4332,1117,3221,261,762,333,912,594,1674
412180,202311,2146,5479,1209,3476,261,801,374,908,635,1709
412190,202311,3877,9306,2144,5783,335,995,881,2128,1216,3123
412200,202311,2455,6440,1394,3967,421,1237,171,429,592,1666
412210,202311,781,1801,373,1008,54,151,163,378,217,529
412215,202311,4185,10166,2573,7016,537,1514,1080,2887,1617,4401
412217,202311,1282,2918,906,2199,23,74,683,1513,706,1587
412220,202311,7739,20695,4643,13629,1115,3172,955,2606,2070,5778
412230,202311,3603,9398,2073,5915,366,1141,577,1383,943,2524
412240,202311,10602,25745,5136,14000,988,2887,1612,3441,2600,6328
412250,202311,2379,5797,1364,3725,387,1068,193,424,580,1492
412260,202311,1729,4070,888,2212,179,442,321,699,500,1141
412265,202311,1337,3146,859,2232,114,319,505,1189,619,1508
412270,202311,1446,3708,767,2139,79,237,334,787,413,1024
412280,202311,525,1366,301,862,72,198,64,155,136,353
412290,202311,1357,3119,830,2116,144,387,357,828,501,1215
412300,202311,2414,5567,1403,3603,288,804,474,1052,762,1856
412310,202311,783,2130,426,1328,76,257,115,280,191,537
412320,202311,872,2107,466,1278,59,212,151,358,210,570
412330,202311,2022,4890,1104,3037,274,805,295,715,569,1520
412340,202311,1560,3844,845,2360,126,385,72,180,198,565
412350,202311,3940,9911,1892,5435,317,991,584,1347,901,2338
412360,202311,385,891,226,566,17,55,143,318,160,373
412370,202311,1570,3801,802,2193,161,464,183,440,344,904
412380,202311,1759,4554,1006,2891,245,764,69,170,314,934
412382,202311,640,1464,362,941,43,138,178,388,221,526
412385,202311,3008,7117,2007,5173,647,1649,569,1504,1216,3153
412390,202311,3124,7107,1763,4520,391,967,504,1209,895,2176
412395,202311,942,2339,538,1437,69,180,263,648,332,828
412400,202311,1193,2835,680,1796,130,387,223,459,353,846
412402,202311,3178,7259,1692,4421,387,947,555,1411,942,2358
412405,202311,3904,9840,1936,5664,610,1722,316,840,926,2562
412410,202311,8503,20497,4933,13615,943,2829,1665,4028,2608,6857
412420,202311,650,1545,303,799,40,122,112,249,152,371
412430,202311,642,1553,254,692,51,131,87,228,138,359
412440,202311,3786,9076,2143,5783,480,1310,656,1644,1136,2954
412450,202311,678,1839,332,961,37,121,42,83,79,204
412460,202311,1472,3349,861,2145,197,502,330,748,527,1250
412470,202311,2025,5695,1508,4527,379,1224,433,1141,812,2365
412480,202311,1854,4207,945,2292,182,485,340,683,522,1168
412490,202311,1629,3720,993,2480,91,249,549,1196,640,1445
412500,202311,2584,5997,1413,3613,271,718,435,924,706,1642
412510,202311,2375,6600,1438,4322,342,1129,199,422,541,1551
412520,202311,1754,4208,812,2222,150,410,74,185,224,595
412530,202311,861,2162,422,1178,96,238,82,216,178,454
412535,202311,992,2487,457,1308,85,257,61,121,146,378
412540,202311,1262,3145,728,2091,158,554,133,312,291,866
412545,202311,947,2292,476,1319,84,235,158,414,242,649
412550,202311,50298,120688,28529,73599,4193,11820,13253,29455,17446,41275
412555,202311,373,888,161,402,17,44,62,115,79,159
412560,202311,7046,17951,4114,11260,1167,3514,550,1189,1717,4703
412570,202311,5475,12528,2724,7101,582,1730,757,1638,1339,3368
412575,202311,1463,3281,943,2293,286,686,370,750,656,1436
412580,202311,2009,4592,1072,2699,139,330,568,1266,707,1596
412590,202311,562,1397,247,706,57,148,32,67,89,215
412600,202311,2183,5007,1478,3583,96,305,957,2032,1053,2337
412610,202311,1029,2583,537,1433,106,268,192,445,298,713
412620,202311,1709,3956,1094,2794,227,605,503,1161,730,1766
412625,202311,13845,34057,7498,20726,1523,4509,1880,4338,3403,8847
412627,202311,1376,3588,716,2123,165,505,174,447,339,952
412630,202311,3362,9156,1761,5308,325,1044,391,987,716,2031
412635,202311,653,1558,307,825,114,308,34,68,148,376
412640,202311,1170,2987,530,1512,70,214,117,263,187,477
412650,202311,2177,5408,1320,3524,247,688,477,1117,724,1805
412660,202311,3727,8626,2149,5443,286,794,813,1749,1099,2543
412665,202311,537,1227,319,805,72,189,112,243,184,432
412667,202311,2071,5133,1221,3367,241,711,460,1176,701,1887
412670,202311,1171,2482,642,1542,104,270,274,564,378,834
412680,202311,2778,6737,1362,3679,230,719,419,876,649,1595
412690,202311,1433,3413,778,2048,162,445,256,570,418,1015
412700,202311,2188,5377,1484,3929,348,967,623,1508,971,2475
412710,202311,6840,18084,3983,11407,819,2489,1113,2561,1932,5050
412720,202311,1664,4504,1059,3009,185,556,253,537,438,1093
412730,202311,3477,8244,2018,5162,296,882,1038,2308,1334,3190
412740,202311,2640,6810,1356,4020,262,859,256,725,518,1584
412750,202311,4986,12214,3271,8839,550,1655,1600,3815,2150,5470
412760,202311,4072,9777,2765,7202,563,1603,1364,3183,1927,4786
412770,202311,16342,39678,7098,20270,1054,3206,1839,4169,2893,7375
412780,202311,1596,3840,951,2554,251,772,253,530,504,1302
412785,202311,2824,6050,1678,4092,334,875,879,1924,1213,2799
412788,202311,1739,4484,1191,3389,351,969,404,1034,755,2003
412790,202311,1759,4251,890,2445,170,489,323,700,493,1189
412795,202311,1509,3629,678,1931,131,338,160,419,291,757
412796,202311,2788,7407,1864,5365,486,1342,487,1297,973,2639
412800,202311,5475,11719,3122,7233,335,960,1760,3427,2095,4387
412810,202311,17821,41626,9327,23931,1146,3267,4408,9640,5554,12907
412820,202311,7998,20315,4525,12828,1195,3407,998,2638,2193,6045
412830,202311,490,1228,261,704,51,138,87,194,138,332
412840,202311,2532,5294,1553,3422,131,357,1018,1938,1149,2295
412850,202311,3511,8359,2294,6106,277,858,1253,2916,1530,3774
412853,202311,2055,4517,1431,3255,188,478,817,1641,1005,2119
412855,202311,1698,4130,683,1896,111,326,150,320,261,646
412860,202311,987,2296,529,1427,101,316,204,456,305,772
412862,202311,815,1982,469,1321,83,250,216,536,299,786
412863,202311,1654,4374,1250,3512,274,851,593,1445,867,2296
412865,202311,795,2064,491,1397,123,366,90,229,213,595
412870,202311,1251,3018,726,2030,234,689,164,413,398,1102
412880,202311,1265,3204,721,2092,153,455,242,627,395,1082
420005,202311,598,1616,284,851,37,108,120,349,157,457
420010,202311,3858,8841,2172,5747,210,600,1395,3495,1605,4095
420020,202311,537,1564,345,1082,61,200,83,197,144,397
420030,202311,181,621,111,426,31,119,26,99,57,218
420040,202311,742,2134,321,1084,54,193,25,60,79,253
420050,202311,998,2373,526,1339,99,281,268,567,367,848
420055,202311,263,720,104,318,17,54,38,99,55,153
420060,202311,335,872,227,622,32,99,109,265,141,364
420070,202311,1148,3118,781,2327,155,491,395,1067,550,1558
420075,202311,95,248,48,141,7,25,15,26,22,51
420080,202311,537,1460,283,808,61,176,66,161,127,337
420090,202311,592,1692,314,1022,75,259,72,183,147,442
420100,202311,1894,4278,1267,3126,163,400,702,1650,865,2050
420110,202311,388,1141,272,864,44,142,113,319,157,461
420120,202311,846,2194,431,1237,71,222,162,360,233,582
420125,202311,502,1459,273,900,62,195,76,209,138,404
420127,202311,406,1043,139,424,14,48,54,139,68,187
420130,202311,7038,18229,4351,12490,875,2774,1558,3632,2433,6406
420140,202311,6621,16308,4147,11384,1101,3323,1068,2433,2169,5756
420150,202311,885,2193,504,1404,61,200,252,625,313,825
420160,202311,269,658,82,244,9,27,25,70,34,97
420165,202311,227,671,95,322,8,26,31,94,39,120
420170,202311,459,1259,321,962,44,156,166,425,210,581
420180,202311,190,579,85,295,13,51,25,77,38,128
420190,202311,275,748,137,411,27,75,40,100,67,175
420195,202311,2852,6854,1842,4900,272,811,993,2337,1265,3148
420200,202311,11617,25580,5912,14485,828,2230,2478,4938,3306,7168
420205,202311,2886,7027,1610,4386,256,755,770,1846,1026,2601
420207,202311,3157,7451,1756,4707,366,1067,663,1536,1029,2603
420208,202311,465,1265,204,650,71,237,44,109,115,346
420209,202311,233,678,109,336,17,65,56,142,73,207
420210,202311,6471,15444,3902,10433,628,1816,1889,4470,2517,6286
420213,202311,993,2746,672,2009,124,384,239,654,363,1038
420215,202311,314,856,177,529,45,145,40,104,85,249
420220,202311,473,1333,255,804,49,179,89,203,138,382
420230,202311,8841,21306,5575,14524,820,2259,2842,6518,3662,8777
420240,202311,22268,57463,11656,32080,1681,5047,4924,10945,6605,15992
420243,202311,693,1589,480,1202,115,287,254,610,369,897
420245,202311,2914,6797,1892,4855,213,609,1094,2484,1307,3093
420250,202311,933,2047,683,1613,62,174,474,1028,536,1202
420253,202311,579,1366,332,900,53,140,182,461,235,601
420257,202311,219,531,120,343,15,57,55,134,70,191
420260,202311,1613,3787,1014,2782,95,296,636,1621,731,1917
420270,202311,810,2038,283,751,38,102,130,312,168,414
420280,202311,2239,5862,1413,3983,214,711,594,1433,808,2144
420285,202311,110,311,75,244,12,45,12,20,24,65
420287,202311,600,1319,320,832,52,150,137,320,189,470
420290,202311,7753,20136,4699,13002,770,2348,2265,5320,3035,7668
420300,202311,11126,29152,4965,14270,1043,3055,1590,3849,2633,6904
420310,202311,942,2114,432,1156,47,125,150,366,197,491
420315,202311,1226,3151,616,1831,98,306,289,779,387,1085
420320,202311,9059,22688,5610,16009,1518,4409,1442,3723,2960,8132
420325,202311,422,1150,238,728,36,125,73,167,109,292
420330,202311,1523,4149,760,2311,173,532,187,489,360,1021
420340,202311,1829,4172,1130,2824,253,666,497,1074,750,1740
420350,202311,1844,4012,1228,2898,196,450,753,1678,949,2128
420360,202311,3957,10309,1631,4919,259,870,150,399,409,1269
420370,202311,1995,4637,1466,3669,108,349,1071,2458,1179,2807
420380,202311,6072,14871,3541,9577,689,2017,1553,3669,2242,5686
420390,202311,1519,3713,821,2180,145,419,270,499,415,918
420395,202311,1834,4771,1002,2919,178,544,199,447,377,991
420400,202311,1633,4026,902,2470,146,430,463,1112,609,1542
420410,202311,746,1856,399,1105,75,232,178,444,253,676
420415,202311,469,1245,268,767,49,169,110,280,159,449
420417,202311,825,2275,495,1495,117,333,188,580,305,913
420419,202311,154,497,90,320,25,92,5,21,30,113
420420,202311,21324,52431,11722,32481,2974,8849,3082,7089,6056,15938
420425,202311,850,2230,463,1318,69,219,199,478,268,697
420430,202311,4644,11654,2383,6681,373,1144,923,2111,1296,3255
420435,202311,470,1183,229,689,46,134,104,299,150,433
420440,202311,1123,2815,602,1653,210,534,156,424,366,958
420445,202311,258,640,149,410,35,102,36,71,71,173
420450,202311,1181,3183,665,1925,136,412,259,614,395,1026
420455,202311,2821,6297,1714,4338,514,1258,537,1343,1051,2601
420460,202311,14231,34567,8929,23637,1465,4261,4355,9885,5820,14146
420470,202311,958,2388,421,1130,62,177,139,289,201,466
420475,202311,97,246,33,100,5,21,11,24,16,45
420480,202311,7530,17685,4016,10861,848,2333,1421,3556,2269,5889
420490,202311,538,1435,298,852,49,158,122,312,171,470
420500,202311,1809,4678,1025,3094,208,695,429,1138,637,1833
420510,202311,160,464,90,276,16,55,29,61,45,116
420515,202311,182,532,97,302,10,43,35,82,45,125
420517,202311,957,2227,648,1589,91,224,371,851,462,1075
420519,202311,382,957,203,593,30,93,89,240,119,333
420520,202311,361,936,149,477,17,65,3,7,20,72
420530,202311,976,2856,485,1544,97,324,146,363,243,687
420535,202311,283,791,76,250,12,39,19,51,31,90
420540,202311,58460,129391,32861,79857,4576,12392,13799,27201,18375,39593
420543,202311,329,913,179,544,32,113,67,171,99,284
420545,202311,2294,6355,1401,4143,239,749,599,1503,838,2252
420550,202311,5860,14038,2900,7979,525,1509,1130,2722,1655,4231
420555,202311,438,1179,239,716,32,106,126,334,158,440
420560,202311,570,1231,331,825,50,133,157,370,207,503
420570,202311,4472,10549,2832,7305,569,1508,1290,3044,1859,4552
420580,202311,2348,6403,1263,4022,260,836,311,851,571,1687
420590,202311,4641,11781,2515,6941,482,1429,740,1583,1222,3012
420600,202311,2008,4988,1309,3508,105,342,847,2066,952,2408
420610,202311,810,2080,424,1237,73,200,199,525,272,725
420620,202311,1119,2769,577,1665,99,303,201,524,300,827
420630,202311,1452,4113,915,2769,182,608,327,841,509,1449
420640,202311,643,1683,241,767,44,148,25,61,69,209
420650,202311,4935,11966,2715,7075,468,1354,1120,2437,1588,3791
420660,202311,599,1452,261,712,48,128,36,63,84,191
420665,202311,968,2357,492,1351,100,283,160,333,260,616
420670,202311,1619,4440,776,2438,111,410,165,401,276,811
420675,202311,295,742,166,499,18,72,98,255,116,327
420680,202311,354,808,160,471,24,82,74,179,98,261
420690,202311,1248,3356,637,1855,104,326,202,438,306,764
420700,202311,4502,11011,2932,7817,316,971,1821,4445,2137,5416
420710,202311,1477,4096,1087,3171,169,547,521,1253,690,1800
420720,202311,1820,4477,1202,3219,182,550,691,1653,873,2203
420730,202311,5258,12698,3440,9069,684,2001,1492,3386,2176,5387
420740,202311,566,1546,286,857,63,207,96,258,159,465
420750,202311,3144,8540,1692,4978,316,1039,529,1249,845,2288
420757,202311,168,424,72,222,12,39,27,73,39,112
420760,202311,486,1335,188,557,40,119,58,147,98,266
420765,202311,830,2157,320,926,52,177,150,370,202,547
420768,202311,1866,4634,1276,3441,183,456,739,1916,922,2372
420770,202311,266,784,93,348,11,54,11,24,22,78
420775,202311,396,994,197,592,40,118,59,149,99,267
420780,202311,1317,3505,581,1707,130,367,106,286,236,653
420785,202311,286,725,150,397,14,48,69,141,83,189
420790,202311,1475,3912,1018,2880,281,919,473,1109,754,2028
420800,202311,1031,2386,498,1354,105,291,229,567,334,858
420810,202311,1707,4764,1258,3754,328,1018,408,1014,736,2032
420820,202311,20116,47951,12140,32305,1754,5052,5822,13407,7576,18459
420830,202311,7210,17324,4226,11450,913,2682,1532,3631,2445,6313
420840,202311,814,2483,334,1192,65,266,48,143,113,409
420845,202311,4334,10372,2578,7036,505,1557,1057,2591,1562,4148
420850,202311,1383,3911,860,2615,162,518,271,652,433,1170
420860,202311,474,1228,238,745,79,243,54,141,133,384
420870,202311,1050,2801,591,1769,124,416,189,486,313,902
420880,202311,1635,4534,1079,3256,267,875,390,973,657,1848
420890,202311,10713,27570,5557,16004,1016,3121,1924,4496,2940,7617
420895,202311,261,725,123,376,22,64,54,151,76,215
420900,202311,2319,5444,1032,2871,144,457,415,916,559,1373
420910,202311,48841,120713,27908,76612,4871,14372,11528,26513,16399,40885
420915,202311,580,2027,444,1673,68,263,197,700,265,963
420917,202311,620,1513,219,565,43,96,90,211,133,307
420920,202311,127,330,37,117,6,22,5,9,11,31
420930,202311,25640,59074,15479,39392,2246,6264,7853,17546,10099,23810
420940,202311,5250,12027,2871,7454,613,1824,928,1771,1541,3595
420945,202311,270,798,101,316,13,41,35,95,48,136
420950,202311,570,1503,297,875,61,202,85,209,146,411
420960,202311,1425,3356,783,2058,127,369,306,682,433,1051
420970,202311,2942,7425,1682,4879,354,1006,462,1321,816,2327
420980,202311,321,1052,231,819,61,228,27,81,88,309
420985,202311,494,1280,201,631,36,108,45,117,81,225
420990,202311,490,1429,251,821,51,171,41,101,92,272
421000,202311,764,2220,421,1352,109,347,65,150,174,497
421003,202311,493,1184,102,291,14,41,8,15,22,56
421005,202311,137,387,81,249,13,45,22,64,35,109
421010,202311,5354,13030,3223,8764,518,1615,1318,2861,1836,4476
421020,202311,535,1533,346,1075,53,194,178,463,231,657
421030,202311,1380,3652,899,2590,194,567,308,800,502,1367
421040,202311,912,2179,421,1222,53,167,218,559,271,726
421050,202311,1639,4295,806,2283,173,493,225,520,398,1013
421055,202311,190,546,99,301,18,57,43,120,61,177
421060,202311,990,2689,603,1795,108,338,249,623,357,961
421070,202311,887,2398,440,1309,95,288,173,446,268,734
421080,202311,666,1790,423,1247,71,248,166,400,237,648
421085,202311,398,1103,117,396,12,36,15,37,27,73
421090,202311,384,969,171,449,21,70,76,165,97,235
421100,202311,1130,2393,407,1099,54,154,78,156,132,310
421105,202311,2018,5047,1059,3012,241,658,305,764,546,1422
421110,202311,1734,4100,1178,3066,130,406,724,1716,854,2122
421120,202311,1510,4223,843,2604,127,399,248,620,375,1019
421125,202311,529,1317,314,818,65,176,106,231,171,407
421130,202311,9644,25152,6753,18793,1334,4001,2991,7345,4325,11346
421140,202311,465,1215,252,726,54,141,99,259,153,400
421145,202311,456,1214,272,782,96,281,52,128,148,409
421150,202311,1112,2923,632,1816,135,425,230,508,365,933
421160,202311,912,2327,573,1545,64,209,312,697,376,906
421165,202311,304,846,139,413,25,73,39,84,64,157
421170,202311,1624,4003,1090,2893,111,315,655,1622,766,1937
421175,202311,1458,3640,724,2117,178,556,254,665,432,1221
421180,202311,527,1251,236,628,32,106,115,231,147,337
421185,202311,411,996,247,651,42,118,102,218,144,336
421187,202311,315,939,120,392,26,76,47,141,73,217
421189,202311,562,1449,311,915,58,184,99,259,157,443
421190,202311,21588,53224,13607,36304,2466,7127,5979,13889,8445,21016
421200,202311,1118,2757,679,1819,90,282,355,854,445,1136
421205,202311,339,869,204,590,47,126,78,219,125,345
421210,202311,1416,3420,650,1910,215,608,118,325,333,933
421220,202311,1808,4865,1176,3451,285,845,321,829,606,1674
421223,202311,567,1345,307,816,55,167,133,304,188,471
421225,202311,1529,3979,1102,3123,98,309,691,1812,789,2121
421227,202311,928,2451,466,1397,101,292,182,530,283,822
421230,202311,915,2304,569,1590,101,309,248,625,349,934
421240,202311,365,1037,137,474,20,82,30,73,50,155
421250,202311,3686,8818,2282,6159,406,1128,1189,2935,1595,4063
421260,202311,342,1060,62,191,15,42,7,19,22,61
421265,202311,1345,2981,928,2250,116,248,551,1262,667,1510
421270,202311,453,1208,216,710,50,173,73,221,123,394
421280,202311,3875,9289,2439,6527,382,1197,1211,2808,1593,4005
421290,202311,1460,3832,544,1582,89,270,74,177,163,447
421300,202311,462,1239,135,435,24,84,23,49,47,133
421310,202311,320,853,196,577,59,179,49,121,108,300
421315,202311,444,1147,207,604,45,132,58,149,103,281
421320,202311,830,2513,326,1045,20,50,53,84,73,134
421330,202311,808,2237,428,1330,80,243,100,262,180,505
421335,202311,545,1532,349,1098,41,139,150,424,191,563
421340,202311,1805,4886,951,3032,172,548,350,980,522,1528
421350,202311,2416,5688,1278,3496,275,733,384,921,659,1654
421360,202311,2792,7094,1432,4192,400,1307,329,637,729,1944
421370,202311,983,3024,519,1742,86,304,118,331,204,635
421380,202311,1139,2633,808,2040,91,298,496,1109,587,1407
421390,202311,200,512,63,198,17,51,18,52,35,103
421400,202311,886,2276,448,1325,78,247,175,442,253,689
421410,202311,249,640,108,331,31,85,16,53,47,138
421415,202311,257,693,146,413,23,70,45,105,68,175
421420,202311,811,2097,436,1231,96,278,190,465,286,743
421430,202311,171,465,74,224,15,40,8,19,23,59
421440,202311,1008,2550,482,1432,105,309,167,451,272,760
421450,202311,484,1499,273,929,39,153,20,73,59,226
421460,202311,378,1139,160,581,7,17,8,18,15,35
421470,202311,510,1374,256,794,54,165,61,176,115,341
421480,202311,4631,11677,2713,7436,395,1219,1175,2698,1570,3917
421490,202311,166,506,84,269,7,27,31,85,38,112
421500,202311,3494,9208,2022,5872,410,1294,765,1778,1175,3072
421505,202311,419,1040,290,797,30,88,142,365,172,453
421507,202311,564,1399,261,712,44,115,82,183,126,298
421510,202311,685,1827,373,1080,44,152,198,463,242,615
421520,202311,594,1546,271,759,55,153,85,194,140,347
421530,202311,443,1274,210,715,35,136,47,110,82,246
421535,202311,582,1448,295,811,54,168,146,336,200,504
421540,202311,493,1123,213,596,31,90,72,179,103,269
421545,202311,945,2641,578,1779,136,438,210,550,346,988
421550,202311,2959,7445,1791,5037,358,1071,710,1756,1068,2827
421555,202311,287,788,54,177,10,38,7,16,17,54
421560,202311,132,417,72,240,12,39,22,58,34,97
421565,202311,1391,3430,835,2337,231,687,339,837,570,1524
421567,202311,602,1732,389,1169,105,318,108,314,213,632
421568,202311,402,1111,158,498,33,124,42,103,75,227
421569,202311,189,514,64,191,10,29,26,60,36,89
421570,202311,2255,5907,1321,3689,221,696,562,1270,783,1966
421575,202311,432,1258,214,639,27,83,58,143,85,226
421580,202311,7173,18099,3487,9630,570,1695,1365,3040,1935,4735
421590,202311,279,718,191,533,45,130,72,173,117,303
421600,202311,818,2030,415,1092,55,158,185,410,240,568
421605,202311,900,2223,521,1474,112,323,189,473,301,796
421610,202311,1310,3224,695,1940,152,445,237,626,389,1071
421620,202311,5322,13044,3342,9189,721,2202,1323,3131,2044,5333
421625,202311,163,450,74,210,12,42,19,36,31,78
421630,202311,3913,9873,1951,5556,338,1047,515,1182,853,2229
421635,202311,589,1486,334,911,31,98,190,455,221,553
421640,202311,1014,2444,688,1881,191,517,305,789,496,1306
421650,202311,3793,9418,2171,6189,438,1325,705,1753,1143,3078
421660,202311,18556,46585,11735,32111,1771,5331,5753,13671,7524,19002
421670,202311,1213,3207,658,1819,139,411,251,589,390,1000
421680,202311,2310,5047,1621,3821,147,378,1068,2334,1215,2712
421690,202311,1973,5541,1053,3338,213,708,215,534,428,1242
421700,202311,819,2353,372,1197,49,164,77,184,126,348
421710,202311,276,830,117,377,15,53,43,118,58,171
421715,202311,238,549,139,329,20,55,75,139,95,194
421720,202311,2832,7335,1383,3950,309,931,445,1024,754,1955
421725,202311,386,919,168,449,21,64,80,161,101,225
421730,202311,762,2110,322,925,51,156,123,289,174,445
421740,202311,1160,3085,587,1716,147,417,164,430,311,847
421750,202311,1304,3016,577,1577,136,416,182,418,318,834
421755,202311,210,554,80,229,17,52,26,60,43,112
421760,202311,1515,3637,713,1937,118,346,266,604,384,950
421770,202311,3343,8142,1948,5370,345,1007,699,1640,1044,2647
421775,202311,259,680,113,337,17,48,28,61,45,109
421780,202311,1223,3182,742,2102,131,380,300,734,431,1114
421790,202311,1222,3110,452,1353,83,240,131,329,214,569
421795,202311,329,950,145,446,16,63,48,131,64,194
421800,202311,4169,10803,2500,7249,482,1441,876,2214,1358,3655
421810,202311,741,1966,373,1125,57,220,159,413,216,633
421820,202311,1552,4216,753,2194,132,410,245,565,377,975
421825,202311,2146,4734,1532,3694,122,306,1022,2344,1144,2650
421830,202311,2598,7112,1571,4799,313,1013,366,1043,679,2056
421835,202311,339,782,207,512,26,79,134,295,160,374
421840,202311,524,1575,331,1052,52,179,101,267,153,446
421850,202311,524,1489,238,808,47,168,35,87,82,255
421860,202311,281,725,123,383,15,50,36,82,51,132
421870,202311,7990,18576,4867,12019,744,2136,2528,5103,3272,7239
421875,202311,397,1146,118,381,16,44,19,49,35,93
421880,202311,954,2507,482,1398,95,260,138,352,233,612
421885,202311,380,1032,153,468,27,94,34,81,61,175
421890,202311,1467,3647,972,2686,123,397,573,1390,696,1787
421895,202311,556,1337,377,1001,37,98,234,612,271,710
421900,202311,1511,3763,783,2047,140,400,308,664,448,1064
421910,202311,456,1319,177,624,36,116,21,63,57,179
421915,202311,476,1273,228,684,59,172,46,111,105,283
421917,202311,827,1794,350,948,79,215,84,207,163,422
421920,202311,559,1562,323,987,89,252,75,218,164,470
421930,202311,4605,10932,2083,5694,373,1071,603,1326,976,2397
421935,202311,506,1458,349,1111,77,254,120,356,197,610
421940,202311,445,1251,153,473,31,108,49,111,80,219
421950,202311,4131,10343,2047,5859,366,1100,577,1369,943,2469
421960,202311,189,464,84,246,12,31,31,90,43,121
421970,202311,2883,7187,1344,3718,270,753,506,1187,776,1940
421985,202311,421,1119,226,656,24,73,114,307,138,380
422000,202311,2691,6346,1680,4491,153,482,1027,2555,1180,3037
430003,202311,902,2147,507,1393,71,204,260,687,331,891
430005,202311,518,1201,341,865,19,57,226,512,245,569
430010,202311,2368,4978,1514,3555,346,796,649,1481,995,2277
430020,202311,700,1504,445,1074,60,155,229,482,289,637
430030,202311,1341,2879,678,1596,126,312,375,769,501,1081
430040,202311,12643,27491,6793,17094,2036,5183,1790,4095,3826,9278
430045,202311,699,1518,427,1049,29,78,288,641,317,719
430047,202311,298,653,76,198,18,40,26,65,44,105
430050,202311,1084,2567,496,1351,131,314,116,294,247,608
430055,202311,309,701,120,316,20,50,46,107,66,157
430057,202311,119,261,44,112,8,12,13,28,21,40
430060,202311,30176,70198,20728,53181,3661,9637,10606,25041,14267,34678
430063,202311,833,2153,639,1775,151,410,322,862,473,1272
430064,202311,1454,3554,922,2526,218,623,395,1002,613,1625
430066,202311,123,299,72,198,10,27,31,72,41,99
430070,202311,664,1673,131,384,24,75,20,49,44,124
430080,202311,1128,2753,489,1332,92,281,179,372,271,653
430085,202311,1144,2285,590,1386,119,264,239,561,358,825
430087,202311,1188,2811,682,1833,80,229,340,848,420,1077
430090,202311,570,1421,187,579,55,188,36,94,91,282
430100,202311,2068,4649,721,1802,92,243,320,676,412,919
430105,202311,2083,4720,1275,3286,175,518,694,1616,869,2134
430107,202311,220,592,92,267,13,40,26,65,39,105
430110,202311,2790,6319,1794,4524,385,992,878,2086,1263,3078
430120,202311,1504,3884,899,2423,164,425,385,961,549,1386
430130,202311,4455,9079,2798,6498,1068,2398,566,1507,1634,3905
430140,202311,1325,3123,777,2024,129,341,356,879,485,1220
430150,202311,734,1816,331,994,81,254,76,195,157,449
430155,202311,278,639,102,262,18,49,42,79,60,128
430160,202311,28851,57909,19641,43435,1584,3939,13823,28454,15407,32393
430163,202311,4576,8933,2817,6261,84,260,2156,4365,2240,4625
430165,202311,426,1061,100,307,15,38,13,36,28,74
430170,202311,1145,2832,291,915,78,287,54,107,132,394
430175,202311,1062,2399,805,1902,116,266,478,1122,594,1388
430180,202311,851,1981,475,1243,115,271,178,465,293,736
430185,202311,798,1924,295,845,83,221,47,119,130,340
430187,202311,1113,2171,692,1587,79,180,454,992,533,1172
430190,202311,1876,4286,1222,3126,286,729,506,1184,792,1913
430192,202311,138,346,40,112,9,25,12,27,21,52
430195,202311,536,1453,60,179,7,19,13,27,20,46
430200,202311,1412,3653,920,2656,235,741,113,303,348,1044
430205,202311,760,1427,604,1175,22,56,510,962,532,1018
430210,202311,9680,23135,4273,11040,637,1745,1268,2578,1905,4323
430215,202311,474,1055,232,594,22,65,108,233,130,298
430220,202311,722,1723,237,708,52,152,71,173,123,325
430222,202311,330,817,160,440,39,103,56,139,95,242
430223,202311,365,867,237,616,29,79,137,313,166,392
430225,202311,46,103,31,77,5,12,16,34,21,46
430230,202311,2879,6536,1979,4963,156,439,1341,3092,1497,3531
430235,202311,599,1500,294,830,47,136,74,167,121,303
430237,202311,690,1382,385,869,23,71,265,534,288,605
430240,202311,1797,3957,699,1816,109,284,272,585,381,869
430245,202311,916,2206,666,1731,130,315,346,918,476,1233
430250,202311,1364,3041,795,2006,254,664,225,503,479,1167
430258,202311,160,397,85,234,16,37,42,111,58,148
430260,202311,895,2056,485,1251,67,204,263,635,330,839
430265,202311,296,803,172,554,31,97,54,166,85,263
430270,202311,4303,8881,2891,6485,570,1205,1652,3542,2222,4747
430280,202311,6586,13519,4009,9034,697,1646,2043,4255,2740,5901
430290,202311,2826,5653,2009,4479,203,454,1464,3097,1667,3551
430300,202311,14273,30690,9212,21430,1541,3521,5180,11172,6721,14693
430310,202311,19331,43503,11365,27959,1520,3922,6418,14362,7938,18284
430320,202311,1104,2668,540,1524,47,141,296,778,343,919
430330,202311,818,1864,368,951,94,241,117,259,211,500
430340,202311,894,1797,514,1172,63,131,346,760,409,891
430350,202311,11386,25183,7316,17703,1192,2951,4102,9249,5294,12200
430355,202311,476,1225,121,356,32,88,11,23,43,111
430360,202311,1150,2635,568,1543,142,417,150,345,292,762
430367,202311,451,911,239,546,40,93,148,315,188,408
430370,202311,583,1530,175,519,47,120,46,116,93,236
430380,202311,799,1868,322,918,54,160,100,255,154,415
430390,202311,4668,10650,2349,6023,441,1177,271,454,712,1631
430400,202311,1289,2551,778,1745,114,296,450,906,564,1202
430410,202311,736,1546,475,1107,42,109,324,697,366,806
430420,202311,3768,8622,2527,6139,413,1190,1368,2790,1781,3980
430430,202311,494,1191,171,492,28,75,27,71,55,146
430435,202311,2477,5492,1459,3587,260,653,693,1630,953,2283
430440,202311,6490,14720,4073,9891,472,1272,2426,5247,2898,6519
430450,202311,10524,21857,7476,16560,1339,3331,4127,8178,5466,11509
430460,202311,55198,121330,32917,81226,5455,13994,16651,38037,22106,52031
430461,202311,232,591,72,220,13,46,32,85,45,131
430462,202311,393,960,181,522,43,132,60,149,103,281
430463,202311,9713,23065,6249,16232,1174,3362,3002,7069,4176,10431
430465,202311,720,1599,419,1025,75,204,230,528,305,732
430466,202311,6531,14315,4397,10645,660,1693,2597,5681,3257,7374
430467,202311,648,1467,385,965,45,125,216,498,261,623
430468,202311,2016,4326,1322,3153,72,201,913,1990,985,2191
430469,202311,734,1920,109,303,14,37,33,70,47,107
430470,202311,7525,17826,4008,10951,1052,3085,858,1892,1910,4977
430471,202311,1079,2477,812,1973,96,244,521,1142,617,1386
430480,202311,827,2143,406,1151,76,236,117,255,193,491
430485,202311,211,518,82,221,21,50,22,48,43,98
430490,202311,666,1543,271,725,52,162,99,183,151,345
430495,202311,498,1265,259,774,55,165,106,293,161,458
430500,202311,1210,2835,702,1893,210,590,214,490,424,1080
430510,202311,36434,87577,21569,55677,4449,12325,8512,18550,12961,30875
430511,202311,396,1032,120,362,22,61,24,50,46,111
430512,202311,1321,2693,896,2019,235,527,319,685,554,1212
430513,202311,980,2149,437,1045,65,157,240,501,305,658
430515,202311,495,1198,264,719,47,129,123,326,170,455
430517,202311,1802,4451,1203,3171,288,705,586,1528,874,2233
430520,202311,1630,3844,748,1947,140,369,193,441,333,810
430530,202311,1137,2646,382,1070,71,218,127,312,198,530
430535,202311,4667,10620,2684,6765,395,1038,1317,3067,1712,4105
430537,202311,686,1484,531,1195,71,147,369,790,440,937
430540,202311,721,1637,338,925,76,194,123,322,199,516
430543,202311,1384,2387,714,1541,205,444,136,313,341,757
430544,202311,836,2186,459,1341,116,353,126,338,242,691
430545,202311,3192,7338,2061,5445,451,1173,985,2474,1436,3647
430550,202311,503,1238,266,722,84,215,78,207,162,422
430558,202311,217,475,65,157,3,9,42,90,45,99
430560,202311,370,839,135,394,19,68,49,116,68,184
430570,202311,1006,2265,534,1278,165,422,199,384,364,806
430580,202311,979,2336,660,1774,163,420,209,614,372,1034
430583,202311,219,532,34,91,10,37,9,14,19,51
430585,202311,267,635,106,285,21,60,35,76,56,136
430587,202311,262,668,135,388,25,80,49,126,74,206
430590,202311,1677,3776,1034,2617,120,316,580,1376,700,1692
430593,202311,44,112,19,54,2,8,11,25,13,33
430595,202311,519,1276,90,268,16,36,15,29,31,65
430597,202311,588,1375,180,474,25,52,62,136,87,188
430600,202311,2346,5821,811,2296,152,438,127,324,279,762
430605,202311,1760,4054,1053,2716,157,412,523,1253,680,1665
430607,202311,868,1811,442,1031,74,139,243,559,317,698
430610,202311,7680,16705,4798,11984,1465,3850,1706,3770,3171,7620
430613,202311,309,687,66,172,14,35,18,39,32,74
430620,202311,1692,3701,723,1715,121,315,302,555,423,870
430630,202311,514,1351,161,445,28,82,41,98,69,180
430632,202311,519,1272,154,435,21,58,60,147,81,205
430635,202311,702,1458,413,923,77,143,244,547,321,690
430637,202311,667,1462,402,989,46,126,251,556,297,682
430640,202311,1377,3566,618,1816,91,257,179,431,270,688
430642,202311,488,1256,208,596,33,82,79,205,112,287
430645,202311,197,454,76,209,16,42,17,35,33,77
430650,202311,2269,5552,1536,4286,459,1222,550,1648,1009,2870
430655,202311,410,935,187,475,23,68,109,237,132,305
430660,202311,6758,15108,4292,10686,729,1951,2169,4923,2898,6874
430670,202311,713,1612,389,982,65,162,183,434,248,596
430673,202311,598,1280,223,606,48,128,72,170,120,298
430675,202311,305,850,61,198,12,33,15,48,27,81
430676,202311,8323,18404,5636,13736,891,2267,3211,7363,4102,9630
430680,202311,1975,4693,877,2363,221,669,284,570,505,1239
430690,202311,4359,9889,2985,7328,1007,2523,1083,2492,2090,5015
430692,202311,245,651,171,518,10,36,121,350,131,386
430693,202311,1147,2870,534,1581,153,479,112,299,265,778
430695,202311,535,1227,270,657,49,124,148,308,197,432
430697,202311,676,1508,425,1079,61,182,267,624,328,806
430700,202311,10853,24787,5351,13792,1171,3150,1437,3077,2608,6227
430705,202311,419,957,161,455,26,76,57,127,83,203
430710,202311,2639,4459,1556,3032,67,175,1253,2280,1320,2455
430720,202311,984,2195,444,1204,62,180,227,543,289,723
430730,202311,1157,2919,632,1805,130,366,222,595,352,961
430740,202311,861,2157,346,984,61,177,126,327,187,504
430745,202311,637,1392,400,938,54,158,254,490,308,648
430750,202311,2192,4925,1262,3157,270,713,644,1444,914,2157
430755,202311,583,1318,328,785,36,107,200,420,236,527
430760,202311,3474,7816,2192,5448,458,1164,977,2203,1435,3367
430770,202311,10238,22379,6849,16363,937,2322,4072,9033,5009,11355
430780,202311,3879,8712,1905,4933,201,571,1025,2308,1226,2879
430781,202311,851,1989,469,1158,157,396,168,365,325,761
430783,202311,452,965,250,620,69,156,105,239,174,395
430786,202311,46,136,20,77,3,11,4,9,7,20
430790,202311,6366,14239,3673,8998,411,1167,2106,4426,2517,5593
430800,202311,1092,2108,704,1511,48,126,514,1019,562,1145
430805,202311,485,1062,300,695,17,47,222,467,239,514
430807,202311,759,1737,348,918,58,155,132,282,190,437
430810,202311,900,2079,365,976,76,219,121,268,197,487
430820,202311,1805,4682,777,2285,136,405,232,578,368,983
430825,202311,325,740,111,258,20,46,48,97,68,143
430830,202311,2646,5779,1849,4279,137,345,1322,2836,1459,3181
430840,202311,1603,3354,914,2194,166,380,542,1256,708,1636
430843,202311,257,605,82,234,5,10,26,62,31,72
430845,202311,623,1341,339,823,74,175,154,339,228,514
430850,202311,3120,7466,1723,4688,554,1583,365,857,919,2440
430860,202311,1568,3650,653,1761,91,287,254,535,345,822
430865,202311,801,1799,402,1019,122,329,168,387,290,716
430870,202311,641,1629,212,628,51,155,38,99,89,254
430880,202311,1915,3917,1158,2627,154,379,696,1454,850,1833
430885,202311,223,551,108,297,15,45,45,100,60,145
430890,202311,1422,3323,685,1880,199,629,68,119,267,748
430900,202311,4442,8162,2433,5121,141,386,1717,3234,1858,3620
430905,202311,1175,2735,634,1651,122,337,240,571,362,908
430910,202311,2987,7407,1648,4342,271,797,678,1480,949,2277
430912,202311,680,1762,353,1030,68,190,161,465,229,655
430915,202311,649,1694,357,1054,104,318,80,212,184,530
430920,202311,37643,83816,25141,60812,3319,8397,15028,33812,18347,42209
430925,202311,127,269,52,135,8,23,23,49,31,72
430930,202311,16373,34208,9959,23188,1138,2934,6293,13270,7431,16204
430940,202311,1709,3967,974,2526,209,554,371,848,580,1402
430950,202311,1025,2100,578,1324,78,213,350,697,428,910
430955,202311,551,1384,124,338,21,51,36,71,57,122
430957,202311,258,719,210,608,43,111,101,293,144,404
430960,202311,1775,3945,788,2023,196,519,236,537,432,1056
430965,202311,2029,4227,1357,3145,75,189,969,2239,1044,2428
430970,202311,502,1160,218,596,32,84,82,213,114,297
430975,202311,624,1601,427,1170,93,277,137,323,230,600
430980,202311,579,1277,291,743,45,110,129,304,174,414
430990,202311,733,1803,469,1250,84,235,208,501,292,736
430995,202311,687,1524,369,926,78,190,179,404,257,594
431000,202311,1866,4144,577,1556,79,215,84,169,163,384
431010,202311,3691,8729,2139,5657,379,1140,925,2028,1304,3168
431020,202311,11959,24388,5830,13977,1057,2698,2618,5475,3675,8173
431030,202311,402,1065,176,560,46,171,18,55,64,226
431033,202311,5584,12173,3136,7858,736,1774,1188,2772,1924,4546
431036,202311,356,785,73,221,9,31,18,52,27,83
431040,202311,1134,2568,632,1608,70,220,389,866,459,1086
431041,202311,496,1090,270,669,50,121,113,229,163,350
431043,202311,397,957,249,627,21,61,151,323,172,384
431046,202311,121,298,39,100,5,12,8,16,13,28
431050,202311,1559,3382,989,2401,186,456,498,1130,684,1586
431053,202311,900,2097,420,1151,87,229,136,317,223,546
431055,202311,815,1769,506,1234,71,161,308,738,379,899
431057,202311,250,718,120,373,34,99,33,107,67,206
431060,202311,7347,16103,4380,10871,1124,2911,1743,3836,2867,6747
431065,202311,608,1377,311,843,36,103,170,417,206,520
431070,202311,525,1293,232,652,51,134,59,187,110,321
431075,202311,331,805,158,421,25,69,75,172,100,241
431080,202311,885,2238,425,1191,66,217,142,317,208,534
431085,202311,983,2376,401,1082,73,186,154,399,227,585
431087,202311,511,1291,339,917,60,168,180,464,240,632
431090,202311,491,1112,137,419,28,86,30,77,58,163
431100,202311,5791,11081,3787,8259,453,1049,2428,4829,2881,5878
431110,202311,1827,3884,1120,2586,178,446,615,1275,793,1721
431112,202311,797,1822,572,1404,71,214,360,803,431,1017
431113,202311,711,1613,486,1192,116,277,253,588,369,865
431115,202311,1430,3386,946,2494,96,322,620,1476,716,1798
431120,202311,3483,7874,2019,5084,486,1373,822,1745,1308,3118
431123,202311,442,1065,245,655,39,87,117,297,156,384
431125,202311,1601,3685,996,2568,237,625,537,1344,774,1969
431127,202311,304,739,54,160,11,32,9,21,20,53
431130,202311,4328,9689,2798,6948,524,1358,1379,3072,1903,4430
431140,202311,8907,19648,4050,9975,586,1507,1794,3582,2380,5089
431142,202311,825,1791,489,1199,62,145,295,682,357,827
431150,202311,1296,3079,851,2248,102,300,511,1264,613,1564
431160,202311,880,2135,473,1301,136,394,145,349,281,743
431162,202311,782,1800,402,1048,46,148,224,522,270,670
431164,202311,202,460,35,103,7,24,10,21,17,45
431170,202311,576,1400,357,954,93,242,87,199,180,441
431171,202311,1227,2431,886,1932,123,277,658,1375,781,1652
431173,202311,569,1341,356,1006,115,354,85,199,200,553
431175,202311,1675,3586,854,2107,129,311,419,962,548,1273
431177,202311,1253,2889,802,2091,177,484,403,978,580,1462
431179,202311,377,820,94,274,27,83,28,73,55,156
431180,202311,3348,8095,1662,4502,396,1028,531,1270,927,2298
431190,202311,766,1800,235,655,32,90,60,130,92,220
431198,202311,520,1376,397,1105,92,254,154,421,246,675
431200,202311,361,857,87,224,23,64,16,31,39,95
431205,202311,309,766,140,383,31,92,40,94,71,186
431210,202311,821,1765,557,1321,133,299,245,581,378,880
431213,202311,457,1119,240,676,25,83,119,293,144,376
431215,202311,782,1749,284,772,39,112,116,287,155,399
431217,202311,217,507,127,336,29,76,35,76,64,152
431220,202311,838,1875,418,1062,102,254,194,449,296,703
431225,202311,2015,4146,1288,2908,149,359,848,1807,997,2166
431230,202311,1025,2461,576,1474,97,287,299,616,396,903
431235,202311,217,573,27,76,2,8,6,9,8,17
431237,202311,479,1335,293,897,40,130,128,369,168,499
431238,202311,43,116,24,69,2,5,9,19,11,24
431240,202311,7145,15615,4734,11174,521,1418,2833,5913,3354,7331
431242,202311,397,890,260,605,27,71,149,310,176,381
431244,202311,497,1179,177,472,43,95,51,121,94,216
431245,202311,1641,3549,834,2061,117,302,364,796,481,1098
431247,202311,353,805,148,393,14,35,61,133,75,168
431250,202311,2603,5532,1790,4250,347,861,1012,2273,1359,3134
431260,202311,531,1277,202,553,20,54,82,173,102,227
431261,202311,366,980,240,701,37,135,128,322,165,457
431262,202311,342,899,158,498,27,93,73,211,100,304
431265,202311,2005,4473,599,1577,157,445,146,281,303,726
431267,202311,295,687,160,428,25,68,80,198,105,266
431270,202311,3771,7620,1709,4099,512,1202,512,1170,1024,2372
431275,202311,201,502,95,252,14,44,54,126,68,170
431280,202311,326,860,116,357,24,76,30,71,54,147
431290,202311,474,1338,206,637,41,133,42,112,83,245
431295,202311,134,320,38,114,9,25,10,29,19,54
431300,202311,406,1041,83,240,21,60,24,59,45,119
431301,202311,326,884,67,217,8,26,9,16,17,42
431303,202311,871,1973,431,1089,34,89,221,469,255,558
431306,202311,2977,6752,1328,3484,208,590,540,1177,748,1767
431308,202311,46,121,34,93,12,37,8,17,20,54
431310,202311,699,1619,366,919,62,139,179,423,241,562
431320,202311,869,2229,419,1211,82,257,121,264,203,521
431330,202311,2688,5928,1195,3011,181,511,555,1167,736,1678
431333,202311,250,622,113,325,22,63,32,83,54,146
431335,202311,39,114,26,86,7,22,4,13,11,35
431337,202311,5678,11710,4030,9027,226,621,3014,6281,3240,6902
431339,202311,600,1411,326,872,75,209,124,298,199,507
431340,202311,26421,59081,15589,38750,2407,6358,7949,17583,10356,23941
431342,202311,484,1072,293,737,55,133,165,400,220,533
431344,202311,460,1109,213,604,45,126,97,257,142,383
431346,202311,256,599,79,227,23,70,23,60,46,130
431349,202311,1309,2745,674,1528,118,286,387,800,505,1086
431350,202311,6509,14631,4255,10622,682,1749,2388,5421,3070,7170
431360,202311,754,1720,296,789,90,259,74,152,164,411
431365,202311,3074,6068,2053,4547,146,375,1548,3170,1694,3545
431370,202311,6910,14585,4166,9878,757,1912,2149,4613,2906,6525
431380,202311,1208,2924,803,2143,196,486,380,1000,576,1486
431390,202311,3345,7574,1660,4218,197,575,862,1822,1059,2397
431395,202311,2306,4713,1525,3483,172,416,1044,2218,1216,2634
431400,202311,404,1064,152,449,25,64,30,76,55,140
431402,202311,1100,2304,682,1630,104,243,384,874,488,1117
431403,202311,251,653,159,446,30,88,54,121,84,209
431405,202311,7738,18088,4796,12428,869,2413,2209,5074,3078,7487
431406,202311,741,1875,419,1174,119,316,95,289,214,605
431407,202311,688,1708,353,990,74,197,120,315,194,512
431410,202311,26308,58471,15563,38470,1961,5548,8908,19203,10869,24751
431413,202311,327,877,67,205,9,22,18,39,27,61
431415,202311,953,2235,517,1409,109,315,192,451,301,766
431417,202311,694,1405,367,855,83,207,180,402,263,609
431420,202311,2176,4341,1367,3124,103,269,927,1935,1030,2204
431430,202311,700,1658,274,767,47,138,99,243,146,381
431440,202311,53916,109187,36537,80821,6338,14845,20290,39879,26628,54724
431442,202311,211,560,68,217,8,28,5,12,13,40
431445,202311,430,1184,113,358,16,47,21,45,37,92
431446,202311,351,892,252,698,35,95,139,362,174,457
431447,202311,946,2258,426,1190,77,219,160,406,237,625
431449,202311,1001,2280,516,1313,117,284,252,586,369,870
431450,202311,3304,5856,2158,4154,234,396,1540,2835,1774,3231
431454,202311,67,220,44,153,8,30,15,50,23,80
431455,202311,603,1351,272,682,43,84,124,311,167,395
431460,202311,4266,8740,2421,5515,453,1132,1239,2546,1692,3678
431470,202311,1703,4260,986,2764,255,707,281,768,536,1475
431475,202311,305,799,39,121,2,7,5,7,7,14
431477,202311,622,1457,289,791,98,250,92,234,190,484
431478,202311,292,794,50,150,13,38,9,21,22,59
431480,202311,4173,9950,2486,6622,534,1414,821,1960,1355,3374
431490,202311,190546,386687,125220,278097,8140,22590,87843,175981,95983,198571
431500,202311,645,1497,333,868,58,143,154,379,212,522
431505,202311,306,683,177,453,28,81,101,240,129,321
431507,202311,359,815,119,340,33,99,28,79,61,178
431510,202311,2132,5052,1134,3018,437,1101,197,502,634,1603
431513,202311,266,556,108,268,31,88,28,50,59,138
431514,202311,138,341,90,242,12,27,37,90,49,117
431515,202311,714,1527,455,1049,104,237,217,470,321,707
431517,202311,99,270,62,182,11,36,26,69,37,105
431520,202311,438,1007,143,388,29,89,50,99,79,188
431530,202311,6859,14019,3467,8431,732,1869,1467,3230,2199,5099
431531,202311,264,608,119,322,29,73,29,87,58,160
431532,202311,799,1678,397,961,77,187,184,419,261,606
431535,202311,484,1163,253,619,60,149,120,267,180,416
431540,202311,2507,6494,1835,5266,129,428,1199,3180,1328,3608
431545,202311,443,1023,93,218,10,21,40,84,50,105
431550,202311,2972,6736,1702,4241,257,642,801,1831,1058,2473
431555,202311,912,1910,436,1062,51,125,246,585,297,710
431560,202311,34786,76964,19270,49313,3340,8770,8178,19494,11518,28264
431570,202311,7127,14030,5100,10839,687,1437,3354,6597,4041,8034
431575,202311,523,1154,326,767,53,144,176,330,229,474
431580,202311,1450,3389,562,1454,59,170,268,571,327,741
431590,202311,1111,2810,556,1579,141,431,177,429,318,860
431595,202311,463,1134,226,629,48,142,81,187,129,329
431600,202311,2384,5492,1333,3550,226,673,498,1084,724,1757
431610,202311,1948,4250,964,2416,206,528,314,832,520,1360
431620,202311,581,1338,282,716,65,179,144,290,209,469
431630,202311,1614,3731,615,1691,153,423,150,372,303,795
431640,202311,9056,18236,6172,13820,1119,2470,3616,7719,4735,10189
431642,202311,837,1779,386,929,97,223,134,287,231,510
431643,202311,494,1153,159,419,22,50,55,131,77,181
431645,202311,3149,5442,2181,4102,58,155,1795,3167,1853,3322
431647,202311,386,892,88,244,13,43,12,21,25,64
431650,202311,176,465,102,303,18,52,39,105,57,157
431660,202311,968,2490,445,1293,71,222,107,245,178,467
431670,202311,1637,3583,789,1945,130,335,406,892,536,1227
431673,202311,258,662,91,284,8,25,24,65,32,90
431675,202311,426,1059,82,270,8,30,10,20,18,50
431680,202311,13520,29465,7950,18790,1780,4435,3356,6942,5136,11377
431690,202311,37627,81632,23171,54801,4619,11339,11393,24102,16012,35441
431695,202311,300,706,135,362,18,52,59,119,77,171
431697,202311,585,1230,363,848,69,138,185,435,254,573
431700,202311,1960,4182,1315,3013,250,535,648,1497,898,2032
431710,202311,20178,40588,12887,29517,1502,3797,8232,17586,9734,21383
431720,202311,9334,20632,4177,10629,1156,3033,670,1435,1826,4468
431725,202311,40,100,18,54,6,22,3,3,9,25
431730,202311,6079,12795,3538,8615,667,1764,1771,3792,2438,5556
431740,202311,6610,14794,3553,9192,771,2113,1123,2527,1894,4640
431750,202311,11264,25964,6272,16582,1802,4998,1628,3818,3430,8816
431755,202311,419,1082,64,206,9,24,6,21,15,45
431760,202311,7038,14669,4154,9549,494,1340,2515,4987,3009,6327
431770,202311,2899,5800,1796,4080,388,801,973,2176,1361,2977
431775,202311,313,717,110,301,25,68,33,68,58,136
431780,202311,2736,6122,1382,3512,299,814,411,901,710,1715
431790,202311,986,2459,522,1472,164,475,134,339,298,814
431795,202311,321,782,142,412,21,59,35,96,56,155
431800,202311,10596,23193,5483,14233,1802,4936,578,1349,2380,6285
431805,202311,302,781,43,157,4,14,1,5,5,19
431810,202311,4084,8492,2395,5461,469,1125,1269,2654,1738,3779
431820,202311,2923,6791,1878,4960,460,1271,787,1911,1247,3182
431830,202311,11057,23184,6520,15968,2093,5460,1155,2706,3248,8166
431840,202311,3743,8240,2532,6130,409,1036,1472,3343,1881,4379
431842,202311,618,1465,181,508,35,101,28,61,63,162
431843,202311,372,967,192,544,54,165,75,192,129,357
431844,202311,225,593,61,202,13,45,19,59,32,104
431845,202311,592,1392,312,802,59,154,138,349,197,503
431846,202311,380,817,270,628,23,65,201,434,224,499
431848,202311,183,461,66,193,10,31,13,23,23,54
431849,202311,426,1038,53,158,4,12,10,27,14,39
431850,202311,5511,13581,3206,8694,977,2638,676,1750,1653,4388
431860,202311,869,1937,412,1018,67,168,228,525,295,693
431861,202311,127,315,60,168,9,27,23,56,32,83
431862,202311,643,1860,444,1443,94,334,197,572,291,906
431870,202311,33114,72778,21603,52055,3005,7507,12567,27958,15572,35465
431880,202311,5280,12163,3320,8531,579,1564,1622,3747,2201,5311
431890,202311,6304,14544,3249,8466,1029,2589,739,1826,1768,4415
431900,202311,1333,3090,720,1863,149,427,295,617,444,1044
431910,202311,962,2140,302,777,78,175,68,156,146,331
431912,202311,756,1649,528,1255,87,188,315,719,402,907
431915,202311,1488,3106,1002,2277,118,269,694,1485,812,1754
431920,202311,1725,3260,1194,2491,49,118,971,1939,1020,2057
431930,202311,1012,2367,543,1477,173,472,169,427,342,899
431935,202311,143,349,52,144,10,34,9,18,19,52
431936,202311,383,971,175,489,44,121,73,187,117,308
431937,202311,254,584,102,273,23,48,24,63,47,111
431940,202311,3840,8162,2023,4862,268,598,1038,2374,1306,2972
431950,202311,3025,6827,1782,4500,420,1104,626,1411,1046,2515
431960,202311,3812,8567,2426,5934,784,1991,441,1031,1225,3022
431970,202311,534,1283,179,474,38,105,51,93,89,198
431971,202311,116,278,45,131,13,34,13,31,26,65
431973,202311,740,1994,475,1443,39,105,327,971,366,1076
431975,202311,162,353,35,92,11,34,9,16,20,50
431980,202311,1626,3445,1126,2601,112,319,755,1523,867,1842
431990,202311,9464,20228,5761,14209,397,1206,3706,8298,4103,9504
432000,202311,21720,44724,13875,31395,1789,4593,8700,17853,10489,22446
432010,202311,3719,7944,1889,4654,466,1151,676,1530,1142,2681
432020,202311,1937,4836,984,2711,361,996,134,358,495,1354
432023,202311,725,1603,279,739,32,87,112,239,144,326
432026,202311,1283,3076,903,2328,293,756,321,835,614,1591
432030,202311,574,1303,249,661,21,67,149,355,170,422
432032,202311,389,920,216,564,21,66,107,237,128,303
432035,202311,884,2194,622,1683,173,472,244,623,417,1095
432040,202311,1309,3098,430,1195,46,137,186,430,232,567
432045,202311,232,554,106,298,11,33,45,116,56,149
432050,202311,714,1608,421,1061,56,155,215,479,271,634
432055,202311,928,2121,541,1401,184,430,162,460,346,890
432057,202311,180,447,135,340,38,78,67,158,105,236
432060,202311,553,1268,121,375,20,58,20,52,40,110
432065,202311,295,711,189,492,34,86,104,245,138,331
432067,202311,1065,2636,765,1995,174,444,358,899,532,1343
432070,202311,1996,4574,1234,3104,196,573,585,1235,781,1808
432080,202311,6780,14001,3809,8863,765,2070,1630,3142,2395,5212
432085,202311,500,1264,339,922,55,155,149,364,204,519
432090,202311,3617,8314,1558,4090,311,785,635,1407,946,2192
432100,202311,1076,2529,431,1264,75,257,56,113,131,370
432110,202311,2739,6334,1722,4408,396,1096,586,1264,982,2360
432120,202311,4927,11961,3241,8712,519,1523,1601,3827,2120,5350
432130,202311,3639,7988,2329,5665,530,1317,1006,2351,1536,3668
432132,202311,366,884,160,415,24,72,69,163,93,235
432135,202311,1231,2599,687,1650,120,254,361,903,481,1157
432140,202311,2574,6051,1802,4559,252,648,1111,2598,1363,3246
432143,202311,2087,4888,1321,3517,163,453,727,1842,890,2295
432145,202311,2422,5845,1107,2978,189,508,360,760,549,1268
432146,202311,174,437,100,281,30,70,24,63,54,133
432147,202311,718,1780,324,931,88,250,49,142,137,392
432149,202311,646,1404,226,570,36,84,103,233,139,317
432150,202311,5730,12655,3683,8992,911,2325,1625,3425,2536,5750
432160,202311,9276,20663,6048,15309,1515,3874,2379,5701,3894,9575
432162,202311,248,540,33,91,3,12,8,8,11,20
432163,202311,234,546,34,100,2,4,6,14,8,18
432166,202311,834,2113,508,1401,120,325,153,368,273,693
432170,202311,1984,4964,995,2905,205,612,321,816,526,1428
432180,202311,3688,8225,1620,4183,261,698,724,1600,985,2298
432183,202311,550,1387,359,975,62,199,199,480,261,679
432185,202311,1112,2577,537,1436,120,318,236,571,356,889
432190,202311,3028,6522,1708,4174,138,406,1091,2330,1229,2736
432195,202311,1258,2989,554,1525,105,287,150,386,255,673
432200,202311,4890,10885,3054,7564,342,832,1831,4296,2173,5128
432210,202311,529,1228,302,788,53,161,121,265,174,426
432215,202311,820,2073,546,1522,123,332,199,582,322,914
432218,202311,295,675,97,255,14,41,38,75,52,116
432220,202311,4948,10315,2953,6818,558,1328,1619,3432,2177,4760
432225,202311,185,449,117,317,30,74,28,68,58,142
432230,202311,906,2069,371,1024,98,283,77,163,175,446
432232,202311,602,1379,325,837,49,140,153,339,202,479
432234,202311,330,791,149,404,29,71,44,104,73,175
432235,202311,64,145,31,75,4,10,19,42,23,52
432237,202311,361,834,277,684,25,51,201,489,226,540
432240,202311,22668,48192,14541,35817,1565,4286,9162,21042,10727,25328
432250,202311,9868,23722,5960,15571,969,2750,2991,6942,3960,9692
432252,202311,600,1357,339,823,39,108,168,345,207,453
432253,202311,1222,3179,737,2043,250,698,163,411,413,1109
432254,202311,716,1662,145,404,20,64,39,90,59,154
432255,202311,122,314,53,153,5,13,23,53,28,66
432260,202311,7814,17500,4440,10955,810,2124,1974,4218,2784,6342
432270,202311,3203,7373,2016,5108,568,1465,683,1630,1251,3095
432280,202311,1497,3592,553,1590,90,264,130,278,220,542
432285,202311,166,489,18,47,3,4,3,10,6,14
432290,202311,450,1086,225,575,41,118,90,195,131,313
432300,202311,43409,93514,28968,68648,2606,7167,19118,40948,21724,48115
432310,202311,1382,2995,927,2239,157,327,605,1482,762,1809
432320,202311,204,463,87,234,16,43,34,85,50,128
432330,202311,203,451,57,166,18,46,11,37,29,83
432335,202311,224,617,65,207,4,9,13,36,17,45
432340,202311,416,973,143,396,18,46,50,137,68,183
432345,202311,1173,2079,901,1727,28,66,745,1379,773,1445
432350,202311,375,893,157,462,31,99,52,132,83,231
432360,202311,283,807,46,142,10,29,11,30,21,59
432370,202311,503,1129,216,592,14,36,105,272,119,308
432375,202311,625,1415,346,854,134,340,59,153,193,493
432377,202311,214,621,42,147,3,11,10,30,13,41
432380,202311,2479,6425,1385,4132,230,730,555,1496,785,2226
500020,202311,4736,10388,2443,6410,321,929,1276,3096,1597,4025
500025,202311,1497,3369,748,1920,91,231,407,954,498,1185
500060,202311,11162,27102,7241,19077,973,2815,4014,9724,4987,12539
500070,202311,6827,15251,4079,10366,838,2226,1744,4244,2582,6470
500080,202311,2053,4632,1027,2709,177,466,434,1035,611,1501
500085,202311,2788,6251,1512,3838,332,882,590,1295,922,2177
500090,202311,2548,6086,1569,4425,278,815,416,1213,694,2028
500100,202311,5383,12274,3276,8440,544,1552,1404,3256,1948,4808
500110,202311,14354,31968,8465,21807,2025,5293,3648,8868,5673,14161
500124,202311,2951,7217,2143,5859,417,1067,1144,3083,1561,4150
500150,202311,2048,4289,1239,3008,197,490,689,1540,886,2030
500190,202311,6650,15623,3397,8904,858,2183,991,2340,1849,4523
500200,202311,3454,7362,1773,4299,246,655,902,1950,1148,2605
500210,202311,6845,14221,4203,10480,1023,2762,2139,4978,3162,7740
500215,202311,1880,4619,1122,3186,138,382,594,1625,732,2007
500220,202311,4684,11289,2951,8002,415,1255,1561,3789,1976,5044
500230,202311,2723,6037,1652,4156,270,697,856,2017,1126,2714
500240,202311,5401,14320,3403,10017,525,1722,1267,3464,1792,5186
500260,202311,4091,8162,2277,5339,263,701,1341,2870,1604,3571
500270,202311,198159,429965,107422,268937,15505,42922,48819,107122,64324,150044
500280,202311,1791,4050,1027,2801,181,463,524,1404,705,1867
500290,202311,4727,10648,2329,6229,395,1231,805,1834,1200,3065
500295,202311,5637,12431,3036,7589,472,1286,1258,2706,1730,3992
500310,202311,1315,2473,693,1609,130,245,319,725,449,970
500315,202311,6261,13428,4762,11300,305,843,3803,8624,4108,9467
500320,202311,26780,64782,15864,44906,3875,10256,6526,19116,10401,29372
500325,202311,8383,16899,4855,11311,669,1735,2863,6066,3532,7801
500330,202311,8852,18594,4939,12238,747,1982,2389,5674,3136,7656
500345,202311,2891,6615,1475,3900,326,853,473,1157,799,2010
500348,202311,3116,6998,2121,5312,410,1084,1273,3004,1683,4088
500350,202311,1526,3847,744,2164,134,399,249,614,383,1013
500370,202311,37146,89262,22978,63085,3724,10982,10163,25656,13887,36638
500375,202311,3189,7967,1587,4530,210,621,554,1337,764,1958
500380,202311,4694,10878,2443,6515,684,1786,333,904,1017,2690
500390,202311,944,1843,499,1222,62,179,298,654,360,833
500400,202311,2202,5227,1154,3069,202,590,403,926,605,1516
500410,202311,3101,6755,1813,4678,228,569,897,2326,1125,2895
500430,202311,3655,8398,1999,5509,344,932,708,2027,1052,2959
500440,202311,2048,4579,855,2354,156,448,305,810,461,1258
500450,202311,2622,6155,1361,3772,309,889,307,838,616,1727
500460,202311,4969,12074,2504,7065,463,1438,439,1049,902,2487
500470,202311,3917,9663,2167,6008,508,1536,627,1446,1135,2982
500480,202311,2424,6937,1786,5807,218,812,1067,3344,1285,4156
500490,202311,1494,3398,712,2033,150,486,163,425,313,911
500500,202311,5187,12836,2877,8689,859,2991,255,754,1114,3745
500510,202311,900,2135,503,1342,50,134,299,693,349,827
500515,202311,2082,4882,1252,3340,208,565,591,1543,799,2108
500520,202311,4366,11362,2894,8566,519,1514,1523,4422,2042,5936
500525,202311,1305,3485,876,2663,147,427,397,1157,544,1584
500540,202311,6934,17069,3491,10392,1081,3513,523,1195,1604,4708
500560,202311,7519,17837,5367,14451,459,1194,3838,10109,4297,11303
500568,202311,6040,12330,3253,7884,921,2161,1132,2528,2053,4689
500570,202311,11846,25285,6919,16592,956,2629,3830,8109,4786,10738
500580,202311,4103,9701,2442,6565,683,1829,848,2219,1531,4048
500600,202311,4932,11456,2816,7486,716,1879,787,2011,1503,3890
500620,202311,11021,25773,5927,15548,927,2483,2802,6643,3729,9126
500625,202311,735,1839,414,1178,70,199,171,432,241,631
500627,202311,978,2500,460,1381,96,309,97,251,193,560
500630,202311,10309,21663,4893,12205,1067,2891,1480,3261,2547,6152
500635,202311,3332,9853,2323,8310,376,1221,1300,5024,1676,6245
500640,202311,2194,4420,1284,3041,90,227,855,1902,945,2129
500660,202311,28932,65318,16454,45051,4408,12501,5264,14151,9672,26652
500690,202311,3595,8401,2186,6014,733,2187,704,1792,1437,3979
500710,202311,4469,10978,2379,6718,495,1470,525,1279,1020,2749
500720,202311,6641,15837,3587,10046,745,2237,1022,2555,1767,4792
500730,202311,1437,3225,664,1788,155,398,185,491,340,889
500740,202311,5743,12917,3130,8488,803,2148,914,2438,1717,4586
500750,202311,1586,3579,868,2279,141,408,378,850,519,1258
500755,202311,1494,3574,719,1999,134,395,200,447,334,842
500769,202311,6790,15703,2906,8003,731,2033,422,928,1153,2961
500770,202311,1767,4458,1147,3361,215,665,335,954,550,1619
500780,202311,1717,4129,831,2314,149,430,197,434,346,864
500790,202311,10600,25806,6105,16923,1093,3252,2214,5575,3307,8827
500793,202311,2865,6686,1625,4176,378,1003,601,1385,979,2388
500795,202311,3842,8143,2732,6558,750,1852,1464,3361,2214,5213
500797,202311,1056,2426,551,1424,166,449,193,449,359,898
500800,202311,4678,10065,2358,6175,562,1546,683,1720,1245,3266
500830,202311,27805,63606,14646,37487,3436,9020,4743,10995,8179,20015
500840,202311,1900,4211,947,2313,112,275,474,1031,586,1306
510010,202311,2240,4508,1388,3272,196,422,874,2017,1070,2439
510020,202311,5732,13853,2197,6349,375,1082,624,1666,999,2748
510025,202311,10129,23074,5559,14954,741,2127,2923,7157,3664,9284
510030,202311,4023,8357,2043,4941,189,496,983,2300,1172,2796
510035,202311,1337,3470,773,2438,209,659,270,922,479,1581
510040,202311,3091,6263,1867,4402,272,618,1011,2388,1283,3006
510050,202311,2973,5557,1779,3912,217,577,1192,2398,1409,2975
510060,202311,2004,4863,1072,2869,297,840,263,573,560,1413
510080,202311,1991,4770,1153,3292,202,668,402,967,604,1635
510100,202311,878,1852,565,1341,72,178,334,733,406,911
510120,202311,366,630,191,416,12,36,137,270,149,306
510125,202311,2525,6179,1577,4312,249,738,575,1356,824,2094
510130,202311,2191,4923,1288,3349,249,729,606,1351,855,2080
510140,202311,3866,9937,2390,7491,1068,3521,508,1647,1576,5168
510160,202311,2677,5703,1844,4507,44,127,1591,3819,1635,3946
510170,202311,6576,15280,4134,10705,690,1924,2169,5105,2859,7029
510180,202311,19225,39205,10978,26426,1449,3712,5825,13501,7274,17213
510185,202311,2130,5224,1219,3685,393,1243,424,1371,817,2614
510190,202311,3260,8430,1687,5462,381,1281,486,1572,867,2853
510250,202311,23113,52752,14377,37926,2219,6242,7633,18975,9852,25217
510260,202311,2461,9651,1951,8703,280,1291,1183,5714,1463,7005
510263,202311,5256,13552,2704,7788,479,1471,635,1408,1114,2879
510267,202311,7542,20106,3452,10313,687,2141,692,1731,1379,3872
510268,202311,1597,3999,855,2501,210,629,141,375,351,1004
510269,202311,1226,3062,695,2003,136,448,301,778,437,1226
510270,202311,3641,9873,2151,6898,397,1311,727,2252,1124,3563
510279,202311,2392,5758,1095,3198,201,607,284,685,485,1292
510285,202311,1398,3403,799,2269,207,640,259,656,466,1296
510300,202311,5413,11748,3569,8913,328,867,2419,5720,2747,6587
510305,202311,1959,5004,1140,3378,270,832,380,1082,650,1914
510310,202311,1410,3210,891,2291,226,572,364,928,590,1500
510320,202311,5398,12354,2819,7490,745,2093,711,1671,1456,3764
510325,202311,5671,15237,3524,10868,929,3108,518,1505,1447,4613
510330,202311,3599,9109,2238,6670,631,1862,958,2786,1589,4648
510335,202311,6398,16472,4209,12497,1083,3392,1523,4202,2606,7594
510336,202311,704,1845,438,1378,56,173,238,787,294,960
510337,202311,1890,4983,1100,3485,403,1303,216,603,619,1906
510340,202311,131604,276787,75012,184260,14907,40367,32623,71198,47530,111565
510343,202311,1563,3486,856,2222,128,355,408,979,536,1334
510345,202311,1904,4385,1068,2674,217,611,588,1324,805,1935
510350,202311,4157,10018,2085,6045,555,1592,456,1256,1011,2848
510360,202311,2324,4412,1203,2947,47,108,870,2143,917,2251
510370,202311,2335,6035,1586,4742,330,900,825,2588,1155,3488
510380,202311,693,1549,355,960,54,185,173,418,227,603
510385,202311,1673,4935,1140,3862,82,346,786,2588,868,2934
510390,202311,1896,4168,1205,3290,227,642,708,1860,935,2502
510395,202311,867,1772,504,1225,44,99,320,771,364,870
510410,202311,7167,17147,4581,12544,539,1508,2886,7629,3425,9137
510420,202311,3444,6269,2076,4315,84,234,1618,3188,1702,3422
510450,202311,641,1458,321,864,62,159,152,394,214,553
510452,202311,1337,3353,918,2497,161,405,516,1415,677,1820
510454,202311,1515,3656,881,2488,152,395,443,1311,595,1706
510455,202311,1207,3052,650,1895,144,448,215,545,359,993
510460,202311,2491,5849,1421,3812,513,1514,405,795,918,2309
510480,202311,6372,14348,3404,8518,622,1684,1550,3375,2172,5059
510490,202311,2262,5174,1500,4030,212,539,900,2383,1112,2922
510500,202311,1826,4153,937,2607,237,674,243,653,480,1327
510510,202311,5164,13318,3063,9355,875,2901,877,2512,1752,5413
510515,202311,6836,16918,4008,11463,790,2326,1565,4136,2355,6462
510517,202311,2172,5154,1276,3628,428,1267,377,992,805,2259
510520,202311,2999,5918,1225,3090,195,538,514,1280,709,1818
510523,202311,1450,3232,852,2174,137,350,453,1076,590,1426
510525,202311,11250,29131,6090,17684,1268,3670,1855,4778,3123,8448
510530,202311,768,1770,517,1385,29,87,372,963,401,1050
510550,202311,3346,8773,2201,6570,438,1369,1055,2955,1493,4324
510558,202311,2815,7162,1795,5380,263,755,886,2692,1149,3447
510560,202311,2598,6939,1340,4214,284,915,198,600,482,1515
510562,202311,8049,17292,4911,11669,796,2070,2537,5321,3333,7391
510590,202311,4337,9721,2756,7282,413,1104,1691,4294,2104,5398
510600,202311,1572,3196,912,2120,202,595,444,855,646,1450
510610,202311,3727,8152,2198,5757,348,958,1199,2968,1547,3926
510615,202311,3636,8753,2190,6227,472,1401,944,2539,1416,3940
510617,202311,1412,3802,1028,3171,120,373,706,2234,826,2607
510618,202311,1706,4028,1055,2864,211,666,548,1332,759,1998
510619,202311,913,2223,434,1312,92,278,92,231,184,509
510620,202311,1772,3742,701,1919,247,751,89,229,336,980
510621,202311,2033,5110,1001,3033,257,815,223,532,480,1347
510622,202311,7457,19242,3442,10148,917,2734,373,896,1290,3630
510623,202311,3781,8402,2067,5242,384,1061,863,2012,1247,3073
510624,202311,1957,4954,850,2630,95,336,146,375,241,711
510625,202311,4861,10893,2571,6650,613,1676,827,2059,1440,3735
510626,202311,1713,4082,1010,2853,335,1073,217,551,552,1624
510627,202311,846,2032,396,1143,132,407,91,264,223,671
510628,202311,1783,3824,1016,2672,331,958,295,680,626,1638
510629,202311,2311,5939,1227,3719,306,1027,226,620,532,1647
510630,202311,4537,11470,2432,7326,575,1688,739,2336,1314,4024
510631,202311,749,1643,494,1215,41,96,368,894,409,990
510637,202311,4680,10259,2509,6422,725,1945,789,1794,1514,3739
510642,202311,7532,18853,4974,14489,1110,3383,2308,6355,3418,9738
510645,202311,1269,2496,679,1650,194,472,250,631,444,1103
510650,202311,10004,21497,6599,16954,787,1465,4389,11954,5176,13419
510665,202311,2120,4352,1088,2589,298,616,346,887,644,1503
510670,202311,518,1090,291,753,38,92,155,410,193,502
510675,202311,8616,22014,4849,14204,1166,3621,993,2494,2159,6115
510677,202311,2660,6565,1747,4967,333,938,950,2626,1283,3564
510680,202311,902,2175,409,1210,64,219,103,258,167,477
510682,202311,2357,6012,1588,4653,403,1231,716,1983,1119,3214
510685,202311,706,1729,415,1156,47,130,229,611,276,741
510700,202311,5493,12177,3295,8687,398,1182,1986,4986,2384,6168
510704,202311,15067,33289,7930,20088,1771,4664,2645,5856,4416,10520
510706,202311,3531,9407,2278,7004,472,1429,1027,3184,1499,4613
510710,202311,3843,8780,1994,5123,635,1586,454,1061,1089,2647
510715,202311,718,1601,381,1000,38,107,242,604,280,711
510718,202311,2815,6311,1506,4257,277,794,733,2199,1010,2993
510719,202311,604,1189,316,750,47,127,153,292,200,419
510720,202311,1126,2417,641,1653,123,336,273,613,396,949
510724,202311,1115,2995,613,1911,95,323,212,570,307,893
510726,202311,1135,2057,549,1215,60,145,349,724,409,869
510729,202311,833,1779,319,858,53,132,87,231,140,363
510730,202311,3680,8320,2202,5723,616,1711,890,2038,1506,3749
510735,202311,1739,4462,1233,3590,149,416,879,2527,1028,2943
510740,202311,1252,2781,673,1653,43,120,454,1003,497,1123
510757,202311,675,2019,451,1562,103,380,160,490,263,870
510760,202311,57650,121448,28175,71172,6905,18609,7316,16075,14221,34684
510770,202311,5554,11017,3556,8190,200,484,2529,5661,2729,6145
510774,202311,570,1379,373,1015,63,165,218,601,281,766
510775,202311,868,2074,430,1258,99,287,100,266,199,553
510776,202311,1014,2458,541,1442,109,302,236,604,345,906
510777,202311,1743,4401,1138,3486,230,810,589,1654,819,2464
510779,202311,1057,2760,631,1934,67,191,373,1174,440,1365
510780,202311,5409,12466,3226,8781,490,1391,1663,4511,2153,5902
510785,202311,2613,6317,1344,3876,312,944,449,1243,761,2187
510787,202311,4693,12271,2433,7175,904,2691,280,742,1184,3433
510788,202311,600,1343,336,883,54,133,156,431,210,564
510790,202311,26589,65047,13367,39105,3054,9466,1509,3950,4563,13416
510792,202311,15156,39138,8109,24092,2042,6243,1921,5067,3963,11310
510794,202311,1580,4102,963,2902,275,891,136,310,411,1201
510795,202311,15292,35531,9102,24085,2047,5808,3123,7124,5170,12932
510800,202311,1933,4913,1090,3164,335,990,159,372,494,1362
510805,202311,1929,4968,1016,3125,198,641,346,952,544,1593
510810,202311,855,1658,506,1161,146,295,252,614,398,909
510820,202311,947,1740,496,1126,32,98,332,674,364,772
510830,202311,953,2298,647,1829,132,388,323,931,455,1319
510835,202311,769,1692,435,1168,70,222,224,536,294,758
510840,202311,84467,164734,50629,116254,8181,18393,28768,63662,36949,82055
510850,202311,2227,5651,1032,3239,225,733,52,110,277,843
510860,202311,3565,8639,2126,6205,828,2598,416,1161,1244,3759
510880,202311,936,2523,561,1759,211,657,65,220,276,877
510885,202311,798,1852,414,1137,93,243,127,342,220,585
510890,202311,1043,2732,584,1781,175,568,108,299,283,867
510895,202311,1907,4492,1134,3078,275,805,487,1156,762,1961
520005,202311,5143,12501,3519,9873,1230,3187,1067,3400,2297,6587
520010,202311,4014,9703,2482,6573,595,1644,939,2221,1534,3865
520013,202311,4766,11104,2517,6702,741,1897,604,1686,1345,3583
520015,202311,618,1469,365,1026,90,230,119,344,209,574
520017,202311,1600,3650,909,2389,159,476,364,865,523,1341
520020,202311,717,1290,468,943,54,112,335,641,389,753
520025,202311,52691,126402,39369,103367,6813,17864,21548,54004,28361,71868
520030,202311,9260,19491,6620,15240,549,1233,4760,10537,5309,11770
520050,202311,528,1187,242,636,61,168,83,207,144,375
520055,202311,2262,5235,1005,2531,171,441,459,1022,630,1463
520060,202311,2571,5933,1511,3982,315,902,425,1085,740,1987
520080,202311,2419,5520,1562,4144,374,947,616,1648,990,2595
520082,202311,1031,2462,602,1624,167,469,196,510,363,979
520085,202311,1284,2930,834,2136,198,494,371,886,569,1380
520090,202311,1101,2012,700,1501,108,145,485,1087,593,1232
520110,202311,60246,146264,31745,90505,8553,25608,1728,4336,10281,29944
520120,202311,329,726,159,419,32,92,66,144,98,236
520130,202311,5228,11345,2985,7220,703,1694,1111,2445,1814,4139
520140,202311,70360,169410,41389,115294,13017,37713,4032,10929,17049,48642
520145,202311,805,1738,403,1059,95,248,97,237,192,485
520150,202311,950,2192,572,1501,76,191,287,705,363,896
520160,202311,1149,2608,628,1620,114,288,280,725,394,1013
520170,202311,5907,12020,3284,8066,562,1378,1810,4221,2372,5599
520180,202311,3710,8316,2601,6539,338,940,1651,3903,1989,4843
520215,202311,2286,4951,1436,3540,145,406,941,2169,1086,2575
520235,202311,981,1906,539,1244,87,201,319,679,406,880
520250,202311,2315,5370,1390,3774,488,1412,94,285,582,1697
520260,202311,912,2035,448,1175,103,252,132,332,235,584
520280,202311,1061,2182,660,1516,155,334,290,660,445,994
520310,202311,1171,2397,667,1601,166,428,291,685,457,1113
520320,202311,2832,6632,1576,4157,220,600,735,1866,955,2466
520330,202311,6634,15432,4423,11356,747,2000,2346,5554,3093,7554
520340,202311,2869,5806,1524,3745,255,543,702,1799,957,2342
520350,202311,4499,10265,2413,6461,733,1946,685,1797,1418,3743
520355,202311,2365,5969,1447,4051,441,1333,215,539,656,1872
520357,202311,1132,2484,732,1869,121,279,455,1168,576,1447
520360,202311,1039,2353,667,1645,87,234,318,693,405,927
520380,202311,1742,4126,818,2257,170,459,233,563,403,1022
520390,202311,1489,3314,825,2200,254,764,128,332,382,1096
520393,202311,925,1931,519,1264,69,197,249,520,318,717
520396,202311,1101,2492,768,1883,84,159,486,1147,570,1306
520400,202311,2067,4474,1406,3477,130,320,940,2310,1070,2630
520410,202311,2807,5796,1602,3759,273,683,817,1806,1090,2489
520420,202311,458,943,321,715,21,60,227,463,248,523
520425,202311,1977,4470,898,2256,279,745,178,345,457,1090
520430,202311,3171,6952,1528,3921,321,851,341,717,662,1568
520440,202311,3908,8885,1866,4951,398,1148,381,946,779,2094
520450,202311,19264,43034,10772,27875,2663,6940,2785,6751,5448,13691
520455,202311,1064,2513,588,1686,162,468,157,445,319,913
520460,202311,1309,2828,843,2104,249,516,320,851,569,1367
520465,202311,1152,2431,840,1961,44,117,627,1383,671,1500
520470,202311,3162,6962,2099,5271,724,1975,728,1672,1452,3647
520480,202311,1381,3350,816,2267,159,444,325,818,484,1262
520485,202311,2066,5636,1495,4544,232,730,873,2549,1105,3279
520490,202311,5602,13130,3669,9837,584,1606,2058,5279,2642,6885
520495,202311,2027,3879,1391,2980,140,283,972,2055,1112,2338
520500,202311,2341,5214,1404,3382,242,672,746,1577,988,2249
520505,202311,1220,2297,860,1806,98,182,591,1221,689,1403
520510,202311,13785,30942,8866,22234,1410,4122,4490,10040,5900,14162
520520,202311,1444,3378,981,2542,277,741,359,871,636,1612
520530,202311,3384,8070,2174,5877,461,1225,910,2617,1371,3842
520540,202311,3990,9496,2067,5555,336,927,725,1654,1061,2581
520545,202311,1938,4351,1181,3018,300,764,414,1045,714,1809
520547,202311,1967,4609,1279,3295,272,689,630,1594,902,2283
520549,202311,22941,52556,16688,42064,2238,5935,10185,24023,12423,29958
520551,202311,6801,15142,4980,12123,475,1341,3558,8075,4033,9416
520552,202311,1320,3030,853,2295,235,608,325,888,560,1496
520570,202311,694,1462,375,923,70,147,179,434,249,581
520580,202311,3143,6084,1869,4385,399,931,945,2133,1344,3064
520590,202311,1745,4016,1008,2670,217,586,377,926,594,1512
520620,202311,13044,30239,8895,23103,1568,4200,4613,11312,6181,15512
520630,202311,1120,2599,706,1870,94,249,346,881,440,1130
520640,202311,2795,6369,1767,4383,525,1306,419,1023,944,2329
520650,202311,1353,2684,849,1933,172,391,467,1042,639,1433
520660,202311,667,1600,310,883,87,261,83,237,170,498
520670,202311,1248,2895,847,2169,87,193,540,1319,627,1512
520680,202311,1072,2282,717,1672,108,214,443,1021,551,1235
520690,202311,515,1173,319,821,95,235,112,272,207,507
520710,202311,561,1267,292,754,21,67,184,433,205,500
520725,202311,1734,3896,1030,2618,268,656,375,946,643,1602
520735,202311,1194,2539,715,1724,214,504,221,499,435,1003
520740,202311,3311,7090,1895,4719,370,982,755,1842,1125,2824
520750,202311,970,1999,626,1444,156,303,296,709,452,1012
520753,202311,1652,3886,1114,2910,220,641,520,1201,740,1842
520760,202311,1875,3651,1349,2969,55,151,1090,2256,1145,2407
520780,202311,2086,4543,1321,3278,239,594,653,1501,892,2095
520790,202311,3992,8733,2265,5728,363,882,1233,3162,1596,4044
520800,202311,25467,57072,17117,43009,3878,9153,8055,20139,11933,29292
520810,202311,1451,3005,916,2281,278,670,323,848,601,1518
520815,202311,748,2110,434,1362,87,275,113,352,200,627
520830,202311,2163,4380,1403,3314,96,227,1025,2315,1121,2542
520840,202311,3788,9273,2549,7123,684,2034,738,1974,1422,4008
520850,202311,1265,2576,711,1681,136,355,343,738,479,1093
520860,202311,12761,30818,7515,20344,1971,5470,2266,5466,4237,10936
520870,202311,210966,446621,126383,302491,24522,60760,55658,121878,80180,182638
520880,202311,13247,34256,8757,24939,1785,5034,3369,9081,5154,14115
520890,202311,6341,12833,3757,8536,607,1539,2005,4082,2612,5621
520910,202311,5997,13818,3400,8850,855,2353,741,1707,1596,4060
520915,202311,1090,2565,590,1529,98,282,288,656,386,938
520920,202311,5721,11745,3612,8609,792,1763,1885,4525,2677,6288
520929,202311,793,1747,510,1255,108,210,206,554,314,764
520940,202311,1240,2991,833,2270,107,248,494,1289,601,1537
520945,202311,578,1210,353,842,139,295,103,262,242,557
520960,202311,1474,2977,979,2245,359,759,345,834,704,1593
520970,202311,5093,11848,3214,8517,1099,2866,686,1855,1785,4721
520980,202311,963,2037,601,1461,103,237,281,645,384,882
520990,202311,4040,8659,2878,6975,442,935,1912,4629,2354,5564
520993,202311,1544,3521,794,1971,296,705,185,438,481,1143
520995,202311,3272,7605,1899,5007,586,1623,311,902,897,2525
521000,202311,12513,29432,6716,17609,1230,3257,2200,5215,3430,8472
521010,202311,5373,12385,3404,8630,609,1670,1637,3724,2246,5394
521015,202311,983,2228,545,1361,23,60,368,834,391,894
521020,202311,6430,14427,3379,8657,833,2126,936,2257,1769,4383
521030,202311,1040,1777,635,1207,44,86,508,921,552,1007
521040,202311,11405,25854,6751,17428,1731,4421,1872,4835,3603,9256
521056,202311,1349,3300,805,2273,252,700,108,317,360,1017
521060,202311,1244,2965,757,2038,290,780,120,331,410,1111
521080,202311,1306,2671,581,1483,111,283,152,350,263,633
521090,202311,3946,9877,2053,5712,452,1343,209,508,661,1851
521100,202311,2450,4987,1546,3609,220,549,888,1981,1108,2530
521120,202311,6428,14443,4160,10726,1408,3749,782,2108,2190,5857
521130,202311,1340,3035,635,1717,128,342,258,688,386,1030
521140,202311,2195,4930,1338,3278,203,548,770,1707,973,2255
521150,202311,19054,40222,10412,26066,2931,7674,3396,7676,6327,15350
521160,202311,1066,2009,590,1233,58,126,391,752,449,878
521170,202311,1373,2983,810,2007,176,477,300,661,476,1138
521180,202311,11251,26410,7566,19655,1692,4756,3167,7751,4859,12507
521190,202311,15676,36063,8636,23157,2090,5920,2790,6685,4880,12605
521200,202311,889,2023,503,1330,103,288,182,419,285,707
521205,202311,783,1692,545,1292,29,78,416,932,445,1010
521210,202311,1135,2786,539,1492,154,436,105,230,259,666
521220,202311,4929,10849,2865,7240,810,2257,1088,2293,1898,4550
521225,202311,566,1086,347,796,22,57,266,590,288,647
521230,202311,1922,4416,1354,3465,599,1611,357,840,956,2451
521250,202311,49782,113123,34662,88640,7670,20390,16821,40264,24491,60654
521260,202311,689,1425,453,1050,81,187,240,496,321,683
521270,202311,2747,6018,2035,4960,229,530,1351,3272,1580,3802
521280,202311,2364,5724,1483,4072,308,878,532,1350,840,2228
521290,202311,734,1536,370,932,35,101,209,481,244,582
521295,202311,1533,3166,911,2154,151,365,476,1023,627,1388
521300,202311,2345,5262,1507,3814,308,814,691,1673,999,2487
521305,202311,861,1817,503,1219,46,109,326,740,372,849
521308,202311,6138,14786,3473,9440,372,1108,1947,4853,2319,5961
521310,202311,14709,34228,7885,20548,1732,4646,2617,6181,4349,10827
521340,202311,534,1140,294,737,21,55,170,387,191,442
521350,202311,2435,5765,1658,4477,131,397,1159,2972,1290,3369
521370,202311,1652,3999,845,2410,275,815,117,364,392,1179
521375,202311,2317,5538,1302,3534,291,751,368,992,659,1743
521377,202311,1551,3260,989,2415,118,247,655,1628,773,1875
521380,202311,8642,21207,4240,12158,770,2369,733,2005,1503,4374
521385,202311,891,1968,549,1442,79,201,301,804,380,1005
521390,202311,901,2135,513,1428,112,363,96,204,208,567
521400,202311,3956,8526,2411,5919,397,1007,1334,3125,1731,4132
521405,202311,1700,4151,882,2430,118,352,409,1034,527,1386
521410,202311,1180,2569,823,1981,197,418,429,1080,626,1498
521440,202311,1836,4168,1128,2900,294,685,437,1103,731,1788
521450,202311,5742,15278,3468,10255,992,2875,722,2042,1714,4917
521460,202311,8982,20508,4813,12633,1368,3602,1173,2997,2541,6599
521470,202311,1123,2550,631,1572,86,186,321,739,407,925
521480,202311,743,1449,392,863,50,112,220,412,270,524
521483,202311,2948,6613,1831,4758,651,1672,517,1376,1168,3048
521486,202311,2193,4902,1367,3464,150,304,817,2012,967,2316
521487,202311,621,1348,401,983,85,176,226,549,311,725
521490,202311,1032,2472,663,1780,48,170,439,1049,487,1219
521500,202311,2544,6250,1555,4290,267,805,682,1654,949,2459
521520,202311,1081,2276,749,1734,101,214,449,1005,550,1219
521523,202311,19868,51588,13370,38465,4256,11882,4766,13096,9022,24978
521525,202311,1323,2953,857,2170,190,455,420,1017,610,1472
521530,202311,2874,6994,1608,4395,314,879,463,1119,777,1998
521540,202311,910,2200,593,1632,149,441,225,562,374,1003
521550,202311,2331,5503,908,2484,183,531,193,521,376,1052
521560,202311,7660,17590,4817,13086,1385,3784,1608,4399,2993,8183
521565,202311,861,1979,502,1314,111,294,215,530,326,824
521570,202311,6014,14732,3380,9429,872,2573,567,1572,1439,4145
521580,202311,719,1565,356,895,71,171,144,333,215,504
521590,202311,1161,2374,700,1661,115,289,372,818,487,1107
521600,202311,559,1365,292,804,61,159,135,340,196,499
521630,202311,2161,4339,1090,2601,402,953,191,419,593,1372
521640,202311,2500,5549,1353,3560,309,897,344,808,653,1705
521645,202311,671,1625,308,902,128,360,29,75,157,435
521680,202311,1845,4467,1254,3369,326,908,514,1263,840,2171
521690,202311,646,1489,444,1148,57,167,237,567,294,734
521710,202311,4559,10192,2664,6800,605,1608,921,2160,1526,3768
521720,202311,3099,6742,1565,4096,211,569,678,1711,889,2280
521730,202311,5865,14194,3349,9352,936,2769,603,1369,1539,4138
521740,202311,6242,14249,3771,9668,1137,3098,1085,2195,2222,5293
521760,202311,25083,56907,17952,45238,3924,10231,9539,22422,13463,32653
521770,202311,4154,9091,2161,5593,441,1211,417,1048,858,2259
521800,202311,9339,21878,5482,14870,1804,4912,1169,3377,2973,8289
521805,202311,1435,2872,718,1733,144,322,318,778,462,1100
521810,202311,973,2078,604,1486,93,217,354,862,447,1079
521830,202311,7835,18940,5539,14774,913,2171,3153,8125,4066,10296
521839,202311,1097,2335,684,1604,57,143,456,954,513,1097
521850,202311,9598,20479,5017,12661,1691,4375,581,1316,2272,5691
521860,202311,2238,5637,1226,3497,264,770,345,862,609,1632
521870,202311,992,2441,592,1633,105,310,241,547,346,857
521878,202311,1164,2779,584,1550,57,158,307,731,364,889
521880,202311,34590,77997,20839,53462,4099,11076,8554,19736,12653,30812
521890,202311,4298,10022,2250,5945,611,1595,521,1242,1132,2837
521900,202311,1819,4037,871,2331,315,796,80,223,395,1019
521910,202311,1736,3656,1103,2667,285,684,390,874,675,1558
521920,202311,731,1679,469,1196,63,192,258,578,321,770
521925,202311,1129,2549,656,1692,156,394,293,729,449,1123
521930,202311,7201,16143,3952,10638,1267,2971,1343,3892,2610,6863
521935,202311,1273,2853,742,1881,96,247,426,1021,522,1268
521940,202311,1667,3517,944,2337,162,427,505,1200,667,1627
521945,202311,915,2067,467,1219,97,219,226,582,323,801
521950,202311,969,2095,576,1420,139,286,246,623,385,909
521960,202311,841,2008,508,1335,59,166,284,652,343,818
521970,202311,3405,7235,2250,5509,354,797,1274,3089,1628,3886
521971,202311,1013,2305,466,1259,113,287,110,260,223,547
521973,202311,2198,5226,1282,3457,221,567,514,1302,735,1869
521975,202311,18672,42365,13239,33225,2167,5705,7735,17964,9902,23669
521980,202311,2782,6103,1834,4651,164,450,1281,3127,1445,3577
521990,202311,1836,4172,1270,3169,258,664,668,1606,926,2270
522000,202311,3380,8011,2274,6265,883,2505,604,1683,1487,4188
522005,202311,526,1075,276,680,45,132,96,229,141,361
522010,202311,6063,14072,3575,9384,902,2400,1093,2625,1995,5025
522015,202311,1361,3195,897,2361,283,701,299,780,582,1481
522020,202311,7083,15233,3997,9961,958,2448,1643,3936,2601,6384
522026,202311,1017,2461,597,1650,96,296,205,502,301,798
522028,202311,687,1533,391,956,53,158,201,419,254,577
522040,202311,4966,9936,2703,6243,700,1491,1150,2458,1850,3949
522045,202311,28059,70441,17064,48441,3953,11538,4039,10526,7992,22064
522050,202311,1598,3731,955,2466,194,552,433,990,627,1542
522060,202311,4298,10329,2541,7061,564,1482,941,2576,1505,4058
522068,202311,2278,4877,1533,3782,247,456,939,2329,1186,2785
522070,202311,1100,2134,816,1712,42,87,659,1326,701,1413
522100,202311,1133,2626,640,1732,125,344,238,612,363,956
522108,202311,1518,3004,1036,2316,58,136,792,1641,850,1777
522119,202311,2562,5401,1813,4310,259,565,1092,2559,1351,3124
522130,202311,711,1558,457,1136,41,106,311,748,352,854
522140,202311,33510,78383,19338,50653,4370,11841,5738,13427,10108,25268
522145,202311,937,2112,592,1547,163,441,263,652,426,1093
522150,202311,1431,3091,766,1926,176,427,202,520,378,947
522155,202311,1237,2902,732,1931,138,371,396,1008,534,1379
522157,202311,956,1887,673,1487,47,98,491,1069,538,1167
522160,202311,8235,19107,4377,11649,1164,3247,439,1207,1603,4454
522170,202311,3540,8319,2408,6363,430,1082,1299,3386,1729,4468
522180,202311,976,2028,497,1118,91,194,130,288,221,482
522185,202311,33714,75619,20839,55253,8699,24473,2680,7050,11379,31523
522190,202311,1039,2224,605,1501,103,289,275,586,378,875
522200,202311,2849,7052,1775,4937,422,1161,592,1559,1014,2720
522205,202311,2050,4723,1224,3190,551,1530,209,439,760,1969
522220,202311,1525,3273,912,2350,136,330,457,1187,593,1517
522230,202311,1810,3913,1098,2691,121,323,654,1477,775,1800
530010,202311,393073,896155,290304,715003,46301,117270,161142,368788,207443,486058
110001,202310,4943,12663,2865,8530,746,2398,737,2003,1483,4401
110002,202310,18905,43897,11393,29960,2839,7879,3250,7918,6089,15797
110003,202310,969,2608,585,1795,164,507,103,292,267,799
110004,202310,18269,42437,9888,26553,2214,6160,3231,8043,5445,14203
110005,202310,3201,7733,1856,5227,546,1526,513,1448,1059,2974
110006,202310,1848,4838,978,2971,201,655,194,495,395,1150
110007,202310,1457,3483,704,2034,176,514,120,344,296,858
110008,202310,4424,10283,2940,8021,646,1566,1494,4488,2140,6054
110009,202310,5697,14741,3071,9553,673,2181,809,2320,1482,4501
110010,202310,10409,28279,7219,22463,1958,5425,3039,10746,4997,16171
110011,202310,9941,23927,5853,16106,1631,4669,1199,2967,2830,7636
110012,202310,23352,53465,12784,34043,3355,8742,3394,8470,6749,17212
110013,202310,7886,20327,4685,13880,1749,5330,697,2075,2446,7405
110014,202310,4697,11340,2641,7313,525,1549,969,2576,1494,4125
110015,202310,7833,18254,4249,11374,1028,3044,1251,2675,2279,5719
110018,202310,5947,13865,2974,7992,723,2006,687,1610,1410,3616
110020,202310,124096,257957,81778,192785,17359,42338,41190,93982,58549,136320
110025,202310,5943,13405,3402,8725,591,1649,1594,3667,2185,5316
110026,202310,733,1811,417,1206,102,307,113,329,215,636
110028,202310,9594,22505,4795,13292,1240,3742,462,1133,1702,4875
110029,202310,1969,4560,962,2680,202,559,373,1004,575,1563
110030,202310,18857,41310,9413,24993,2889,8101,1304,3225,4193,11326
110032,202310,4766,12067,2387,7093,748,2266,385,1136,1133,3402
110033,202310,6026,16248,4175,12655,1262,3863,1402,4372,2664,8235
110034,202310,3970,8853,2263,6099,845,2406,483,1350,1328,3756
110037,202310,1857,5206,1109,3659,304,1038,225,708,529,1746
110040,202310,3769,9607,2275,6676,671,2118,433,1139,1104,3257
110045,202310,5733,15112,3562,10827,1081,3428,962,2774,2043,6202
110050,202310,2113,5303,1090,3306,358,1196,105,223,463,1419
110060,202310,1194,3249,633,1924,183,548,115,324,298,872
110070,202310,1830,5174,1162,3694,328,1096,234,616,562,1712
110080,202310,8196,18091,5361,13691,1345,3500,2427,6133,3772,9633
110090,202310,757,1933,440,1312,127,421,123,335,250,756
110092,202310,1807,4740,1088,3281,264,843,497,1420,761,2263
110094,202310,3759,9884,2383,7161,761,2328,433,1356,1194,3684
110100,202310,2166,5716,1514,4471,545,1665,413,1199,958,2864
110110,202310,2335,5804,1369,4028,400,1245,210,651,610,1896
110120,202310,1702,4397,987,2932,275,827,257,724,532,1551
110130,202310,3300,7582,1673,4548,476,1364,200,530,676,1894
110140,202310,3168,8122,2075,5926,457,1390,896,2416,1353,3806
110143,202310,1777,4474,1127,3209,336,1027,356,947,692,1974
110145,202310,1155,2776,594,1671,191,506,187,550,378,1056
110146,202310,683,1687,380,1094,138,394,83,258,221,652
110147,202310,996,2341,510,1367,63,171,241,567,304,738
110148,202310,1226,3066,483,1445,125,402,48,91,173,493
110149,202310,4373,10393,2604,7241,868,2497,577,1611,1445,4108
110150,202310,2874,7297,1553,4874,583,1979,126,338,709,2317
110155,202310,1068,2859,635,1822,131,416,222,566,353,982
110160,202310,1892,5153,1125,3459,399,1270,148,464,547,1734
110170,202310,2514,5910,1446,3904,273,793,743,1802,1016,2595
110175,202310,2758,7000,1612,4653,311,932,664,1792,975,2724
110180,202310,1640,4068,983,2791,274,799,257,709,531,1508
120001,202310,4531,11252,3261,9175,490,1522,2021,5408,2511,6930
120005,202310,2606,8645,2214,7965,258,944,1522,5535,1780,6479
120010,202310,7924,18673,6435,16320,639,1536,4734,11894,5373,13430
120013,202310,3262,9025,2596,7954,1001,3018,889,2922,1890,5940
120017,202310,3843,9181,2859,7586,431,1105,1764,4800,2195,5905
120020,202310,20010,60521,17236,55032,1315,4268,12647,39817,13962,44085
120025,202310,4821,10829,3674,9319,634,1565,2215,5817,2849,7382
120030,202310,7769,27640,6762,25619,565,2279,4636,17621,5201,19900
120032,202310,2190,8564,1996,8136,102,628,1623,6419,1725,7047
120033,202310,5619,16147,5032,15085,144,557,4244,12374,4388,12931
120034,202310,3720,11081,3040,9875,159,649,2401,7539,2560,8188
120035,202310,5262,16288,4690,15271,234,859,3990,12675,4224,13534
120038,202310,4228,10752,3323,9201,624,1769,1820,5055,2444,6824
120039,202310,2558,9515,2289,8942,176,884,1727,6544,1903,7428
120040,202310,81237,193418,61951,160405,8536,22162,36809,91585,45345,113747
120042,202310,4329,13123,3744,11975,160,625,3025,9442,3185,10067
120043,202310,1840,6471,1499,5908,69,421,1159,4397,1228,4818
120045,202310,7268,16427,5444,13883,715,1878,3498,8719,4213,10597
120050,202310,12414,36400,10776,33639,501,1824,8484,26038,8985,27862
120060,202310,12492,40892,10866,38121,561,2547,8690,29672,9251,32219
120070,202310,4584,12339,3609,10739,777,2147,1921,6049,2698,8196
120080,202310,7089,16166,5947,14405,678,1556,4373,10471,5051,12027
130002,202310,4456,13825,3809,12899,443,1209,2991,10564,3434,11773
130006,202310,3286,10020,2567,8824,438,1386,1617,5874,2055,7260
130008,202310,3339,9951,2773,9070,219,690,2199,7336,2418,8026
130010,202310,5508,12916,4548,11693,162,406,3975,10090,4137,10496
130014,202310,5011,12507,3364,9812,757,2227,1659,4997,2416,7224
130020,202310,3424,12122,2787,10974,215,1207,1922,7159,2137,8366
130030,202310,20137,41440,17669,38478,276,714,16510,35518,16786,36232
130040,202310,5068,13719,3942,12192,625,1791,2656,8511,3281,10302
130050,202310,8801,29225,7089,26522,669,2439,5081,18972,5750,21411
130060,202310,9074,32502,7520,30126,373,1995,6015,23576,6388,25571
130063,202310,8239,23141,7030,21604,249,1038,6196,18586,6445,19624
130068,202310,4874,13451,3942,12136,252,823,3206,9833,3458,10656
130070,202310,9091,23601,7074,21028,912,2260,4905,15152,5817,17412
130080,202310,9612,27971,7917,25810,309,1007,6675,21729,6984,22736
130083,202310,3780,10324,3111,9433,238,725,2469,7698,2707,8423
130090,202310,5106,12535,4304,11504,111,317,3658,9897,3769,10214
130100,202310,9078,25605,7282,23476,276,968,6027,19483,6303,20451
130110,202310,11059,26429,8195,22359,1787,4336,4482,13316,6269,17652
130115,202310,6353,17125,5067,15346,175,497,4227,12839,4402,13336
130120,202310,21023,57789,17441,52620,1884,5976,13057,39131,14941,45107
130130,202310,7242,19389,5387,16782,759,2296,3554,11603,4313,13899
130140,202310,9136,27585,7650,25626,357,1446,6337,21048,6694,22494
130150,202310,5043,14744,4447,13849,237,994,3445,10438,3682,11432
130160,202310,8100,21809,6808,20067,334,937,5815,17111,6149,18048
130165,202310,4300,13618,3853,12935,107,407,3289,10936,3396,11343
130170,202310,18424,41131,14473,36230,618,1534,12331,30307,12949,31841
130180,202310,5466,15382,5041,14833,62,328,4682,13551,4744,13879
130185,202310,25861,53909,19965,46928,1574,2599,16189,39139,17763,41738
130190,202310,27246,75389,21150,65880,2605,7522,14796,46492,17401,54014
130195,202310,3074,10111,2539,9364,137,575,2021,7506,2158,8081
130200,202310,3761,8982,2870,7713,230,692,2097,5445,2327,6137
130210,202310,2033,6716,1707,6201,204,920,1137,3850,1341,4770
130220,202310,3388,9005,2683,8112,129,383,2302,6989,2431,7372
130230,202310,6494,22391,5584,21073,187,1027,4875,18234,5062,19261
130240,202310,18331,40579,14715,35983,207,849,13340,31649,13547,32498
130250,202310,32590,85980,26128,77321,1736,4357,20319,60897,22055,65254
130255,202310,6225,16405,4914,14106,301,725,3807,10832,4108,11557
130260,202310,509026,1109156,388011,927805,70889,176991,240106,551202,310995,728193
130270,202310,12778,37985,9979,33427,2021,5923,6057,21151,8078,27074
130280,202310,4712,15281,4149,14556,191,819,3597,12462,3788,13281
130290,202310,22076,52707,18644,48435,690,2206,16437,41905,17127,44111
130300,202310,6305,17689,5219,16072,243,918,4089,12236,4332,13154
130310,202310,10636,25216,8826,22800,572,1582,7087,17839,7659,19421
130320,202310,4357,12823,3339,11185,492,1596,2003,6729,2495,8325
130330,202310,5669,15672,4341,13885,248,801,3409,10981,3657,11782
130340,202310,31757,80440,25620,72513,1823,4343,20326,58846,22149,63189
130350,202310,4631,15133,4020,14242,161,745,3383,11768,3544,12513
130353,202310,9400,23085,6971,19486,1343,3505,4040,11590,5383,15095
130356,202310,7046,18975,5450,16351,1350,3714,2742,8622,4092,12336
130360,202310,3596,10829,2704,9571,234,960,2122,7339,2356,8299
130370,202310,6468,25243,5218,23147,683,3651,3044,13356,3727,17007
130380,202310,10389,39620,9288,37577,794,3499,6941,27717,7735,31216
130390,202310,9375,31419,7724,28661,498,2450,6166,22151,6664,24601
130395,202310,3170,8616,2466,7430,155,540,1966,5743,2121,6283
130400,202310,3701,9713,2925,8596,100,322,2493,7203,2593,7525
130406,202310,14995,46024,12225,42201,3428,10303,6583,24315,10011,34618
130410,202310,5687,17077,4631,15352,1266,4154,2498,8567,3764,12721
130420,202310,19991,57247,16334,52343,2571,7348,10862,36022,13433,43370
130423,202310,5417,15660,4521,14473,328,1359,3656,11383,3984,12742
130426,202310,3964,12196,3470,11580,126,398,2983,10380,3109,10778
130430,202310,6302,13879,5075,12235,251,669,4220,9867,4471,10536
130440,202310,7354,17260,6021,15563,176,526,5446,13856,5622,14382
140002,202310,3112,8218,2478,7366,406,996,1641,5183,2047,6179
140005,202310,4312,11361,3410,10102,2046,6130,705,2137,2751,8267
140010,202310,75276,193587,54682,158178,14577,43620,18046,52011,32623,95631
140015,202310,7993,15837,6198,13862,277,593,5429,12018,5706,12611
140017,202310,7283,16729,5622,14464,447,1037,4215,10947,4662,11984
140020,202310,7153,17601,5631,15500,755,1948,3637,10268,4392,12216
140023,202310,3653,9203,2701,7748,347,1053,1872,5310,2219,6363
140028,202310,2546,6024,1964,5210,143,374,1465,3900,1608,4274
140030,202310,7943,16548,6336,14534,356,752,5246,11886,5602,12638
140040,202310,3725,13061,3335,12524,157,858,2774,10188,2931,11046
140045,202310,6436,19998,5360,18355,2020,5975,2433,9522,4453,15497
140047,202310,7898,20196,6099,17269,962,2653,3539,10182,4501,12835
140050,202310,2365,5943,1779,4990,346,847,993,2847,1339,3694
140060,202310,2930,6261,2386,5498,223,432,1831,4210,2054,4642
140070,202310,2563,11907,2406,11564,168,1053,1826,8601,1994,9654
150010,202310,66051,135754,53120,117513,1494,3142,45653,98190,47147,101332
150013,202310,2773,5636,2122,4841,70,153,1799,4027,1869,4180
150020,202310,19544,49035,16721,44797,1785,3857,12755,34752,14540,38609
150030,202310,11772,36586,10122,34330,824,2140,7803,28057,8627,30197
150034,202310,5357,11543,3725,9156,270,674,2762,6598,3032,7272
150040,202310,20345,47696,16383,42675,1069,1937,13919,37114,14988,39051
150050,202310,10006,26566,8555,24451,292,941,7460,21333,7752,22274
150060,202310,31252,74849,22604,60629,3746,9714,12992,34995,16738,44709
150070,202310,10994,31028,9133,28539,313,1282,7911,24223,8224,25505
150080,202310,117244,247752,81814,192344,22491,51268,27897,70850,50388,122118
150085,202310,12447,28658,10175,25559,230,668,9073,22269,9303,22937
150090,202310,16128,40527,14148,37197,581,1489,12017,30853,12598,32342
150095,202310,9376,19872,7488,17350,796,1336,5793,13696,6589,15032
150100,202310,3856,11436,3161,10254,184,577,2580,8254,2764,8831
150110,202310,5972,19510,5378,18751,168,667,4769,16558,4937,17225
150120,202310,10240,26843,8798,24633,417,987,7391,20653,7808,21640
150125,202310,1186,2763,780,2122,94,271,468,1239,562,1510
150130,202310,32651,81215,24847,67735,4995,12269,14193,39868,19188,52137
150140,202310,393042,741300,292857,595632,25417,51975,212606,411854,238023,463829
150145,202310,5373,15044,3874,12395,1512,4814,855,3320,2367,8134
150150,202310,23577,50840,17349,41634,1929,4338,11494,26999,13423,31337
150157,202310,4495,11051,3210,9063,507,1496,1807,5097,2314,6593
150160,202310,5256,10820,4378,9464,309,721,3458,7073,3767,7794
150170,202310,36451,90986,30259,80070,5766,13051,18419,51640,24185,64691
150172,202310,7398,16250,5486,13407,438,1049,4090,9879,4528,10928
150175,202310,2612,6276,2031,5292,172,565,1536,3773,1708,4338
150178,202310,16286,33820,11570,27985,1070,1571,8844,22671,9914,24242
150180,202310,36765,92610,31499,86082,2925,5032,24592,72346,27517,77378
150190,202310,9904,23939,8276,21730,218,721,6939,17659,7157,18380
150195,202310,6634,17536,5768,16208,181,525,5124,14204,5305,14729
150200,202310,7442,18602,6320,17141,91,285,5596,15039,5687,15324
150210,202310,42414,107429,37774,100715,1240,3013,32953,87406,34193,90419
150215,202310,15125,38354,11040,30177,1831,5223,6197,16178,8028,21401
150220,202310,18263,42775,14151,36073,918,2037,10335,25704,11253,27741
150230,202310,18550,42795,15345,37947,1943,4075,10910,27173,12853,31248
150240,202310,46652,112849,34589,90352,7572,19634,14937,36869,22509,56503
150250,202310,5557,17986,5008,17297,346,1187,4294,14864,4640,16051
150260,202310,3923,9924,3121,8599,114,352,2491,6593,2605,6945
150270,202310,11263,28684,6751,19871,1885,5634,1656,4949,3541,10583
150275,202310,9966,24608,8558,22542,251,838,7274,18443,7525,19281
150276,202310,3070,7587,2415,6642,277,722,1595,4527,1872,5249
150277,202310,7092,15570,4723,12147,727,1709,2923,7390,3650,9099
150280,202310,9575,30256,8789,28942,801,2139,6896,23463,7697,25602
150285,202310,4470,12934,3650,11454,245,725,2751,8446,2996,9171
150290,202310,14197,32511,11759,29398,428,915,10091,25224,10519,26139
150293,202310,12018,26522,8434,21181,1000,2588,5400,12913,6400,15501
150295,202310,9356,22326,5581,16391,1846,5224,1836,5887,3682,11111
150300,202310,4252,8689,3631,7910,58,143,3344,7201,3402,7344
150304,202310,5580,14363,4252,12146,875,2332,2456,7169,3331,9501
150307,202310,7260,19977,6091,17949,257,749,4718,13705,4975,14454
150309,202310,8050,20595,5771,16465,1021,2840,3157,9058,4178,11898
150310,202310,9221,31075,8364,29776,508,2107,6855,24406,7363,26513
150320,202310,12166,27904,9898,24200,1369,2842,6603,16238,7972,19080
150330,202310,19831,51319,17058,47154,2929,6657,10967,33056,13896,39713
150340,202310,3055,8010,2426,6956,267,673,1660,4724,1927,5397
150345,202310,11772,27720,9732,24895,465,1286,8095,20238,8560,21524
150350,202310,12915,26311,10602,23155,1023,1701,8401,18480,9424,20181
150360,202310,32706,80110,23379,66261,2212,4947,16692,47917,18904,52864
150370,202310,14532,37032,10854,31432,1539,3932,7292,21977,8831,25909
150375,202310,5064,18246,4337,16925,294,1256,3362,12745,3656,14001
150380,202310,12823,28503,9284,23327,450,1151,7259,17656,7709,18807
150390,202310,10203,35789,8359,32201,2031,6453,4505,19235,6536,25688
150400,202310,8269,25440,7478,24021,165,502,6261,20446,6426,20948
150405,202310,11288,25532,8714,21845,841,1509,6493,16815,7334,18324
150410,202310,2402,6406,1887,5529,165,450,1280,3701,1445,4151
150420,202310,61784,146945,43018,116455,9648,27153,20491,54288,30139,81441
150430,202310,10361,25779,8439,22810,779,1621,6277,16830,7056,18451
150440,202310,8784,20169,7301,17999,566,1309,5889,14342,6455,15651
150442,202310,39729,79447,29106,64425,1774,3978,21843,46048,23617,50026
150445,202310,10197,23954,8417,21340,196,542,7382,18403,7578,18945
150450,202310,8232,24457,7490,23403,252,1220,6747,20352,6999,21572
150460,202310,11317,29722,9772,27538,541,1153,8052,23198,8593,24351
150470,202310,25590,61723,20660,54702,673,2454,17242,43463,17915,45917
150475,202310,7155,19107,5464,16158,991,2610,3220,9892,4211,12502
150480,202310,18318,48278,15482,43852,4357,10733,8551,26291,12908,37024
150490,202310,10212,31353,8728,28933,862,2360,6434,22037,7296,24397
150495,202310,6830,18418,5936,17023,206,746,5041,14001,5247,14747
150497,202310,3416,9457,2342,7454,437,1418,1187,3770,1624,5188
150500,202310,3838,9096,2977,7596,181,497,2240,5438,2421,5935
150503,202310,7696,18062,4868,13955,1585,4053,1708,5400,3293,9453
150506,202310,17636,43230,14076,37913,2297,5826,9417,26291,11714,32117
150510,202310,16591,42669,13181,36699,1196,2796,10041,27957,11237,30753
150520,202310,10908,31505,9997,30161,134,711,9186,27176,9320,27887
150530,202310,16542,48584,13471,43734,1426,3935,9820,32260,11246,36195
150540,202310,6611,14811,5339,12854,368,833,4259,10078,4627,10911
150543,202310,9132,23259,6616,19237,708,2170,4347,12471,5055,14641
150548,202310,13389,35310,11141,31782,556,1453,9217,26201,9773,27654
150549,202310,2370,5850,1840,5021,129,391,1361,3631,1490,4022
150550,202310,25999,67711,18012,52311,5354,15539,5919,17098,11273,32637
150553,202310,53337,130155,34418,94540,10144,27605,12779,34743,22923,62348
150555,202310,2644,6203,1810,4846,184,481,1208,3224,1392,3705
150560,202310,2565,6157,1980,5107,185,467,1292,3211,1477,3678
150563,202310,3485,9027,2558,7352,612,1808,1260,3530,1872,5338
150565,202310,5768,16232,4571,14023,201,612,3518,10721,3719,11333
150570,202310,10004,23529,8588,21479,194,553,7582,18437,7776,18990
150580,202310,15129,50582,12371,47084,1710,5426,8735,34903,10445,40329
150590,202310,10775,30621,8635,27704,482,1629,6866,21900,7348,23529
150600,202310,13427,34873,11700,32393,511,1416,10063,27721,10574,29137
150610,202310,4132,9158,3382,8004,143,373,2795,6362,2938,6735
150611,202310,4098,9613,3237,8280,106,319,2647,6453,2753,6772
150613,202310,18762,46743,12329,34974,2749,8322,5171,13747,7920,22069
150616,202310,4846,12055,3046,8580,653,1876,1441,3935,2094,5811
150618,202310,9454,23165,6970,18940,1148,3277,4118,10885,5266,14162
150619,202310,8224,20818,6196,17687,1195,3012,3700,10959,4895,13971
150620,202310,9823,28230,7808,24202,1924,5423,3667,11709,5591,17132
150630,202310,9319,18997,8025,17242,138,334,7246,15092,7384,15426
150635,202310,6936,16227,5128,13041,641,1488,3201,8045,3842,9533
150640,202310,2583,6805,2222,6312,64,197,1910,5387,1974,5584
150650,202310,15713,37316,12260,31380,3795,9460,4613,12393,8408,21853
150655,202310,7077,17317,5859,15403,150,533,4864,12284,5014,12817
150658,202310,5485,14567,3504,10950,1070,3474,1272,3887,2342,7361
150660,202310,7160,18045,5670,15544,1407,3735,2857,7682,4264,11417
150670,202310,12904,25277,9047,20276,1310,3126,5957,13024,7267,16150
150680,202310,101554,249923,71832,199832,16629,42071,35658,104167,52287,146238
150690,202310,3293,7096,2519,6008,155,355,2000,4695,2155,5050
150700,202310,9023,22133,7231,19361,1020,2088,4832,13385,5852,15473
150710,202310,4818,13460,3853,11712,862,2609,2071,6283,2933,8892
150715,202310,6760,15696,5006,13051,452,1204,3761,9531,4213,10735
150720,202310,10717,26039,9063,23485,367,1133,7586,18895,7953,20028
150730,202310,17759,46285,13589,39430,2467,7440,8306,24219,10773,31659
150740,202310,5140,12426,4002,10546,476,1048,2771,7334,3247,8382
150745,202310,7155,17346,5202,14301,727,2107,3357,9066,4084,11173
150746,202310,2206,5489,1763,4764,77,232,1380,3596,1457,3828
150747,202310,7116,16885,5778,14778,437,985,4508,11466,4945,12451
150750,202310,4902,12705,3595,10665,368,1106,2454,7365,2822,8471
150760,202310,14911,37937,12235,33559,2567,6465,6936,19681,9503,26146
150770,202310,9048,26405,7992,25009,255,590,7039,22509,7294,23099
150775,202310,1535,3536,1101,2927,113,350,738,1887,851,2237
150780,202310,6472,16916,5400,15497,234,693,4569,13098,4803,13791
150790,202310,8004,18466,6279,16352,583,1241,4184,12440,4767,13681
150795,202310,21996,55481,17657,48513,3435,9078,10201,28166,13636,37244
150796,202310,5122,10475,3945,8934,338,759,3112,6913,3450,7672
150797,202310,5817,14728,4492,12588,441,1199,3399,9368,3840,10567
150800,202310,18975,51188,15174,44873,3085,8436,8593,26181,11678,34617
150803,202310,11265,25265,9419,22557,273,783,8142,18734,8415,19517
150805,202310,4640,12481,3479,10547,516,1499,2209,6700,2725,8199
150808,202310,8384,22455,5442,16997,1828,6285,753,2303,2581,8588
150810,202310,27800,61309,19134,49208,4596,11494,9282,25399,13878,36893
150812,202310,8594,19338,6798,16243,515,1428,5020,11148,5535,12576
150815,202310,11903,31625,9308,28020,1790,5276,5952,18157,7742,23433
150820,202310,19196,38987,15286,33741,1506,2440,11773,26788,13279,29228
150830,202310,16698,45580,14664,42562,593,1598,12636,36560,13229,38158
150835,202310,4689,12332,3782,10852,442,1315,2557,7229,2999,8544
150840,202310,11119,27470,7847,21588,1094,3218,4569,11844,5663,15062
160005,202310,1845,3841,1470,3378,54,141,1233,2727,1287,2868
160010,202310,2800,6767,2375,6230,64,226,2111,5375,2175,5601
160015,202310,5143,10623,4294,9616,447,822,3581,8108,4028,8930
160020,202310,3268,8380,2672,7517,337,863,1886,5505,2223,6368
160021,202310,1653,5145,1330,4709,65,329,866,3130,931,3459
160023,202310,1790,5385,1456,4771,274,821,826,2813,1100,3634
160025,202310,2451,6290,2174,5948,298,538,1751,5063,2049,5601
160027,202310,14678,29927,12067,26395,1083,2196,9503,20731,10586,22927
160030,202310,119044,274163,89774,231368,16279,39229,51432,135501,67711,174730
160040,202310,7991,22653,6703,20740,565,1548,5296,16464,5861,18012
160050,202310,8912,20973,7137,18639,2506,5824,3479,9902,5985,15726
160053,202310,5776,14544,4675,12828,270,693,3706,10232,3976,10925
160055,202310,2230,4258,1963,3931,28,55,1813,3529,1841,3584
160060,202310,40035,84293,30689,72388,4235,8063,21569,52166,25804,60229
160070,202310,4196,12170,3425,10955,439,1211,2451,8159,2890,9370
160080,202310,4107,10513,3394,9660,70,226,2984,8489,3054,8715
170025,202310,793,1959,394,1186,103,308,84,238,187,546
170030,202310,1400,3821,881,2744,170,513,311,946,481,1459
170035,202310,1733,4089,1063,2855,116,330,585,1468,701,1798
170040,202310,2206,5429,1463,4178,263,732,696,2053,959,2785
170070,202310,2374,5002,1426,3550,131,385,820,1927,951,2312
170100,202310,3074,7503,2165,5869,328,791,1320,3572,1648,4363
170105,202310,765,2044,437,1358,108,336,111,293,219,629
170110,202310,1353,3432,860,2517,73,237,465,1274,538,1511
170130,202310,1804,4430,1168,3266,102,336,748,1988,850,2324
170190,202310,1864,4393,1257,3342,148,449,753,1844,901,2293
170200,202310,2378,5271,1268,3269,348,835,362,925,710,1760
170210,202310,34397,85042,21251,59890,5590,16239,4141,11543,9731,27782
170215,202310,1525,3663,1001,2806,92,291,614,1623,706,1914
170220,202310,6923,19476,5069,15913,2450,7575,844,3065,3294,10640
170230,202310,1533,3918,1003,2847,176,516,468,1238,644,1754
170240,202310,3631,8213,2528,6351,266,687,1662,3948,1928,4635
170255,202310,4501,11886,2921,8829,558,1674,1346,3986,1904,5660
170270,202310,991,2295,601,1617,66,181,349,883,415,1064
170290,202310,3756,9299,2943,7978,321,636,2107,5893,2428,6529
170300,202310,2589,5861,1780,4554,133,365,1243,2943,1376,3308
170305,202310,808,1989,522,1408,83,225,239,622,322,847
170307,202310,1362,3696,987,2939,113,369,619,1676,732,2045
170310,202310,1981,4377,1205,3087,210,526,571,1410,781,1936
170320,202310,1258,3049,780,2183,101,293,431,1152,532,1445
170330,202310,1224,3257,961,2794,55,230,688,1830,743,2060
170360,202310,717,1654,455,1212,38,91,262,627,300,718
170370,202310,1634,3676,949,2469,137,399,503,1155,640,1554
170380,202310,2260,5842,1506,4511,196,513,794,2418,990,2931
170382,202310,571,1531,408,1220,18,72,246,646,264,718
170384,202310,2110,6342,1520,5087,299,960,711,2231,1010,3191
170386,202310,1164,2983,542,1664,65,219,192,516,257,735
170388,202310,839,2030,527,1460,92,254,281,729,373,983
170389,202310,998,2898,687,2293,113,406,354,1172,467,1578
170390,202310,2110,4297,1345,3237,61,184,1029,2401,1090,2585
170410,202310,725,1648,453,1149,30,79,303,707,333,786
170460,202310,511,1260,321,896,41,122,174,456,215,578
170510,202310,1068,2692,629,1827,39,141,391,1027,430,1168
170550,202310,8352,19835,5418,14657,1400,4022,1927,4824,3327,8846
170555,202310,1633,3910,1060,2872,151,384,504,1334,655,1718
170560,202310,1147,2915,748,2230,103,299,360,1080,463,1379
170600,202310,1676,4065,1084,3055,155,405,598,1635,753,2040
170610,202310,1991,4549,1218,3165,91,281,795,1894,886,2175
170625,202310,524,1263,277,740,51,116,119,292,170,408
170650,202310,1847,4511,1328,3625,142,433,851,2175,993,2608
170700,202310,4355,11496,2785,8130,558,1668,1118,2988,1676,4656
170710,202310,2108,4566,1349,3363,135,367,881,2092,1016,2459
170720,202310,2242,4958,1448,3660,168,435,924,2211,1092,2646
170730,202310,1340,3171,830,2281,119,299,464,1248,583,1547
170740,202310,2479,7100,1821,5796,157,575,1258,3817,1415,4392
170755,202310,999,2407,604,1685,118,339,259,640,377,979
170765,202310,1337,3157,795,2156,152,383,380,996,532,1379
170770,202310,2258,5697,1627,4615,133,441,1162,3128,1295,3569
170820,202310,4771,12328,3020,8969,626,1884,1335,3713,1961,5597
170825,202310,1360,2835,909,2133,106,227,632,1439,738,1666
170830,202310,1625,3800,1047,2789,366,1001,336,767,702,1768
170900,202310,3907,10431,3123,9221,472,1164,2027,6153,2499,7317
170930,202310,4981,12095,3265,8734,758,2121,1171,2902,1929,5023
170950,202310,14480,37135,8030,23948,2359,7338,1027,2890,3386,10228
170980,202310,621,1440,330,903,48,135,145,366,193,501
171050,202310,2008,5586,1529,4694,149,450,1059,3244,1208,3694
171070,202310,1646,4025,1257,3391,262,592,633,1920,895,2512
171090,202310,1167,2860,812,2247,143,410,401,1062,544,1472
171110,202310,669,1695,380,1090,71,205,163,427,234,632
171150,202310,1133,2587,594,1648,112,358,268,629,380,987
171180,202310,762,2048,389,1253,74,240,137,429,211,669
171190,202310,2543,7046,1959,5960,312,969,1082,3260,1394,4229
171195,202310,1022,2811,664,2063,86,278,377,1064,463,1342
171200,202310,736,1906,426,1301,105,344,104,272,209,616
171215,202310,507,1205,364,935,50,142,161,375,211,517
171240,202310,914,2650,596,2006,18,88,399,1237,417,1325
171245,202310,903,2409,564,1690,62,217,263,674,325,891
171250,202310,1103,2857,609,1855,89,287,231,684,320,971
171270,202310,581,1832,390,1393,69,274,175,572,244,846
171280,202310,1039,2793,725,2213,61,180,432,1300,493,1480
171320,202310,4806,12213,2981,8590,638,1834,1059,2963,1697,4797
171330,202310,3678,9010,2287,6368,627,1747,882,2343,1509,4090
171360,202310,1937,4694,1187,3470,142,375,654,2006,796,2381
171370,202310,820,1946,526,1465,76,235,281,716,357,951
171380,202310,1661,4076,1173,3273,168,407,680,1887,848,2294
171395,202310,1186,2814,733,2064,121,340,375,1014,496,1354
171420,202310,2413,5864,1508,4089,260,696,775,1988,1035,2684
171430,202310,1317,3428,887,2552,82,264,519,1349,601,1613
171488,202310,3029,7547,2011,5670,371,1080,963,2576,1334,3656
171500,202310,1044,2446,602,1603,93,278,302,759,395,1037
171510,202310,1026,2860,750,2299,66,274,490,1352,556,1626
171515,202310,582,1298,364,938,27,89,231,522,258,611
171525,202310,847,2072,508,1445,67,213,287,739,354,952
171550,202310,406,1052,257,799,32,132,109,280,141,412
171570,202310,1348,3474,977,2747,142,401,554,1473,696,1874
171575,202310,1844,4454,1113,3121,192,555,522,1368,714,1923
171610,202310,7349,19031,4378,13225,1177,3773,686,2070,1863,5843
171620,202310,3654,8123,2809,6796,217,492,2077,4894,2294,5386
171630,202310,1332,3186,877,2451,139,392,500,1388,639,1780
171650,202310,2812,7394,1750,5214,482,1529,332,953,814,2482
171660,202310,2767,6360,1630,4331,129,398,1098,2744,1227,3142
171665,202310,1551,3905,1021,2940,251,793,345,936,596,1729
171670,202310,2260,5387,1475,3955,318,898,635,1571,953,2469
171700,202310,1401,3530,896,2511,140,366,500,1354,640,1720
171720,202310,884,2042,536,1423,70,196,324,823,394,1019
171750,202310,1632,4541,976,3175,215,687,281,1034,496,1721
171780,202310,1520,3457,928,2430,93,288,556,1346,649,1634
171790,202310,1624,4774,1162,3787,176,575,597,1859,773,2434
171800,202310,861,2072,541,1474,67,177,298,743,365,920
171820,202310,14714,37247,8724,25646,1969,6005,2146,6186,4115,12191
171830,202310,1921,5368,1477,4490,388,1100,612,2055,1000,3155
171840,202310,852,2014,529,1433,38,111,310,776,348,887
171845,202310,884,1944,536,1376,64,163,321,775,385,938
171850,202310,1267,3241,947,2590,42,154,728,1847,770,2001
171855,202310,1189,3302,784,2444,107,316,414,1211,521,1527
171865,202310,593,1516,405,1131,62,200,207,487,269,687
171870,202310,964,2429,554,1653,107,332,229,643,336,975
171875,202310,1782,4279,1293,3439,64,254,997,2481,1061,2735
171880,202310,1818,4227,1364,3507,56,164,1067,2671,1123,2835
171884,202310,1382,3170,897,2302,145,359,510,1263,655,1622
171886,202310,1753,4352,1083,3196,333,1007,260,803,593,1810
171888,202310,653,1757,406,1245,39,139,225,614,264,753
171889,202310,514,1449,289,959,84,278,83,263,167,541
171890,202310,1588,4103,944,2838,116,388,535,1487,651,1875
171900,202310,729,2117,467,1570,64,218,215,698,279,916
172000,202310,670,1866,429,1336,79,229,134,398,213,627
172010,202310,1623,4350,1158,3444,102,272,744,2200,846,2472
172015,202310,442,1382,290,1044,49,185,115,360,164,545
172020,202310,3500,8850,2647,7428,354,965,1645,4661,1999,5626
172025,202310,869,2117,525,1477,45,131,342,878,387,1009
172030,202310,1484,3964,1042,3133,97,326,674,1908,771,2234
172049,202310,1394,3328,805,2370,111,338,409,1178,520,1516
172065,202310,1789,4094,1178,3159,168,385,585,1707,753,2092
172080,202310,2761,7320,1943,5724,131,418,1250,3555,1381,3973
172085,202310,492,1262,233,683,39,119,77,201,116,320
172090,202310,4994,10659,3525,8452,165,510,2688,5978,2853,6488
172093,202310,539,1471,346,1074,26,129,195,532,221,661
172097,202310,750,1819,380,1091,62,201,152,400,214,601
172100,202310,66364,149691,39243,101039,7401,20250,16137,38674,23538,58924
172110,202310,2145,6513,1606,5534,135,583,1125,3707,1260,4290
172120,202310,6350,16387,4216,12476,598,1635,2265,6606,2863,8241
172125,202310,492,1203,290,813,22,76,161,376,183,452
172130,202310,644,1542,401,1098,17,53,222,516,239,569
172208,202310,3019,6597,2031,5092,174,410,1397,3392,1571,3802
172210,202310,3266,7179,2176,5516,244,582,1447,3658,1691,4240
210005,202310,24781,62459,16064,46708,4591,13641,5751,16274,10342,29915
210010,202310,2685,6699,2337,6225,49,171,2060,5384,2109,5555
210015,202310,3871,10159,3090,8932,151,459,2500,7155,2651,7614
210020,202310,9537,18631,7462,15984,419,793,6237,13189,6656,13982
210030,202310,5588,16444,4721,14972,614,1999,3241,9947,3855,11946
210040,202310,2576,5109,2086,4476,87,225,1803,3765,1890,3990
210043,202310,6829,17542,5272,15111,361,1060,3879,10921,4240,11981
210047,202310,8538,21998,6200,18552,219,836,4786,13839,5005,14675
210050,202310,3017,8127,2214,6577,160,596,1576,4396,1736,4992
210055,202310,2601,6586,2103,5802,70,159,1741,4876,1811,5035
210060,202310,8830,28890,7339,25973,1058,3649,4593,16455,5651,20104
210070,202310,8108,18730,6952,17111,191,494,6172,14952,6363,15446
210080,202310,5397,14583,4769,13698,95,412,4226,11884,4321,12296
210083,202310,7192,16488,5807,14812,120,424,5272,13200,5392,13624
210087,202310,3153,8105,2494,7144,151,432,1995,5649,2146,6081
210090,202310,11014,29903,9495,27260,718,1574,7581,21849,8299,23423
210095,202310,7344,22849,6239,21029,744,2373,4364,15146,5108,17519
210100,202310,7765,20972,6049,17648,979,2683,3665,10620,4644,13303
210110,202310,3797,9227,3288,8534,56,206,2887,7298,2943,7504
210120,202310,35677,75725,26878,63178,1373,2843,21081,48240,22454,51083
210125,202310,5567,13069,4474,11616,920,1914,2891,8004,3811,9918
210130,202310,4974,11395,3746,9718,61,189,3279,8364,3340,8553
210135,202310,2170,4715,1669,3951,66,172,1441,3334,1507,3506
210140,202310,25844,61769,17425,48133,2689,7036,9569,25714,12258,32750
210150,202310,5599,12020,4428,10291,121,325,3696,8285,3817,8610
210160,202310,26934,60500,20723,51468,2896,6205,13821,34349,16717,40554
210170,202310,21430,54528,17950,49241,2479,5857,12323,34554,14802,40411
210173,202310,2619,8378,2346,7880,96,386,2051,6732,2147,7118
210177,202310,3849,9564,3097,8503,460,1166,2152,6017,2612,7183
210180,202310,1849,4091,1438,3499,31,109,1236,2957,1267,3066
210190,202310,6943,15103,5343,12704,114,257,4635,10735,4749,10992
210193,202310,1607,4044,1279,3504,95,253,921,2525,1016,2778
210197,202310,2373,6536,1970,5893,172,468,1470,4434,1642,4902
210200,202310,9783,26520,8009,23636,901,2633,5671,16444,6572,19077
210203,202310,8286,21997,6412,19271,781,2149,4453,13634,5234,15783
210207,202310,4598,10172,3323,8444,172,451,2466,6159,2638,6610
210210,202310,8927,24652,7614,22689,191,832,6244,18131,6435,18963
210215,202310,2912,8150,2399,7334,180,692,1887,5615,2067,6307
210220,202310,8719,23663,7789,22171,250,1104,6824,18595,7074,19699
210230,202310,6899,17264,5873,15564,301,680,5032,13283,5333,13963
210232,202310,14992,39559,11485,33891,1593,4332,7473,22207,9066,26539
210235,202310,4011,10686,3195,9311,145,486,2577,7354,2722,7840
210237,202310,5105,10859,4110,9629,91,255,3757,8661,3848,8916
210240,202310,3049,8150,2493,7156,134,333,1960,5595,2094,5928
210250,202310,7277,17561,6226,16128,144,477,5489,13869,5633,14346
210255,202310,3164,8612,2265,6714,310,937,1267,3540,1577,4477
210260,202310,6409,16657,5212,14750,569,1663,3922,10802,4491,12465
210270,202310,5712,13760,4652,12283,172,613,3803,9735,3975,10348
210275,202310,3964,9060,3096,7903,203,484,2454,6263,2657,6747
210280,202310,7655,17203,5848,14349,157,600,4600,10497,4757,11097
210290,202310,9941,21682,8345,19677,219,505,7530,17512,7749,18017
210300,202310,38177,97101,28175,80646,8641,24991,9340,29367,17981,54358
210310,202310,3613,8003,2926,6988,37,107,2629,6167,2666,6274
210312,202310,3453,7176,2880,6500,47,135,2534,5511,2581,5646
210315,202310,4326,9645,3680,8890,137,357,3338,7997,3475,8354
210317,202310,5190,14304,4499,13333,137,512,3921,11465,4058,11977
210320,202310,33351,69707,28995,63962,374,1219,26259,56343,26633,57562
210325,202310,4225,10794,3137,9151,569,1773,2029,5789,2598,7562
210330,202310,33746,77563,24535,65253,3354,7180,16023,45874,19377,53054
210340,202310,15235,33477,12366,29393,633,1348,9934,23571,10567,24919
210350,202310,11801,28111,9711,25097,223,684,8322,20990,8545,21674
210355,202310,4407,13296,3649,11939,90,422,2943,9443,3033,9865
210360,202310,14798,42474,11897,37028,574,2133,8262,24568,8836,26701
210370,202310,14607,27336,10283,22600,330,585,9257,20415,9587,21000
210375,202310,3857,9778,2444,7309,1059,3191,430,1258,1489,4449
210380,202310,6675,15361,5181,13245,292,727,4189,10455,4481,11182
210390,202310,3897,9764,3442,9022,113,397,3036,7776,3149,8173
210400,202310,5493,13774,4367,12164,286,667,3561,9959,3847,10626
210405,202310,9048,20739,6495,16779,969,2264,3898,9983,4867,12247
210407,202310,2469,6941,1893,5819,215,546,1314,4057,1529,4603
210408,202310,3288,10524,2910,9915,182,741,2277,7693,2459,8434
210409,202310,4609,13809,3799,12374,255,993,2743,8829,2998,9822
210410,202310,4384,11325,3244,9042,97,357,2531,6677,2628,7034
210420,202310,4642,13208,3730,11479,249,738,2895,8758,3144,9496
210430,202310,2768,7077,2240,6245,195,534,1775,4877,1970,5411
210440,202310,5003,12219,3898,10578,202,494,3235,8662,3437,9156
210450,202310,2705,7083,2128,6108,301,685,1444,4265,1745,4950
210455,202310,5912,13652,4068,10907,1079,2915,1647,4314,2726,7229
210460,202310,3941,10339,2968,8809,158,523,2231,6409,2389,6932
210462,202310,2021,5425,1522,4567,75,227,1160,3456,1235,3683
210465,202310,3160,8081,2555,7154,129,419,2089,5697,2218,6116
210467,202310,7324,19032,5903,16900,966,2527,3974,11516,4940,14043
210470,202310,2042,5338,1439,4348,198,543,942,2865,1140,3408
210480,202310,20351,54393,15699,47631,2337,5443,10038,32821,12375,38264
210490,202310,3833,8724,2766,7204,124,312,2233,5743,2357,6055
210500,202310,7692,25047,6722,23201,428,1585,5302,17905,5730,19490
210510,202310,8358,20819,6863,18814,184,676,6012,16063,6196,16739
210515,202310,4370,11580,3481,10301,229,707,2730,8043,2959,8750
210520,202310,3108,8125,2487,7131,183,519,1923,5375,2106,5894
210530,202310,69251,154898,45560,115353,9525,24663,20424,51501,29949,76164
210535,202310,4593,12342,3896,11231,190,564,3270,9346,3460,9910
210540,202310,18276,46986,13790,39601,2473,6174,7858,23609,10331,29783
210542,202310,7686,16580,5242,13405,591,1510,3725,9348,4316,10858
210545,202310,2485,7044,2071,6241,62,249,1655,4829,1717,5078
210547,202310,4451,14058,3711,12694,318,936,2714,9572,3032,10508
210550,202310,6937,19264,4771,15332,725,2325,2565,8224,3290,10549
210560,202310,4390,12362,3563,10873,155,506,2890,8636,3045,9142
210565,202310,1793,4602,1336,3890,88,241,911,2619,999,2860
210570,202310,12906,32245,10548,28753,741,1867,8478,22977,9219,24844
210580,202310,3406,7907,2429,6488,242,617,1697,4696,1939,5313
210590,202310,4802,12934,3755,11382,93,379,3109,9194,3202,9573
210592,202310,3352,8218,2827,7282,59,208,2381,5918,2440,6126
210594,202310,2883,7548,1999,5985,225,641,1286,3862,1511,4503
210596,202310,3513,10423,2886,9268,350,1094,2088,6769,2438,7863
210598,202310,2395,5827,2014,5275,115,286,1662,4302,1777,4588
210600,202310,3573,8987,2643,7492,386,1005,1586,4491,1972,5496
210610,202310,3726,8624,2815,7285,67,226,2313,5776,2380,6002
210620,202310,3553,7778,2702,6638,146,314,2234,5410,2380,5724
210630,202310,3763,10579,3094,9298,278,863,2239,6566,2517,7429
210632,202310,7308,16659,6141,15025,177,481,5329,12704,5506,13185
210635,202310,1837,6013,1629,5577,219,655,1146,4040,1365,4695
210637,202310,3300,8995,2600,7880,199,633,1974,6000,2173,6633
210640,202310,5939,16688,5289,15833,82,378,4683,13705,4765,14083
210650,202310,8201,20600,6742,18425,143,444,5820,15657,5963,16101
210660,202310,9421,24450,7632,21338,178,743,6488,17371,6666,18114
210663,202310,3676,8215,3022,7348,319,572,2183,5621,2502,6193
210667,202310,2246,6373,1871,5754,87,316,1518,4617,1605,4933
210670,202310,6994,17372,5916,15633,148,477,5097,13048,5245,13525
210675,202310,6566,14413,5175,12537,733,1605,3757,9106,4490,10711
210680,202310,5917,11828,4717,10342,103,248,4314,9318,4417,9566
210690,202310,11376,25404,8798,22020,259,681,7707,18644,7966,19325
210700,202310,3231,7881,2416,6629,173,382,1808,4918,1981,5300
210710,202310,6404,16435,5265,14767,130,461,4557,12525,4687,12986
210720,202310,3698,10118,3009,9152,136,490,2517,7563,2653,8053
210725,202310,1551,4386,1117,3524,59,171,758,2400,817,2571
210730,202310,1751,3595,1336,3018,47,95,1164,2604,1211,2699
210735,202310,5326,13252,4134,11536,431,1019,3099,8916,3530,9935
210740,202310,6354,14167,4924,12299,143,317,4099,10043,4242,10360
210745,202310,4968,11979,4062,10635,113,396,3431,8724,3544,9120
210750,202310,32581,77223,25179,65226,4425,9959,14566,38849,18991,48808
210760,202310,7795,15882,6191,14004,140,325,5622,12682,5762,13007
210770,202310,7304,16177,5716,14096,94,333,5033,12076,5127,12409
210780,202310,8732,23996,6760,20389,523,1538,4865,14258,5388,15796
210790,202310,5218,14195,4267,12718,363,1054,3188,9635,3551,10689
210800,202310,5867,13807,4647,12013,92,358,4050,10077,4142,10435
210805,202310,5063,15448,4326,14137,249,876,3343,10772,3592,11648
210810,202310,5999,15472,4968,13906,609,1450,3669,10552,4278,12002
210820,202310,8487,21947,6420,18288,1216,3155,3287,9482,4503,12637
210825,202310,10733,23852,9206,21728,237,659,8288,19008,8525,19667
210830,202310,10727,24838,9055,22482,926,1685,7092,18227,8018,19912
210840,202310,6098,10510,5214,9372,43,125,4938,8657,4981,8782
210845,202310,7357,17441,5767,15341,170,466,5052,13284,5222,13750
210850,202310,8637,21948,6752,18989,488,1413,5184,14254,5672,15667
210860,202310,26032,56808,19442,47861,1990,4134,14044,35268,16034,39402
210870,202310,8830,19184,6539,16283,229,527,5515,13525,5744,14052
210880,202310,4979,13078,3921,11307,268,841,2842,8005,3110,8846
210890,202310,6078,13160,5134,11796,185,476,4484,9970,4669,10446
210900,202310,5890,15256,4019,11657,1476,4178,821,2683,2297,6861
210905,202310,2752,5625,2227,4937,64,143,2061,4519,2125,4662
210910,202310,8895,24857,6513,20338,1515,4436,3085,9539,4600,13975
210920,202310,3730,10255,3105,9292,93,376,2687,7839,2780,8215
210923,202310,2329,5214,1858,4467,81,169,1481,3442,1562,3611
210927,202310,5467,16346,4380,14565,836,2487,2469,8525,3305,11012
210930,202310,3503,8995,2875,7901,109,322,2392,6330,2501,6652
210940,202310,4002,10825,3361,9940,268,1139,2599,7071,2867,8210
210945,202310,10284,23188,8597,20989,656,1224,6734,16696,7390,17920
210950,202310,6448,15871,4567,12995,703,1616,2826,8483,3529,10099
210955,202310,1798,4846,1346,4037,171,498,843,2468,1014,2966
210960,202310,11123,29465,8292,24200,3567,10104,1909,6322,5476,16426
210970,202310,2101,4825,1584,3918,91,241,1243,2905,1334,3146
210975,202310,1989,5524,1655,4932,241,708,1088,3188,1329,3896
210980,202310,12693,24621,10693,22287,363,543,9623,19993,9986,20536
210990,202310,21927,53033,15693,43735,1886,4714,10259,28987,12145,33701
211000,202310,17354,44165,13201,38187,3374,8396,7490,23198,10864,31594
211003,202310,7616,17475,6017,15424,137,518,5059,12626,5196,13144
211010,202310,8464,23740,7221,21944,209,869,6257,18702,6466,19571
211020,202310,11498,26263,9473,23677,232,649,8213,20321,8445,20970
211023,202310,2474,7044,2086,6385,137,387,1586,4755,1723,5142
211027,202310,4771,11610,4229,10766,97,327,3812,9447,3909,9774
211030,202310,4559,11346,3752,10074,458,1181,2680,7288,3138,8469
211040,202310,5354,16559,4659,15333,143,632,3994,12870,4137,13502
211050,202310,10897,24635,8987,21993,205,597,7739,18517,7944,19114
211060,202310,9301,22452,7905,20373,308,983,6762,16889,7070,17872
211065,202310,2955,6808,2228,5782,122,303,1817,4647,1939,4950
211070,202310,10311,27224,8155,23736,422,1300,6542,18628,6964,19928
211080,202310,1576,3769,1135,3013,37,143,847,2057,884,2200
211085,202310,2721,6640,2022,5629,243,588,1433,4120,1676,4708
211090,202310,3712,9084,3095,8201,49,175,2762,7180,2811,7355
211100,202310,9059,18526,7856,16990,104,252,7183,15292,7287,15544
211102,202310,3933,11043,3323,10054,616,1881,2190,6556,2806,8437
211105,202310,2763,7664,2194,6621,122,366,1695,4975,1817,5341
211107,202310,5498,15487,4252,13363,214,666,3303,10477,3517,11143
211110,202310,7724,17795,5716,14581,491,1162,4348,10851,4839,12013
211120,202310,63032,137108,46476,113628,8156,17814,27595,68877,35751,86691
211125,202310,2149,5835,1613,4928,48,180,1290,3833,1338,4013
211130,202310,226893,486057,177349,408906,26041,53090,112043,259116,138084,312206
211140,202310,5636,14749,4404,12771,257,739,3431,9819,3688,10558
211150,202310,11657,27282,8919,23348,579,1193,6701,18035,7280,19228
211153,202310,3687,8825,2307,6892,465,1236,1233,3903,1698,5139
211157,202310,1530,4177,1205,3560,121,385,779,2220,900,2605
211160,202310,6583,14214,4823,11525,195,621,3737,8319,3932,8940
211163,202310,1733,4952,1449,4469,81,270,1152,3556,1233,3826
211167,202310,2034,5199,1731,4726,38,116,1474,3942,1512,4058
211170,202310,8868,17155,7544,15447,122,348,6919,13736,7041,14084
211172,202310,3017,7586,2291,6363,105,296,1831,4858,1936,5154
211174,202310,3523,8797,3000,8148,68,240,2699,7212,2767,7452
211176,202310,4977,12558,3576,10338,244,726,2728,7687,2972,8413
211178,202310,6609,12329,5424,10984,59,225,5113,10079,5172,10304
211180,202310,4940,14207,4174,12900,164,599,3318,10028,3482,10627
211190,202310,3831,9427,3048,8197,73,270,2621,6821,2694,7091
211195,202310,1902,4380,1497,3727,74,173,1236,3010,1310,3183
211200,202310,2491,6798,1697,5255,191,575,1081,3228,1272,3803
211210,202310,7201,20056,5893,17895,644,1894,4236,12774,4880,14668
211220,202310,53651,114157,40185,95131,3932,8621,28562,65907,32494,74528
211223,202310,6308,15408,4497,12533,681,1844,2516,6852,3197,8696
211227,202310,2000,5546,1622,4954,76,286,1284,3891,1360,4177
211230,202310,10555,25240,8358,21857,341,758,6939,17930,7280,18688
211240,202310,12962,28456,11717,26872,165,570,10931,24586,11096,25156
211245,202310,9022,18746,7383,16889,213,520,6733,15147,6946,15667
211250,202310,18450,47059,15571,42257,1454,3946,11686,31068,13140,35014
211260,202310,9994,26963,8063,24471,296,978,6830,20612,7126,21590
211270,202310,11998,33070,9663,29665,498,1464,7406,22722,7904,24186
211280,202310,19474,40891,16133,36303,368,937,14355,31419,14723,32356
211285,202310,2451,6837,2000,6076,201,656,1364,4032,1565,4688
211290,202310,8611,22730,6961,19900,436,1294,5210,14488,5646,15782
211300,202310,8417,22444,6628,19146,474,1434,4718,13183,5192,14617
211400,202310,13877,33896,10315,28374,1609,3985,6406,18175,8015,22160
220005,202310,2370,5333,1913,4585,93,225,1554,3569,1647,3794
220010,202310,1778,4397,1263,3438,77,172,926,2476,1003,2648
220020,202310,5714,11859,4475,10031,292,578,3719,8094,4011,8672
220025,202310,2740,5308,2101,4328,63,126,1760,3482,1823,3608
220027,202310,1689,3541,1281,2904,37,96,1072,2339,1109,2435
220030,202310,4773,9871,3919,8567,142,319,3409,7226,3551,7545
220040,202310,10369,27062,8102,22646,1787,4565,4199,11983,5986,16548
220045,202310,1972,4844,1460,3957,64,254,1133,2844,1197,3098
220050,202310,6850,14326,5315,12167,87,297,4685,10217,4772,10514
220060,202310,3463,5872,2664,4916,95,194,2395,4330,2490,4524
220070,202310,2822,6479,2103,5394,108,301,1578,3858,1686,4159
220080,202310,882,2257,656,1862,27,109,491,1291,518,1400
220090,202310,2043,4264,1473,3376,49,128,1187,2636,1236,2764
220095,202310,1271,2234,1042,1924,29,69,930,1640,959,1709
220100,202310,1682,3946,1152,3037,54,172,870,2123,924,2295
220105,202310,2380,6428,1831,5436,197,580,1241,3643,1438,4223
220110,202310,4253,9901,3277,8286,83,303,2662,6513,2745,6816
220115,202310,3531,8884,2841,7720,176,502,2138,5564,2314,6066
220117,202310,1597,3410,1136,2694,27,82,933,2111,960,2193
220120,202310,20921,39555,17292,34766,272,721,15763,30829,16035,31550
220130,202310,1316,3057,1001,2595,30,106,853,2100,883,2206
220140,202310,2832,5128,2079,4203,94,160,1714,3455,1808,3615
220150,202310,7971,19659,6448,16837,220,676,5125,12750,5345,13426
220155,202310,1428,3695,1023,2928,36,106,719,1976,755,2082
220157,202310,1295,2775,984,2305,44,99,736,1640,780,1739
220160,202310,3518,8257,2618,6624,70,208,2071,4999,2141,5207
220170,202310,1810,4368,1303,3553,47,151,1022,2679,1069,2830
220173,202310,2506,6323,1722,4828,77,227,1339,3622,1416,3849
220177,202310,2862,6149,2457,5622,46,174,2234,4957,2280,5131
220180,202310,1403,2851,1011,2165,18,52,859,1711,877,1763
220190,202310,10282,20375,7754,16888,711,1269,5432,11915,6143,13184
220191,202310,2044,5219,1683,4575,137,395,1212,3164,1349,3559
220192,202310,2404,5674,1584,4228,57,182,1240,3211,1297,3393
220194,202310,2306,5329,1757,4296,46,169,1416,3227,1462,3396
220196,202310,2566,5802,2099,4998,37,112,1687,3836,1724,3948
220198,202310,1552,3400,1222,2959,27,85,1054,2537,1081,2622
220200,202310,6115,15764,4953,13915,197,616,3838,10477,4035,11093
220202,202310,2581,6203,1970,5149,40,140,1642,4115,1682,4255
220205,202310,3307,7546,2651,6353,64,198,2158,4941,2222,5139
220207,202310,964,2505,724,2058,89,233,421,1179,510,1412
220208,202310,2155,5948,1615,4876,594,1908,468,1313,1062,3221
220209,202310,1880,4952,1388,3955,23,97,1116,3091,1139,3188
220210,202310,2277,4594,1717,3701,42,103,1454,2994,1496,3097
220211,202310,1956,4146,1582,3602,28,85,1329,2943,1357,3028
220213,202310,2149,4963,1538,3811,47,135,1178,2689,1225,2824
220217,202310,2939,6875,2521,6359,161,285,2161,5595,2322,5880
220220,202310,16893,33289,13150,27628,506,1172,10846,21828,11352,23000
220225,202310,1225,2651,913,2231,14,51,798,1867,812,1918
220230,202310,6977,15055,5264,12428,424,1010,4003,9123,4427,10133
220240,202310,4024,9705,3020,7915,106,350,2363,5872,2469,6222
220245,202310,2491,4310,1709,3345,26,83,1533,2896,1559,2979
220250,202310,3679,8732,2908,7658,74,222,2493,6425,2567,6647
220253,202310,2026,4860,1528,4046,62,177,1209,3091,1271,3268
220255,202310,2451,5013,1921,4233,68,193,1620,3386,1688,3579
220260,202310,6329,15059,4886,12501,279,692,3792,9481,4071,10173
220265,202310,1923,4853,1597,4325,87,274,1262,3241,1349,3515
220270,202310,7450,21181,6429,19120,226,831,5219,14684,5445,15515
220271,202310,1819,3955,1434,3341,69,154,1176,2672,1245,2826
220272,202310,2081,5374,1645,4520,83,247,1195,3136,1278,3383
220273,202310,1506,3938,1099,3168,85,261,773,2184,858,2445
220275,202310,3137,5945,2228,4682,85,139,1893,3911,1978,4050
220277,202310,2829,5849,2080,4672,102,213,1694,3646,1796,3859
220280,202310,2412,4372,1842,3617,28,65,1648,3165,1676,3230
220285,202310,2036,4036,1586,3449,23,62,1417,2980,1440,3042
220290,202310,8500,20650,6014,16705,600,1495,3872,10782,4472,12277
220300,202310,2276,5877,1585,4798,90,327,1118,3239,1208,3566
220310,202310,3921,9003,2805,7485,99,287,2277,5944,2376,6231
220320,202310,3751,9365,2619,7318,62,245,2033,5415,2095,5660
220323,202310,2071,5072,1439,3980,67,214,1119,2918,1186,3132
220325,202310,1493,4007,1097,3249,41,136,808,2305,849,2441
220327,202310,2045,4903,1574,4092,57,189,1230,2978,1287,3167
220330,202310,6622,13181,5174,11316,144,410,4403,9227,4547,9637
220335,202310,2232,5483,1855,4886,142,345,1464,3788,1606,4133
220340,202310,2088,5212,1387,3913,198,541,702,1923,900,2464
220342,202310,1481,3624,1186,3122,109,192,880,2361,989,2553
220345,202310,3601,7238,2467,5600,36,100,2109,4628,2145,4728
220350,202310,3910,9004,2707,6967,254,657,1770,4373,2024,5030
220360,202310,1617,3570,1129,2744,24,75,887,2037,911,2112
220370,202310,11065,27435,9092,24056,531,1435,7190,18517,7721,19952
220375,202310,2092,4809,1733,4330,39,140,1601,3919,1640,4059
220380,202310,1877,3757,1333,2954,39,88,1138,2495,1177,2583
220385,202310,1122,2203,794,1647,12,37,702,1388,714,1425
220390,202310,16437,34147,11599,26550,2329,5131,6080,13583,8409,18714
220400,202310,1820,3900,1190,2855,36,103,910,2012,946,2115
220410,202310,1431,3481,1002,2690,31,96,781,1974,812,2070
220415,202310,988,2328,707,1817,27,61,510,1269,537,1330
220420,202310,2224,5762,1542,4399,208,581,907,2461,1115,3042
220430,202310,3566,7595,2799,6475,73,179,2391,5381,2464,5560
220435,202310,2519,5342,1951,4402,63,167,1584,3432,1647,3599
220440,202310,3960,9001,3107,7690,73,291,2640,6159,2713,6450
220450,202310,3359,7362,2544,6160,63,222,2142,4965,2205,5187
220455,202310,1766,4185,1532,3851,25,76,1326,3290,1351,3366
220460,202310,1387,2795,1141,2422,28,52,967,1984,995,2036
220465,202310,2997,7901,2424,6916,193,476,1789,4997,1982,5473
220470,202310,4708,11158,3608,9181,212,476,2662,6557,2874,7033
220480,202310,3179,7502,2186,5780,257,522,1367,3616,1624,4138
220490,202310,2907,6390,2161,5278,33,101,1859,4399,1892,4500
220500,202310,4081,8684,2969,6853,184,316,2217,4945,2401,5261
220510,202310,3269,7564,2358,5924,192,474,1744,4363,1936,4837
220515,202310,2226,4512,1848,3929,66,97,1576,3303,1642,3400
220520,202310,6372,13938,5060,11829,164,448,4075,9138,4239,9586
220525,202310,1676,3550,1277,3021,38,82,1089,2564,1127,2646
220527,202310,2036,4283,1546,3492,79,171,1340,2977,1419,3148
220530,202310,2014,4019,1478,3305,187,375,1027,2328,1214,2703
220535,202310,941,2339,802,2085,24,70,606,1468,630,1538
220540,202310,3852,10661,3201,9383,249,692,2352,6798,2601,7490
220545,202310,1836,4687,1477,4073,86,282,1197,3194,1283,3476
220550,202310,10572,29832,8332,25200,653,1988,5433,15603,6086,17591
220551,202310,1763,4151,1370,3441,21,46,1132,2754,1153,2800
220552,202310,1894,4941,1390,3961,35,135,1071,2869,1106,3004
220553,202310,2601,5074,1964,4185,35,79,1743,3625,1778,3704
220554,202310,1175,2524,832,1983,72,148,607,1412,679,1560
220555,202310,4770,8744,3792,7479,74,216,3242,6270,3316,6486
220556,202310,1575,3889,1107,2937,41,152,749,1777,790,1929
220557,202310,2305,5977,1544,4410,104,330,1098,2957,1202,3287
220558,202310,1781,4075,1296,3324,41,126,1066,2616,1107,2742
220559,202310,2237,4757,1696,3848,67,123,1378,3082,1445,3205
220560,202310,2367,4501,1792,3763,40,109,1581,3227,1621,3336
220570,202310,9915,25418,8185,22440,847,2116,5663,15199,6510,17315
220580,202310,8143,19371,6664,16972,201,597,5664,14076,5865,14673
220585,202310,2523,6866,1822,5400,77,222,1329,3819,1406,4041
220590,202310,2041,4253,1524,3435,103,209,1185,2586,1288,2795
220595,202310,3378,8024,2694,6949,88,286,2173,5329,2261,5615
220600,202310,2237,3791,1695,3112,36,64,1545,2779,1581,2843
220605,202310,1702,4562,1302,3751,50,178,930,2534,980,2712
220610,202310,3575,8473,3045,7685,74,230,2699,6671,2773,6901
220620,202310,10982,26050,9146,23219,183,703,7981,19520,8164,20223
220630,202310,406,1095,282,861,29,100,164,445,193,545
220635,202310,2172,5597,1706,4652,47,114,1369,3621,1416,3735
220640,202310,2908,7119,2232,5940,82,247,1727,4400,1809,4647
220650,202310,3029,6654,2354,5581,77,190,1974,4619,2051,4809
220660,202310,3195,8490,2338,6878,100,387,1786,5006,1886,5393
220665,202310,1727,4212,1332,3548,42,153,1104,2799,1146,2952
220667,202310,1907,4977,1559,4319,80,240,1191,3168,1271,3408
220669,202310,1995,5225,1709,4716,47,153,1444,3864,1491,4017
220670,202310,2864,5981,2061,4807,49,127,1736,3917,1785,4044
220672,202310,4105,9071,3093,7685,107,302,2532,6032,2639,6334
220675,202310,1579,3846,1271,3262,113,298,899,2209,1012,2507
220680,202310,3783,7826,3285,7110,140,234,2929,6322,3069,6556
220690,202310,1882,4375,1386,3533,114,324,996,2402,1110,2726
220695,202310,1104,2730,906,2376,34,88,735,1891,769,1979
220700,202310,15570,29624,11518,23848,451,983,9304,18247,9755,19230
220710,202310,1060,2555,681,1858,28,98,522,1347,550,1445
220720,202310,2714,5385,2178,4624,33,78,1859,3803,1892,3881
220730,202310,1730,3907,1311,3198,24,74,1100,2533,1124,2607
220735,202310,1220,2447,818,1787,47,96,617,1276,664,1372
220740,202310,1626,3758,1151,3046,83,193,868,2262,951,2455
220750,202310,5375,10972,4252,9386,247,405,3672,8106,3919,8511
220755,202310,1833,3681,1319,2903,50,107,1060,2267,1110,2374
220760,202310,4160,9019,3357,7954,63,173,3007,6964,3070,7137
220770,202310,35760,88224,27300,72619,8704,22577,9228,24977,17932,47554
220775,202310,1782,3680,1434,3223,43,127,1232,2693,1275,2820
220777,202310,1829,4109,1304,3255,35,78,919,2340,954,2418
220779,202310,1480,3550,1151,3014,163,274,831,2277,994,2551
220780,202310,7371,15747,6068,13797,487,1022,4542,10229,5029,11251
220785,202310,1760,3501,1412,3031,25,59,1317,2778,1342,2837
220790,202310,12868,30682,10576,27051,360,1079,8440,20955,8800,22034
220793,202310,1197,2653,881,2128,25,83,744,1736,769,1819
220795,202310,1650,3778,1305,3250,67,203,1080,2591,1147,2794
220800,202310,26691,50221,20258,40890,2030,4139,14803,28348,16833,32487
220810,202310,3819,9058,2859,7438,93,235,2208,5708,2301,5943
220820,202310,7453,15408,6000,13198,363,642,4888,10666,5251,11308
220830,202310,9429,20949,7555,17917,432,946,5750,13104,6182,14050
220840,202310,17002,41354,12992,33568,1612,3869,8372,20711,9984,24580
220850,202310,3581,9625,2955,8656,68,272,2538,7276,2606,7548
220855,202310,1056,1958,848,1688,23,46,771,1519,794,1565
220860,202310,1510,2900,1181,2440,25,57,1056,2114,1081,2171
220865,202310,2694,6656,1832,5010,51,176,1302,3333,1353,3509
220870,202310,3994,8822,2929,7316,84,288,2409,5757,2493,6045
220880,202310,8298,14613,6565,12481,191,380,5790,10726,5981,11106
220885,202310,1836,4355,1410,3670,160,385,1031,2655,1191,3040
220887,202310,1991,3618,1482,2939,47,71,1341,2632,1388,2703
220890,202310,1679,4454,1260,3681,78,272,912,2587,990,2859
220900,202310,2637,5210,2006,4306,40,117,1727,3528,1767,3645
220910,202310,2169,4681,1655,3870,361,627,1044,2613,1405,3240
220915,202310,1084,2683,705,1961,43,125,506,1308,549,1433
220920,202310,1996,5005,1503,4166,128,327,1061,2849,1189,3176
220930,202310,2432,5077,1842,4261,49,149,1571,3628,1620,3777
220935,202310,1266,3313,884,2492,20,80,590,1551,610,1631
220937,202310,1773,4067,1291,3217,40,134,1032,2410,1072,2544
220940,202310,2293,4751,1694,3771,42,96,1370,2924,1412,3020
220945,202310,596,1818,414,1422,27,114,249,811,276,925
220950,202310,1647,3337,1004,2312,16,43,826,1786,842,1829
220955,202310,2053,4344,1497,3425,39,114,1217,2653,1256,2767
220960,202310,891,2094,562,1502,63,205,333,789,396,994
220965,202310,2281,5092,1803,4333,25,100,1558,3564,1583,3664
220970,202310,2616,5005,1796,3807,26,65,1550,3152,1576,3217
220975,202310,930,2138,675,1755,30,86,539,1341,569,1427
220980,202310,1637,3641,1343,3178,35,99,1130,2578,1165,2677
220985,202310,1806,3770,1382,3034,96,163,1049,2260,1145,2423
220987,202310,1850,4581,1480,3915,40,140,1223,3135,1263,3275
220990,202310,2003,4876,1549,4090,49,129,1264,3246,1313,3375
220995,202310,1734,3826,1314,3126,34,86,1091,2525,1125,2611
220997,202310,2915,7401,2417,6513,54,185,2031,5205,2085,5390
221000,202310,5942,13620,4548,11400,237,654,3481,8306,3718,8960
221005,202310,2004,4384,1650,3769,34,97,1394,2998,1428,3095
221010,202310,1554,2943,1085,2325,32,87,895,1807,927,1894
221020,202310,1832,4993,1447,4238,40,145,1077,3065,1117,3210
221030,202310,2084,4155,1582,3452,35,94,1374,2923,1409,3017
221035,202310,1885,4139,1356,3329,64,152,1092,2631,1156,2783
221037,202310,848,2011,603,1528,21,45,444,1043,465,1088
221038,202310,624,1531,440,1205,53,134,269,701,322,835
221039,202310,989,2400,741,1985,35,103,565,1438,600,1541
221040,202310,5531,13659,4023,10912,311,831,2880,7549,3191,8380
221050,202310,5652,11050,4601,9584,109,261,4114,8375,4223,8636
221060,202310,12122,28457,8833,22684,761,1638,6339,15987,7100,17625
221062,202310,1657,4103,1278,3470,136,309,879,2398,1015,2707
221063,202310,1529,3534,1115,2779,50,153,879,2068,929,2221
221065,202310,3596,7563,2821,6310,55,121,2461,5341,2516,5462
221070,202310,4028,11058,2927,8787,549,1558,1566,4789,2115,6347
221080,202310,4459,9443,3337,7743,72,208,2709,5883,2781,6091
221090,202310,1689,3593,1277,2928,22,62,1103,2436,1125,2498
221093,202310,2100,4635,1675,3866,195,378,1156,2606,1351,2984
221095,202310,1079,2469,813,2059,55,139,615,1525,670,1664
221097,202310,1000,2254,673,1686,25,68,495,1164,520,1232
221100,202310,191239,417195,143830,335171,11868,28634,99116,215895,110984,244529
221110,202310,14281,33314,11783,29634,462,1202,9660,23616,10122,24818
221120,202310,6157,15543,4849,13312,233,737,3747,9931,3980,10668
221130,202310,7319,15602,5093,11578,1405,2715,2475,5720,3880,8435
221135,202310,2427,5114,1932,4424,92,172,1610,3710,1702,3882
221140,202310,1934,3535,1446,2898,68,131,1206,2332,1274,2463
221150,202310,1355,3003,877,2191,31,79,663,1538,694,1617
221160,202310,906,1968,695,1632,42,70,521,1201,563,1271
221170,202310,1371,3022,1172,2674,36,95,1022,2271,1058,2366
230010,202310,3592,8433,2522,6481,228,524,1859,4636,2087,5160
230015,202310,4521,11747,3626,9892,233,652,2445,6460,2678,7112
230020,202310,18890,47842,16308,43456,1595,3485,12061,32213,13656,35698
230030,202310,15629,34342,11736,28431,751,1538,8714,21312,9465,22850
230040,202310,5722,12120,4404,10062,149,402,3319,7613,3468,8015
230050,202310,3037,8712,1986,6160,368,1046,848,2384,1216,3430
230060,202310,3038,7011,2100,5324,51,177,1663,4025,1714,4202
230070,202310,5540,12035,3739,8776,719,1583,2225,5099,2944,6682
230075,202310,12319,32367,10364,28804,1233,2603,7224,20168,8457,22771
230080,202310,3698,6827,2642,5483,21,52,2393,4850,2414,4902
230090,202310,5634,11621,4153,9205,188,385,3434,7316,3622,7701
230100,202310,28288,60079,21936,50200,2789,5883,14166,31896,16955,37779
230110,202310,17844,46016,13365,36986,3495,8686,5295,14645,8790,23331
230120,202310,9890,22993,7461,18815,1095,2532,4592,11359,5687,13891
230125,202310,3820,8885,2931,7378,150,367,2187,5222,2337,5589
230130,202310,6971,18579,5013,14474,521,1248,3258,9265,3779,10513
230140,202310,4332,11224,3195,8855,95,284,2360,6165,2455,6449
230150,202310,1922,5020,1428,3982,261,668,737,2078,998,2746
230160,202310,8907,17922,6866,14809,342,613,5543,11631,5885,12244
230170,202310,7563,19239,5419,14905,560,1403,3535,9412,4095,10815
230180,202310,2015,4762,1460,3708,29,87,1191,2877,1220,2964
230185,202310,5796,13352,4231,10708,595,1361,2620,6659,3215,8020
230190,202310,18567,50037,12692,37460,2431,6434,5781,16649,8212,23083
230195,202310,7180,18104,5853,15671,393,901,4362,11538,4755,12439
230200,202310,6001,14798,4561,12036,398,980,3172,8025,3570,9005
230205,202310,5677,13251,4650,11709,611,1179,3248,8339,3859,9518
230210,202310,13335,26889,10477,22748,412,834,8476,17607,8888,18441
230220,202310,19153,41262,15432,35695,1478,2952,11315,25649,12793,28601
230230,202310,8794,21839,7319,18919,875,1757,5089,13230,5964,14987
230240,202310,16991,37781,12879,30923,1008,1806,9222,21548,10230,23354
230250,202310,11814,28268,9696,24456,2469,5393,4584,11440,7053,16833
230260,202310,18753,46932,14547,38995,2196,5275,8640,22753,10836,28028
230270,202310,8701,20896,5898,15625,1042,2497,3145,8502,4187,10999
230280,202310,24801,55878,18696,45273,542,1711,14814,33183,15356,34894
230290,202310,6030,13678,4882,11635,244,545,3858,8873,4102,9418
230300,202310,6243,13900,5040,12127,89,279,4290,9992,4379,10271
230310,202310,5936,14819,4264,11548,182,528,3044,7801,3226,8329
230320,202310,9401,23811,7155,19802,259,893,5264,13803,5523,14696
230330,202310,5933,13945,4027,10303,254,545,2930,7244,3184,7789
230340,202310,4641,12908,3577,10617,365,1028,2260,6524,2625,7552
230350,202310,23662,54291,18541,45795,1431,3647,12786,30193,14217,33840
230360,202310,3765,8513,2684,6703,148,320,1955,4859,2103,5179
230365,202310,3763,7827,2947,6620,93,234,2530,5568,2623,5802
230370,202310,106496,222018,85708,189644,6606,14461,64357,136010,70963,150471
230380,202310,7477,18308,5310,14173,138,415,3970,10007,4108,10422
230390,202310,4130,10358,3277,8920,81,313,2523,6571,2604,6884
230393,202310,4253,10268,3080,8024,77,307,2424,5911,2501,6218
230395,202310,6927,16956,5100,13476,525,1345,3277,8199,3802,9544
230400,202310,7156,16671,5608,14013,162,498,4473,10479,4635,10977
230410,202310,16678,43476,12453,35623,1636,4206,7727,21701,9363,25907
230420,202310,39374,91485,28202,70986,3671,8621,16535,39420,20206,48041
230423,202310,5465,14435,4351,12126,347,944,2989,8062,3336,9006
230425,202310,7792,20313,6603,17860,809,1978,4394,11690,5203,13668
230426,202310,3326,7559,2126,5272,86,240,1566,3678,1652,3918
230427,202310,2184,5463,1289,3557,110,317,834,2115,944,2432
230428,202310,12753,30593,9765,25348,1651,4121,5028,12358,6679,16479
230430,202310,5994,15247,4184,11862,230,555,3038,8312,3268,8867
230435,202310,8004,17695,5426,13164,836,1914,3021,7089,3857,9003
230440,202310,634492,1274495,483029,1037423,39831,87793,338837,684867,378668,772660
230445,202310,4991,12266,3658,9790,429,998,2241,5715,2670,6713
230450,202310,4678,11371,3599,9494,237,672,2531,6197,2768,6869
230460,202310,2737,6284,2191,5413,84,261,1759,4206,1843,4467
230465,202310,5073,12315,3740,9711,432,819,2590,6724,3022,7543
230470,202310,14539,40330,12100,35632,1334,3019,8169,23688,9503,26707
230480,202310,1919,4617,1363,3581,78,220,965,2362,1043,2582
230490,202310,3416,8343,2477,6520,236,611,1530,3673,1766,4284
230495,202310,7676,18263,5816,14769,1045,2323,3335,8216,4380,10539
230500,202310,11572,32604,9169,27907,782,2033,6494,19740,7276,21773
230510,202310,2189,5197,1552,3948,179,454,951,2250,1130,2704
230520,202310,5962,13897,4701,11675,371,843,3471,8321,3842,9164
230523,202310,21460,55740,13424,37998,3131,8380,3295,9591,6426,17971
230526,202310,4836,11438,3602,9277,265,499,2623,6832,2888,7331
230530,202310,6741,18858,5132,15661,1330,3862,2521,7777,3851,11639
230533,202310,6079,11371,4219,8613,103,264,3535,6769,3638,7033
230535,202310,5878,15158,4387,12389,423,1161,2672,7336,3095,8497
230540,202310,18689,45459,14245,37724,389,1226,11292,28536,11681,29762
230550,202310,28679,63976,20575,49712,3382,6333,12362,29785,15744,36118
230560,202310,9242,19283,6513,15022,712,969,4851,11787,5563,12756
230565,202310,3746,8975,2869,7410,137,339,2182,5392,2319,5731
230570,202310,4065,9283,2995,7492,94,287,2395,5704,2489,5991
230580,202310,15248,32525,11870,27316,976,1690,9385,21438,10361,23128
230590,202310,11926,28699,8928,23323,840,1979,6151,15665,6991,17644
230600,202310,4689,10334,3355,8077,383,695,2106,5186,2489,5881
230610,202310,8437,20274,6768,17417,627,1442,4947,12584,5574,14026
230620,202310,2810,6163,1999,4664,74,214,1498,3177,1572,3391
230625,202310,13462,31359,10105,24934,2085,5179,4954,11460,7039,16639
230630,202310,14411,35502,11350,29774,1784,3945,6613,17470,8397,21415
230640,202310,32843,89664,26750,78136,1952,5598,18972,52974,20924,58572
230650,202310,6345,14941,4854,12355,393,788,3665,9082,4058,9870
230655,202310,12247,33708,10931,31301,879,2142,8536,24357,9415,26499
230660,202310,7286,18789,5400,15322,188,655,4083,11066,4271,11721
230670,202310,7177,15176,4659,11127,259,563,3627,8334,3886,8897
230680,202310,3498,8319,2455,6376,181,395,1669,4251,1850,4646
230690,202310,8617,22510,6215,17522,566,1535,3697,10165,4263,11700
230700,202310,13003,28212,9178,21263,345,967,7089,15451,7434,16418
230710,202310,8228,22930,6180,18204,728,1979,3744,10457,4472,12436
230720,202310,2330,6100,1629,4674,132,357,992,2699,1124,3056
230725,202310,5967,15202,4981,13405,821,1990,2889,7673,3710,9663
230730,202310,76938,177079,53106,137657,12101,29732,21668,56460,33769,86192
230740,202310,7336,18091,5531,14969,153,433,4173,11000,4326,11433
230750,202310,10341,24125,7178,18321,166,534,5774,13822,5940,14356
230760,202310,14690,33741,11106,27444,711,1761,7811,18132,8522,19893
230763,202310,5836,13795,4306,11074,96,344,3409,8166,3505,8510
230765,202310,59791,138477,45292,112422,4902,12347,28783,67097,33685,79444
230770,202310,36150,71137,27353,58522,1955,4167,20125,40997,22080,45164
230780,202310,8304,24582,6769,20950,1054,2862,3977,12358,5031,15220
230790,202310,3968,9448,3343,8405,150,388,2545,6062,2695,6450
230800,202310,11180,29728,8706,24472,1247,3135,5092,13716,6339,16851
230810,202310,13162,35362,10268,29517,1119,2527,6795,19295,7914,21822
230820,202310,4458,12619,3145,9671,457,1283,1737,5137,2194,6420
230830,202310,9169,21603,6796,17271,378,870,4962,11974,5340,12844
230835,202310,4939,10447,3426,8000,135,300,2872,6444,3007,6744
230837,202310,5099,11151,4129,9648,78,239,3632,8063,3710,8302
230840,202310,11702,30624,9149,25859,899,2376,6272,17419,7171,19795
230850,202310,12410,29810,9504,24523,638,1441,6951,17585,7589,19026
230860,202310,8017,14753,6137,12036,191,369,5404,10236,5595,10605
230870,202310,22705,44709,17098,35561,1158,1954,13310,26795,14468,28749
230880,202310,2379,6388,1995,5606,84,291,1508,3986,1592,4277
230890,202310,5660,15692,4659,13755,305,930,3212,9209,3517,10139
230900,202310,4146,10201,3133,8183,377,835,1972,5014,2349,5849
230910,202310,4249,9277,3082,7484,72,253,2555,5965,2627,6218
230920,202310,5791,14212,4159,11305,152,410,3112,8100,3264,8510
230930,202310,8439,20896,6059,16482,1104,2310,3345,9328,4449,11638
230940,202310,10249,22287,7904,18564,249,543,6578,15040,6827,15583
230945,202310,7902,19793,6171,16512,604,1303,4137,10772,4741,12075
230950,202310,7830,16755,6112,14139,228,583,5056,11355,5284,11938
230960,202310,15836,40706,11750,32206,2064,5419,5649,14568,7713,19987
230970,202310,19990,46337,14977,37588,2105,4828,8802,21377,10907,26205
230980,202310,4357,9279,3365,7591,290,569,2464,5443,2754,6012
230990,202310,2043,5039,1531,4065,82,281,1118,2760,1200,3041
231000,202310,3762,8137,2590,6067,85,221,2006,4439,2091,4660
231010,202310,4455,8999,3052,6746,81,186,2520,5317,2601,5503
231020,202310,11429,28471,9216,24171,1776,4056,5284,13988,7060,18044
231025,202310,10674,24243,8760,21067,636,1403,6637,15573,7273,16976
231030,202310,8821,23736,6026,17972,879,2516,3412,10025,4291,12541
231040,202310,3826,8722,2991,7243,130,320,2424,5581,2554,5901
231050,202310,14907,32401,10381,24325,633,1565,7958,17778,8591,19343
231060,202310,3603,8645,2894,7464,138,387,2240,5621,2378,6008
231070,202310,9863,24953,7809,21175,890,2068,5008,13330,5898,15398
231080,202310,4550,11378,3248,8917,268,683,2151,5737,2419,6420
231085,202310,9040,19208,6350,15295,421,895,4517,10427,4938,11322
231090,202310,5236,12209,3533,8956,204,506,2460,5929,2664,6435
231095,202310,2657,7273,1829,5459,168,502,1180,3386,1348,3888
231100,202310,3622,9233,2705,7495,156,450,1964,5199,2120,5649
231110,202310,4476,11845,3671,10160,1462,3480,1224,3531,2686,7011
231120,202310,2980,7253,2267,6004,122,254,1662,4273,1784,4527
231123,202310,2435,5575,1622,4068,119,295,1060,2493,1179,2788
231126,202310,6735,16188,4794,12563,434,932,3473,9032,3907,9964
231130,202310,31439,62952,23719,52008,1315,3104,18052,36484,19367,39588
231135,202310,5057,12574,3762,10044,281,643,2593,6744,2874,7387
231140,202310,21890,51623,16125,41342,1911,4451,10403,25530,12314,29981
231150,202310,7026,17224,4192,11395,800,2084,1571,4002,2371,6086
231160,202310,8745,22067,6944,18501,929,2125,4330,11326,5259,13451
231170,202310,5664,14338,4220,11510,342,905,2989,7766,3331,8671
231180,202310,19736,47461,14012,35797,2253,5334,7362,17988,9615,23322
231190,202310,5173,12376,3597,9487,99,312,2764,6861,2863,7173
231195,202310,5981,16303,4494,13350,322,914,3088,9126,3410,10040
231200,202310,10439,25165,8293,21088,133,455,7097,17014,7230,17469
231210,202310,5965,15043,4489,12394,139,496,3492,9086,3631,9582
231220,202310,16330,35057,11182,25818,888,1559,7960,17619,8848,19178
231230,202310,12225,34256,9827,29514,923,2725,6696,19641,7619,22366
231240,202310,14669,38701,10955,30694,1671,4305,6014,16164,7685,20469
231250,202310,2522,5343,1382,3053,112,224,990,2041,1102,2265
231260,202310,4107,9656,3112,7950,416,908,1980,5022,2396,5930
231270,202310,7828,17431,5576,13531,163,524,4246,9535,4409,10059
231280,202310,2304,6131,1792,5183,149,406,1180,3354,1329,3760
231290,202310,45197,119573,31971,91243,4997,12944,15845,43141,20842,56085
231300,202310,5153,12381,3453,8981,403,921,2022,5023,2425,5944
231310,202310,10776,22254,7503,16424,467,1183,5550,11297,6017,12480
231320,202310,7874,20280,5688,16082,390,785,4121,11593,4511,12378
231325,202310,2907,6729,1937,4952,127,267,1363,3399,1490,3666
231330,202310,14249,34835,10399,27637,1339,3311,6670,17260,8009,20571
231335,202310,6730,15651,5259,13388,177,487,4305,10648,4482,11135
231340,202310,22894,61875,18229,53026,1806,5144,12476,35913,14282,41057
231350,202310,19912,47237,16333,41533,640,1555,13460,33328,14100,34883
231355,202310,5542,14194,4487,12245,326,812,3398,8937,3724,9749
231360,202310,9873,26085,7641,21918,441,1325,5749,15879,6190,17204
231370,202310,2452,6052,1709,4630,89,293,1236,3194,1325,3487
231375,202310,5003,13464,4110,11822,199,563,3016,8625,3215,9188
231380,202310,7437,16723,6146,14898,199,450,5015,11917,5214,12367
231390,202310,4108,10679,3325,9201,101,348,2495,6521,2596,6869
231395,202310,5440,13446,4143,11109,261,656,2949,7654,3210,8310
231400,202310,12246,29622,9385,24325,378,1062,7018,17131,7396,18193
231410,202310,20249,50287,16704,44268,822,2069,13469,34813,14291,36882
240010,202310,3020,7051,1981,5045,323,817,925,2213,1248,3030
240020,202310,17977,40976,13256,32236,888,2426,9108,20367,9996,22793
240030,202310,4898,8969,3860,7452,96,259,3332,6006,3428,6265
240040,202310,940,2433,669,1912,25,72,451,1216,476,1288
240050,202310,4234,9948,2977,7647,90,216,2142,5246,2232,5462
240060,202310,1820,4171,1279,3195,42,90,978,2365,1020,2455
240070,202310,3329,8182,2407,6077,226,559,1589,3659,1815,4218
240080,202310,3521,8510,2398,6369,159,457,1567,3867,1726,4324
240090,202310,2825,5791,2073,4556,46,90,1742,3741,1788,3831
240100,202310,13530,27900,9529,20891,317,847,7441,15039,7758,15886
240110,202310,6275,15332,4514,11843,311,863,3074,7439,3385,8302
240120,202310,4135,10394,3071,8548,310,857,1933,5095,2243,5952
240130,202310,4930,8419,3694,6770,56,141,3331,5905,3387,6046
240140,202310,2169,5984,1575,4733,182,597,884,2404,1066,3001
240145,202310,8676,21514,6307,17143,614,1697,3925,10105,4539,11802
240150,202310,1340,3088,980,2415,68,171,672,1545,740,1716
240160,202310,1804,4546,1312,3615,45,147,963,2490,1008,2637
240165,202310,1177,2842,822,2126,25,91,649,1569,674,1660
240170,202310,3481,7972,2579,6329,318,753,1632,3812,1950,4565
240180,202310,3688,9664,2663,7515,526,1413,1265,3545,1791,4958
240185,202310,1787,4731,1460,4100,42,154,1145,3043,1187,3197
240190,202310,1393,3265,1005,2596,38,119,738,1781,776,1900
240200,202310,16448,34420,11513,25819,1908,3838,6350,13697,8258,17535
240210,202310,4238,8512,3155,6741,59,190,2625,5247,2684,5437
240220,202310,8855,23498,7127,20326,586,1903,4936,13378,5522,15281
240230,202310,6973,15576,5008,12220,381,728,3430,8405,3811,9133
240240,202310,2179,5754,1347,3912,241,724,465,1122,706,1846
240250,202310,3710,8193,2734,6524,71,228,2129,4709,2200,4937
240260,202310,20377,51618,16052,43896,4552,11760,6178,18236,10730,29996
240270,202310,3087,7792,2161,6002,141,411,1384,3779,1525,4190
240280,202310,1914,4404,1403,3508,66,141,1049,2546,1115,2687
240290,202310,1345,3471,991,2687,25,84,656,1629,681,1713
240300,202310,2643,6068,1757,4492,125,336,1089,2627,1214,2963
240310,202310,10519,25080,7242,18787,1316,3159,3286,8237,4602,11396
240320,202310,2267,5660,1394,3934,110,322,896,2335,1006,2657
240325,202310,49122,109978,35397,85545,4860,11563,20380,45794,25240,57357
240330,202310,2188,5299,1483,3959,88,270,985,2451,1073,2721
240340,202310,2486,4865,1743,3667,50,120,1428,2813,1478,2933
240350,202310,3093,6370,2523,5633,98,275,2125,4583,2223,4858
240360,202310,16661,38849,13120,32620,1967,4700,7874,18810,9841,23510
240370,202310,2686,5692,1791,4053,152,345,1220,2533,1372,2878
240375,202310,1168,2464,843,1902,35,101,617,1265,652,1366
240380,202310,2812,6940,1966,5180,255,637,1144,2837,1399,3474
240390,202310,1143,2576,683,1713,33,70,400,922,433,992
240400,202310,1684,3809,1155,2894,43,116,786,1808,829,1924
240410,202310,712,1901,497,1459,67,216,253,665,320,881
240420,202310,6455,18503,5099,15421,411,1362,3282,9175,3693,10537
240430,202310,4238,9487,3031,7289,160,402,2234,5018,2394,5420
240440,202310,3434,6844,2570,5487,218,475,1919,3916,2137,4391
240450,202310,5334,12968,3567,9430,239,709,2246,5275,2485,5984
240460,202310,4227,9765,3373,8333,301,702,2433,5793,2734,6495
240470,202310,4106,11198,2649,7960,838,2186,895,2899,1733,5085
240480,202310,671,1679,369,1023,21,47,173,466,194,513
240485,202310,2490,6349,1745,4856,152,455,994,2657,1146,3112
240490,202310,2012,4373,1387,3251,83,162,1019,2277,1102,2439
240500,202310,2633,6237,2036,5133,120,306,1574,3813,1694,4119
240510,202310,2059,4874,1560,3972,118,357,1143,2670,1261,3027
240520,202310,1979,3967,1343,3043,121,233,1028,2246,1149,2479
240530,202310,2879,6828,2327,5903,189,350,1760,4403,1949,4753
240540,202310,2755,5870,2188,4972,60,198,1868,4076,1928,4274
240550,202310,1062,2342,839,1947,121,235,604,1414,725,1649
240560,202310,4790,10061,3896,8781,163,303,3207,7086,3370,7389
240570,202310,3363,8084,1861,4805,293,739,696,1521,989,2260
240580,202310,10767,26409,8530,22215,636,1669,6445,16044,7081,17713
240590,202310,1124,2181,808,1682,40,110,616,1175,656,1285
240600,202310,2112,5033,1372,3567,54,147,940,2269,994,2416
240610,202310,5543,12483,4299,10172,356,836,2925,6530,3281,7366
240615,202310,1573,3497,1114,2706,73,185,785,1760,858,1945
240620,202310,2406,5694,1841,4676,53,160,1496,3606,1549,3766
240630,202310,2921,6299,2391,5442,240,407,1741,3986,1981,4393
240640,202310,1076,2564,749,1980,38,106,556,1384,594,1490
240650,202310,4829,12877,3515,10112,392,1019,2143,6078,2535,7097
240660,202310,5426,9618,4326,8250,124,290,3719,6827,3843,7117
240670,202310,3157,7616,2086,5396,218,524,1268,3022,1486,3546
240680,202310,1930,4449,1375,3456,116,288,976,2338,1092,2626
240690,202310,1490,3122,1061,2396,21,67,884,1858,905,1925
240700,202310,2840,7427,2070,5975,118,304,1453,4059,1571,4363
240710,202310,25450,52104,19480,42361,2351,4858,12961,27217,15312,32075
240720,202310,6341,14468,4645,11497,775,1945,2656,6298,3431,8243
240725,202310,1302,3375,912,2631,63,176,573,1564,636,1740
240730,202310,2686,6638,1941,5221,78,254,1391,3528,1469,3782
240740,202310,2278,5647,1608,4282,118,373,1079,2608,1197,2981
240750,202310,2713,7722,2133,6461,248,761,1280,3662,1528,4423
240760,202310,2065,4127,1314,2991,116,244,902,2100,1018,2344
240770,202310,4036,9436,3091,7948,111,358,2434,5904,2545,6262
240780,202310,6657,15732,5000,12784,718,1662,3043,7476,3761,9138
240790,202310,1076,2650,753,2026,21,79,514,1253,535,1332
240800,202310,74615,149276,51202,110162,6577,13174,30954,61899,37531,75073
240810,202310,141926,298241,111797,247865,11941,25163,75405,159394,87346,184557
240820,202310,8210,21199,6443,17720,1202,3081,3541,9560,4743,12641
240830,202310,10696,25982,8427,22165,494,1303,6373,16200,6867,17503
240840,202310,1302,2933,897,2203,49,106,605,1408,654,1514
240850,202310,1660,4129,1011,2713,93,223,578,1468,671,1691
240860,202310,1864,3957,1309,2997,35,98,1096,2370,1131,2468
240870,202310,1264,2848,852,2104,193,448,415,1008,608,1456
240880,202310,1568,4414,1234,3712,95,313,805,2278,900,2591
240890,202310,6744,14765,4636,10901,477,1185,2896,6039,3373,7224
240895,202310,3651,9647,3017,8535,394,1121,2024,5644,2418,6765
240910,202310,4167,10100,3170,8323,81,260,2395,5943,2476,6203
240920,202310,1317,2836,886,2132,100,199,566,1345,666,1544
240930,202310,4382,8859,3054,6930,303,491,1949,4686,2252,5177
240933,202310,1910,4359,1452,3641,47,167,1158,2743,1205,2910
240940,202310,9047,18819,6356,14175,915,1783,3883,8355,4798,10138
240950,202310,1327,3552,989,2838,49,179,678,1799,727,1978
240960,202310,849,2077,683,1716,19,73,517,1212,536,1285
240970,202310,2416,5081,1741,3959,73,195,1395,3022,1468,3217
240980,202310,4896,10979,3996,9472,106,390,3269,7235,3375,7625
240990,202310,3655,8245,2817,6636,273,659,1933,4163,2206,4822
241000,202310,1308,2758,903,2014,18,64,759,1598,777,1662
241010,202310,3934,9981,3163,8460,135,441,2400,5974,2535,6415
241020,202310,2564,6032,1769,4486,107,308,1222,2812,1329,3120
241025,202310,1986,5042,1335,3695,65,232,875,2212,940,2444
241030,202310,3108,8444,2255,6675,230,713,1533,4319,1763,5032
241040,202310,2738,7440,2099,6265,198,572,1456,4239,1654,4811
241050,202310,1735,4258,1245,3307,66,166,864,2232,930,2398
241060,202310,1006,2387,746,1848,37,85,531,1220,568,1305
241070,202310,869,2023,641,1629,21,61,493,1174,514,1235
241080,202310,1301,3287,930,2546,43,149,636,1618,679,1767
241090,202310,2514,6184,1803,4933,68,263,1307,3321,1375,3584
241100,202310,1388,3447,958,2587,121,224,556,1512,677,1736
241105,202310,1474,3774,1065,2985,165,464,533,1354,698,1818
241110,202310,1068,2739,684,1915,43,142,429,1086,472,1228
241120,202310,9351,23570,7159,19534,761,2053,4622,12095,5383,14148
241140,202310,3922,9461,2638,6894,256,584,1673,4285,1929,4869
241142,202310,882,2186,524,1412,55,151,274,650,329,801
241150,202310,7225,16646,5585,13817,258,633,4292,10253,4550,10886
241160,202310,1319,3398,799,2322,113,313,389,1035,502,1348
241170,202310,1599,3552,1199,2813,35,119,963,2120,998,2239
241180,202310,1236,2787,808,1978,57,168,477,1105,534,1273
241190,202310,1432,3207,1015,2420,51,138,709,1578,760,1716
241200,202310,33325,69849,26060,57593,3285,7204,16957,35152,20242,42356
241210,202310,2048,4513,1295,3090,217,441,738,1753,955,2194
241220,202310,12561,30961,9805,25783,2569,6362,4337,11509,6906,17871
241230,202310,3546,8168,2682,6708,228,452,1972,4815,2200,5267
241240,202310,1469,3754,751,2148,116,363,262,662,378,1025
241250,202310,7878,18175,5627,14053,144,477,4374,10150,4518,10627
241255,202310,3393,8826,2615,7291,261,733,1682,4471,1943,5204
241260,202310,5839,13472,4198,10587,165,488,3094,7237,3259,7725
241270,202310,1902,4973,1419,3998,138,378,900,2400,1038,2778
241280,202310,3213,6248,2515,5058,89,174,2180,4221,2269,4395
241290,202310,3779,8322,2566,6368,101,279,1949,4590,2050,4869
241300,202310,1917,4466,1337,3385,57,168,933,2199,990,2367
241310,202310,2790,5702,2101,4700,61,161,1712,3659,1773,3820
241320,202310,1150,3361,861,2746,124,356,430,1344,554,1700
241330,202310,2062,4616,1501,3798,42,126,1253,3056,1295,3182
241335,202310,4615,11268,3526,9179,140,435,2626,6409,2766,6844
241340,202310,2081,4864,1449,3642,247,644,728,1655,975,2299
241350,202310,2571,6117,2011,5119,107,267,1480,3602,1587,3869
241355,202310,1690,3944,1211,3037,60,155,880,2094,940,2249
241360,202310,2511,5699,1600,3938,88,235,1161,2665,1249,2900
241370,202310,1627,3864,1150,2936,53,155,816,1924,869,2079
241380,202310,893,2036,624,1554,103,211,355,892,458,1103
241390,202310,3411,8628,2647,7336,198,504,1844,4976,2042,5480
241400,202310,4439,10637,3510,9034,278,733,2519,6150,2797,6883
241410,202310,3066,8127,2269,6490,273,794,1419,3918,1692,4712
241415,202310,2289,5412,1736,4379,140,288,1243,3007,1383,3295
241420,202310,4035,10209,3241,8736,637,1628,1694,4526,2331,6154
241430,202310,872,1914,519,1239,19,43,354,762,373,805
241440,202310,10569,27267,8778,23866,295,928,6967,18121,7262,19049
241445,202310,1656,3370,1282,2826,36,101,1113,2355,1149,2456
241450,202310,3844,7622,2795,5943,171,335,2206,4526,2377,4861
241460,202310,4798,11490,3186,8077,372,870,1983,4656,2355,5526
241470,202310,1765,4037,1263,3276,44,158,1003,2477,1047,2635
241475,202310,1421,3425,943,2521,21,61,697,1731,718,1792
241480,202310,3809,10353,2824,8275,902,2572,914,2765,1816,5337
241490,202310,906,1832,571,1299,27,83,445,943,472,1026
241500,202310,972,2408,781,2129,37,110,584,1531,621,1641
250010,202310,3241,8249,2376,6472,72,228,1762,4521,1834,4749
250020,202310,1924,4476,1283,3271,262,514,770,2031,1032,2545
250030,202310,8623,20515,6810,17443,1278,3071,4193,10469,5471,13540
250040,202310,5541,14504,4322,12203,912,2472,2260,6177,3172,8649
250050,202310,4482,10495,3593,9152,188,457,2725,6860,2913,7317
250053,202310,1574,3945,1305,3451,141,293,868,2248,1009,2541
250057,202310,907,2452,804,2293,15,60,698,1957,713,2017
250060,202310,7543,16819,5808,13976,902,1765,3601,8647,4503,10412
250070,202310,4901,11816,3729,9705,82,274,2901,7173,2983,7447
250073,202310,966,2235,706,1775,11,35,571,1376,582,1411
250077,202310,3258,6837,2318,5304,34,100,1964,4311,1998,4411
250080,202310,7483,14242,5777,12062,87,253,5204,10559,5291,10812
250090,202310,4719,8825,3739,7442,162,244,3181,6197,3343,6441
250100,202310,4221,11265,3405,9658,228,595,2470,6755,2698,7350
250110,202310,6045,14862,5039,13249,389,974,3605,9136,3994,10110
250115,202310,926,1907,596,1369,35,77,467,1044,502,1121
250120,202310,2201,5736,1797,5012,33,122,1391,3699,1424,3821
250130,202310,7411,15633,5860,13355,274,461,4821,10850,5095,11311
250135,202310,1689,3967,1368,3390,239,621,936,2232,1175,2853
250140,202310,2912,7363,2365,6521,237,656,1619,4363,1856,5019
250150,202310,5721,15759,4675,13750,196,648,3475,9693,3671,10341
250153,202310,1646,3967,1251,3309,59,140,960,2470,1019,2610
250157,202310,2704,6196,2155,5242,60,142,1774,4149,1834,4291
250160,202310,4445,9806,3319,8028,74,191,2814,6631,2888,6822
250170,202310,2215,5213,1835,4638,52,157,1456,3514,1508,3671
250180,202310,31660,61157,24588,51062,2848,5249,17033,33621,19881,38870
250190,202310,5222,12016,4022,10044,475,1100,2585,6156,3060,7256
250200,202310,3110,5900,2383,4866,182,368,1973,3865,2155,4233
250205,202310,1004,2785,747,2271,37,140,531,1544,568,1684
250210,202310,1694,4475,1336,3797,115,347,930,2536,1045,2883
250215,202310,1904,4674,1304,3509,75,216,733,1951,808,2167
250220,202310,820,2014,580,1566,29,89,389,974,418,1063
250230,202310,1933,3923,1213,2815,30,83,945,2079,975,2162
250240,202310,3810,8229,3078,6994,124,272,2582,5678,2706,5950
250250,202310,6070,13923,4789,11935,393,695,3596,9288,3989,9983
250260,202310,1862,4781,1400,3904,94,243,956,2613,1050,2856
250270,202310,1405,3782,1142,3303,95,263,710,2115,805,2378
250280,202310,4971,10465,4001,9019,391,643,2882,6641,3273,7284
250290,202310,2362,4718,1823,3866,49,106,1458,2945,1507,3051
250300,202310,7407,15855,5862,13600,302,824,4508,9930,4810,10754
250310,202310,1509,3854,1094,3069,127,300,700,1947,827,2247
250320,202310,18748,34493,14693,29420,400,1106,12268,23225,12668,24331
250330,202310,3186,7249,2438,6038,84,264,1953,4516,2037,4780
250340,202310,1556,3193,1216,2688,26,65,1057,2270,1083,2335
250350,202310,4587,11893,3470,9832,262,617,2522,7224,2784,7841
250355,202310,2831,6446,2276,5698,42,183,2016,4893,2058,5076
250360,202310,2133,4947,1758,4357,133,360,1309,3067,1442,3427
250370,202310,21110,41747,16758,35165,367,1035,14236,28388,14603,29423
250375,202310,1544,3288,1122,2743,31,62,981,2412,1012,2474
250380,202310,2207,4591,1861,4097,110,263,1539,3224,1649,3487
250390,202310,2363,5174,1828,4290,113,276,1439,3275,1552,3551
250400,202310,95295,211568,62426,155360,19384,50300,17577,39988,36961,90288
250403,202310,2983,6040,2339,5203,47,199,1940,3919,1987,4118
250407,202310,1907,3749,1238,2718,132,205,859,1983,991,2188
250410,202310,863,1988,684,1671,29,78,561,1299,590,1377
250415,202310,2477,5703,1988,4907,42,120,1714,4119,1756,4239
250420,202310,1752,3578,1442,3114,33,96,1237,2550,1270,2646
250430,202310,9534,18569,7215,15145,329,748,5746,11271,6075,12019
250435,202310,2000,4989,1364,3811,68,181,986,2641,1054,2822
250440,202310,5379,12855,4317,11186,112,331,3659,9195,3771,9526
250450,202310,2188,4934,1675,4162,100,182,1290,3225,1390,3407
250460,202310,9863,23681,7592,19827,549,1572,5338,13147,5887,14719
250470,202310,2226,4606,1684,3740,76,193,1338,2793,1414,2986
250480,202310,4797,11366,3723,9823,331,705,2819,7469,3150,8174
250485,202310,857,1758,535,1209,51,70,388,873,439,943
250490,202310,6924,13571,5534,11736,142,368,4595,9361,4737,9729
250500,202310,2469,6027,1965,5132,51,156,1519,3821,1570,3977
250510,202310,7134,14696,5525,12281,486,739,4153,9413,4639,10152
250520,202310,2226,5391,1715,4562,71,217,1281,3227,1352,3444
250523,202310,2651,5644,2092,4798,163,347,1568,3441,1731,3788
250527,202310,2127,4515,1808,4100,23,80,1620,3604,1643,3684
250530,202310,823,1868,634,1554,17,37,484,1120,501,1157
250535,202310,1665,4247,1353,3639,22,72,1106,2850,1128,2922
250540,202310,4005,7352,3014,6130,321,376,2384,5062,2705,5438
250550,202310,948,2744,759,2354,57,188,507,1492,564,1680
250560,202310,2108,5040,1632,4254,117,285,1180,2930,1297,3215
250570,202310,3344,8664,2672,7420,187,514,1902,5123,2089,5637
250580,202310,1247,2910,1009,2524,70,163,768,1846,838,2009
250590,202310,1253,2637,1026,2279,29,83,858,1796,887,1879
250600,202310,9140,22405,6745,18407,357,957,4865,12740,5222,13697
250610,202310,3441,8799,2745,7581,149,454,2072,5545,2221,5999
250620,202310,1144,2389,870,1922,31,76,699,1470,730,1546
250625,202310,2744,7209,2285,6372,52,186,1906,5136,1958,5322
250630,202310,15760,34185,12244,28337,1095,2589,8563,18622,9658,21211
250640,202310,4578,10512,3608,8963,121,431,2813,6526,2934,6957
250650,202310,1282,2700,906,2155,16,65,749,1706,765,1771
250660,202310,1882,4155,1326,3278,76,193,1049,2432,1125,2625
250670,202310,2981,7616,2531,6743,56,201,2096,5315,2152,5516
250680,202310,7616,14467,5833,12198,152,449,4902,9662,5054,10111
250690,202310,8834,17191,6598,14128,167,365,5553,11413,5720,11778
250700,202310,5773,14225,4487,11791,728,1836,2748,6873,3476,8709
250710,202310,5409,13857,4141,11721,462,1149,2703,7589,3165,8738
250720,202310,3551,8346,2759,7066,80,271,2250,5485,2330,5756
250730,202310,5451,12282,4356,10556,383,741,3256,7661,3639,8402
250740,202310,2507,5434,1863,4442,122,251,1335,3086,1457,3337
250750,202310,169426,351470,129602,288536,9436,22798,93423,193083,102859,215881
250760,202310,3700,6883,3032,5899,51,134,2721,5102,2772,5236
250770,202310,4936,13278,3904,11410,500,1222,2455,7122,2955,8344
250780,202310,2276,5199,1718,4183,54,150,1390,3235,1444,3385
250790,202310,3170,7915,2476,6634,108,386,1716,4158,1824,4544
250800,202310,2940,6873,2274,5703,137,289,1724,4217,1861,4506
250810,202310,1767,3833,1250,2992,142,230,841,2083,983,2313
250820,202310,2551,5893,2176,5369,54,159,1825,4392,1879,4551
250830,202310,7406,19425,5467,15431,266,853,3773,9864,4039,10717
250840,202310,876,2517,688,2105,35,112,501,1523,536,1635
250850,202310,2194,5570,1756,4758,30,118,1427,3688,1457,3806
250855,202310,1439,3406,1156,2922,41,124,947,2284,988,2408
250860,202310,4347,11161,3195,9041,462,1322,1781,4739,2243,6061
250870,202310,1286,2947,962,2363,52,124,706,1654,758,1778
250880,202310,1946,4411,1445,3576,132,320,1024,2439,1156,2759
250890,202310,14834,30336,11736,26058,314,858,9654,19985,9968,20843
250900,202310,3978,9106,3074,7503,117,353,2511,5789,2628,6142
250905,202310,3134,7603,2668,6930,92,298,2293,5808,2385,6106
250910,202310,9082,17287,7127,14748,117,364,6309,12565,6426,12929
250915,202310,2676,5306,1723,4105,54,134,1443,3328,1497,3462
250920,202310,4857,10210,3830,8533,633,966,2486,5707,3119,6673
250930,202310,2852,6887,2203,5897,155,491,1601,4000,1756,4491
250933,202310,1520,3955,1192,3325,54,182,880,2312,934,2494
250937,202310,974,2257,752,1887,37,74,553,1370,590,1444
250939,202310,2538,5565,1963,4623,44,121,1619,3633,1663,3754
250940,202310,4776,11103,3707,9447,96,317,2997,7388,3093,7705
250950,202310,2054,4784,1503,3938,45,131,1168,2892,1213,3023
250960,202310,1384,3489,1111,2968,43,147,836,2087,879,2234
250970,202310,11584,25106,8991,20599,513,1056,7026,15575,7539,16631
250980,202310,2825,6661,2272,5727,42,134,1912,4608,1954,4742
250990,202310,2592,6858,2035,5827,87,257,1453,3952,1540,4209
251000,202310,2320,5923,1772,4923,45,131,1363,3677,1408,3808
251010,202310,2999,7364,2439,6457,94,321,1937,4904,2031,5225
251020,202310,1919,4664,1475,3862,51,176,1128,2758,1179,2934
251030,202310,1216,2917,902,2342,56,148,569,1444,625,1592
251040,202310,2201,5314,1672,4390,24,77,1379,3469,1403,3546
251050,202310,1153,3025,859,2384,49,162,577,1469,626,1631
251060,202310,1378,2746,891,2016,49,87,658,1477,707,1564
251065,202310,565,1428,375,1049,95,203,174,510,269,713
251070,202310,909,1967,664,1562,21,79,531,1161,552,1240
251080,202310,27089,57851,20363,46933,4137,8959,10984,25405,15121,34364
251090,202310,3490,8788,2685,7338,68,226,2187,5757,2255,5983
251100,202310,943,2693,710,2188,59,145,461,1330,520,1475
251110,202310,2246,5163,1681,4085,307,546,1056,2641,1363,3187
251120,202310,10035,22706,7657,19075,369,1055,5694,13353,6063,14408
251130,202310,6099,10334,5049,9058,58,114,4641,8080,4699,8194
251140,202310,4830,12405,3943,10900,181,562,2895,7793,3076,8355
251150,202310,3419,8520,2885,7580,79,325,2221,5491,2300,5816
251160,202310,2946,6897,2402,6016,48,188,2062,4957,2110,5145
251170,202310,2303,4913,1864,4287,39,117,1637,3617,1676,3734
251180,202310,3348,7657,2540,6398,374,744,1549,4039,1923,4783
251190,202310,7072,13785,5798,12040,188,408,4925,9796,5113,10204
251200,202310,5715,13680,4644,12096,210,529,3690,9465,3900,9994
251203,202310,1263,3520,949,2788,74,227,600,1637,674,1864
251207,202310,1340,3184,879,2318,27,78,617,1546,644,1624
251210,202310,9907,21944,7187,17593,699,1372,4744,11752,5443,13124
251220,202310,1620,3390,1093,2616,65,136,824,1938,889,2074
251230,202310,5664,14232,4496,11940,147,426,3363,8477,3510,8903
251240,202310,4448,11455,3191,8943,353,955,1972,5329,2325,6284
251250,202310,15176,34459,11659,28060,1311,2962,7924,18346,9235,21308
251260,202310,650,1494,512,1249,9,22,404,934,413,956
251270,202310,5509,14285,4510,12609,332,874,3350,9317,3682,10191
251272,202310,1740,3906,1461,3487,32,118,1276,2887,1308,3005
251274,202310,1020,2587,721,2005,80,222,381,997,461,1219
251275,202310,1975,4154,1449,3287,87,193,1134,2430,1221,2623
251276,202310,1617,3950,1284,3419,31,107,963,2421,994,2528
251278,202310,818,1902,621,1535,37,86,471,1093,508,1179
251280,202310,3390,6934,2803,6042,64,167,2370,4792,2434,4959
251290,202310,10345,18164,8409,15691,265,562,7236,12879,7501,13441
251300,202310,981,2490,765,2086,15,47,636,1702,651,1749
251310,202310,3454,8533,2718,7270,54,216,2094,5329,2148,5545
251315,202310,2280,6168,1892,5379,113,299,1435,3971,1548,4270
251320,202310,1930,4578,1388,3597,53,170,1023,2501,1076,2671
251330,202310,2563,5186,1843,4198,54,157,1515,3307,1569,3464
251335,202310,1393,3369,1142,2953,14,46,1004,2511,1018,2557
251340,202310,4600,9745,3273,7718,249,545,2366,5333,2615,5878
251350,202310,1340,3340,1055,2823,108,204,761,2039,869,2243
251360,202310,2250,5361,1570,4222,30,86,1219,3168,1249,3254
251365,202310,927,2221,603,1570,25,75,440,1109,465,1184
251370,202310,36880,83269,27708,68280,6027,13547,13082,32433,19109,45980
251380,202310,1891,3974,1448,3238,55,147,1184,2515,1239,2662
251385,202310,932,2163,630,1579,28,67,449,1042,477,1109
251390,202310,9808,22196,8062,19358,649,1522,5837,13538,6486,15060
251392,202310,1275,3028,972,2534,39,98,730,1870,769,1968
251394,202310,835,2118,616,1710,64,177,394,1044,458,1221
251396,202310,862,2116,620,1631,33,100,443,1073,476,1173
251398,202310,1222,2861,734,1948,17,50,538,1335,555,1385
251400,202310,1775,3458,1268,2681,74,132,976,1975,1050,2107
251410,202310,1903,3831,1373,3013,31,118,1148,2347,1179,2465
251420,202310,2565,5644,1922,4743,49,121,1520,3598,1569,3719
251430,202310,1840,4811,1461,4075,58,184,1160,3114,1218,3298
251440,202310,1328,3188,1001,2608,105,231,687,1801,792,2032
251445,202310,2066,4859,1676,4244,40,149,1315,3137,1355,3286
251450,202310,5713,14058,4485,11705,117,373,3602,8942,3719,9315
251455,202310,1032,2707,822,2290,40,126,626,1662,666,1788
251460,202310,1193,2927,887,2375,94,250,616,1607,710,1857
251465,202310,613,1507,460,1206,11,37,332,817,343,854
251470,202310,1312,3374,910,2525,166,477,459,1136,625,1613
251480,202310,1287,2945,883,2209,35,111,643,1496,678,1607
251490,202310,2410,5432,1826,4526,169,331,1311,3241,1480,3572
251500,202310,2676,5996,2170,5228,134,298,1665,3810,1799,4108
251510,202310,3118,8575,2271,6789,170,493,1396,3957,1566,4450
251520,202310,1216,2865,838,2180,54,121,568,1405,622,1526
251530,202310,19117,38675,14755,32949,227,699,12520,26617,12747,27316
251540,202310,3665,9335,2888,7858,99,365,2227,5721,2326,6086
251550,202310,5422,10070,3989,8097,175,368,3329,6537,3504,6905
251560,202310,668,1846,531,1578,34,114,384,1038,418,1152
251570,202310,1089,2788,767,2111,36,93,552,1447,588,1540
251580,202310,2862,5468,2234,4518,42,104,1893,3592,1935,3696
251590,202310,1979,4187,1488,3453,55,147,1260,2794,1315,2941
251593,202310,1164,3127,943,2711,103,273,579,1603,682,1876
251597,202310,2858,6410,2392,5713,31,103,2089,4853,2120,4956
251600,202310,7647,18882,6113,16312,472,1118,4532,11872,5004,12990
251610,202310,4257,10248,3329,8478,482,1052,2157,5378,2639,6430
251615,202310,1657,3522,1162,2681,45,127,987,2194,1032,2321
251620,202310,24377,47644,17832,39119,429,1017,14801,31853,15230,32870
251630,202310,6476,12673,4854,10226,300,670,3780,7471,4080,8141
251640,202310,2654,6249,2140,5429,46,152,1742,4185,1788,4337
251650,202310,5154,11475,3952,9683,111,320,3201,7451,3312,7771
251660,202310,4526,11249,3532,9319,103,401,2806,6982,2909,7383
251670,202310,5792,12452,4721,10900,141,465,4002,8847,4143,9312
251675,202310,1134,2367,929,2035,31,63,800,1701,831,1764
251680,202310,3164,7176,2344,5861,133,311,1785,4395,1918,4706
251690,202310,3998,9815,2959,7791,210,599,2114,5286,2324,5885
251700,202310,2859,6786,2186,5701,69,250,1735,4235,1804,4485
251710,202310,967,2179,589,1413,40,109,398,861,438,970
251720,202310,1544,3912,1102,3089,35,118,787,2092,822,2210
251740,202310,818,1958,597,1551,24,81,444,1085,468,1166
260005,202310,38750,73295,28238,58081,1974,3977,21244,41539,23218,45516
260010,202310,12831,29672,9422,23543,666,1749,5976,14063,6642,15812
260020,202310,8401,16695,5925,13140,110,361,4732,9826,4842,10187
260030,202310,10325,19941,8078,16733,144,470,6875,13545,7019,14015
260040,202310,8865,19849,6456,16007,352,971,4635,10897,4987,11868
260050,202310,17898,37768,14495,33530,300,785,12954,29407,13254,30192
260060,202310,5251,11131,3961,9005,481,785,2731,6455,3212,7240
260070,202310,14755,29175,11469,24307,270,782,9464,18911,9734,19693
260080,202310,8547,16140,6843,13813,132,305,5780,11179,5912,11484
260090,202310,6860,14560,5482,12479,596,1063,3877,8859,4473,9922
260100,202310,4059,8515,3174,7176,55,188,2665,5693,2720,5881
260105,202310,6375,14565,5070,12414,123,439,4072,9406,4195,9845
260110,202310,26280,66796,20954,57836,1326,3661,15498,41198,16824,44859
260120,202310,20220,43740,15880,36903,1977,3912,10859,25104,12836,29016
260130,202310,4062,8860,3211,7565,68,182,2536,5619,2604,5801
260140,202310,16829,31734,12880,26421,460,1026,10514,20487,10974,21513
260150,202310,4548,8723,3683,7580,118,198,3161,6335,3279,6533
260160,202310,9222,17688,7382,15295,192,506,6499,12966,6691,13472
260170,202310,27430,55348,20902,45598,1370,2878,15592,32638,16962,35516
260180,202310,4478,9869,3413,8255,106,318,2712,6192,2818,6510
260190,202310,27552,44468,21005,36407,277,556,18764,31233,19041,31789
260200,202310,13473,28914,10744,25084,495,988,9046,20706,9541,21694
260210,202310,13609,33838,10625,28729,536,1326,8092,21408,8628,22734
260220,202310,15143,28414,12602,25058,298,561,10853,20888,11151,21449
260230,202310,16613,30791,13267,26347,366,694,11211,21611,11577,22305
260240,202310,3455,8766,2690,7296,58,205,2078,5348,2136,5553
260250,202310,2996,6468,2314,5336,94,236,1773,3867,1867,4103
260260,202310,18076,39569,14767,34527,1481,2898,10365,24622,11846,27520
260270,202310,6222,11647,4949,10025,123,325,4238,8235,4361,8560
260280,202310,16899,39772,14053,35231,339,1173,11989,28620,12328,29793
260290,202310,57794,126376,43462,101837,4091,9859,29560,64582,33651,74441
260300,202310,13573,28555,10647,24182,333,928,8719,18716,9052,19644
260310,202310,8280,16435,6808,14352,451,775,5523,11455,5974,12230
260320,202310,8921,23296,6708,19327,175,553,5296,14874,5471,15427
260330,202310,2830,7812,2237,6616,115,332,1636,4662,1751,4994
260340,202310,2670,6026,2113,5124,54,175,1697,3865,1751,4040
260345,202310,40074,84852,30324,68882,3484,7647,19600,41931,23084,49578
260350,202310,8233,14470,6424,12324,38,126,5805,10760,5843,10886
260360,202310,2943,6712,2171,5260,81,240,1579,3596,1660,3836
260370,202310,7023,16466,5413,13625,192,536,4303,10230,4495,10766
260380,202310,6197,15695,4732,13101,217,510,3459,9291,3676,9801
260390,202310,5765,15239,3998,11469,268,705,2586,7168,2854,7873
260392,202310,5174,12339,4361,11179,63,312,3758,9293,3821,9605
260400,202310,28611,52977,22346,43706,449,1181,18497,33664,18946,34845
260410,202310,108068,226453,78869,181588,15930,36222,38754,87807,54684,124029
260415,202310,6103,12875,4697,10733,84,272,3949,8644,4033,8916
260420,202310,16612,28037,12637,23463,224,622,11167,20052,11391,20674
260430,202310,3302,9263,2527,7645,182,576,1621,4720,1803,5296
260440,202310,5330,10809,4092,9045,97,311,3373,7054,3470,7365
260450,202310,7089,15800,5771,13815,358,726,4592,10897,4950,11623
260460,202310,7123,17102,5367,13743,386,1089,3580,8410,3966,9499
260470,202310,6170,12791,4830,11145,148,370,4113,9572,4261,9942
260480,202310,4552,10379,3384,8431,328,861,2267,5355,2595,6216
260490,202310,7154,13363,5604,11259,98,324,4838,9175,4936,9499
260500,202310,7681,16639,6003,14030,828,1705,3885,9042,4713,10747
260510,202310,14376,27902,11315,23435,275,723,9707,19353,9982,20076
260515,202310,5668,12987,4079,10053,131,356,2914,6542,3045,6898
260520,202310,20368,41157,15604,34012,1048,2225,11760,24244,12808,26469
260530,202310,12764,29406,10158,25267,168,635,8677,20584,8845,21219
260540,202310,9770,17342,8134,15290,113,247,7361,13491,7474,13738
260545,202310,193,475,118,319,21,54,40,85,61,139
260550,202310,3877,9304,2709,7133,186,541,1726,4130,1912,4671
260560,202310,6951,15807,5191,12943,181,560,4022,9475,4203,10035
260570,202310,11606,23242,9326,20134,209,621,8000,16431,8209,17052
260580,202310,6494,12016,5473,10624,107,201,4865,9219,4972,9420
260590,202310,9343,16639,7131,13935,126,340,6106,11442,6232,11782
260600,202310,44865,95522,33855,77566,1765,4376,25452,54075,27217,58451
260610,202310,9884,22664,7466,18850,318,914,5705,13787,6023,14701
260620,202310,28745,56486,22046,46112,1610,3522,16527,32376,18137,35898
260630,202310,2826,6737,2205,5689,65,192,1763,4375,1828,4567
260640,202310,33737,61225,25964,51096,1710,2813,20393,39266,22103,42079
260650,202310,7559,16867,5571,14096,437,835,4357,10872,4794,11707
260660,202310,9605,19901,7525,16953,262,696,6393,13760,6655,14456
260670,202310,2818,6313,2063,4989,83,261,1559,3520,1642,3781
260680,202310,40352,82104,29515,64753,2599,5390,20892,43577,23491,48967
260690,202310,4274,9574,3090,7629,80,249,2459,5793,2539,6042
260700,202310,9561,19075,8392,17712,129,374,7798,16170,7927,16544
260710,202310,1680,3866,1206,3076,43,122,902,2173,945,2295
260720,202310,40514,78205,30200,63522,1624,3873,23303,46233,24927,50106
260730,202310,10295,25297,8349,22244,265,777,6929,17820,7194,18597
260740,202310,1634,3882,1199,3124,37,149,902,2216,939,2365
260750,202310,9803,21174,7285,17875,214,502,6168,15075,6382,15577
260760,202310,8753,16650,7034,14448,128,329,6042,11848,6170,12177
260765,202310,10775,25997,8450,22046,788,2092,5493,13490,6281,15582
260770,202310,4944,10693,3684,8641,123,356,2981,6686,3104,7042
260775,202310,7876,17242,6265,14428,222,641,4841,10322,5063,10963
260780,202310,4770,11878,3460,9242,284,854,2133,5030,2417,5884
260790,202310,202952,373374,154524,303811,19266,38149,105968,197472,125234,235621
260795,202310,4569,8682,3439,7178,144,390,2610,5062,2754,5452
260800,202310,8022,14377,6769,12624,296,480,5889,10674,6185,11154
260805,202310,4807,10845,3624,8697,127,410,2883,6449,3010,6859
260810,202310,8431,19140,6576,15628,377,900,4916,10964,5293,11864
260820,202310,6147,11428,4814,9750,122,342,3990,7800,4112,8142
260825,202310,3544,9300,2808,7928,138,482,2046,5503,2184,5985
260830,202310,5341,13498,4104,11258,422,986,2765,7545,3187,8531
260840,202310,5855,11957,4731,10327,205,481,3969,8303,4174,8784
260845,202310,5719,12884,4452,10655,194,576,3320,7369,3514,7945
260850,202310,6119,14251,4405,10903,488,1060,2716,6384,3204,7444
260860,202310,4082,10451,3104,8588,239,582,2233,5997,2472,6579
260870,202310,5778,11119,4676,9671,130,242,4006,8077,4136,8319
260875,202310,10958,21388,7823,16828,681,1490,5250,10788,5931,12278
260880,202310,14471,31886,11690,27292,663,1331,9126,20717,9789,22048
260890,202310,16859,36532,12984,30049,1909,4043,7489,17097,9398,21140
260900,202310,6957,17202,5249,14387,661,1694,2865,7580,3526,9274
260910,202310,4291,9519,3499,8273,203,376,2633,6132,2836,6508
260915,202310,7407,15087,6207,13454,95,235,5677,12046,5772,12281
260920,202310,4388,8270,3354,6990,156,416,2667,5314,2823,5730
260930,202310,5235,13000,3934,10658,171,508,2995,7639,3166,8147
260940,202310,20075,39723,15497,32662,1375,2870,11290,22631,12665,25501
260950,202310,9692,21276,6932,16282,378,1054,4790,10161,5168,11215
260960,202310,121948,218110,92775,177002,8741,16128,67777,122351,76518,138479
260970,202310,7046,15957,5319,13228,361,661,3827,9414,4188,10075
260980,202310,6024,14194,4839,12517,126,402,4027,10108,4153,10510
260990,202310,20774,50924,15875,43147,1044,2618,11570,30333,12614,32951
261000,202310,21667,41542,16012,33566,788,1764,12414,24465,13202,26229
261010,202310,2690,5958,2124,5129,86,210,1741,4088,1827,4298
261020,202310,8667,18781,6867,15747,276,735,5454,11714,5730,12449
261030,202310,5159,12754,4008,10594,157,471,2996,7426,3153,7897
261040,202310,6759,16315,5065,13236,200,626,3763,9191,3963,9817
261050,202310,10036,21828,7989,18567,213,515,6379,14157,6592,14672
261060,202310,19215,40430,15075,34538,416,1205,12057,26141,12473,27346
261070,202310,98042,186396,71461,146475,8557,16523,48811,95944,57368,112467
261080,202310,9115,18040,7526,15905,92,227,6932,14260,7024,14487
261090,202310,26100,49944,20506,42092,1051,1933,16427,32454,17478,34387
261100,202310,11196,25933,8805,22022,511,1255,6601,15867,7112,17122
261110,202310,101417,236062,73842,183804,9053,23310,42470,98363,51523,121673
261120,202310,4973,9909,3931,8368,156,326,3295,6741,3451,7067
261130,202310,9867,19688,7852,16735,234,452,6592,13645,6826,14097
261140,202310,4930,9452,3618,7499,276,435,2638,5300,2914,5735
261150,202310,7000,14741,5458,12412,234,559,4250,9287,4484,9846
261153,202310,2351,6163,1691,4814,93,274,1133,3136,1226,3410
261160,202310,325820,643842,238431,512509,72452,148485,84852,191671,157304,340156
261170,202310,10266,19196,8211,16328,338,629,7005,13409,7343,14038
261180,202310,11852,25296,9031,20821,458,1115,6820,14925,7278,16040
261190,202310,6814,14927,5309,12378,179,598,4199,9054,4378,9652
261200,202310,4458,8613,3425,7121,155,323,2737,5503,2892,5826
261210,202310,2289,4912,1764,4077,140,210,1355,3102,1495,3312
261220,202310,19362,43902,14592,35268,1184,2950,10109,22564,11293,25514
261230,202310,4749,11646,3587,9836,82,312,2760,7274,2842,7586
261240,202310,7982,15375,6513,13187,226,426,5598,10976,5824,11402
261245,202310,4907,11372,3663,9270,92,345,2817,6600,2909,6945
261247,202310,3846,9975,2856,8106,321,861,1806,5005,2127,5866
261250,202310,38993,72685,31119,62542,5837,11162,19924,40432,25761,51594
261255,202310,4916,12547,3473,9680,152,525,2422,6243,2574,6768
261260,202310,20463,39980,16300,34510,382,1046,14222,28714,14604,29760
261270,202310,6747,12444,5429,10682,217,380,4716,9016,4933,9396
261280,202310,3304,7757,2657,6656,124,366,2027,4779,2151,5145
261290,202310,3752,7899,2791,6626,67,182,2217,5120,2284,5302
261300,202310,17651,38929,13501,31982,485,1332,10428,23109,10913,24441
261310,202310,12993,26814,10219,22538,849,1809,7619,16063,8468,17872
261320,202310,7556,18137,5978,15440,158,439,4741,11727,4899,12166
261330,202310,8047,15744,6657,13830,174,379,5779,11591,5953,11970
261340,202310,7854,15428,6309,13298,338,642,5184,10586,5522,11228
261350,202310,10433,27078,7988,22354,397,1096,5810,15702,6207,16798
261360,202310,11341,21978,8872,18273,676,1231,6808,13572,7484,14803
261370,202310,33782,71086,25179,57516,2147,4851,17705,38113,19852,42964
261380,202310,5591,13227,4512,11401,517,1172,2898,7220,3415,8392
261390,202310,22987,55683,16730,44740,1849,4529,10513,26926,12362,31455
261400,202310,6278,15310,4953,12799,200,697,3762,8993,3962,9690
261410,202310,12760,26068,9457,21015,251,677,7692,15951,7943,16628
261420,202310,11149,26109,8802,22419,584,1586,6579,15840,7163,17426
261430,202310,5583,11161,4436,9443,65,210,3897,7888,3962,8098
261440,202310,1676,4482,1260,3662,54,221,871,2380,925,2601
261450,202310,19194,42680,15245,36361,728,1652,11631,27210,12359,28862
261460,202310,9761,22663,7526,18936,293,747,5704,13867,5997,14614
261470,202310,4691,10317,3550,8492,68,225,2911,6574,2979,6799
261480,202310,6932,17559,5386,14783,275,867,3895,9878,4170,10745
261485,202310,7386,17397,5720,14562,416,1195,4091,9837,4507,11032
261500,202310,8880,19089,7090,16354,893,1595,4743,11263,5636,12858
261510,202310,2238,5858,1753,4939,71,268,1315,3584,1386,3852
261520,202310,2974,7503,2307,6108,137,407,1615,3976,1752,4383
261530,202310,15518,38144,11157,29981,766,2349,6726,16202,7492,18551
261540,202310,12331,30368,10499,27401,2892,6720,4862,13964,7754,20684
261550,202310,4658,10674,3540,8687,282,716,2428,5536,2710,6252
261560,202310,12140,27173,9843,23590,355,941,7941,18139,8296,19080
261570,202310,4609,10969,3210,8424,305,862,2065,5099,2370,5961
261580,202310,9158,19420,7247,16600,101,359,6436,14176,6537,14535
261590,202310,3418,7334,2600,6046,60,183,2076,4531,2136,4714
261600,202310,7684,14639,6224,12531,162,375,5263,10080,5425,10455
261610,202310,2777,7083,2045,5679,266,703,1183,3254,1449,3957
261618,202310,3604,6826,2840,5752,100,197,2355,4584,2455,4781
261620,202310,6205,14315,5348,12979,648,1399,3718,9236,4366,10635
261630,202310,7395,18619,5517,14770,406,1137,3415,8324,3821,9461
261640,202310,49553,94114,37059,76794,2491,4298,27352,55813,29843,60111
261650,202310,5576,11135,4159,9215,349,648,3175,7031,3524,7679
270010,202310,5136,15155,3890,12596,133,583,2715,8293,2848,8876
270020,202310,5219,10571,4005,8869,161,401,3216,6584,3377,6985
270030,202310,47498,112679,37225,95342,2604,6839,27147,66584,29751,73423
270040,202310,12134,28695,9059,24147,857,2493,6113,15439,6970,17932
270050,202310,6739,13724,5241,11884,213,524,4404,9725,4617,10249
270060,202310,2766,6364,2041,5235,136,342,1453,3520,1589,3862
270070,202310,6592,14504,5305,12587,171,559,4439,10029,4610,10588
270080,202310,1829,4245,1302,3342,82,195,934,2301,1016,2496
270090,202310,2266,5809,1867,5101,96,303,1502,3993,1598,4296
270100,202310,8976,16543,7180,14093,200,446,6244,11867,6444,12313
270110,202310,3922,8469,2768,6846,171,334,2043,5004,2214,5338
270120,202310,3047,7532,2440,6588,114,331,1800,4673,1914,5004
270130,202310,6140,13925,4712,11812,206,649,3777,9004,3983,9653
270135,202310,2413,5120,1872,4440,53,176,1570,3562,1623,3738
270140,202310,10317,22919,6994,17490,478,1232,4802,11144,5280,12376
270150,202310,3870,8797,3351,8049,86,256,3008,7094,3094,7350
270160,202310,6144,15393,4839,13446,186,654,3988,10600,4174,11254
270170,202310,3802,10021,2861,8348,175,628,1882,5023,2057,5651
270180,202310,2889,7560,2389,6802,87,343,1935,5304,2022,5647
270190,202310,3042,6057,2562,5432,43,122,2274,4648,2317,4770
270200,202310,3392,8748,2576,7256,545,1271,1488,4321,2033,5592
270210,202310,7084,14332,5651,12531,185,582,4800,10231,4985,10813
270220,202310,2092,4467,1492,3485,120,295,1089,2378,1209,2673
270230,202310,12691,30053,9635,24825,956,2566,6861,16797,7817,19363
270235,202310,7712,20609,6023,17515,305,906,4475,12547,4780,13453
270240,202310,14377,33891,10656,27735,980,2621,7376,18249,8356,20870
270250,202310,4228,8301,3269,6918,169,392,2585,5144,2754,5536
270255,202310,5233,13398,3812,10758,175,534,2837,7663,3012,8197
270260,202310,6670,18224,5483,16021,143,499,4405,12427,4548,12926
270270,202310,1231,2910,903,2436,107,288,639,1684,746,1972
270280,202310,4535,9630,3180,7802,231,496,2227,5477,2458,5973
270290,202310,9777,26868,8275,24229,239,883,6806,19428,7045,20311
270300,202310,4860,11461,3433,9447,211,606,2445,6488,2656,7094
270310,202310,7948,20154,6140,17068,196,650,4693,12514,4889,13164
270320,202310,6685,17558,5001,14080,360,1199,3334,8587,3694,9786
270330,202310,5320,14479,4333,12872,197,733,3527,10091,3724,10824
270340,202310,1968,4606,1521,3888,109,182,1226,3147,1335,3329
270350,202310,2263,4570,1641,3761,218,354,975,2396,1193,2750
270360,202310,4335,8283,3621,7420,77,216,3256,6467,3333,6683
270370,202310,1607,4491,1317,3929,39,164,1056,3042,1095,3206
270375,202310,4866,8755,3722,7434,105,255,3126,6025,3231,6280
270380,202310,7017,15811,5305,13394,639,1396,3752,9503,4391,10899
270390,202310,1530,3336,1082,2767,17,73,886,2210,903,2283
270400,202310,7721,18426,5637,14896,399,1043,3852,9768,4251,10811
270410,202310,6471,15798,5136,13639,169,556,4141,10535,4310,11091
270420,202310,8456,19589,7165,17538,201,595,5989,14018,6190,14613
270430,202310,225036,450113,161640,357215,20008,43730,100582,210957,120590,254687
270440,202310,5650,13572,4446,11753,215,700,3352,8552,3567,9252
270450,202310,11378,23657,9233,20781,502,1006,7328,16291,7830,17297
270460,202310,4701,9359,3413,7609,246,547,2575,5427,2821,5974
270470,202310,14936,35678,11632,30213,732,2072,8586,21194,9318,23266
270480,202310,3763,8486,2808,7042,206,507,2089,4982,2295,5489
270490,202310,1072,2658,841,2304,42,129,638,1663,680,1792
270500,202310,5863,15494,4934,13770,284,757,3892,10610,4176,11367
270510,202310,7746,17002,5818,14192,286,819,4473,10292,4759,11111
270520,202310,4956,12117,3368,9227,659,1734,1605,4321,2264,6055
270530,202310,1638,4203,1226,3449,82,199,835,2315,917,2514
270540,202310,2685,6458,2046,5503,79,227,1698,4425,1777,4652
270550,202310,8012,18313,5704,15235,655,1565,3718,9938,4373,11503
270560,202310,3661,8102,2743,6715,163,519,2036,4626,2199,5145
270570,202310,6808,14461,5355,12175,465,1170,4177,8891,4642,10061
270580,202310,2947,7103,2425,6268,109,288,2009,5035,2118,5323
270590,202310,1707,4606,1459,4195,90,285,1185,3335,1275,3620
270600,202310,3370,8903,2858,8013,147,499,2278,6250,2425,6749
270610,202310,4326,10310,3449,8959,206,503,2519,6279,2725,6782
270620,202310,1422,3903,1189,3455,67,206,925,2598,992,2804
270630,202310,24073,48817,19234,41775,675,1794,16147,33081,16822,34875
270640,202310,6816,16838,5285,14270,151,523,3996,10220,4147,10743
270642,202310,3168,8691,2521,7438,222,665,1698,4718,1920,5383
270644,202310,4776,10601,3699,9058,322,796,2711,6478,3033,7274
270650,202310,4587,10563,3679,9201,239,653,2783,6533,3022,7186
270660,202310,2363,5201,1893,4494,96,192,1409,3227,1505,3419
270670,202310,23548,45630,17796,37682,1354,2441,13595,27712,14949,30153
270680,202310,7726,14486,6396,12863,275,458,5577,11122,5852,11580
270690,202310,12858,27396,9626,22598,346,987,7543,16739,7889,17726
270700,202310,707,1815,560,1548,84,233,356,930,440,1163
270710,202310,7172,18779,5663,16083,393,1101,4182,11536,4575,12637
270720,202310,4495,11223,3603,9636,139,452,2884,7377,3023,7829
270730,202310,9414,18991,6942,15979,714,1236,4980,11845,5694,13081
270740,202310,2825,6791,2201,5837,126,391,1650,4129,1776,4520
270750,202310,6833,15288,5556,13362,121,408,4914,11387,5035,11795
270760,202310,4023,9670,3091,8249,75,306,2464,6303,2539,6609
270770,202310,29833,65364,20972,51293,3009,7075,12768,29888,15777,36963
270780,202310,2501,5387,2064,4749,76,201,1742,3861,1818,4062
270790,202310,2214,5005,1676,4146,105,252,1295,3050,1400,3302
270800,202310,14700,32767,11770,28134,700,1741,8910,20336,9610,22077
270810,202310,4221,9978,3042,8069,467,991,1919,5039,2386,6030
270820,202310,1928,5120,1522,4427,104,325,1141,3205,1245,3530
270830,202310,6333,13470,4651,11120,491,941,3341,7927,3832,8868
270840,202310,9861,26535,7708,22708,438,1744,5585,15381,6023,17125
270850,202310,10874,22004,8372,18761,611,1409,6552,14228,7163,15637
270860,202310,17862,35841,12450,28467,869,2156,9251,20311,10120,22467
270870,202310,2876,7372,2001,5739,200,627,1206,3219,1406,3846
270880,202310,9608,25648,7642,22003,257,928,5935,16411,6192,17339
270890,202310,4276,10304,3157,8295,573,1478,1592,4020,2165,5498
270895,202310,4699,11112,3903,9917,157,423,3164,7759,3321,8182
270900,202310,1849,4373,1330,3539,53,172,983,2467,1036,2639
270910,202310,5668,13774,4408,11701,320,757,3256,8359,3576,9116
270915,202310,11522,28539,8142,22149,801,2380,5005,12482,5806,14862
270920,202310,7475,18590,5998,16239,117,435,4945,12986,5062,13421
270930,202310,22234,45081,15639,36294,2199,4756,9914,22492,12113,27248
270940,202310,7293,17333,5470,14703,175,634,4108,10333,4283,10967
280010,202310,670,1777,481,1385,22,79,302,784,324,863
280020,202310,6595,14001,5072,11565,475,1018,3686,8017,4161,9035
280030,202310,129380,250818,95366,198051,18568,35129,51353,105241,69921,140370
280040,202310,3793,8630,2937,7208,206,515,2178,5096,2384,5611
280050,202310,5253,13265,3758,10352,862,2304,1731,4497,2593,6801
280060,202310,10061,21199,7223,16613,1143,2608,4161,9008,5304,11616
280067,202310,8902,18365,6714,14817,621,1030,4805,10411,5426,11441
280070,202310,2220,5912,1865,5300,117,380,1363,3623,1480,4003
280100,202310,5461,12157,4154,9950,711,1449,2337,5718,3048,7167
280110,202310,2032,4219,1591,3577,41,123,1368,2942,1409,3065
280120,202310,10096,23862,8117,20506,1160,2614,5335,13575,6495,16189
280130,202310,10607,22352,7920,18460,744,1705,5585,12666,6329,14371
280140,202310,7670,14871,6230,12691,956,1402,4224,8928,5180,10330
280150,202310,4867,11067,3371,8355,562,1107,2023,4927,2585,6034
280160,202310,1627,3873,1216,3120,123,254,793,1904,916,2158
280170,202310,7203,15123,5614,12707,250,632,4417,9517,4667,10149
280190,202310,2071,3416,1673,2884,30,56,1477,2455,1507,2511
280200,202310,1524,3597,1060,2832,70,263,714,1701,784,1964
280210,202310,22797,47382,16814,37565,2457,5086,10588,22831,13045,27917
280220,202310,2072,4586,1587,3859,78,160,1218,2878,1296,3038
280230,202310,5062,11498,3578,9018,225,448,2391,5816,2616,6264
280240,202310,3926,9238,3138,7948,42,178,2648,6386,2690,6564
280250,202310,1372,2529,875,1719,41,92,702,1292,743,1384
280260,202310,3116,6045,2428,5106,62,157,2148,4364,2210,4521
280270,202310,3121,7151,2502,6189,122,361,2081,4875,2203,5236
280280,202310,4727,12377,3687,10515,506,1139,2382,6926,2888,8065
280290,202310,27921,59788,20943,48429,2538,6309,12243,27875,14781,34184
280300,202310,16602,32206,13397,28285,1068,1571,10419,22635,11487,24206
280310,202310,1691,3812,1256,3076,55,151,958,2214,1013,2365
280320,202310,11734,26237,9063,21739,952,2163,6376,14498,7328,16661
280330,202310,5576,12312,3900,9526,297,742,2698,6205,2995,6947
280340,202310,6416,11888,4620,9640,194,369,3784,7652,3978,8021
280350,202310,40427,74776,31377,61569,5027,7042,20851,42183,25878,49225
280360,202310,7282,17632,5117,13610,650,1663,3084,7690,3734,9353
280370,202310,2885,5954,2126,4686,235,399,1482,3284,1717,3683
280380,202310,1315,2984,986,2424,125,307,648,1538,773,1845
280390,202310,5084,10258,3806,8212,303,541,2947,6207,3250,6748
280400,202310,5180,10664,3793,8579,338,731,2803,6143,3141,6874
280410,202310,3541,8255,2594,6503,510,1140,1468,3580,1978,4720
280420,202310,5630,12358,4612,10936,125,292,3968,9262,4093,9554
280430,202310,2999,5885,2374,4990,93,227,1926,3821,2019,4048
280440,202310,5664,12219,4399,10152,403,849,3316,7312,3719,8161
280445,202310,2630,6302,2223,5555,213,362,1574,3906,1787,4268
280450,202310,12174,26982,9426,22550,2738,6062,4402,10884,7140,16946
280460,202310,8773,17932,7034,15365,604,1314,5241,10899,5845,12213
280470,202310,2039,5021,1514,3995,239,548,968,2501,1207,3049
280480,202310,66074,132841,50079,107689,6592,13424,32280,66408,38872,79832
280490,202310,4133,10791,3118,8840,297,700,2012,5480,2309,6180
280500,202310,1311,2623,931,2076,34,95,734,1586,768,1681
280510,202310,4580,7644,3668,6421,301,423,3052,5291,3353,5714
280520,202310,2345,4779,1848,4045,170,332,1348,2857,1518,3189
280530,202310,2856,6418,2134,5233,111,280,1648,3867,1759,4147
280540,202310,10515,24874,8691,21937,407,1059,7188,17716,7595,18775
280550,202310,8354,16709,6295,13602,195,524,5130,10351,5325,10875
280560,202310,9354,21682,8003,19468,215,641,6857,16169,7072,16810
280570,202310,8755,17754,6545,14538,350,776,4977,10382,5327,11158
280580,202310,7872,16188,6208,13532,484,879,4765,10012,5249,10891
280590,202310,3357,7034,2349,5529,154,388,1648,3597,1802,3985
280600,202310,5316,11293,4218,9371,1068,1833,2318,5459,3386,7292
280610,202310,3558,6964,2693,5684,123,271,2185,4386,2308,4657
280620,202310,7867,16021,5956,13233,446,750,4378,9766,4824,10516
280630,202310,5240,11489,4197,9821,376,758,2970,6811,3346,7569
280640,202310,3093,6626,2321,5580,90,245,1970,4582,2060,4827
280650,202310,1403,3331,995,2603,123,309,580,1396,703,1705
280660,202310,4768,8936,3577,7329,321,592,2781,5580,3102,6172
280670,202310,26126,53496,19396,43231,3980,7922,10621,23661,14601,31583
280680,202310,3555,7524,2695,6155,265,497,1792,4135,2057,4632
280690,202310,1337,2631,991,2121,56,130,788,1611,844,1741
280700,202310,1474,3027,1127,2474,20,55,939,1979,959,2034
280710,202310,18988,36090,14123,29809,810,1542,11467,23592,12277,25134
280720,202310,3104,6238,2164,4922,40,121,1750,3858,1790,3979
280730,202310,1258,2869,930,2294,108,255,623,1492,731,1747
280740,202310,21401,40117,16659,32944,901,1923,13306,24783,14207,26706
280750,202310,4132,10384,3175,8568,347,791,2142,5742,2489,6533
280760,202310,9288,19550,7043,16142,677,1374,5058,11435,5735,12809
290010,202310,3751,6779,2380,4720,37,88,2017,3746,2054,3834
290020,202310,7316,15087,6068,13363,435,691,4815,10496,5250,11187
290030,202310,5439,11121,4058,9312,462,900,2834,6659,3296,7559
290035,202310,6166,11746,4742,9777,201,347,3808,7647,4009,7994
290040,202310,7222,12241,5715,10359,216,366,4956,8820,5172,9186
290050,202310,2541,7161,1847,5561,148,481,1192,3330,1340,3811
290060,202310,1936,3643,1268,2692,139,270,925,1874,1064,2144
290070,202310,53272,100555,39509,80339,3688,6806,28557,56121,32245,62927
290080,202310,8764,19728,6821,16553,814,1997,4551,10652,5365,12649
290090,202310,2759,4365,1905,3430,39,71,1711,3007,1750,3078
290100,202310,12185,27617,8382,21068,1838,4249,3579,9355,5417,13604
290110,202310,6902,15685,4881,11869,954,1981,2486,5997,3440,7978
290115,202310,4928,13010,3788,10827,401,1117,2785,7776,3186,8893
290120,202310,8377,17537,6274,14323,265,617,5163,11310,5428,11927
290130,202310,5558,11529,3789,8896,279,550,2586,6212,2865,6762
290135,202310,5682,11572,3944,8509,339,706,2877,5860,3216,6566
290140,202310,5283,12125,3647,9582,218,565,2820,7184,3038,7749
290150,202310,4265,7896,3074,6309,134,333,2403,4614,2537,4947
290160,202310,4561,8617,3665,7272,250,402,3016,5890,3266,6292
290170,202310,4687,9294,3542,7827,157,336,2987,6430,3144,6766
290180,202310,3641,8532,2794,7098,110,345,2269,5539,2379,5884
290190,202310,6238,12995,5176,11458,128,330,4394,9409,4522,9739
290195,202310,3328,6732,2390,5476,162,327,1878,4251,2040,4578
290200,202310,5030,12421,3408,9361,222,496,2366,6347,2588,6843
290205,202310,4697,9772,3513,7768,153,381,2717,5634,2870,6015
290210,202310,17999,39749,14320,33730,1757,3545,10117,23771,11874,27316
290220,202310,4241,7760,3355,6591,109,282,2822,5312,2931,5594
290225,202310,3789,6645,2655,5354,74,189,2266,4361,2340,4550
290230,202310,3917,7513,3366,6813,194,290,2660,5452,2854,5742
290240,202310,5101,10095,3886,8515,190,428,3191,6784,3381,7212
290250,202310,5195,12171,3730,9826,204,461,2893,7551,3097,8012
290260,202310,6578,13947,5040,11498,283,643,4101,8913,4384,9556
290265,202310,3799,10301,2723,8060,417,1240,1534,4321,1951,5561
290270,202310,13270,39618,10924,34804,921,2834,7668,23874,8589,26708
290280,202310,7411,20393,5549,16215,787,2346,3243,8908,4030,11254
290290,202310,12053,31425,8212,23807,1086,3232,4556,12404,5642,15636
290300,202310,4984,12136,3313,8885,227,689,2308,5860,2535,6549
290310,202310,2871,4986,2144,4107,29,76,1920,3580,1949,3656
290320,202310,38710,85184,27203,65720,5120,12476,14474,33226,19594,45702
290323,202310,4662,11271,3516,9222,135,371,2688,6914,2823,7285
290327,202310,5220,13038,3723,9834,418,977,2347,6014,2765,6991
290330,202310,3182,5079,2356,4147,67,172,2069,3532,2136,3704
290340,202310,7969,16091,5773,13125,471,1090,4350,9518,4821,10608
290350,202310,5844,14547,4386,11879,297,862,3125,8148,3422,9010
290360,202310,6642,13719,5154,11512,240,634,4313,9224,4553,9858
290370,202310,5668,12376,3601,9310,198,519,2487,6356,2685,6875
290380,202310,7322,15314,5465,12530,173,374,4552,10274,4725,10648
290390,202310,18973,47250,13819,37823,1395,3696,8987,23821,10382,27517
290395,202310,3667,8787,2552,6756,114,341,1899,4750,2013,5091
290400,202310,4529,11081,3104,8450,151,454,2289,5921,2440,6375
290405,202310,5500,14122,4209,11682,574,1536,2550,7104,3124,8640
290410,202310,6950,16061,4744,12392,181,652,3484,8564,3665,9216
290420,202310,3760,9080,2719,7278,140,345,1955,5176,2095,5521
290430,202310,4628,9717,3526,8030,166,450,2792,5986,2958,6436
290440,202310,3474,7699,2287,5729,194,463,1562,3847,1756,4310
290450,202310,5257,10041,3718,7714,85,237,3211,6268,3296,6505
290460,202310,15841,40291,10572,29095,2505,6966,3761,9777,6266,16743
290470,202310,6139,12104,4091,9092,369,770,2786,5999,3155,6769
290475,202310,8133,19844,6084,16263,157,553,4909,12570,5066,13123
290480,202310,2320,4917,1639,3751,62,184,1204,2455,1266,2639
290485,202310,5701,14250,4526,12331,253,739,3365,8957,3618,9696
290490,202310,12123,23463,9790,20010,591,1155,7655,15141,8246,16296
290500,202310,5216,13792,3430,9874,819,2364,1194,3308,2013,5672
290510,202310,4450,9170,3404,7705,105,258,2867,6377,2972,6635
290515,202310,4221,10320,3200,8569,104,399,2481,6245,2585,6644
290520,202310,15301,37424,10392,27498,611,1949,6827,16269,7438,18218
290530,202310,5883,15070,4481,12571,148,502,3575,9768,3723,10270
290540,202310,5150,11453,4263,10245,191,479,3511,8238,3702,8717
290550,202310,5443,11598,4282,10062,144,466,3599,8138,3743,8604
290560,202310,7686,17531,5166,13387,552,1476,3091,7353,3643,8829
290570,202310,77463,161080,61330,135689,5893,14111,45087,94247,50980,108358
290580,202310,11503,25954,9337,22706,913,2102,6709,16273,7622,18375
290590,202310,8413,23218,6534,19808,195,661,5036,15215,5231,15876
290600,202310,23442,57577,17987,47769,1381,3736,13347,34004,14728,37740
290610,202310,2931,8154,2074,6366,100,343,1441,4251,1541,4594
290620,202310,7297,18999,5585,15819,524,1439,4041,11240,4565,12679
290630,202310,13355,25136,10227,20976,756,1623,7849,15645,8605,17268
290640,202310,3284,6949,2190,5160,239,503,1507,3574,1746,4077
290650,202310,24414,45926,19837,39507,767,1953,17014,32226,17781,34179
290660,202310,4543,10607,3175,8121,210,598,2214,5504,2424,6102
290670,202310,10898,21259,8540,17738,207,552,7403,14778,7610,15330
290680,202310,13798,32231,10288,26513,369,1229,7859,19141,8228,20370
290682,202310,6752,13654,5356,11667,430,672,3867,8967,4297,9639
290685,202310,4359,8868,2837,6536,448,945,1642,3831,2090,4776
290687,202310,10546,22010,8062,18002,1229,2512,4997,11194,6226,13706
290689,202310,3428,8214,2247,6042,354,891,1330,3495,1684,4386
290690,202310,7078,16101,5026,12623,459,1082,3387,8214,3846,9296
290700,202310,3875,7725,3067,6631,118,313,2506,5210,2624,5523
290710,202310,11305,25245,8815,21556,266,724,7501,17853,7767,18577
290720,202310,26278,59212,20605,50076,1581,3613,14810,34260,16391,37873
290730,202310,8849,18598,6663,15514,684,1374,4364,10229,5048,11603
290740,202310,1344,3040,941,2396,85,179,708,1789,793,1968
290750,202310,18003,34464,13136,25979,444,1109,10643,19564,11087,20673
290755,202310,2383,6134,1699,4856,212,473,1034,3003,1246,3476
290760,202310,4523,11575,3330,9276,183,434,2289,6357,2472,6791
290770,202310,3957,8857,3293,7879,80,270,2729,6236,2809,6506
290780,202310,9465,21171,6794,16744,740,1334,4525,11296,5265,12630
290790,202310,6310,14934,4874,12598,299,805,3703,9329,4002,10134
290800,202310,8216,14686,5397,11082,554,894,3753,7862,4307,8756
290810,202310,6915,14862,5030,11906,239,606,3820,8802,4059,9408
290820,202310,6812,14986,5042,11877,271,636,3580,8038,3851,8674
290830,202310,5152,11502,3782,8986,160,546,2708,5704,2868,6250
290840,202310,22869,53152,16979,42796,2066,4491,10051,26291,12117,30782
290850,202310,11573,20979,8632,17123,653,1199,6472,12439,7125,13638
290860,202310,8148,19024,6552,16775,360,807,5328,13615,5688,14422
290870,202310,5881,14288,3873,10246,389,879,2504,6437,2893,7316
290880,202310,1728,3758,1197,2974,252,547,584,1575,836,2122
290890,202310,12336,21314,9385,17722,330,708,7977,14540,8307,15248
290900,202310,2779,6751,1787,4782,284,739,968,2500,1252,3239
290910,202310,6264,12791,4289,9764,94,253,3670,8119,3764,8372
290920,202310,6368,13727,5106,12069,214,467,4122,10117,4336,10584
290930,202310,8649,22111,6202,17558,305,936,4278,11536,4583,12472
290940,202310,4145,10439,3095,8632,255,704,2213,5979,2468,6683
290950,202310,1708,3804,1199,2961,115,268,750,1870,865,2138
290960,202310,7525,16127,5971,13805,484,818,4674,10850,5158,11668
290970,202310,3680,10198,2663,8090,206,615,1845,5422,2051,6037
290980,202310,18845,37641,14111,29784,923,2214,9819,18988,10742,21202
290990,202310,12108,28038,9702,23903,523,1417,7576,17670,8099,19087
291000,202310,4002,8949,2844,7350,217,580,2069,5253,2286,5833
291005,202310,22116,46450,17000,38361,1075,2687,12961,27452,14036,30139
291010,202310,3613,10151,2471,7509,184,554,1516,4385,1700,4939
291020,202310,1537,3421,1078,2591,40,117,753,1621,793,1738
291030,202310,3097,6482,1989,4559,244,501,1170,2550,1414,3051
291040,202310,6537,15570,4797,12877,284,746,3527,9351,3811,10097
291050,202310,14886,28973,11562,23822,1471,2858,8148,16356,9619,19214
291060,202310,11308,24199,8831,20506,1307,2352,5842,13691,7149,16043
291070,202310,22846,48494,17766,40341,486,1278,14911,32478,15397,33756
291072,202310,36620,77352,23402,54744,3685,8286,12401,27813,16086,36099
291075,202310,6481,14449,5263,12332,124,333,4234,9404,4358,9737
291077,202310,2048,4814,1405,3673,94,193,918,2404,1012,2597
291080,202310,174415,363052,120847,277063,24030,55382,59427,129362,83457,184744
291085,202310,6902,15299,4999,12226,286,858,3810,8843,4096,9701
291090,202310,2567,4382,1638,3258,52,123,1344,2566,1396,2689
291100,202310,3908,7213,2585,5496,111,218,2011,4135,2122,4353
291110,202310,7125,19378,5126,15398,292,953,3572,10015,3864,10968
291120,202310,10339,20592,7911,17157,600,1186,5823,12252,6423,13438
291125,202310,2825,4399,1961,3409,87,126,1688,2885,1775,3011
291130,202310,3836,9575,2453,6781,136,439,1692,4336,1828,4775
291140,202310,5785,14023,3556,9578,680,1580,1911,5220,2591,6800
291150,202310,3396,5823,2413,4669,112,220,2010,3845,2122,4065
291160,202310,6193,15183,4297,11706,614,1615,2381,6024,2995,7639
291165,202310,2504,6302,1492,4223,41,150,946,2510,987,2660
291170,202310,27771,62713,19528,47347,1753,4113,12308,28087,14061,32200
291180,202310,9659,16710,6796,12939,393,685,5639,10443,6032,11128
291185,202310,4310,9341,3447,7958,187,372,2727,6211,2914,6583
291190,202310,9360,19997,7083,16804,378,862,5137,12173,5515,13035
291200,202310,3258,8151,2100,5806,124,391,1296,3277,1420,3668
291210,202310,9783,17257,6628,13402,372,713,5196,10203,5568,10916
291220,202310,6091,14303,4681,11764,614,1443,2826,6830,3440,8273
291230,202310,6031,10219,4299,8175,90,168,3836,7131,3926,7299
291240,202310,5068,11740,3887,9723,115,326,3207,7735,3322,8061
291250,202310,3923,10565,2782,8375,252,641,1543,4765,1795,5406
291260,202310,1842,3660,1319,2935,27,66,1074,2306,1101,2372
291270,202310,6881,14942,4937,12109,644,1533,3305,8023,3949,9556
291280,202310,3423,7371,2078,5028,150,367,1410,3122,1560,3489
291290,202310,6674,15699,4386,11769,458,1255,2770,7063,3228,8318
291300,202310,4698,11059,3387,8747,274,581,2367,6012,2641,6593
291310,202310,6395,14707,4878,11981,139,372,4058,9574,4197,9946
291320,202310,8002,19049,5661,14849,1428,3516,2774,7370,4202,10886
291330,202310,2249,5171,1650,4123,69,201,1225,2902,1294,3103
291340,202310,5162,11790,3678,9200,298,677,2358,5790,2656,6467
291345,202310,3596,8741,2951,7674,225,591,2177,5556,2402,6147
291350,202310,8591,17732,6187,14415,389,898,4670,10481,5059,11379
291360,202310,56365,107025,39400,83970,6082,12192,23242,49231,29324,61423
291370,202310,10268,24022,8106,20250,1243,2649,5101,12462,6344,15111
291380,202310,5946,11782,4570,9863,135,407,3784,7714,3919,8121
291390,202310,16915,30645,11648,23914,940,1545,8973,17973,9913,19518
291400,202310,21037,42091,15394,33105,2254,4130,9574,21016,11828,25146
291410,202310,3638,8377,2467,6193,59,186,1847,4390,1906,4576
291420,202310,2243,4851,1613,3984,24,86,1379,3317,1403,3403
291430,202310,3155,7716,2356,6273,175,445,1694,4308,1869,4753
291440,202310,8246,20098,6347,16825,504,1238,4429,11762,4933,13000
291450,202310,13974,25055,10647,21007,322,594,9272,18146,9594,18740
291460,202310,23252,49656,17661,40087,2160,4397,11766,25674,13926,30071
291465,202310,10560,22965,7750,19345,390,1202,5956,14170,6346,15372
291470,202310,26272,47397,19057,37609,1182,2108,13963,26061,15145,28169
291480,202310,54640,106971,37995,80991,4787,10102,22164,44532,26951,54634
291490,202310,9529,18397,7822,16287,531,1104,6264,12645,6795,13749
291500,202310,6830,12869,5214,10790,134,390,4490,8867,4624,9257
291510,202310,5962,11335,4234,9037,109,317,3573,7319,3682,7636
291520,202310,5661,11370,3684,8507,234,556,2746,6009,2980,6565
291530,202310,2762,5625,1728,4136,164,419,1120,2554,1284,2973
291535,202310,4760,11395,3612,9449,216,555,2782,7163,2998,7718
291540,202310,2720,5110,1766,3856,105,204,1382,2943,1487,3147
291550,202310,8336,15212,5687,11546,412,759,4181,8260,4593,9019
291560,202310,21791,47426,13601,34424,3579,8747,4953,12291,8532,21038
291570,202310,2852,5700,2005,4679,59,134,1653,3766,1712,3900
291580,202310,7723,17138,5249,13308,460,1087,3570,8636,4030,9723
291590,202310,3516,6407,2718,5387,82,194,2325,4360,2407,4554
291600,202310,6810,13648,4675,10327,519,1222,2956,6267,3475,7489
291610,202310,8690,16727,6889,14364,728,1079,5099,10755,5827,11834
291620,202310,3576,7018,2422,5532,189,390,1695,3884,1884,4274
291630,202310,4318,7804,2921,6041,498,803,2008,4294,2506,5097
291640,202310,23223,46142,15282,33819,1209,2888,9911,20507,11120,23395
291650,202310,12688,25665,10182,22207,740,1287,7750,16711,8490,17998
291660,202310,2372,5171,1602,3942,153,388,1041,2355,1194,2743
291670,202310,2424,5764,1787,4735,305,698,1021,2797,1326,3495
291680,202310,5078,10917,3595,8620,781,1790,1909,4607,2690,6397
291685,202310,5700,12860,4112,10280,388,849,2850,7048,3238,7897
291690,202310,5548,9783,3670,7153,175,337,3129,5881,3304,6218
291700,202310,12019,27605,9843,23979,289,845,8376,19628,8665,20473
291710,202310,6812,13130,4628,9981,378,814,3339,6764,3717,7578
291720,202310,5422,14579,3987,11599,1082,3094,1803,5156,2885,8250
291730,202310,9914,18394,8012,15880,471,953,6540,12606,7011,13559
291733,202310,3622,7977,2668,6538,141,369,1930,4748,2071,5117
291735,202310,3137,7911,2120,5936,118,297,1425,3993,1543,4290
291740,202310,5008,11589,2929,7687,124,281,1994,5087,2118,5368
291750,202310,27507,56339,20183,44395,2975,5718,12867,28084,15842,33802
291760,202310,13876,34543,9377,26624,3257,10054,1450,3854,4707,13908
291770,202310,9558,22243,6768,16792,478,1334,4818,10969,5296,12303
291780,202310,6544,14560,5497,12970,218,503,4526,10394,4744,10897
291790,202310,3811,8164,3157,7212,511,772,2065,4991,2576,5763
291800,202310,45809,94641,32213,73428,5467,11448,17913,38727,23380,50175
291810,202310,13472,27794,10267,23271,611,1099,7875,17805,8486,18904
291820,202310,4817,10944,3767,9319,158,363,2933,7082,3091,7445
291830,202310,6108,11504,4532,9341,542,723,3236,6857,3778,7580
291835,202310,7892,21131,5776,17071,1240,3433,2947,8837,4187,12270
291840,202310,68412,156490,53287,130870,7329,17307,34052,80561,41381,97868
291845,202310,4240,8190,3134,6708,392,705,2067,4517,2459,5222
291850,202310,5634,13005,4299,10820,154,422,3546,8800,3700,9222
291855,202310,2887,4702,2096,3807,89,173,1820,3242,1909,3415
291860,202310,2571,6247,1508,4056,67,170,975,2498,1042,2668
291870,202310,1554,3550,875,2327,85,242,505,1252,590,1494
291875,202310,3573,9682,2723,7822,117,415,1883,5115,2000,5530
291880,202310,6867,16446,5277,13661,452,1108,3727,9591,4179,10699
291890,202310,2115,3762,1178,2580,186,365,683,1421,869,1786
291900,202310,1651,3428,1147,2637,51,120,893,1914,944,2034
291905,202310,2518,6195,1809,4913,106,310,1318,3366,1424,3676
291910,202310,4570,8451,3465,6983,94,234,2961,5809,3055,6043
291915,202310,8931,22381,6541,18041,271,732,4403,12038,4674,12770
291920,202310,47795,100806,36956,84108,1998,5438,27471,58066,29469,63504
291930,202310,3458,7493,2673,6308,351,726,1809,4292,2160,5018
291940,202310,4518,10395,2621,7002,338,847,1501,3919,1839,4766
291950,202310,11012,30571,8102,24448,596,1735,5105,15038,5701,16773
291955,202310,27245,57714,20928,48076,1499,3677,15053,32794,16552,36471
291960,202310,4740,9437,3560,7784,358,535,2683,6062,3041,6597
291970,202310,6195,12486,4831,10656,215,504,3764,7952,3979,8456
291980,202310,12353,30902,8744,24152,931,2334,5491,15049,6422,17383
291990,202310,2780,6272,2125,5407,105,384,1748,4265,1853,4649
291992,202310,5783,11553,4273,9170,177,439,3421,6936,3598,7375
291995,202310,2880,6360,2065,4988,107,332,1566,3515,1673,3847
292000,202310,3409,6713,2618,5725,90,223,2171,4635,2261,4858
292010,202310,7212,14261,5365,11419,124,336,4551,9275,4675,9611
292020,202310,5840,13773,4428,11207,129,400,3561,8528,3690,8928
292030,202310,2680,6696,2000,5389,253,718,1158,2942,1411,3660
292040,202310,5821,12141,4228,9809,182,346,3417,7798,3599,8144
292045,202310,5521,10967,4038,8889,76,204,3615,7817,3691,8021
292050,202310,7980,19348,5522,14618,387,960,3536,8889,3923,9849
292060,202310,16334,30841,13873,27591,795,1485,11492,22068,12287,23553
292070,202310,9043,17899,7346,15673,584,1247,5911,12252,6495,13499
292080,202310,4720,8838,3678,7477,64,177,3269,6423,3333,6600
292090,202310,5317,10065,3405,7600,157,361,2602,5597,2759,5958
292100,202310,16662,35035,11804,27364,1864,4319,6781,14943,8645,19262
292105,202310,3952,9128,2899,7395,93,316,2234,5450,2327,5766
292110,202310,8354,16437,5537,12384,976,2164,3167,6866,4143,9030
292120,202310,8779,19432,6425,15223,851,1703,4146,9940,4997,11643
292130,202310,4052,8584,2929,6953,316,633,1902,4392,2218,5025
292140,202310,7281,13951,5546,11384,201,429,4758,9437,4959,9866
292145,202310,3270,7721,2394,6132,157,292,1742,4540,1899,4832
292150,202310,20322,43491,15930,36253,419,1060,13121,28408,13540,29468
292160,202310,3523,7420,2374,5830,48,158,1852,4654,1900,4812
292170,202310,10604,25149,7754,20276,625,1728,5314,13115,5939,14843
292180,202310,3479,8720,2286,6352,214,588,1406,3682,1620,4270
292190,202310,3849,8651,2760,6779,335,765,1743,4177,2078,4942
292200,202310,11689,25937,7136,18119,1879,4853,2587,6395,4466,11248
292205,202310,4760,11257,3687,9462,151,410,3029,7578,3180,7988
292210,202310,8277,15584,6453,13198,113,290,5809,11538,5922,11828
292220,202310,2813,5644,2059,4416,162,331,1509,3023,1671,3354
292225,202310,3857,9939,3007,8462,86,286,2415,6539,2501,6825
292230,202310,10877,22441,8184,18391,387,1043,6113,12817,6500,13860
292240,202310,6337,15692,4904,12939,387,1015,3350,8661,3737,9676
292250,202310,7832,16890,6188,14230,486,1087,4628,10267,5114,11354
292260,202310,4227,9783,3359,8533,114,292,2826,7089,2940,7381
292265,202310,4620,10485,3579,8771,97,290,2949,6950,3046,7240
292270,202310,6108,11259,4528,9199,259,462,3525,6924,3784,7386
292273,202310,3435,6672,2448,5324,154,334,1753,3880,1907,4214
292275,202310,2246,4924,1726,4154,52,130,1363,3100,1415,3230
292280,202310,3400,6859,2521,5761,111,245,2089,4766,2200,5011
292285,202310,3184,6420,2290,5150,143,284,1791,4054,1934,4338
292290,202310,9311,20388,6830,16590,614,1131,5106,12400,5720,13531
292300,202310,13225,29390,8899,22379,1663,4108,4701,11546,6364,15654
292303,202310,4190,9271,3305,7789,95,250,2775,6316,2870,6566
292305,202310,2829,6503,2341,5734,135,333,1909,4552,2044,4885
292310,202310,8528,17917,6695,15286,175,462,5676,12418,5851,12880
292320,202310,6978,16514,5027,13065,187,489,3843,9612,4030,10101
292330,202310,3947,6666,3010,5536,163,250,2481,4561,2644,4811
292335,202310,6284,14456,4977,12316,422,989,3750,9179,4172,10168
292340,202310,6437,16403,4634,12725,540,1322,2957,7993,3497,9315
292350,202310,3476,7883,2741,6788,164,407,2153,5185,2317,5592
292360,202310,6069,14319,4452,11397,311,785,3086,7604,3397,8389
292370,202310,13473,27108,10598,23099,183,637,9497,19989,9680,20626
292380,202310,8344,20399,6629,17106,537,1286,4818,12001,5355,13287
292390,202310,5937,9381,4277,7406,165,262,3796,6475,3961,6737
292400,202310,30243,71146,22807,57714,2760,6575,14707,36078,17467,42653
292405,202310,5541,11845,4129,9494,178,429,3153,7200,3331,7629
292410,202310,3086,5672,2339,4698,119,218,1970,3883,2089,4101
292420,202310,6305,12041,5174,10473,163,295,4564,8990,4727,9285
292430,202310,6065,16022,3909,11620,327,972,2491,7019,2818,7991
292440,202310,11623,29262,9970,26679,156,644,8632,22447,8788,23091
292450,202310,5091,12694,3318,9152,215,591,2261,5933,2476,6524
292460,202310,8043,16303,6242,13481,368,957,5027,10277,5395,11234
292465,202310,3166,6927,2335,5576,94,227,1611,3970,1705,4197
292467,202310,2685,6157,2185,5395,290,630,1456,3720,1746,4350
292470,202310,3367,7972,2194,5961,164,439,1512,4046,1676,4485
292480,202310,8171,15074,6342,12740,307,500,5430,10838,5737,11338
292490,202310,3603,6771,2544,5309,63,146,2104,4184,2167,4330
292500,202310,9072,19680,6382,15087,371,779,4789,10945,5160,11724
292510,202310,17664,39544,12278,30442,1730,3446,7883,19692,9613,23138
292520,202310,9437,20594,7106,16505,464,1212,5301,11635,5765,12847
292525,202310,8219,16600,6172,13977,190,485,5240,11528,5430,12013
292530,202310,48958,108089,34342,83497,6715,17048,17223,39038,23938,56086
292540,202310,5107,8543,3701,6975,255,477,3075,5728,3330,6205
292550,202310,10699,25505,7280,20541,716,2013,4414,12472,5130,14485
292560,202310,5633,12371,4105,9966,177,509,3131,7196,3308,7705
292570,202310,4528,10389,3331,8275,104,341,2615,6149,2719,6490
292575,202310,8316,21220,6956,18891,1416,3640,4275,11749,5691,15389
292580,202310,9728,19951,7483,16569,357,590,6051,13116,6408,13706
292590,202310,9009,21139,6820,17088,544,1333,5268,12805,5812,14138
292593,202310,3584,7808,2437,5761,111,285,1847,4160,1958,4445
292595,202310,6914,15518,5543,13492,315,688,4319,10436,4634,11124
292600,202310,13937,32697,10917,27771,813,1766,8272,20978,9085,22744
292610,202310,5639,12183,4156,9651,250,581,3148,6965,3398,7546
292620,202310,8210,18513,6152,15711,207,675,5057,12537,5264,13212
292630,202310,11730,24169,8379,18622,1720,3699,5043,10782,6763,14481
292640,202310,9793,24947,7118,19870,674,1719,4410,12346,5084,14065
292650,202310,5084,11326,4076,9831,120,424,3516,8180,3636,8604
292660,202310,13245,32766,10100,27372,560,1492,7271,19338,7831,20830
292665,202310,2514,6361,1947,5486,119,273,1440,4100,1559,4373
292670,202310,4083,10334,2833,7883,324,959,1730,4511,2054,5470
292680,202310,4693,10970,3386,8591,139,352,2518,6051,2657,6403
292690,202310,2898,6982,1811,5145,277,723,1017,2954,1294,3677
292700,202310,13045,29503,9774,23862,882,1764,6860,16511,7742,18275
292710,202310,4402,9105,3873,8396,113,299,3494,7362,3607,7661
292720,202310,10503,21619,7855,17953,556,1117,5686,13077,6242,14194
292730,202310,6975,13235,5644,11264,300,510,4698,9276,4998,9786
292740,202310,576280,1103309,454896,916262,57642,110796,304879,586048,362521,696844
292750,202310,9345,19085,7182,16014,348,804,5774,12443,6122,13247
292760,202310,4765,11911,3663,9847,183,496,2721,7099,2904,7595
292770,202310,10204,21456,7477,17440,1070,2595,4735,10665,5805,13260
292780,202310,2555,4352,1737,3342,75,152,1404,2539,1479,2691
292790,202310,4737,8633,3135,6669,294,516,2317,4848,2611,5364
292800,202310,14897,31522,11524,26045,1311,2500,8152,18587,9463,21087
292805,202310,4629,9184,3389,7496,189,441,2652,5590,2841,6031
292810,202310,17080,32931,12590,26062,400,1053,10265,19716,10665,20769
292820,202310,8041,20762,5394,15911,760,2058,3271,9424,4031,11482
292830,202310,3652,7471,2831,6384,163,359,2186,4890,2349,5249
292840,202310,12801,25512,9886,21377,211,588,8584,17753,8795,18341
292850,202310,3219,7274,2392,5925,170,391,1700,4007,1870,4398
292860,202310,22590,42417,17212,34784,527,1338,14088,26688,14615,28026
292870,202310,29915,60769,21933,47548,2903,5204,13462,28149,16365,33353
292880,202310,14092,34891,9909,26898,453,1431,6527,15938,6980,17369
292890,202310,11063,23707,8618,19910,301,816,6867,14931,7168,15747
292895,202310,4135,7511,2907,5656,260,499,2163,4072,2423,4571
292900,202310,3758,8046,2970,6738,53,177,2333,4900,2386,5077
292905,202310,5522,12304,3945,9721,385,871,2675,6324,3060,7195
292910,202310,7215,15587,5763,13287,198,375,4690,10480,4888,10855
292920,202310,12736,28733,9917,23699,433,1303,7711,17330,8144,18633
292925,202310,6278,16240,4406,12365,443,1086,2821,7772,3264,8858
292930,202310,8949,22852,6465,17610,1037,2635,3147,8187,4184,10822
292935,202310,3306,6119,2436,5024,40,105,2121,4311,2161,4416
292937,202310,3278,7670,2526,6552,464,1241,1175,3301,1639,4542
292940,202310,3764,8226,2708,6530,503,1111,1568,3840,2071,4951
292950,202310,11232,26057,7843,19629,667,1657,5272,12247,5939,13904
292960,202310,6929,14274,5169,11589,244,546,3888,8312,4132,8858
292970,202310,5014,12148,4084,10661,153,426,3196,8210,3349,8636
292975,202310,5250,10441,4155,8963,125,297,3515,7281,3640,7578
292980,202310,4841,9104,3655,7356,70,162,3196,6197,3266,6359
292990,202310,13990,34688,10497,28263,686,2040,7489,18911,8175,20951
293000,202310,3241,7104,2312,5494,241,429,1521,3646,1762,4075
293010,202310,24105,52167,17365,41079,3073,6920,10233,23647,13306,30567
293015,202310,10551,28203,7562,22317,737,2079,4903,14207,5640,16286
293020,202310,12785,30086,10657,26692,203,632,9321,22677,9524,23309
293030,202310,6288,14960,4284,11504,324,616,2724,7493,3048,8109
293040,202310,5426,12154,3873,9798,157,359,3064,7584,3221,7943
293050,202310,32544,63165,24946,50975,1966,3688,18641,36489,20607,40177
293060,202310,4669,10948,3339,8428,257,679,2376,5673,2633,6352
293070,202310,43630,82034,33620,66837,2174,4491,25476,47862,27650,52353
293075,202310,4480,11887,3560,10279,82,326,2949,8339,3031,8665
293076,202310,4191,8764,3450,7755,132,246,2903,6541,3035,6787
293077,202310,8445,19427,5765,14702,1009,2131,3014,8110,4023,10241
293080,202310,5338,14035,4095,11624,113,403,3203,8672,3316,9075
293090,202310,3824,10147,2512,7549,257,741,1608,4659,1865,5400
293100,202310,7230,16810,5230,13160,565,1228,3668,9116,4233,10344
293105,202310,4767,13281,3704,11083,335,931,2445,7234,2780,8165
293110,202310,3239,6533,2409,5241,170,324,1870,3994,2040,4318
293120,202310,6543,13519,5353,11674,485,791,4042,8869,4527,9660
293130,202310,4605,10527,3657,9124,119,352,3119,7546,3238,7898
293135,202310,40641,87279,24833,61381,5546,14694,8831,20374,14377,35068
293140,202310,3620,6010,2743,4891,130,206,2250,3854,2380,4060
293150,202310,6330,16552,4349,12290,605,1394,2658,7306,3263,8700
293160,202310,5047,10287,4200,9230,533,773,3115,7343,3648,8116
293170,202310,6796,10899,4836,8503,125,259,4118,6860,4243,7119
293180,202310,5746,13524,4338,11016,149,427,3423,8306,3572,8733
293190,202310,21585,42538,17828,37082,225,774,15764,31293,15989,32067
293200,202310,11662,22946,8639,18298,604,1117,6752,14047,7356,15164
293210,202310,6998,15075,5228,12197,581,1198,3588,8269,4169,9467
293220,202310,7597,15115,5170,11253,826,1643,3256,6860,4082,8503
293230,202310,6073,11706,4159,9175,467,932,2835,6249,3302,7181
293240,202310,5534,12227,4110,9849,192,367,2981,7302,3173,7669
293245,202310,4899,11434,3907,9713,251,629,2913,6811,3164,7440
293250,202310,7041,15011,4854,11473,552,1255,3162,7093,3714,8348
293260,202310,6031,13234,4160,10023,281,699,2821,6691,3102,7390
293270,202310,9316,17812,6766,14824,533,889,5240,11866,5773,12755
293280,202310,5977,12647,4657,10593,294,665,3689,8045,3983,8710
293290,202310,22701,53844,18075,45867,1758,4454,12543,30552,14301,35006
293300,202310,8529,17156,6408,13645,902,1606,4279,8830,5181,10436
293305,202310,5763,11332,4019,8904,116,335,3440,7305,3556,7640
293310,202310,2790,6128,2067,4926,45,118,1690,3849,1735,3967
293315,202310,5766,11005,4337,8962,415,650,3351,6993,3766,7643
293317,202310,3427,7129,2703,5928,427,814,1768,3887,2195,4701
293320,202310,18575,34482,14930,29948,288,724,13138,25241,13426,25965
293325,202310,2348,4901,1627,3887,177,428,1024,2320,1201,2748
293330,202310,103883,232945,72033,173941,10705,25257,40573,90953,51278,116210
293340,202310,2701,6611,1921,5151,179,443,1275,3359,1454,3802
293345,202310,4833,10922,3296,8386,835,2031,1377,3830,2212,5861
293350,202310,7293,17520,5804,15332,381,950,4559,11955,4940,12905
293360,202310,19458,40491,15025,34504,610,1432,12402,28011,13012,29443
310010,202310,1236,2552,750,1804,133,343,322,649,455,992
310020,202310,4217,9824,2667,6798,449,1254,1191,2637,1640,3891
310030,202310,2512,6232,1788,4842,253,711,1101,2795,1354,3506
310040,202310,1057,2470,680,1734,77,228,340,739,417,967
310050,202310,2172,5234,1568,4116,176,499,916,2202,1092,2701
310060,202310,3826,9201,2812,7542,347,950,1713,4619,2060,5569
310070,202310,430,951,264,665,20,45,177,430,197,475
310080,202310,909,2305,575,1629,77,231,250,663,327,894
310090,202310,6775,14120,5017,11309,237,645,3893,8221,4130,8866
310100,202310,4793,10563,3509,8437,102,338,2733,6114,2835,6452
310110,202310,6053,14152,4008,10314,542,1532,2272,5423,2814,6955
310120,202310,877,1908,496,1287,86,273,207,428,293,701
310130,202310,520,1199,421,1021,38,133,313,687,351,820
310140,202310,466,1177,315,899,65,198,133,326,198,524
310150,202310,8265,18015,5219,12436,465,1264,3078,6526,3543,7790
310160,202310,14215,30615,9048,21398,2116,4832,3803,8230,5919,13062
310163,202310,1521,4106,939,2775,260,801,226,519,486,1320
310170,202310,12538,26821,9063,21188,1070,2273,6002,13594,7072,15867
310180,202310,2597,5490,1641,3875,183,474,1043,2291,1226,2765
310190,202310,3384,8695,2062,5906,526,1634,437,1062,963,2696
310200,202310,2529,6400,1681,4744,485,1504,571,1282,1056,2786
310205,202310,1521,3697,1073,2927,160,427,629,1681,789,2108
310210,202310,2966,7173,2056,5325,139,314,1409,3497,1548,3811
310220,202310,1438,3573,953,2629,91,289,580,1467,671,1756
310230,202310,3080,7098,2147,5244,400,920,1118,2516,1518,3436
310240,202310,1322,3340,930,2522,121,351,529,1330,650,1681
310250,202310,1574,3246,1099,2449,39,118,830,1709,869,1827
310260,202310,5096,12081,2833,7524,619,1880,945,1898,1564,3778
310270,202310,3648,6852,2539,5311,103,236,1998,3978,2101,4214
310280,202310,3716,7170,2395,5116,179,387,1627,3124,1806,3511
310285,202310,2266,6313,1578,4862,203,639,876,2609,1079,3248
310290,202310,2126,5002,1520,3776,229,626,841,1809,1070,2435
310300,202310,2143,5292,1251,3409,130,377,593,1346,723,1723
310310,202310,416,873,235,561,43,111,120,252,163,363
310320,202310,596,1375,315,841,35,92,169,419,204,511
310330,202310,639,1392,298,732,59,152,125,275,184,427
310340,202310,10427,23461,6268,15548,1079,2473,2820,6856,3899,9329
310350,202310,18088,40117,10869,27182,1790,4876,5231,11599,7021,16475
310360,202310,819,1560,573,1176,26,74,432,822,458,896
310370,202310,1548,4377,1158,3597,308,987,337,1078,645,2065
310375,202310,1123,2524,660,1728,253,638,167,422,420,1060
310380,202310,441,986,194,524,17,54,109,262,126,316
310390,202310,818,2243,601,1786,89,289,291,769,380,1058
310400,202310,16590,37066,9982,25159,1238,3395,5336,12177,6574,15572
310410,202310,1342,3516,627,1835,78,245,249,582,327,827
310420,202310,6358,15305,3602,9421,460,1262,1765,3969,2225,5231
310430,202310,2259,5586,1295,3569,251,716,561,1294,812,2010
310440,202310,849,1945,445,1164,85,201,177,412,262,613
310445,202310,1655,4185,1093,2998,100,253,745,1946,845,2199
310450,202310,6012,12658,3753,8887,332,903,2476,5362,2808,6265
310460,202310,2224,5390,1297,3494,283,730,291,673,574,1403
310470,202310,4096,8600,2871,6816,710,1514,1492,3607,2202,5121
310480,202310,1254,2955,785,2097,85,269,421,975,506,1244
310490,202310,3745,9014,2466,6576,409,1087,1129,2689,1538,3776
310500,202310,1949,4479,1403,3518,205,522,812,1886,1017,2408
310510,202310,3143,7166,1895,4701,343,922,778,1711,1121,2633
310520,202310,1523,3563,837,2195,129,364,347,851,476,1215
310530,202310,1071,2553,610,1598,71,209,223,445,294,654
310540,202310,3685,9619,2217,6303,405,1195,784,1869,1189,3064
310550,202310,1578,3431,982,2360,120,280,546,1191,666,1471
310560,202310,22832,53248,13708,34514,1690,4760,7041,14668,8731,19428
310570,202310,1562,3309,1055,2527,47,131,794,1752,841,1883
310590,202310,5424,12463,3285,7908,226,663,2014,4276,2240,4939
310600,202310,1846,4605,1158,3019,136,343,602,1389,738,1732
310610,202310,614,1574,319,1000,68,216,63,186,131,402
310620,202310,315120,693321,201568,471734,23719,61227,112797,228377,136516,289604
310630,202310,6044,14720,3427,8975,535,1359,1774,4269,2309,5628
310640,202310,2070,4556,1355,3218,98,302,926,1941,1024,2243
310650,202310,2944,7070,1778,4711,120,352,1065,2636,1185,2988
310660,202310,1767,4078,1328,3419,44,153,1067,2632,1111,2785
310665,202310,1754,3733,1261,2981,82,257,981,2220,1063,2477
310670,202310,89199,197096,59368,139435,7348,18309,35060,74750,42408,93059
310680,202310,996,2048,731,1626,30,87,543,1117,573,1204
310690,202310,3424,6998,2147,4960,323,646,1253,2689,1576,3335
310700,202310,660,1217,453,940,13,32,350,687,363,719
310710,202310,8236,20848,4580,13572,1188,3579,768,2001,1956,5580
310720,202310,1501,3019,1051,2335,49,128,786,1605,835,1733
310730,202310,13150,29830,9262,22716,666,1891,6380,14395,7046,16286
310740,202310,9137,21916,5545,14234,664,1917,2760,6083,3424,8000
310750,202310,1766,3723,1122,2574,176,436,592,1174,768,1610
310760,202310,945,2132,591,1514,71,169,348,862,419,1031
310770,202310,1373,3367,811,2274,110,334,385,929,495,1263
310780,202310,5020,10503,3403,7920,343,841,2206,4844,2549,5685
310790,202310,2398,6781,1782,5345,426,1406,420,1030,846,2436
310800,202310,2931,8014,1597,4928,326,1065,117,283,443,1348
310810,202310,1933,4066,1374,3063,129,294,945,1981,1074,2275
310820,202310,1507,3420,707,1933,169,446,196,499,365,945
310825,202310,3338,8093,2336,6389,69,279,1809,4627,1878,4906
310830,202310,2932,6989,1800,4755,347,982,883,1984,1230,2966
310840,202310,2865,6988,1712,4672,375,1096,565,1232,940,2328
310850,202310,1701,4092,1162,3165,126,355,733,1857,859,2212
310855,202310,4254,9790,2695,6901,294,732,1615,3867,1909,4599
310860,202310,8472,21687,6038,16942,964,2387,3128,8743,4092,11130
310870,202310,1205,2630,849,2050,78,195,598,1338,676,1533
310880,202310,1090,2937,695,2054,106,310,346,949,452,1259
310890,202310,2749,7255,1455,4409,272,864,199,488,471,1352
310900,202310,5660,14431,3398,9220,657,1904,1366,3148,2023,5052
310910,202310,2795,6280,1545,4031,245,705,374,832,619,1537
310920,202310,2340,5444,1506,3958,268,690,790,2009,1058,2699
310925,202310,1365,3071,903,2253,69,169,607,1424,676,1593
310930,202310,7026,16231,4078,11223,902,2361,1598,4531,2500,6892
310940,202310,8809,18219,5895,13520,284,784,4384,9360,4668,10144
310945,202310,1859,4090,1157,2844,154,405,639,1433,793,1838
310950,202310,2309,6315,1248,3880,209,701,328,775,537,1476
310960,202310,857,2176,391,1111,56,156,122,302,178,458
310970,202310,1466,4119,850,2681,214,683,154,397,368,1080
310980,202310,460,967,214,509,17,51,119,243,136,294
310990,202310,1915,4414,1284,3237,151,433,734,1599,885,2032
311000,202310,5476,13392,3566,9610,822,2191,1560,3798,2382,5989
311010,202310,1232,2992,908,2397,228,614,408,1049,636,1663
311020,202310,1463,3361,782,2057,67,192,431,1024,498,1216
311030,202310,2421,5436,1444,3695,412,1153,483,1089,895,2242
311040,202310,379,1068,241,740,83,281,56,139,139,420
311050,202310,3587,8082,2346,5860,356,1033,1264,2708,1620,3741
311060,202310,4875,11086,2763,6865,327,885,1329,2792,1656,3677
311070,202310,3173,6908,1898,4662,245,698,990,2104,1235,2802
311080,202310,1440,2800,1003,2153,49,137,757,1480,806,1617
311090,202310,2924,8095,1873,5729,432,1305,540,1558,972,2863
311100,202310,3180,8090,1903,5556,357,1142,515,1257,872,2399
311110,202310,4659,9367,1881,4677,474,1186,261,582,735,1768
311115,202310,1709,3260,1203,2542,29,90,942,1961,971,2051
311120,202310,9489,22126,5675,14190,910,2432,2524,5210,3434,7642
311130,202310,2372,5739,1461,4021,160,495,796,1943,956,2438
311140,202310,2047,4629,1212,3129,274,660,536,1326,810,1986
311150,202310,1786,5125,1221,3861,199,665,544,1522,743,2187
311160,202310,5355,13563,3214,9231,558,1760,1243,3122,1801,4882
311170,202310,1241,2874,838,2215,86,233,508,1344,594,1577
311180,202310,2047,4231,1017,2514,161,394,438,969,599,1363
311190,202310,1044,2714,652,1869,83,247,269,645,352,892
311200,202310,3002,7119,1821,4635,394,1058,741,1578,1135,2636
311205,202310,1135,2964,802,2292,51,159,448,1160,499,1319
311210,202310,1301,3416,1033,2948,133,327,672,1993,805,2320
311220,202310,1133,2448,871,1918,23,60,705,1439,728,1499
311230,202310,9743,26795,6159,18695,1481,4509,1673,4927,3154,9436
311240,202310,1527,3368,1004,2434,129,364,594,1221,723,1585
311250,202310,1793,4476,1078,2953,212,589,431,1020,643,1609
311260,202310,3304,7458,1623,4135,216,564,713,1513,929,2077
311265,202310,1736,3637,1100,2596,67,161,787,1702,854,1863
311270,202310,3844,9865,2766,7746,217,766,1744,4372,1961,5138
311280,202310,1666,3959,845,2326,227,612,197,472,424,1084
311290,202310,2230,6246,1778,5264,160,469,1083,3122,1243,3591
311300,202310,5419,13109,4103,10833,234,652,3014,7536,3248,8188
311310,202310,650,1639,430,1145,45,124,267,663,312,787
311320,202310,3833,10660,2590,7569,394,1173,1167,2975,1561,4148
311330,202310,8035,17249,5023,12115,879,2271,2090,4993,2969,7264
311340,202310,13917,34659,8900,24276,2130,5792,2569,6379,4699,12171
311350,202310,2823,6367,1633,4059,385,893,578,1280,963,2173
311360,202310,1455,3246,839,2189,194,511,352,857,546,1368
311370,202310,5692,12740,3498,8875,503,1409,1658,3659,2161,5068
311380,202310,492,1393,333,1028,42,138,181,536,223,674
311390,202310,2110,5794,1409,4366,375,1153,334,890,709,2043
311400,202310,2124,5103,1190,3066,227,605,442,905,669,1510
311410,202310,2423,6583,1611,4832,269,878,615,1573,884,2451
311420,202310,2085,5424,1256,3599,253,760,367,843,620,1603
311430,202310,5800,13840,3191,8426,529,1412,1257,3028,1786,4440
311440,202310,3937,9935,2316,6548,540,1695,341,645,881,2340
311450,202310,3261,8667,1793,5360,430,1456,458,1022,888,2478
311455,202310,1354,2858,719,1748,72,208,446,971,518,1179
311460,202310,769,2094,391,1223,73,237,95,240,168,477
311470,202310,588,1637,341,1085,80,278,46,120,126,398
311480,202310,1466,2911,1086,2308,106,198,821,1685,927,1883
311490,202310,367,983,229,659,43,143,97,226,140,369
311500,202310,666,1520,397,1019,33,98,204,458,237,556
311510,202310,4555,9848,2763,6658,466,1076,1374,3051,1840,4127
311520,202310,859,2050,609,1551,74,185,375,919,449,1104
311530,202310,12131,25354,6770,16199,1915,5143,1979,3856,3894,8999
311535,202310,1291,3053,643,1675,76,218,311,700,387,918
311540,202310,674,1762,523,1468,79,215,303,847,382,1062
311545,202310,2531,6339,1934,5295,126,333,1363,3591,1489,3924
311547,202310,2225,4352,1603,3354,78,173,1339,2699,1417,2872
311550,202310,3707,8866,2549,6583,473,1267,1085,2366,1558,3633
311560,202310,364,742,176,414,30,83,66,127,96,210
311570,202310,1635,3528,962,2487,66,189,595,1529,661,1718
311580,202310,2732,4905,1585,3304,168,340,1034,2035,1202,2375
311590,202310,791,1848,573,1496,67,188,317,756,384,944
311600,202310,1797,4137,1366,3489,199,600,890,2178,1089,2778
311610,202310,2890,7480,1808,5175,133,414,1098,2892,1231,3306
311615,202310,4644,10431,3299,8178,161,450,2442,5658,2603,6108
311620,202310,741,1819,449,1269,51,161,229,593,280,754
311630,202310,1557,3983,1053,2889,164,410,529,1430,693,1840
311640,202310,1004,2386,606,1626,91,249,324,788,415,1037
311650,202310,2300,5102,1569,3860,319,756,792,1833,1111,2589
311660,202310,4215,10812,2413,6698,358,1089,815,1752,1173,2841
311670,202310,2082,4586,1257,3019,175,422,608,1323,783,1745
311680,202310,2887,6716,1964,5038,154,348,1311,3298,1465,3646
311690,202310,753,1501,440,1037,51,109,241,545,292,654
311700,202310,2461,5340,1654,4041,32,90,1343,3155,1375,3245
311710,202310,1982,5282,1244,3747,340,1122,310,810,650,1932
311720,202310,547,1453,397,1137,59,181,235,657,294,838
311730,202310,6238,13608,3718,8900,740,2020,1821,3880,2561,5900
311740,202310,1205,2973,906,2484,79,223,605,1660,684,1883
311750,202310,4863,12842,3117,8928,322,955,1796,4599,2118,5554
311760,202310,938,2374,617,1655,111,343,245,499,356,842
311770,202310,2789,7031,1724,4843,389,1078,518,1270,907,2348
311780,202310,1977,4965,1124,3143,223,604,395,922,618,1526
311783,202310,2873,6496,1989,4897,62,199,1548,3551,1610,3750
311787,202310,1003,2651,588,1656,84,248,185,418,269,666
311790,202310,1987,5033,1126,3169,319,971,313,742,632,1713
311800,202310,6979,18480,3765,10487,954,2719,830,1718,1784,4437
311810,202310,1269,3056,929,2408,67,191,688,1652,755,1843
311820,202310,1338,2816,817,1930,75,192,523,1132,598,1324
311830,202310,12008,30339,7432,20291,2080,5854,1398,3446,3478,9300
311840,202310,5022,11034,3454,8577,352,909,2190,5298,2542,6207
311850,202310,443,994,313,760,15,57,219,458,234,515
311860,202310,104161,224831,68463,158132,7762,19907,40917,84592,48679,104499
311870,202310,2270,5545,1317,3659,233,760,545,1263,778,2023
311880,202310,7601,17804,5477,14306,429,1053,3708,9445,4137,10498
311890,202310,2378,4798,1650,3638,67,198,1233,2464,1300,2662
311900,202310,785,1983,500,1489,90,247,203,591,293,838
311910,202310,5434,12249,3778,9554,752,1906,1902,4509,2654,6415
311920,202310,2681,5912,1956,4710,152,333,1333,3104,1485,3437
311930,202310,6209,12571,3905,8802,764,1803,1965,3988,2729,5791
311940,202310,19825,46415,10871,27685,1695,4526,4483,10015,6178,14541
311950,202310,2978,6849,1900,4826,163,422,1122,2699,1285,3121
311960,202310,608,1409,359,926,50,140,144,317,194,457
311970,202310,493,1471,308,1004,45,172,69,166,114,338
311980,202310,572,1405,248,736,45,144,88,225,133,369
311990,202310,648,1467,322,873,62,177,127,285,189,462
311995,202310,1209,3236,380,1126,53,167,74,138,127,305
312000,202310,996,2071,646,1511,27,68,463,994,490,1062
312010,202310,1472,3242,956,2278,55,132,658,1472,713,1604
312015,202310,1720,4005,1305,3287,66,198,990,2342,1056,2540
312020,202310,2436,6585,1429,4160,263,779,358,873,621,1652
312030,202310,2663,5325,1931,4329,64,227,1584,3358,1648,3585
312040,202310,1049,2808,584,1738,120,363,218,562,338,925
312050,202310,1480,4130,1081,3283,198,684,361,918,559,1602
312060,202310,1220,2790,694,1903,182,521,188,449,370,970
312070,202310,1124,2930,655,1834,28,85,401,1040,429,1125
312080,202310,3782,8212,2511,5948,176,486,1623,3296,1799,3782
312083,202310,1367,2861,981,2270,50,129,729,1561,779,1690
312087,202310,3060,6817,2169,5304,134,401,1651,3842,1785,4243
312090,202310,15354,35061,10141,25548,1101,3175,5569,12308,6670,15483
312100,202310,2061,5032,1330,3553,96,300,826,2021,922,2321
312110,202310,1250,3499,907,2707,158,567,453,1133,611,1700
312120,202310,1363,3404,781,2246,213,648,210,467,423,1115
312125,202310,2641,5651,1858,4400,128,295,1304,2933,1432,3228
312130,202310,1543,3230,931,2117,62,172,587,1118,649,1290
312140,202310,955,2561,655,1888,189,552,176,444,365,996
312150,202310,707,1696,509,1302,53,118,314,738,367,856
312160,202310,12642,29079,8041,20041,1084,2862,4033,8825,5117,11687
312170,202310,1066,2446,710,1751,62,148,438,1042,500,1190
312180,202310,1753,4085,1134,2843,114,293,664,1483,778,1776
312190,202310,1037,2440,666,1686,96,251,305,669,401,920
312200,202310,5825,14216,3926,10781,911,2970,1909,4359,2820,7329
312210,202310,1790,3335,1178,2443,128,228,838,1649,966,1877
312220,202310,2038,5499,1505,4413,184,569,902,2544,1086,3113
312230,202310,28745,64383,17042,41536,3359,8788,6329,12620,9688,21408
312235,202310,2806,5702,1949,4368,267,453,1341,2919,1608,3372
312240,202310,993,2812,614,1946,133,420,181,499,314,919
312245,202310,4065,7502,3183,6239,63,166,2877,5437,2940,5603
312247,202310,1254,2622,690,1654,91,221,393,863,484,1084
312250,202310,1140,2767,563,1575,100,305,144,319,244,624
312260,202310,1271,2956,899,2226,67,165,641,1482,708,1647
312270,202310,963,2338,627,1616,20,73,383,849,403,922
312280,202310,541,1474,379,1105,89,290,139,342,228,632
312290,202310,1254,3232,840,2378,168,497,256,596,424,1093
312300,202310,1562,4145,983,2788,236,696,243,534,479,1230
312310,202310,1324,3491,817,2296,99,306,410,993,509,1299
312320,202310,2714,6123,1485,3707,242,614,537,1131,779,1745
312330,202310,1185,2929,839,2244,160,478,434,1053,594,1531
312340,202310,290,688,179,468,22,68,93,209,115,277
312350,202310,283,557,183,411,11,34,119,220,130,254
312352,202310,1817,5274,1424,4439,310,1025,616,2025,926,3050
312360,202310,4624,11507,2793,7663,503,1443,1166,2729,1669,4172
312370,202310,2731,5942,1890,4550,238,685,1129,2448,1367,3133
312380,202310,2596,5260,1783,3994,56,181,1389,2935,1445,3116
312385,202310,1582,3803,1053,2792,393,1030,333,896,726,1926
312390,202310,2463,6293,1467,4057,240,745,416,945,656,1690
312400,202310,3935,10107,2741,7796,1003,3110,416,1092,1419,4202
312410,202310,20946,47082,14356,34911,1983,4924,8422,18904,10405,23828
312420,202310,5196,12469,3733,9899,930,2686,1468,3600,2398,6286
312430,202310,11107,24162,7805,18290,473,1336,5434,11628,5907,12964
312440,202310,1387,3909,1039,3171,567,1801,158,448,725,2249
312450,202310,1791,4681,1108,3268,318,988,354,968,672,1956
312460,202310,619,1326,383,942,24,64,266,604,290,668
312470,202310,582,1299,297,761,45,116,90,170,135,286
312480,202310,1259,2929,758,1974,67,183,390,938,457,1121
312490,202310,3314,6581,2163,4698,249,556,1289,2592,1538,3148
312500,202310,1352,2830,942,2166,45,132,665,1422,710,1554
312510,202310,6926,16870,3106,8496,530,1466,831,1863,1361,3329
312520,202310,491,1092,315,781,50,144,186,412,236,556
312530,202310,959,1921,692,1547,41,104,504,1069,545,1173
312540,202310,1849,4525,1131,3033,168,430,630,1574,798,2004
312550,202310,1013,2297,591,1430,31,73,386,837,417,910
312560,202310,2207,5166,1567,4097,99,293,1067,2658,1166,2951
312570,202310,3504,7266,2197,5252,385,922,1080,2456,1465,3378
312580,202310,822,2008,456,1226,66,199,214,504,280,703
312590,202310,1819,4724,1282,3572,258,755,557,1362,815,2117
312595,202310,2695,6840,1975,5587,442,1264,812,2379,1254,3643
312600,202310,1626,3740,837,2038,133,363,288,614,421,977
312610,202310,9163,21526,4910,12809,1036,2811,1405,3086,2441,5897
312620,202310,3084,6762,2007,5061,76,273,1571,3734,1647,4007
312630,202310,418,1063,261,757,55,181,97,225,152,406
312640,202310,636,1603,432,1203,63,185,206,499,269,684
312650,202310,2534,5600,1443,3492,56,168,1076,2345,1132,2513
312660,202310,1663,3520,1073,2488,83,203,734,1543,817,1746
312670,202310,7545,16035,5495,12645,192,595,4263,9035,4455,9630
312675,202310,1415,3247,1045,2638,68,188,753,1785,821,1973
312680,202310,1999,4265,1577,3605,88,258,1262,2710,1350,2968
312690,202310,3697,6869,2341,4962,232,436,1642,3357,1874,3793
312695,202310,1291,2943,956,2349,52,115,782,1848,834,1963
312700,202310,2672,6457,1558,4212,196,602,814,1920,1010,2522
312705,202310,2180,3907,1701,3229,37,96,1538,2794,1575,2890
312707,202310,1679,4244,995,2879,39,146,644,1662,683,1808
312710,202310,9982,21348,5310,13333,1476,3726,1306,3185,2782,6911
312720,202310,1295,3100,881,2314,107,258,507,1213,614,1471
312730,202310,1984,4260,1243,3100,128,317,789,1878,917,2195
312733,202310,1646,3967,1026,2777,46,158,641,1529,687,1687
312735,202310,1007,2317,612,1516,65,179,386,846,451,1025
312737,202310,1029,2081,629,1461,62,168,423,912,485,1080
312738,202310,1062,2354,646,1589,62,181,395,859,457,1040
312740,202310,517,1295,278,802,63,176,73,159,136,335
312750,202310,1760,4468,1053,3005,176,527,419,1059,595,1586
312760,202310,2228,5954,1358,4056,258,727,467,1298,725,2025
312770,202310,58399,128510,31887,79886,5715,15050,12461,27518,18176,42568
312780,202310,3335,8274,2474,6652,411,1040,1322,3418,1733,4458
312790,202310,291,660,110,317,6,16,31,59,37,75
312800,202310,7717,17896,5199,12956,383,1145,3201,7076,3584,8221
312810,202310,1957,4961,1109,3300,350,1055,293,737,643,1792
312820,202310,2142,5038,1444,3717,118,268,943,2320,1061,2588
312825,202310,1941,3721,1367,2883,58,140,1083,2190,1141,2330
312830,202310,3431,8669,1668,4816,470,1268,506,1203,976,2471
312840,202310,1846,4242,1215,3074,162,423,567,1232,729,1655
312850,202310,1468,2741,872,1770,43,142,619,1087,662,1229
312860,202310,1324,3215,743,2101,190,526,216,541,406,1067
312870,202310,7628,18624,3740,10499,609,1726,1088,2629,1697,4355
312880,202310,1937,4200,1250,2960,193,437,668,1525,861,1962
312890,202310,2859,6258,1696,4131,169,405,952,2155,1121,2560
312900,202310,1680,3862,1066,2767,305,797,394,931,699,1728
312910,202310,1767,3134,884,1909,125,242,481,998,606,1240
312920,202310,1204,2936,695,1937,89,290,228,477,317,767
312930,202310,3126,6745,1900,4629,290,748,991,2362,1281,3110
312940,202310,1226,2990,803,2222,62,182,429,1058,491,1240
312950,202310,4356,9380,2639,6415,438,1100,1419,3125,1857,4225
312960,202310,2156,5085,1588,4137,153,378,1035,2716,1188,3094
312965,202310,1990,4824,1388,3737,202,477,768,2082,970,2559
312970,202310,2283,5480,1472,3986,155,516,806,1911,961,2427
312980,202310,33875,83117,21435,56591,4309,11332,7911,19005,12220,30337
312990,202310,641,1465,367,997,71,206,139,347,210,553
313000,202310,617,1552,413,1175,30,101,229,561,259,662
313005,202310,2978,7713,2135,6085,138,387,1507,4119,1645,4506
313010,202310,7860,18802,5307,13853,805,2343,2748,6428,3553,8771
313020,202310,1269,3465,855,2544,189,609,145,326,334,935
313030,202310,1491,3086,808,1948,137,316,435,943,572,1259
313040,202310,1142,3107,784,2317,59,225,413,1064,472,1289
313050,202310,2294,5845,1389,4143,251,778,309,761,560,1539
313055,202310,2257,5522,1696,4541,711,2110,568,1303,1279,3413
313060,202310,1372,3093,838,2093,167,494,211,412,378,906
313065,202310,2125,5125,1670,4254,49,203,1330,3172,1379,3375
313070,202310,1052,2620,668,1817,173,479,217,532,390,1011
313080,202310,495,1229,282,765,53,169,107,232,160,401
313090,202310,7118,15838,4805,11617,257,691,3435,7857,3692,8548
313100,202310,1636,3792,1119,2816,61,190,777,1781,838,1971
313110,202310,1918,4573,1130,3012,155,432,516,1209,671,1641
313115,202310,3596,8830,2315,6123,239,685,1272,2930,1511,3615
313120,202310,4539,10090,2872,7433,651,1721,1435,3505,2086,5226
313130,202310,42363,96456,24286,60363,3141,8326,12776,28215,15917,36541
313140,202310,1032,1995,596,1360,68,152,380,805,448,957
313150,202310,1738,4504,1015,2967,269,867,139,294,408,1161
313160,202310,1868,4127,1150,2870,87,225,710,1679,797,1904
313170,202310,14846,38116,8532,23566,1410,4006,3176,7480,4586,11486
313180,202310,3229,7373,2159,5266,236,531,1381,3194,1617,3725
313190,202310,5967,15054,3431,9469,606,1749,1310,2984,1916,4733
313200,202310,1441,3139,984,2272,41,125,761,1618,802,1743
313210,202310,5460,12330,3835,9510,358,988,2497,5625,2855,6613
313220,202310,2491,6029,1374,3637,231,634,548,1228,779,1862
313230,202310,3431,8477,2550,7138,81,295,1936,5216,2017,5511
313240,202310,14691,32357,8846,21899,1194,3176,4344,9411,5538,12587
313250,202310,8029,20810,5300,14770,1174,3281,2202,5560,3376,8841
313260,202310,997,2257,577,1529,69,231,285,596,354,827
313270,202310,8306,16219,5796,12555,560,1223,4166,8520,4726,9743
313280,202310,589,1401,345,930,46,128,160,375,206,503
313290,202310,1339,3910,928,3009,199,689,342,991,541,1680
313300,202310,2437,5997,1510,4063,326,932,589,1370,915,2302
313310,202310,1946,5118,1242,3413,266,775,381,801,647,1576
313320,202310,2429,5838,1523,4237,362,1100,458,1215,820,2315
313330,202310,5310,12002,3319,8591,295,780,2009,4932,2304,5712
313340,202310,2278,4606,1409,3144,117,311,962,1906,1079,2217
313350,202310,3808,9442,2092,5499,314,904,893,1975,1207,2879
313360,202310,2254,4979,1238,3123,205,586,589,1248,794,1834
313370,202310,2161,5259,1170,3112,239,623,378,783,617,1406
313375,202310,2367,5710,1102,3043,248,708,267,606,515,1314
313380,202310,8646,19803,5287,12981,893,2410,2213,4536,3106,6946
313390,202310,1034,2801,752,2196,49,180,492,1320,541,1500
313400,202310,4732,10303,3102,7590,169,435,2235,5225,2404,5660
313410,202310,1833,4169,1171,3008,274,692,593,1399,867,2091
313420,202310,20402,42250,9520,23424,2281,5847,2583,5549,4864,11396
313430,202310,1597,3577,1122,2622,71,223,843,1757,914,1980
313440,202310,9600,17530,5967,12404,245,663,4488,8644,4733,9307
313450,202310,915,2277,505,1394,90,264,175,377,265,641
313460,202310,3142,7840,2257,6223,402,1188,953,2400,1355,3588
313470,202310,3422,7644,2440,6039,189,492,1768,4172,1957,4664
313480,202310,1535,4013,820,2401,145,415,313,794,458,1209
313490,202310,3966,9549,1603,4618,294,879,416,968,710,1847
313500,202310,713,1685,376,985,89,199,128,335,217,534
313505,202310,13381,30336,9486,23907,633,1717,6667,16078,7300,17795
313507,202310,1621,3708,1087,2795,49,162,768,1829,817,1991
313510,202310,20027,47131,12783,32279,1450,3696,6781,15388,8231,19084
313520,202310,20352,45860,14992,36924,804,2104,11110,25724,11914,27828
313530,202310,736,2013,396,1163,75,244,155,365,230,609
313535,202310,2795,7071,1937,5354,217,547,1098,2887,1315,3434
313540,202310,1150,2907,663,1752,90,269,340,758,430,1027
313545,202310,1412,4121,966,3066,145,441,444,1299,589,1740
313550,202310,2750,6945,1981,5239,245,648,1287,3285,1532,3933
313560,202310,3723,5987,2560,4562,60,115,2180,3752,2240,3867
313570,202310,1212,3119,826,2358,184,538,342,847,526,1385
313580,202310,7840,16128,5567,12351,308,761,4045,8324,4353,9085
313590,202310,1469,3440,930,2483,152,419,466,1142,618,1561
313600,202310,5564,11526,4186,9377,104,260,3487,7373,3591,7633
313610,202310,1222,2749,819,1948,79,208,509,1088,588,1296
313620,202310,7451,17746,5104,13115,552,1623,2880,6588,3432,8211
313630,202310,11234,24909,7031,17647,749,2164,4083,9249,4832,11413
313640,202310,1671,3106,1055,2246,85,199,762,1565,847,1764
313650,202310,1966,5422,1362,4215,149,492,744,2194,893,2686
313652,202310,1101,2799,824,2202,82,220,535,1324,617,1544
313655,202310,1457,3092,970,2355,61,158,631,1439,692,1597
313657,202310,1295,3093,906,2383,32,132,624,1478,656,1610
313660,202310,1541,3507,1104,2739,96,312,718,1582,814,1894
313665,202310,7533,17164,4935,12040,603,1567,2812,6102,3415,7669
313670,202310,75775,166640,45047,111534,6239,16271,21477,47242,27716,63513
313680,202310,1372,3103,924,2281,42,120,600,1339,642,1459
313690,202310,1311,3599,822,2554,178,596,147,377,325,973
313695,202310,2115,5072,1343,3663,145,380,789,2126,934,2506
313700,202310,3692,9848,2769,8225,266,752,1938,5631,2204,6383
313710,202310,1776,3712,1025,2475,164,475,583,1238,747,1713
313720,202310,8563,21088,5011,13223,731,2003,2341,5372,3072,7375
313730,202310,1664,3277,1054,2338,80,169,726,1579,806,1748
313740,202310,2135,6911,1509,5203,334,1218,396,1184,730,2402
313750,202310,3066,7009,2114,5201,292,852,1234,2714,1526,3566
313753,202310,2562,5869,1427,3775,425,1190,291,699,716,1889
313760,202310,8386,20854,5552,14871,972,2729,2445,5668,3417,8397
313770,202310,5224,13316,3686,10555,831,2321,2046,5845,2877,8166
313780,202310,5167,12113,3029,8097,888,2205,786,2131,1674,4336
313790,202310,775,1971,547,1481,58,167,326,797,384,964
313800,202310,1676,3494,1025,2437,140,346,515,1120,655,1466
313810,202310,2374,4897,1604,3649,69,193,1201,2496,1270,2689
313820,202310,21912,51793,10766,27025,1929,4768,3288,6986,5217,11754
313830,202310,505,1336,338,969,68,203,110,276,178,479
313835,202310,1178,2868,676,1864,55,169,340,830,395,999
313840,202310,10773,25039,6639,17379,1705,4355,1690,4280,3395,8635
313850,202310,1252,2616,829,1917,135,322,430,868,565,1190
313860,202310,3756,8550,2429,6016,365,953,1195,2616,1560,3569
313862,202310,1391,2948,548,1463,65,173,250,613,315,786
313865,202310,3241,7378,2306,5786,95,278,1606,3659,1701,3937
313867,202310,1610,4699,1218,3851,371,1170,410,1312,781,2482
313868,202310,2069,5566,1440,4301,89,336,1019,2793,1108,3129
313870,202310,1355,3199,720,1901,150,393,261,605,411,998
313880,202310,2938,6778,1799,4471,330,977,874,1748,1204,2725
313890,202310,2935,5186,2091,4076,67,147,1649,3008,1716,3155
313900,202310,7233,18095,3985,11068,1088,3081,1123,2509,2211,5590
313910,202310,971,2561,588,1701,128,379,150,389,278,768
313920,202310,3500,9205,2620,7444,547,1498,1163,3277,1710,4775
313925,202310,1956,4427,1272,3140,257,512,693,1679,950,2191
313930,202310,6527,15443,4424,11559,380,909,2843,7089,3223,7998
313940,202310,13046,34759,8180,24881,2127,7027,1629,4977,3756,12004
313950,202310,7065,13746,4773,10431,300,795,3462,7058,3762,7853
313960,202310,7228,15740,4174,10344,577,1610,1908,4036,2485,5646
313970,202310,2055,4700,1430,3488,43,119,971,2160,1014,2279
313980,202310,1845,4427,1170,3249,206,577,410,1048,616,1625
313990,202310,2905,7388,1913,5302,310,985,1045,2544,1355,3529
314000,202310,13835,30704,8670,20907,700,2022,5216,11524,5916,13546
314010,202310,1651,3588,1085,2664,85,214,692,1537,777,1751
314015,202310,3144,7572,2085,5424,269,796,1133,2591,1402,3387
314020,202310,694,1680,346,1049,127,444,12,26,139,470
314030,202310,1089,2756,627,1723,105,303,240,583,345,886
314040,202310,771,1947,568,1552,68,220,356,887,424,1107
314050,202310,2754,6312,1771,4388,128,370,1117,2467,1245,2837
314053,202310,2671,6707,1861,5102,330,861,1026,2843,1356,3704
314055,202310,2951,6382,2244,5313,77,207,1768,4032,1845,4239
314060,202310,1591,3710,1000,2590,47,112,692,1712,739,1824
314070,202310,6369,14948,4233,10613,620,1609,2110,4719,2730,6328
314080,202310,2531,6017,1540,4088,160,448,785,1855,945,2303
314085,202310,2895,7036,1998,5477,234,641,1178,3081,1412,3722
314090,202310,6296,14795,4504,11640,466,1248,2615,6564,3081,7812
314100,202310,3590,8012,2462,6233,140,377,1716,4237,1856,4614
314110,202310,6437,16093,4094,10798,755,2099,1786,4128,2541,6227
314120,202310,961,2059,314,835,65,192,111,251,176,443
314130,202310,889,2073,565,1433,18,55,385,897,403,952
314140,202310,5759,13725,3882,10045,468,1284,2242,5305,2710,6589
314150,202310,1757,3967,1051,2716,188,477,538,1335,726,1812
314160,202310,2936,6619,1731,4404,196,495,699,1637,895,2132
314170,202310,1196,2911,722,1839,79,242,423,910,502,1152
314180,202310,6854,16723,4384,11939,716,2009,1919,4905,2635,6914
314190,202310,771,1757,509,1286,82,238,262,555,344,793
314200,202310,3770,9285,2662,7192,259,663,1615,4162,1874,4825
314210,202310,2380,5627,1470,3791,316,873,436,970,752,1843
314220,202310,2264,5513,1521,4136,293,850,583,1391,876,2241
314225,202310,1267,3315,841,2438,193,549,366,989,559,1538
314230,202310,1112,2709,647,1802,127,332,245,622,372,954
314240,202310,1368,3457,899,2560,189,547,348,952,537,1499
314250,202310,512,1360,283,847,56,170,97,236,153,406
314260,202310,1339,3200,890,2428,317,887,175,383,492,1270
314270,202310,4052,9978,2896,7871,126,335,1983,5230,2109,5565
314280,202310,4480,9721,2615,6573,291,818,1422,3232,1713,4050
314290,202310,5626,12669,4011,9622,243,613,2908,6532,3151,7145
314300,202310,2457,6384,1270,3685,356,1067,302,729,658,1796
314310,202310,4534,11127,2580,7324,702,2264,322,649,1024,2913
314315,202310,1250,3364,885,2591,61,193,584,1617,645,1810
314320,202310,4317,10307,2442,6502,385,1167,1058,2381,1443,3548
314330,202310,74002,188376,46939,133412,11678,32265,12399,32808,24077,65073
314340,202310,3485,7984,2079,5285,367,1113,948,1943,1315,3056
314345,202310,2037,4844,1402,3640,174,404,881,2118,1055,2522
314350,202310,1279,3288,632,1873,103,293,158,336,261,629
314360,202310,717,1861,370,1108,50,139,105,283,155,422
314370,202310,945,2107,626,1554,70,157,410,955,480,1112
314380,202310,1559,3888,919,2612,217,639,296,771,513,1410
314390,202310,20573,45459,12089,29944,2031,5453,5175,10828,7206,16281
314400,202310,4962,13667,3373,10387,1234,4005,756,2304,1990,6309
314410,202310,3836,10001,2207,6435,586,2030,395,839,981,2869
314420,202310,952,2136,564,1456,26,91,357,866,383,957
314430,202310,9916,21048,5806,13909,952,2364,2526,5585,3478,7949
314435,202310,2339,5638,1349,3657,255,659,582,1442,837,2101
314437,202310,1117,2529,719,1816,75,207,456,1080,531,1287
314440,202310,785,2040,472,1369,95,335,158,353,253,688
314450,202310,1813,4303,1145,2944,169,485,575,1273,744,1758
314460,202310,4459,11832,2921,8403,668,2057,1172,2842,1840,4899
314465,202310,2913,7098,2149,5615,176,390,1481,3681,1657,4071
314467,202310,1204,2847,859,2260,149,428,478,1196,627,1624
314470,202310,3008,7530,1938,5125,398,1122,824,1857,1222,2979
314480,202310,11715,28770,7174,18772,1146,3139,3042,6788,4188,9927
314490,202310,1311,3058,861,2215,103,268,509,1217,612,1485
314500,202310,2678,5836,1412,3693,502,1249,195,531,697,1780
314505,202310,2913,5699,2059,4406,135,237,1491,3100,1626,3337
314510,202310,2836,6916,1931,5487,721,2243,432,1091,1153,3334
314520,202310,10970,29201,7453,21470,1569,4704,1630,4165,3199,8869
314530,202310,6720,18134,5171,15016,657,1656,3138,8735,3795,10391
314535,202310,3590,7484,2566,5851,148,386,1992,4334,2140,4720
314537,202310,1476,3709,997,2778,87,231,620,1625,707,1856
314540,202310,531,1191,316,811,20,61,169,373,189,434
314545,202310,2362,5006,1576,3789,68,223,1121,2489,1189,2712
314550,202310,924,2047,497,1238,55,156,240,522,295,678
314560,202310,6495,16341,3943,10426,472,1424,1960,4273,2432,5697
314570,202310,419,1075,272,796,51,150,123,347,174,497
314580,202310,635,1654,386,1122,88,245,117,305,205,550
314585,202310,946,2524,546,1568,48,145,255,642,303,787
314587,202310,2854,6801,1948,5178,741,2018,752,1851,1493,3869
314590,202310,5460,12980,3439,8814,509,1339,1528,3483,2037,4822
314600,202310,2379,6006,1260,3764,265,851,151,363,416,1214
314610,202310,12571,28499,7708,19081,998,2693,3527,8017,4525,10710
314620,202310,3105,6106,2275,4944,160,309,1752,3791,1912,4100
314625,202310,2007,4362,1384,3386,59,228,1027,2277,1086,2505
314630,202310,6088,13811,4299,10972,222,690,3117,7449,3339,8139
314640,202310,1089,2083,744,1519,27,89,572,1049,599,1138
314650,202310,1035,2326,549,1412,67,194,257,550,324,744
314655,202310,1820,4458,1098,3094,251,630,499,1417,750,2047
314660,202310,457,878,297,603,16,29,219,403,235,432
314670,202310,1866,3901,1119,2721,56,168,768,1725,824,1893
314675,202310,2044,4702,1551,3848,111,248,1131,2703,1242,2951
314690,202310,2653,6687,1769,5052,465,1342,469,1232,934,2574
314700,202310,15590,37600,8905,24089,1337,3890,3996,9609,5333,13499
314710,202310,10371,26132,6175,16516,1027,2888,2302,5114,3329,8002
314720,202310,3020,8182,1613,4913,328,1063,269,578,597,1641
314730,202310,3412,8094,1728,4562,322,916,602,1260,924,2176
314740,202310,4217,10493,2841,7784,548,1629,1277,3082,1825,4711
314750,202310,368,887,232,589,22,59,125,281,147,340
314760,202310,2437,6434,1327,3862,240,731,336,701,576,1432
314770,202310,1298,3535,614,1862,77,223,108,263,185,486
314780,202310,461,1035,283,723,19,48,175,400,194,448
314790,202310,16123,38632,9507,25418,1855,5273,3727,8759,5582,14032
314795,202310,1850,4151,1343,3272,81,183,923,2082,1004,2265
314800,202310,15573,36393,8878,23115,1415,3998,3680,8062,5095,12060
314810,202310,14097,33429,8615,22758,2139,5636,3026,7360,5165,12996
314820,202310,1565,3444,989,2466,69,195,612,1363,681,1558
314830,202310,2307,5571,1589,4170,152,412,936,2196,1088,2608
314840,202310,1106,2991,797,2376,86,312,507,1381,593,1693
314850,202310,3507,5867,2555,4658,49,127,2257,3993,2306,4120
314860,202310,4205,10197,3101,8136,137,392,2220,5484,2357,5876
314870,202310,8794,16720,5790,12609,327,762,4260,9070,4587,9832
314875,202310,2178,6004,1711,5159,302,828,1008,3026,1310,3854
314880,202310,960,2143,572,1452,41,114,326,757,367,871
314890,202310,599,1714,347,1071,84,294,93,200,177,494
314900,202310,1161,2532,720,1712,81,214,443,937,524,1151
314910,202310,2047,5400,1240,3770,250,866,489,1287,739,2153
314915,202310,2610,6852,1805,5309,239,676,960,2742,1199,3418
314920,202310,758,1643,441,1114,41,114,248,597,289,711
314930,202310,8599,21227,5317,14003,1003,2804,2239,4966,3242,7770
314940,202310,535,1126,355,815,42,110,208,440,250,550
314950,202310,874,1978,469,1254,62,206,232,522,294,728
314960,202310,1223,2639,825,1943,75,175,518,1155,593,1330
314970,202310,1589,4223,1031,3040,193,612,385,912,578,1524
314980,202310,2843,6523,1849,4684,191,520,1119,2598,1310,3118
314990,202310,3569,9375,1973,5553,351,982,479,1098,830,2080
314995,202310,2167,5245,1372,3625,94,312,774,1776,868,2088
315000,202310,1313,3013,843,2244,97,284,523,1291,620,1575
315010,202310,529,1266,376,1005,32,91,234,575,266,666
315015,202310,3087,7432,2386,6143,227,679,1582,3768,1809,4447
315020,202310,995,2566,541,1531,59,180,260,592,319,772
315030,202310,903,2092,506,1336,151,378,129,292,280,670
315040,202310,1255,2904,936,2302,141,388,579,1328,720,1716
315050,202310,1407,3287,802,2127,88,253,359,865,447,1118
315053,202310,1545,3456,961,2383,136,320,508,1180,644,1500
315057,202310,2310,5683,1576,4399,150,389,897,2562,1047,2951
315060,202310,939,2501,586,1708,115,366,158,387,273,753
315070,202310,1175,2252,745,1574,132,280,461,935,593,1215
315080,202310,4331,10079,2731,6979,149,398,1871,4418,2020,4816
315090,202310,1023,2700,675,1970,119,345,297,754,416,1099
315100,202310,1830,4875,982,2872,193,581,368,880,561,1461
315110,202310,2940,6161,1751,4155,143,351,1014,2276,1157,2627
315120,202310,16171,34221,9873,23613,1432,3317,5161,11665,6593,14982
315130,202310,2324,5555,1580,4027,200,539,795,1755,995,2294
315140,202310,4292,10487,3011,7865,508,1419,1667,3978,2175,5397
315150,202310,5945,13994,3480,9294,602,1680,1401,3324,2003,5004
315160,202310,2606,5564,1422,3441,198,526,762,1632,960,2158
315170,202310,1832,5290,1133,3582,205,680,327,936,532,1616
315180,202310,22538,51777,10411,27271,1783,4810,3551,7740,5334,12550
315190,202310,2698,5494,1840,4243,351,726,1141,2648,1492,3374
315200,202310,6091,14806,3954,10829,1289,3637,1082,2494,2371,6131
315210,202310,10656,25770,5880,15362,736,2041,2562,5621,3298,7662
315213,202310,1270,3046,965,2510,30,90,759,1869,789,1959
315217,202310,3267,8249,2132,6171,851,2441,633,1672,1484,4113
315220,202310,10871,26710,6969,19136,724,1789,3555,9711,4279,11500
315230,202310,3711,7159,2623,5541,162,299,1893,3878,2055,4177
315240,202310,3163,7885,2197,6049,559,1619,836,2170,1395,3789
315250,202310,20148,48563,11674,30789,1870,5202,5069,11350,6939,16552
315260,202310,1181,2932,595,1692,109,303,155,364,264,667
315270,202310,1312,3329,860,2366,112,335,408,888,520,1223
315280,202310,4400,9993,2446,6253,637,1658,797,1847,1434,3505
315290,202310,1525,3444,778,2096,134,396,310,716,444,1112
315300,202310,811,1843,524,1370,35,92,334,836,369,928
315310,202310,1611,3600,1026,2482,80,212,704,1526,784,1738
315320,202310,761,2040,454,1366,71,204,157,410,228,614
315330,202310,877,2582,450,1442,65,217,171,456,236,673
315340,202310,3402,7879,1814,4876,493,1249,514,1349,1007,2598
315350,202310,2417,5353,1791,4299,178,461,1252,2844,1430,3305
315360,202310,2074,5352,1337,3726,198,577,566,1374,764,1951
315370,202310,781,1861,479,1269,72,200,195,437,267,637
315380,202310,273,709,162,471,40,124,17,31,57,155
315390,202310,1639,4098,1094,2939,120,404,576,1277,696,1681
315400,202310,5093,12217,3389,8976,451,1248,1807,4383,2258,5631
315410,202310,2291,5020,1392,3453,362,984,335,696,697,1680
315415,202310,1908,4860,1232,3478,374,1235,204,452,578,1687
315420,202310,1939,4976,1155,3352,319,940,257,638,576,1578
315430,202310,4344,9944,2549,6885,471,1377,1075,2627,1546,4004
315440,202310,1270,2953,804,2079,110,303,460,1060,570,1363
315445,202310,2872,5570,1868,4098,155,314,1393,2985,1548,3299
315450,202310,2686,6639,1764,4820,198,538,1089,2774,1287,3312
315460,202310,63397,147551,45184,112142,4964,13960,26968,59716,31932,73676
315470,202310,858,2179,477,1265,61,174,208,478,269,652
315480,202310,2024,4918,1174,3027,162,431,566,1257,728,1688
315490,202310,3578,8235,1918,5053,334,880,631,1496,965,2376
315500,202310,656,1592,335,884,19,43,210,500,229,543
315510,202310,1718,3752,1245,3029,36,147,973,2137,1009,2284
315520,202310,1410,3091,1056,2504,48,107,837,1875,885,1982
315530,202310,1084,2358,800,1815,62,167,590,1221,652,1388
315540,202310,2101,4984,1139,3065,135,368,459,1081,594,1449
315550,202310,2256,5624,1217,3461,195,613,374,993,569,1606
315560,202310,8290,21302,6166,16998,568,1486,4066,10712,4634,12198
315570,202310,3230,7333,1791,4518,325,933,836,1736,1161,2669
315580,202310,4204,8716,2675,6042,363,920,1223,2421,1586,3341
315590,202310,1654,3010,1286,2448,30,95,1041,1765,1071,1860
315600,202310,3079,8276,1895,5827,551,1620,616,1996,1167,3616
315610,202310,1278,2886,762,1866,84,249,382,761,466,1010
315620,202310,664,1577,411,1136,40,129,214,564,254,693
315630,202310,1583,3784,1020,2615,180,475,449,998,629,1473
315640,202310,519,1144,356,881,32,88,204,452,236,540
315645,202310,1233,2919,764,2054,167,495,290,673,457,1168
315650,202310,2293,4555,1594,3422,85,199,1252,2549,1337,2748
315660,202310,2589,6063,1702,4389,289,736,837,2062,1126,2798
315670,202310,21726,51103,14180,35949,2753,6990,6099,13893,8852,20883
315680,202310,3952,9731,2527,6947,380,1108,1179,3022,1559,4130
315690,202310,4912,11282,2271,6188,473,1272,627,1745,1100,3017
315700,202310,11051,26277,7276,18619,792,2126,4030,9318,4822,11444
315710,202310,2151,4651,1302,3272,92,223,813,1894,905,2117
315720,202310,5725,13584,3725,9472,218,700,2385,5386,2603,6086
315725,202310,2949,6630,2001,5039,308,728,1227,3112,1535,3840
315727,202310,824,1877,555,1411,64,200,297,667,361,867
315730,202310,800,2151,522,1508,103,305,192,455,295,760
315733,202310,1916,4390,1222,3056,249,613,496,1100,745,1713
315737,202310,1446,3502,888,2382,44,149,623,1546,667,1695
315740,202310,1091,2777,757,2037,72,210,472,1136,544,1346
315750,202310,1596,3641,1104,2870,111,264,657,1741,768,2005
315760,202310,1485,3043,975,2253,38,109,747,1617,785,1726
315765,202310,2522,5292,1978,4586,34,115,1725,3904,1759,4019
315770,202310,1677,4211,1046,2959,280,792,304,825,584,1617
315780,202310,41451,99623,28648,73128,2615,7435,16809,38676,19424,46111
315790,202310,4315,12096,3353,10181,536,1605,1688,5353,2224,6958
315800,202310,1701,4817,1092,3292,118,407,480,1181,598,1588
315810,202310,1785,3702,1288,2871,72,178,977,2006,1049,2184
315820,202310,3709,7972,2615,6202,350,711,1607,3724,1957,4435
315830,202310,1633,4283,786,2248,112,326,223,498,335,824
315840,202310,1153,2502,660,1580,66,169,363,724,429,893
315850,202310,1469,3712,1011,2850,206,598,498,1308,704,1906
315860,202310,648,1736,412,1263,73,228,110,274,183,502
315870,202310,581,1431,415,1125,38,118,282,712,320,830
315880,202310,1448,3175,855,2042,122,332,454,898,576,1230
315890,202310,2253,5645,1681,4697,569,1782,506,1275,1075,3057
315895,202310,8222,20227,4599,12355,583,1714,2062,4855,2645,6569
315900,202310,1144,2713,822,2128,117,311,473,1154,590,1465
315910,202310,824,1829,646,1542,40,110,490,1104,530,1214
315920,202310,1644,3824,792,2122,164,512,308,674,472,1186
315930,202310,1417,2826,821,1892,71,167,514,1103,585,1270
315935,202310,1522,3909,1016,2850,152,444,481,1251,633,1695
315940,202310,741,1793,488,1332,58,181,245,597,303,778
315950,202310,1602,3841,1244,3222,149,386,836,2115,985,2501
315960,202310,6659,17343,3293,9529,742,2220,680,1430,1422,3650
315970,202310,679,1710,476,1357,58,172,260,680,318,852
315980,202310,5339,10868,2542,5853,381,917,1297,2624,1678,3541
315990,202310,4357,10169,2683,6812,480,1255,1226,2785,1706,4040
316000,202310,979,2101,652,1588,63,195,383,824,446,1019
316010,202310,833,2188,527,1482,81,232,206,476,287,708
316020,202310,1177,2829,832,2145,79,198,532,1267,611,1465
316030,202310,3342,8201,2196,6020,434,1165,1080,3043,1514,4208
316040,202310,3306,8783,1851,5675,336,1143,501,1190,837,2333
316045,202310,2787,5729,2247,4950,160,335,1816,3914,1976,4249
316050,202310,552,1286,361,938,37,90,223,522,260,612
316060,202310,876,1851,539,1339,35,103,334,743,369,846
316070,202310,7768,18469,5249,13210,1007,2388,2273,5274,3280,7662
316080,202310,1070,2837,687,1976,107,331,296,727,403,1058
316090,202310,688,1670,416,1040,42,148,227,464,269,612
316095,202310,1554,4378,1006,3045,266,859,270,727,536,1586
316100,202310,3065,7792,1872,5198,322,1001,755,1761,1077,2762
316105,202310,901,2137,605,1620,47,135,356,921,403,1056
316110,202310,18360,42986,13579,34550,928,2771,9667,22833,10595,25604
316120,202310,1519,3789,746,2030,139,425,237,493,376,918
316130,202310,1577,3288,826,1921,104,267,443,901,547,1168
316140,202310,1295,3181,670,1935,163,481,188,494,351,975
316150,202310,2759,5755,1563,3559,189,424,881,1822,1070,2246
316160,202310,1207,2830,823,2089,24,72,570,1343,594,1415
316165,202310,1089,2357,705,1716,67,175,453,1012,520,1187
316170,202310,1825,3684,1199,2659,59,149,846,1694,905,1843
316180,202310,2059,5198,1089,3032,192,545,377,880,569,1425
316190,202310,3361,8763,1385,3887,167,508,616,1386,783,1894
316200,202310,4938,11841,3168,8360,445,1265,1596,3682,2041,4947
316210,202310,7507,19631,4001,11209,1207,3541,462,1027,1669,4568
316220,202310,947,2661,477,1568,94,336,111,336,205,672
316225,202310,1991,4091,1351,3077,54,185,993,1976,1047,2161
316230,202310,631,1481,419,1098,99,286,214,530,313,816
316240,202310,7069,17735,5383,14455,445,1255,3799,9561,4244,10816
316245,202310,3934,10844,3113,9310,235,889,1993,5372,2228,6261
316250,202310,15185,32816,9300,21842,1913,4628,3572,7571,5485,12199
316255,202310,3567,9431,2697,7780,329,909,1717,4923,2046,5832
316257,202310,2028,4131,1293,2944,128,277,823,1766,951,2043
316260,202310,3349,6691,2245,4873,236,465,1431,3004,1667,3469
316265,202310,1343,3225,893,2385,33,73,664,1690,697,1763
316270,202310,4788,12726,3550,9983,500,1455,1842,4621,2342,6076
316280,202310,3867,9133,2740,6970,394,1032,1431,3395,1825,4427
316290,202310,5304,12545,3144,8073,398,1033,1292,2916,1690,3949
316292,202310,8022,19076,5342,13906,635,1850,3212,7555,3847,9405
316294,202310,1228,3361,742,2346,183,635,222,584,405,1219
316295,202310,4775,11799,3048,8196,328,934,1633,3863,1961,4797
316300,202310,1396,3207,991,2543,55,169,701,1666,756,1835
316310,202310,915,2398,535,1524,93,285,162,393,255,678
316320,202310,848,2162,503,1418,77,253,158,413,235,666
316330,202310,1300,2969,870,2201,38,100,643,1520,681,1620
316340,202310,1301,3148,876,2286,134,356,448,1016,582,1372
316350,202310,1821,4161,1399,3416,156,356,980,2268,1136,2624
316360,202310,784,1870,556,1476,90,229,346,902,436,1131
316370,202310,7982,18132,5066,12593,641,1851,2587,5290,3228,7141
316380,202310,2176,4553,1424,3311,92,223,966,2126,1058,2349
316390,202310,941,2322,604,1686,231,714,137,320,368,1034
316400,202310,1545,3983,733,2203,96,291,241,603,337,894
316410,202310,1549,3475,1157,2784,32,95,887,2000,919,2095
316420,202310,2272,5522,1702,4574,69,212,1226,3095,1295,3307
316430,202310,1176,2812,664,1834,131,416,267,628,398,1044
316440,202310,1091,3143,612,1997,103,333,147,431,250,764
316443,202310,727,1803,410,1162,89,276,155,387,244,663
316447,202310,2764,5994,2128,4960,198,327,1625,3772,1823,4099
316450,202310,2587,6742,1690,4869,216,600,947,2599,1163,3199
316460,202310,1757,4174,1137,2971,94,286,639,1480,733,1766
316470,202310,9650,24586,5858,16192,945,2670,2353,5467,3298,8137
316480,202310,283,639,208,501,30,72,121,252,151,324
316490,202310,421,1083,236,685,50,156,77,181,127,337
316500,202310,1767,4810,1040,3076,239,739,332,812,571,1551
316510,202310,1009,2876,700,2180,114,344,298,880,412,1224
316520,202310,1702,3720,1077,2528,202,509,359,700,561,1209
316530,202310,1558,3447,1012,2432,116,311,587,1244,703,1555
316540,202310,1452,3213,946,2327,179,458,367,808,546,1266
316550,202310,1895,4487,1463,3728,57,188,1153,2774,1210,2962
316553,202310,6441,16629,3665,9890,533,1556,1743,3985,2276,5541
316555,202310,3291,8393,2540,7244,109,432,1946,5230,2055,5662
316556,202310,706,1490,448,995,35,78,290,550,325,628
316557,202310,1597,4270,1219,3555,428,1308,417,1126,845,2434
316560,202310,501,1400,279,892,49,173,66,179,115,352
316570,202310,1907,4702,1211,3295,296,710,379,1049,675,1759
316580,202310,447,954,221,538,34,92,85,167,119,259
316590,202310,1613,3607,937,2246,100,202,596,1346,696,1548
316600,202310,1292,3237,988,2592,142,446,622,1466,764,1912
316610,202310,778,1998,534,1527,63,176,302,788,365,964
316620,202310,2895,6412,2100,4974,176,392,1545,3492,1721,3884
316630,202310,1933,5185,1469,4221,449,1256,512,1644,961,2900
316640,202310,227,558,156,413,43,128,50,102,93,230
316650,202310,1434,3491,1024,2761,83,207,651,1637,734,1844
316660,202310,205,482,90,235,8,20,32,65,40,85
316670,202310,2014,4496,1252,3189,398,1001,318,713,716,1714
316680,202310,2939,6997,1797,4660,196,548,988,2411,1184,2959
316690,202310,1660,4427,854,2571,151,454,136,297,287,751
316695,202310,1194,3162,796,2339,23,88,507,1362,530,1450
316700,202310,679,1153,499,920,13,27,416,707,429,734
316710,202310,4569,12071,3153,8944,445,1312,1706,4296,2151,5608
316720,202310,30755,73523,19997,51392,3054,8342,9848,22586,12902,30928
316730,202310,699,1507,470,1076,44,101,267,560,311,661
316740,202310,1121,2680,754,2004,95,293,462,1100,557,1393
316750,202310,528,1321,336,953,81,238,131,343,212,581
316760,202310,5016,13734,3784,11257,1299,4339,1366,3753,2665,8092
316770,202310,1932,3903,1282,2942,48,127,988,2195,1036,2322
316780,202310,762,2029,527,1554,185,553,69,145,254,698
316790,202310,942,2309,569,1561,104,302,169,428,273,730
316800,202310,8550,21064,5837,15835,957,2801,2712,6670,3669,9471
316805,202310,1517,2783,1074,2211,40,95,870,1707,910,1802
316810,202310,1001,2441,615,1645,50,142,389,973,439,1115
316820,202310,498,938,245,526,11,29,165,315,176,344
316830,202310,1171,2634,760,1885,107,262,428,996,535,1258
316840,202310,3830,8292,2661,6353,123,360,1989,4375,2112,4735
316850,202310,3025,6495,1887,4455,174,491,1199,2488,1373,2979
316860,202310,30723,66968,20207,49132,3011,8106,10481,23046,13492,31152
316870,202310,11638,27421,6898,17529,869,2390,3448,7377,4317,9767
316880,202310,1503,3461,1062,2652,161,420,548,1206,709,1626
316890,202310,1425,3049,793,2108,104,320,438,1049,542,1369
316900,202310,3992,9001,2501,6133,445,1143,1149,2488,1594,3631
316905,202310,616,1659,400,1204,230,698,76,238,306,936
316910,202310,1339,3195,769,2090,174,505,202,474,376,979
316920,202310,2576,5210,1676,3741,336,600,967,2063,1303,2663
316930,202310,12541,31088,7986,21751,1689,4807,2862,6634,4551,11441
316935,202310,5747,13540,3550,9224,624,1704,1610,3694,2234,5398
316940,202310,7828,20532,5270,14835,1003,2876,2078,5015,3081,7891
316950,202310,2535,5015,1754,3897,143,322,1327,2829,1470,3151
316960,202310,7130,13831,4200,9416,331,827,2829,5939,3160,6766
316970,202310,5503,13002,3637,9240,725,1912,1550,3359,2275,5271
316980,202310,1164,2920,801,2269,227,699,311,761,538,1460
316990,202310,17200,40971,10228,26272,2614,6907,2532,5537,5146,12444
317000,202310,3488,8179,2696,6924,130,335,2151,5346,2281,5681
317005,202310,3273,8274,2174,5989,442,1281,975,2437,1417,3718
317010,202310,39974,87041,23854,59364,3575,9577,12401,28020,15976,37597
317020,202310,101061,221934,53597,133098,10764,27962,18923,40790,29687,68752
317030,202310,835,2010,607,1636,24,82,414,1038,438,1120
317040,202310,15088,34753,7878,21276,2076,5796,1580,4117,3656,9913
317043,202310,1179,2240,661,1450,29,73,502,1040,531,1113
317047,202310,1356,2897,783,1880,55,160,498,1054,553,1214
317050,202310,1492,4373,806,2542,120,381,243,583,363,964
317052,202310,3040,7089,2043,5357,287,718,1169,2895,1456,3613
317057,202310,2869,5280,1893,3800,43,108,1525,2871,1568,2979
317060,202310,635,1538,297,834,62,195,107,249,169,444
317065,202310,1382,3579,953,2624,61,203,602,1455,663,1658
317070,202310,11114,28094,7526,20705,1197,3577,3293,7776,4490,11353
317075,202310,1415,3184,927,2248,147,372,504,1118,651,1490
317080,202310,8592,18302,5512,12813,1099,2721,2562,5554,3661,8275
317090,202310,5912,14854,4572,12475,486,1192,3075,8245,3561,9437
317100,202310,3262,7214,1725,4298,407,988,639,1415,1046,2403
317103,202310,3114,6538,2185,5009,191,426,1521,3288,1712,3714
317107,202310,1855,4260,1198,2964,59,156,773,1638,832,1794
317110,202310,854,1838,423,1108,83,228,191,444,274,672
317115,202310,1443,3634,1036,2841,154,459,572,1497,726,1956
317120,202310,26482,60686,18007,44466,1751,4842,10837,23922,12588,28764
317130,202310,14713,31492,8484,20159,1357,3247,3190,6973,4547,10220
317140,202310,1230,2647,754,1829,141,314,434,1049,575,1363
317150,202310,1324,2640,896,2021,30,103,701,1446,731,1549
317160,202310,4152,9336,2272,6003,339,817,1021,2880,1360,3697
317170,202310,2664,5936,1839,4363,121,346,1253,2579,1374,2925
317180,202310,2262,6361,1284,3998,274,836,187,540,461,1376
317190,202310,1352,3347,878,2471,172,515,420,1066,592,1581
317200,202310,8476,20424,4680,12222,982,2670,1178,2609,2160,5279
317210,202310,1541,3273,984,2352,41,135,662,1468,703,1603
317220,202310,444,1071,316,825,54,179,179,398,233,577
320010,202310,6150,16665,3936,11827,973,3106,1168,3351,2141,6457
320013,202310,2640,6502,1545,4266,355,1051,655,1773,1010,2824
320016,202310,3561,8417,2313,6192,355,971,1388,3560,1743,4531
320020,202310,6557,14659,4243,10389,628,1736,2281,5017,2909,6753
320030,202310,2348,5749,1345,3666,210,635,588,1348,798,1983
320035,202310,2499,5964,1742,4541,273,758,1003,2493,1276,3251
320040,202310,5936,14803,4034,10776,610,1668,2021,4817,2631,6485
320050,202310,2527,5104,1725,3803,206,578,1165,2282,1371,2860
320060,202310,20390,49738,12020,32125,2449,6882,4908,11630,7357,18512
320070,202310,2585,6148,1547,3964,195,547,810,1820,1005,2367
320080,202310,7326,16964,4373,10970,741,1975,2013,4491,2754,6466
320090,202310,10682,26165,5830,15944,1252,3646,1970,4619,3222,8265
320100,202310,4573,10319,3214,7845,432,1155,1946,4348,2378,5503
320110,202310,3338,6682,2039,4605,396,838,1100,2256,1496,3094
320115,202310,2809,8076,2128,6696,747,2434,540,1672,1287,4106
320120,202310,36016,80933,20836,51614,2966,7605,10336,22927,13302,30532
320130,202310,81702,187649,55252,137002,7639,20059,31224,71082,38863,91141
320140,202310,5488,13313,3221,8492,705,1924,1364,3265,2069,5189
320150,202310,19004,44215,10622,27602,2793,7824,1512,2887,4305,10711
320160,202310,8857,21228,5559,14735,871,2467,2847,6887,3718,9354
320170,202310,2378,6084,1481,4240,410,1193,430,1295,840,2488
320180,202310,963,2722,662,2091,223,774,112,304,335,1078
320190,202310,4178,11755,2663,8338,584,2005,468,1204,1052,3209
320200,202310,1740,4352,1036,2966,236,731,276,728,512,1459
320210,202310,5874,13535,3914,9917,676,1835,1831,4194,2507,6029
320220,202310,4984,11147,3000,7445,658,1674,1266,2867,1924,4541
320225,202310,2084,5731,1278,3924,380,1270,267,750,647,2020
320230,202310,7427,17604,4687,12411,1276,3487,1177,3135,2453,6622
320240,202310,23257,53689,14595,38132,4118,11238,3455,8286,7573,19524
320245,202310,4223,11507,2647,8021,657,2102,278,747,935,2849
320250,202310,3924,9101,2019,4948,332,899,967,2034,1299,2933
320255,202310,2845,7497,2170,6167,388,1188,1317,3643,1705,4831
320260,202310,1873,4791,980,2841,270,781,252,612,522,1393
320265,202310,3008,8472,1945,6147,584,2005,156,405,740,2410
320270,202310,2925,7340,1818,5072,499,1529,562,1435,1061,2964
320280,202310,11963,26503,8368,20121,914,2483,5501,12014,6415,14497
320290,202310,1677,4614,951,2893,247,841,238,674,485,1515
320300,202310,5881,15448,4087,11770,1271,4063,1052,2764,2323,6827
320305,202310,7239,17872,4801,13094,851,2517,2268,5718,3119,8235
320310,202310,2746,6681,1633,4294,298,800,754,1779,1052,2579
320313,202310,3374,7548,1709,4165,341,905,613,1192,954,2097
320316,202310,2023,5252,1326,3906,254,767,612,1790,866,2557
320320,202310,27890,68404,16995,47180,4707,13338,4040,10515,8747,23853
320330,202310,3765,8906,2573,6799,435,1126,1397,3643,1832,4769
320332,202310,11405,26394,7855,19765,1912,4754,3778,8958,5690,13712
320334,202310,2675,6699,1451,4142,237,796,337,707,574,1503
320335,202310,2450,6465,1353,3968,303,1013,402,986,705,1999
320340,202310,7633,15640,5220,11693,473,1068,3526,7481,3999,8549
320350,202310,6782,14699,4064,9661,532,1392,2212,4777,2744,6169
320360,202310,1774,4158,1051,2751,131,360,531,1268,662,1628
320370,202310,3907,10414,2674,7723,732,2357,925,2391,1657,4748
320380,202310,4100,8815,2975,6715,245,682,2111,4323,2356,5005
320390,202310,10833,25554,6525,16671,1463,3925,2540,5938,4003,9863
320400,202310,4195,10814,2603,7419,904,2674,797,2111,1701,4785
320405,202310,6942,15922,4278,10865,672,1743,2244,5300,2916,7043
320410,202310,5974,14402,3824,10406,778,2092,1598,4246,2376,6338
320420,202310,5886,12900,3826,9312,956,2452,1507,3463,2463,5915
320425,202310,2747,5823,1796,4136,141,356,1208,2562,1349,2918
320430,202310,4041,9375,2565,6552,397,1006,1405,3346,1802,4352
320435,202310,3214,8959,2349,7065,839,2722,559,1630,1398,4352
320440,202310,1959,4849,1199,3291,225,684,488,1127,713,1811
320450,202310,2878,6846,2024,5186,312,1003,1155,2548,1467,3551
320455,202310,6029,16730,3521,10921,871,2964,864,2218,1735,5182
320460,202310,2740,7407,1661,4987,481,1551,429,1092,910,2643
320465,202310,2152,5473,1250,3572,330,1007,486,1325,816,2332
320470,202310,5827,14101,3594,9602,733,2069,1131,2637,1864,4706
320480,202310,3619,7599,2346,5335,315,679,1426,2977,1741,3656
320490,202310,35392,79186,20993,51958,4016,9769,9200,21998,13216,31767
320495,202310,1826,4550,1146,3128,294,912,144,250,438,1162
320500,202310,96282,221071,64629,160546,8705,23111,35735,80238,44440,103349
320501,202310,6500,16846,3729,10990,932,2786,891,2393,1823,5179
320503,202310,3441,8946,1933,5739,563,1821,495,1254,1058,3075
320506,202310,3896,10327,2311,6545,724,2151,617,1468,1341,3619
320510,202310,16614,39147,10596,27497,2171,5392,4484,11124,6655,16516
320515,202310,2366,5922,1438,3932,448,1306,404,995,852,2301
320517,202310,3045,8018,2182,6215,634,1951,834,2260,1468,4211
320520,202310,67661,151621,43693,107209,6859,17767,21052,46559,27911,64326
320530,202310,49335,109888,32247,77497,2859,8066,19890,41787,22749,49853
330010,202310,38960,84275,27998,64659,2340,5991,19559,41782,21899,47773
330015,202310,2454,5101,1653,3711,268,635,919,1867,1187,2502
330020,202310,33192,69729,24930,56561,2483,6415,17739,37551,20222,43966
330022,202310,2648,6506,1602,4500,338,1001,573,1474,911,2475
330023,202310,10310,21518,7023,15980,1011,2503,4123,8447,5134,10950
330025,202310,10767,21475,6390,14080,905,2241,3364,6608,4269,8849
330030,202310,16535,36301,11289,27181,1051,2745,7143,15496,8194,18241
330040,202310,26944,59207,19033,44631,1089,3093,13619,29052,14708,32145
330045,202310,150120,282120,115389,234007,7385,14799,91656,180798,99041,195597
330050,202310,5283,11453,3717,8791,534,1523,2277,4716,2811,6239
330060,202310,8920,19352,5459,13255,1096,2846,2047,4424,3143,7270
330070,202310,48274,99734,36051,80815,4579,10769,22939,49178,27518,59947
330080,202310,15448,31106,11619,25130,1450,3053,8025,16659,9475,19712
330090,202310,4721,8740,2985,6177,320,505,1895,3926,2215,4431
330093,202310,4277,8710,2673,6136,168,474,1968,4165,2136,4639
330095,202310,2152,5043,1312,3385,131,374,753,1730,884,2104
330100,202310,109361,237051,86483,199365,6621,15228,63606,139061,70227,154289
330110,202310,3422,7843,2556,6281,220,640,1721,3840,1941,4480
330115,202310,4082,8493,2418,5649,416,1025,1300,2658,1716,3683
330120,202310,4886,9289,3220,6913,171,420,2405,4788,2576,5208
330130,202310,8460,19224,6222,15449,835,2113,3741,8719,4576,10832
330140,202310,6339,12355,4756,10075,241,660,3791,7521,4032,8181
330150,202310,3893,8622,2575,6306,420,1054,1360,3084,1780,4138
330160,202310,2380,5443,1721,4245,267,764,951,2025,1218,2789
330170,202310,241839,460443,184321,376609,21599,45333,131633,258033,153232,303366
330180,202310,3257,6295,2286,4791,91,261,1715,3235,1806,3496
330185,202310,17764,34318,13238,27643,536,1435,10541,20413,11077,21848
330187,202310,9002,18502,6054,13592,831,1962,3655,7401,4486,9363
330190,202310,70251,135029,53649,109830,2941,6846,42137,81183,45078,88029
330200,202310,29833,61476,22193,50110,2697,6258,15347,33234,18044,39492
330205,202310,3072,6777,1936,4739,194,506,1209,2639,1403,3145
330210,202310,4748,10202,3072,7290,520,1207,1450,3060,1970,4267
330220,202310,21205,44868,13346,30815,2466,5832,6425,13275,8891,19107
330225,202310,6709,14419,4493,10667,341,932,2905,6224,3246,7156
330227,202310,29710,58683,23275,49407,647,1768,19724,39430,20371,41198
330230,202310,2510,5301,1376,3430,178,417,612,1438,790,1855
330240,202310,43668,93305,32492,73601,3864,9078,21401,45762,25265,54840
330245,202310,2343,5251,1252,3251,282,783,525,1156,807,1939
330250,202310,74628,147130,57376,121293,6248,13420,41564,84516,47812,97936
330260,202310,10461,20585,7619,16465,395,1041,5896,12022,6291,13063
330270,202310,50639,106557,28124,67408,3843,9691,14523,31876,18366,41567
330280,202310,4281,8814,2906,6504,322,717,1844,3818,2166,4535
330285,202310,47195,88991,35358,71232,2058,4703,28073,52923,30131,57626
330290,202310,7072,13447,5083,10653,369,1006,3770,7221,4139,8227
330300,202310,8322,16753,5473,12438,434,1064,3844,8308,4278,9372
330310,202310,3887,7942,2609,5783,138,345,1936,3986,2074,4331
330320,202310,28070,55042,19403,42610,2721,5842,12847,26773,15568,32615
330330,202310,81235,152562,58947,119705,5160,10925,43722,83974,48882,94899
330340,202310,29887,61502,19626,44407,2753,7257,11184,22310,13937,29567
330350,202310,260918,483593,201053,401615,10236,21881,166631,318878,176867,340759
330360,202310,11374,22342,8640,18129,419,948,6864,13437,7283,14385
330370,202310,8452,19854,5746,14772,974,2736,2862,6756,3836,9492
330380,202310,11021,23307,7739,17534,497,1378,5554,11530,6051,12908
330385,202310,6565,15147,4791,12196,893,2432,2338,5511,3231,7943
330390,202310,54995,117497,37113,85560,3442,9383,24542,50327,27984,59710
330395,202310,5370,10942,3870,8658,178,530,2896,5948,3074,6478
330400,202310,5288,11673,3957,9375,255,749,2720,5735,2975,6484
330410,202310,4958,10483,3340,7726,357,1000,2279,4756,2636,5756
330411,202310,4147,9808,2687,6964,174,541,1698,3948,1872,4489
330412,202310,2553,5804,1854,4532,153,427,1250,2757,1403,3184
330414,202310,37921,80735,28377,65598,2434,5861,20606,45293,23040,51154
330415,202310,6484,15281,4024,10586,449,1238,2287,5500,2736,6738
330420,202310,19330,42285,12379,29625,1513,3888,6986,15013,8499,18901
330430,202310,16321,30937,12374,25032,639,1433,9780,18644,10419,20077
330440,202310,4550,10021,2845,6851,323,863,1840,3956,2163,4819
330450,202310,2174,5138,1479,3803,114,326,919,2166,1033,2492
330452,202310,31761,67402,23423,53329,2033,5363,16561,34820,18594,40183
330455,202310,1137175,2160568,853349,1735505,93447,197432,595960,1148794,689407,1346226
330460,202310,1760,4070,1227,3172,181,453,630,1578,811,2031
330470,202310,9025,18833,5573,13059,1379,3458,2204,4627,3583,8085
330475,202310,13860,29774,10428,24754,1570,4054,6604,14878,8174,18932
330480,202310,8145,18094,6110,14508,562,1420,3989,8665,4551,10085
330490,202310,180918,354375,131447,278426,11681,25884,94402,189147,106083,215031
330500,202310,12619,26206,8832,20078,594,1491,6365,13524,6959,15015
330510,202310,78870,161498,57949,129965,5251,12644,41708,87584,46959,100228
330513,202310,1930,4198,1297,3164,205,518,665,1539,870,2057
330515,202310,3991,9267,2799,7237,576,1572,1111,2622,1687,4194
330520,202310,22344,47596,16750,38393,1792,4527,10953,23348,12745,27875
330530,202310,2320,5000,1469,3577,273,700,695,1606,968,2306
330540,202310,4536,10235,3074,7592,595,1546,1570,3581,2165,5127
330550,202310,31807,61558,20249,43663,2816,6383,12094,24495,14910,30878
330555,202310,32695,55948,24357,44865,903,1988,20218,35588,21121,37576
330560,202310,6036,13081,4304,10170,710,1663,2606,5778,3316,7441
330570,202310,4499,9979,3550,8479,609,1570,2241,5143,2850,6713
330575,202310,9464,19450,7390,15839,365,951,5859,11625,6224,12576
330580,202310,36471,78083,26260,59597,3984,9305,15357,31956,19341,41261
330590,202310,2237,4971,1706,4168,261,619,908,2192,1169,2811
330600,202310,19690,42617,13578,31619,923,2554,9418,19865,10341,22419
330610,202310,14806,31731,10734,24741,1210,2950,7018,15010,8228,17960
330615,202310,3108,7032,2316,5849,401,874,1431,3703,1832,4577
330620,202310,6769,15686,4778,12160,743,1925,2593,6026,3336,7951
330630,202310,48246,99585,31132,69802,1696,4750,22323,45126,24019,49876
350010,202310,3209,7604,1536,4015,259,724,376,805,635,1529
350020,202310,859,2115,424,1181,63,188,157,361,220,549
350030,202310,5295,12703,3484,9134,741,2052,1683,3973,2424,6025
350040,202310,1005,2635,519,1556,77,248,162,353,239,601
350050,202310,2053,4611,1109,2844,195,572,343,646,538,1218
350055,202310,1249,2764,809,1958,111,262,459,960,570,1222
350060,202310,441,954,176,428,41,101,67,141,108,242
350070,202310,4637,11041,2771,7387,438,1245,1113,2503,1551,3748
350075,202310,885,2264,487,1419,149,412,65,177,214,589
350080,202310,891,2164,458,1237,56,176,229,515,285,691
350090,202310,817,1640,424,942,59,149,259,497,318,646
350100,202310,3504,7986,2093,5249,142,417,1394,3086,1536,3503
350110,202310,685,1475,419,959,16,54,302,628,318,682
350115,202310,1432,3882,923,2646,160,458,361,924,521,1382
350120,202310,726,1625,348,924,43,115,184,438,227,553
350130,202310,4641,11021,3011,7639,439,1231,1662,3678,2101,4909
350140,202310,930,2306,474,1322,52,170,251,610,303,780
350150,202310,589,1644,302,925,76,242,82,190,158,432
350160,202310,17508,40649,10523,26285,1515,4170,5805,12879,7320,17049
350170,202310,4069,9805,2715,6694,495,1278,1410,3038,1905,4316
350180,202310,1280,2807,673,1624,75,181,376,806,451,987
350190,202310,5463,13822,3296,8509,422,1246,1772,3783,2194,5029
350200,202310,739,1703,472,1174,51,137,265,596,316,733
350210,202310,9137,18980,5422,12408,426,1171,3631,7320,4057,8491
350220,202310,4337,10722,2531,6753,464,1323,1121,2494,1585,3817
350230,202310,1570,3464,1019,2584,133,389,608,1391,741,1780
350240,202310,812,2131,371,1094,86,255,70,176,156,431
350250,202310,4980,12104,3076,8468,791,2162,798,2033,1589,4195
350260,202310,1081,2385,517,1326,84,208,239,563,323,771
350270,202310,5835,13687,3916,9892,577,1501,2137,4896,2714,6397
350275,202310,4280,9728,2934,7215,196,616,2053,4529,2249,5145
350280,202310,25969,54987,14555,34452,2153,5344,7293,15220,9446,20564
350290,202310,4717,11747,2890,7811,584,1682,1174,2706,1758,4388
350300,202310,1075,2298,613,1452,94,264,407,859,501,1123
350310,202310,1301,3293,774,2143,102,321,363,856,465,1177
350315,202310,915,1970,472,1180,26,99,289,625,315,724
350320,202310,24301,56553,15297,38424,2686,7309,7393,15842,10079,23151
350330,202310,18698,41627,11376,27080,1133,3016,7297,15555,8430,18571
350335,202310,472,1236,276,809,36,112,116,325,152,437
350340,202310,1786,4289,924,2461,138,408,433,959,571,1367
350350,202310,935,2128,625,1585,93,208,356,871,449,1079
350360,202310,1599,4047,918,2439,144,379,381,909,525,1288
350370,202310,941,2140,554,1325,152,343,211,444,363,787
350380,202310,6745,17059,3746,10195,870,2408,1252,2984,2122,5392
350390,202310,16248,37313,10448,25982,1502,4078,6063,13540,7565,17618
350395,202310,509,1213,197,573,23,73,77,204,100,277
350400,202310,12035,27526,7150,18160,1888,5051,2248,5113,4136,10164
350410,202310,15113,38238,9226,25945,1872,5521,3237,8254,5109,13775
350420,202310,1675,3928,931,2372,188,465,280,587,468,1052
350430,202310,872,2104,607,1632,103,315,274,635,377,950
350440,202310,2822,6326,1799,4366,224,568,1113,2496,1337,3064
350450,202310,10268,25548,6801,18565,1460,4332,2947,6978,4407,11310
350460,202310,3404,8018,1875,4997,298,864,860,2010,1158,2874
350470,202310,342,758,221,537,12,38,168,373,180,411
350480,202310,1164,2727,678,1821,177,532,133,272,310,804
350490,202310,2776,6170,1688,4217,248,720,866,1787,1114,2507
350500,202310,812,2026,483,1352,89,277,182,441,271,718
350510,202310,1618,3607,1008,2397,111,277,633,1370,744,1647
350520,202310,3348,8780,2184,6267,334,1009,1029,2613,1363,3622
350530,202310,4191,9584,2562,6160,205,576,1608,3428,1813,4004
350535,202310,1985,4709,1430,3701,202,578,895,2171,1097,2749
350540,202310,2576,5263,1749,3954,230,664,1180,2330,1410,2994
350550,202310,13913,31074,8426,20812,987,2710,4435,9583,5422,12293
350560,202310,6501,14322,4645,10890,187,558,3522,7657,3709,8215
350570,202310,45119,109239,29965,78131,5514,14761,13799,32205,19313,46966
350580,202310,2936,7009,1454,3888,383,1042,316,611,699,1653
350590,202310,7246,17317,4623,11533,709,2005,2672,5853,3381,7858
350600,202310,46567,102826,25284,63386,4581,12193,10735,23386,15316,35579
350610,202310,9675,23653,5915,15642,680,1989,3272,7564,3952,9553
350620,202310,519,1236,254,686,29,78,134,319,163,397
350630,202310,2397,5078,1428,3334,92,248,952,2010,1044,2258
350635,202310,16287,34273,10983,25179,1096,2710,7513,16021,8609,18731
350640,202310,1157,2900,507,1476,83,252,142,336,225,588
350650,202310,11938,28997,7229,19019,1408,3849,2897,6616,4305,10465
350660,202310,6658,15159,4535,11401,758,1775,2526,6066,3284,7841
350670,202310,2476,6061,1500,4106,260,711,702,1730,962,2441
350680,202310,1622,3897,955,2526,142,411,497,1170,639,1581
350690,202310,1970,4680,1146,3105,206,599,513,1224,719,1823
350700,202310,7445,16740,4879,12067,1199,3139,2280,4913,3479,8052
350710,202310,4384,10076,2951,7288,553,1490,1502,3303,2055,4793
350715,202310,928,2458,668,1897,119,384,324,747,443,1131
350720,202310,213,495,92,245,14,41,33,68,47,109
350730,202310,838,2235,476,1406,50,143,241,609,291,752
350740,202310,2096,5057,1205,3180,225,618,408,905,633,1523
350745,202310,811,1961,369,1012,26,79,188,441,214,520
350750,202310,16322,38359,11082,28094,2014,5486,4813,10719,6827,16205
350760,202310,25416,55113,15488,36461,2076,5580,8275,16774,10351,22354
350770,202310,1369,3008,773,1914,92,257,495,1113,587,1370
350775,202310,950,1987,477,1142,73,193,249,528,322,721
350780,202310,3091,6927,1962,5115,564,1420,656,1754,1220,3174
350790,202310,2560,6273,1332,3765,314,932,301,676,615,1608
350800,202310,4808,11934,3558,9510,549,1458,2014,4954,2563,6412
350810,202310,3786,8291,2357,5742,554,1424,1043,2313,1597,3737
350820,202310,1250,2663,631,1485,50,136,392,815,442,951
350830,202310,1120,2746,531,1456,104,292,182,405,286,697
350840,202310,4472,12099,2896,8595,619,1979,1105,2778,1724,4757
350850,202310,11789,28803,8005,21203,1373,3835,4014,9642,5387,13477
350860,202310,5489,12361,4080,9928,478,1211,2574,5854,3052,7065
350870,202310,3525,8771,2145,6198,471,1358,820,2201,1291,3559
350880,202310,2279,5475,1537,3932,390,1038,675,1441,1065,2479
350890,202310,653,1600,282,756,64,180,101,221,165,401
350900,202310,13571,31941,8166,20326,1271,3306,4313,9552,5584,12858
350910,202310,1265,2676,871,1979,107,214,577,1258,684,1472
350920,202310,17713,40621,11775,29075,986,2746,7697,17271,8683,20017
350925,202310,6003,14113,3883,10147,628,1840,2076,4568,2704,6408
350930,202310,1914,4554,901,2352,80,203,494,1170,574,1373
350940,202310,3801,8462,2628,6370,297,805,1707,3728,2004,4533
350945,202310,1279,3207,781,2127,150,409,318,757,468,1166
350950,202310,142303,322762,90722,219361,12720,32824,50601,109982,63321,142806
350960,202310,10613,24863,6798,17006,1070,2962,3503,7584,4573,10546
350970,202310,5319,13395,2941,8038,686,2095,962,1987,1648,4082
350980,202310,1034,2349,764,1837,114,299,452,996,566,1295
350990,202310,2979,6883,2089,5335,510,1469,1000,2301,1510,3770
350995,202310,1174,3138,870,2406,62,208,566,1414,628,1622
351000,202310,3952,10210,2122,6095,439,1356,487,1185,926,2541
351010,202310,566,1342,279,752,44,133,125,314,169,447
351015,202310,1336,3552,804,2233,142,435,346,822,488,1257
351020,202310,11057,26486,6802,17845,1473,3811,2779,6396,4252,10207
351030,202310,4221,11134,2797,7973,663,2024,1099,2767,1762,4791
351040,202310,7978,16723,5339,12101,464,1193,3658,7498,4122,8691
351050,202310,25101,56311,16418,40848,3205,8164,7989,18187,11194,26351
351060,202310,70769,157905,45446,110659,4824,12999,28441,63644,33265,76643
351070,202310,2004,4606,972,2684,265,762,155,366,420,1128
351080,202310,3830,8293,2468,6130,332,856,1330,2938,1662,3794
351090,202310,452,1102,283,769,52,123,129,326,181,449
351100,202310,3932,9472,1978,5208,324,905,796,1857,1120,2762
351110,202310,7991,19049,5009,13216,977,2654,2195,5151,3172,7805
351120,202310,1040,2458,548,1402,98,284,209,433,307,717
351130,202310,1556,4037,585,1755,107,339,116,294,223,633
351140,202310,3054,7599,1873,5106,421,1245,641,1421,1062,2666
351150,202310,3634,9510,2014,5811,349,1097,499,1216,848,2313
351160,202310,1967,5435,1125,3417,200,601,187,439,387,1040
351170,202310,2248,5215,1595,3906,139,400,1080,2405,1219,2805
351190,202310,1296,3312,699,1969,180,503,174,441,354,944
351200,202310,1998,4636,1201,3142,152,414,545,1181,697,1595
351210,202310,1927,4290,1049,2581,87,251,682,1509,769,1760
351220,202310,5280,12153,3623,8995,481,1168,2104,4848,2585,6016
351230,202310,3143,7211,1949,4890,327,882,941,2018,1268,2900
351240,202310,3069,7656,1341,3704,236,655,160,296,396,951
351250,202310,1309,3300,580,1650,90,268,206,513,296,781
351260,202310,1043,2365,617,1561,125,330,242,526,367,856
351270,202310,700,1740,401,1084,49,136,194,434,243,570
351280,202310,5247,12800,3206,8460,812,2216,1015,2414,1827,4630
351290,202310,2001,4281,1124,2649,84,230,786,1711,870,1941
351300,202310,32999,79186,20830,55006,3790,10573,9500,22552,13290,33125
351310,202310,5419,11767,3444,8071,339,836,2185,4658,2524,5494
351320,202310,1048,2804,596,1797,86,264,150,400,236,664
351330,202310,376,915,181,500,24,59,75,173,99,232
351340,202310,11451,25432,8582,19853,1822,4405,4741,9786,6563,14191
351350,202310,19131,42326,12889,30086,1340,3350,8740,18609,10080,21959
351360,202310,5281,12112,3882,9708,832,2182,1766,3936,2598,6118
351370,202310,2691,6946,1433,4152,318,989,297,637,615,1626
351380,202310,64335,139464,38001,90427,4290,10886,22998,50287,27288,61173
351385,202310,487,1207,157,455,33,98,58,136,91,234
351390,202310,1914,4311,1156,3113,92,267,807,2035,899,2302
351400,202310,1604,3926,962,2486,235,537,382,958,617,1495
351410,202310,3592,8880,2164,5833,461,1276,832,1978,1293,3254
351420,202310,638,1447,330,853,66,155,168,407,234,562
351430,202310,1345,3080,819,2009,103,258,501,1093,604,1351
351440,202310,5036,11855,2769,6997,508,1328,1008,2105,1516,3433
351450,202310,2346,5540,1186,3167,232,729,406,846,638,1575
351460,202310,1419,3276,905,2293,180,451,506,1181,686,1632
351470,202310,1590,3678,953,2394,85,245,577,1298,662,1543
351480,202310,3175,8097,2114,6057,380,1131,951,2440,1331,3571
351490,202310,3072,7556,2087,5500,119,396,1472,3584,1591,3980
351492,202310,497,1157,327,780,20,61,242,525,262,586
351495,202310,295,731,163,440,20,43,89,214,109,257
351500,202310,62446,132262,40888,93837,6302,14957,24931,52438,31233,67395
351510,202310,19024,40891,12095,28099,1453,3739,7543,16238,8996,19977
351512,202310,601,1494,327,880,57,147,101,226,158,373
351515,202310,4211,9416,2095,5294,426,1168,508,1192,934,2360
351518,202310,2561,6308,1466,4087,265,788,544,1248,809,2036
351519,202310,834,2143,346,1047,65,193,72,179,137,372
351520,202310,1331,3076,559,1545,71,210,279,682,350,892
351530,202310,448,1062,215,546,35,96,92,180,127,276
351535,202310,2102,4885,1260,3292,222,632,552,1320,774,1952
351540,202310,3577,7910,2085,5151,257,752,1068,2236,1325,2988
351550,202310,10087,22820,5669,14141,940,2454,2736,6002,3676,8456
351560,202310,726,1895,422,1205,78,230,175,441,253,671
351565,202310,374,882,234,609,25,75,129,290,154,365
351570,202310,33193,76531,22234,54263,1997,5547,14410,32179,16407,37726
351580,202310,294,725,137,396,27,85,58,171,85,256
351590,202310,513,1126,222,585,26,87,102,224,128,311
351600,202310,1704,4180,1016,2658,185,488,425,962,610,1450
351610,202310,858,1864,421,1021,61,116,233,529,294,645
351620,202310,34492,82929,21337,57538,3242,9645,9605,22482,12847,32127
351630,202310,40590,91926,26885,65829,2527,6950,17581,38975,20108,45925
351640,202310,28653,63851,19217,45921,1565,4325,12897,27885,14462,32210
351650,202310,496,1303,184,584,30,100,43,128,73,228
351660,202310,781,2051,466,1339,73,226,129,309,202,535
351670,202310,8238,20466,4194,11108,884,2326,1783,4035,2667,6361
351680,202310,542,1393,310,908,56,159,111,285,167,444
351685,202310,690,1713,387,1048,78,206,143,325,221,531
351690,202310,1536,3635,754,2066,126,395,262,593,388,988
351700,202310,1840,4021,1098,2621,169,440,629,1308,798,1748
351710,202310,1045,2469,583,1516,52,164,325,732,377,896
351720,202310,1999,4801,1134,3040,192,507,514,1242,706,1749
351730,202310,1362,3049,849,2112,77,202,528,1171,605,1373
351740,202310,4329,9908,3007,7321,401,1062,1712,3728,2113,4790
351750,202310,2624,6372,1326,3620,199,579,634,1530,833,2109
351760,202310,4338,10682,2831,7575,611,1793,1148,2671,1759,4464
351770,202310,2795,6630,2010,5027,509,1269,992,2252,1501,3521
351780,202310,1381,3191,658,1702,82,227,311,726,393,953
351790,202310,2052,4422,1328,3185,249,587,682,1547,931,2134
351800,202310,533,1173,229,592,31,90,82,158,113,248
351810,202310,1502,3540,953,2461,240,677,416,930,656,1607
351820,202310,4267,10176,2591,6601,607,1606,1001,2219,1608,3825
351830,202310,7010,15557,4400,10641,373,1072,2798,5973,3171,7045
351840,202310,13376,32453,9136,24006,850,2531,5700,13535,6550,16066
351850,202310,1856,4905,978,2936,198,662,276,618,474,1280
351860,202310,3763,9555,2453,6775,880,2409,756,1835,1636,4244
351870,202310,42306,95725,29592,72395,5576,13868,15274,35410,20850,49278
351880,202310,242650,527213,160547,375687,22926,62322,97095,202024,120021,264346
351885,202310,1399,3092,961,2323,51,131,708,1616,759,1747
351890,202310,1023,2480,500,1448,101,318,133,324,234,642
351900,202310,1699,4100,1098,2992,127,332,654,1718,781,2050
351905,202310,823,2158,486,1352,63,182,201,471,264,653
351907,202310,32430,76320,20503,52206,2663,7560,11516,26138,14179,33698
351910,202310,2372,5398,1368,3295,152,443,845,1754,997,2197
351920,202310,1186,2817,766,1960,155,356,274,627,429,983
351925,202310,1346,3199,861,2177,107,329,476,1034,583,1363
351930,202310,6227,13585,4694,10708,674,1495,2982,6266,3656,7761
351940,202310,1452,3409,888,2312,178,476,349,865,527,1341
351950,202310,2122,4086,1348,2864,73,196,998,1959,1071,2155
351960,202310,7636,17340,4696,11664,1166,2978,1775,3886,2941,6864
351970,202310,15426,35518,11323,28226,1582,4439,7109,16014,8691,20453
351980,202310,1432,3165,717,1827,142,396,296,644,438,1040
351990,202310,1848,4042,1013,2461,50,148,614,1272,664,1420
352000,202310,3772,9050,2618,6531,262,754,1704,3799,1966,4553
352010,202310,3213,7592,2106,5513,590,1565,549,1348,1139,2913
352020,202310,2311,5368,1541,3902,273,732,775,1762,1048,2494
352030,202310,8492,18777,5928,14125,769,2107,3820,8193,4589,10300
352040,202310,6381,14609,3934,9748,782,2072,1630,3538,2412,5610
352042,202310,5334,11229,3089,7420,366,920,1855,4156,2221,5076
352044,202310,2757,6766,1353,3810,222,694,316,666,538,1360
352050,202310,19056,46467,10198,27455,2854,8108,2198,4455,5052,12563
352060,202310,1036,2440,654,1682,126,370,313,712,439,1082
352070,202310,1221,2419,644,1478,101,233,332,685,433,918
352080,202310,582,1397,251,662,35,94,101,224,136,318
352090,202310,2106,5410,1379,3770,182,537,694,1598,876,2135
352100,202310,5321,13522,3361,9396,736,2120,1342,3390,2078,5510
352110,202310,1017,2542,593,1587,112,307,258,596,370,903
352115,202310,622,1595,456,1316,137,432,171,405,308,837
352120,202310,1092,2812,760,2093,65,171,463,1154,528,1325
352130,202310,2488,6519,1307,3549,215,607,568,1329,783,1936
352140,202310,1911,4628,1112,2896,215,569,429,1003,644,1572
352150,202310,1130,2762,724,1966,126,355,403,1044,529,1399
352160,202310,1245,2850,698,1789,70,190,347,819,417,1009
352170,202310,3840,9567,2457,6568,506,1461,987,2221,1493,3682
352180,202310,3749,9360,2468,6768,505,1506,994,2374,1499,3880
352190,202310,2260,5136,1567,3905,245,651,834,1933,1079,2584
352200,202310,440,1293,250,814,41,132,82,225,123,357
352210,202310,32967,65405,23604,51380,1503,3782,17938,36451,19441,40233
352215,202310,814,2015,570,1556,133,355,262,670,395,1025
352220,202310,40783,85441,26645,59652,3646,9151,16546,32878,20192,42029
352230,202310,21276,54377,13783,38351,3742,10625,4480,10519,8222,21144
352240,202310,14439,34117,9929,25909,2286,6223,4677,10743,6963,16966
352250,202310,35924,90385,25632,70627,3778,11210,14435,36585,18213,47795
352260,202310,6763,15568,3913,9606,727,1948,1730,3458,2457,5406
352265,202310,1133,3033,919,2646,251,774,393,1056,644,1830
352270,202310,2952,7462,2047,5488,433,1188,848,2069,1281,3257
352280,202310,3228,7026,2243,5375,508,1278,1086,2320,1594,3598
352290,202310,2068,5156,1208,3233,206,566,523,1182,729,1748
352300,202310,1233,2870,588,1497,72,198,285,616,357,814
352310,202310,66655,155238,45702,116382,7969,20012,27041,65214,35010,85226
352320,202310,9290,20914,6427,15414,947,2415,3720,7793,4667,10208
352330,202310,3559,7771,2507,6088,241,759,1649,3533,1890,4292
352340,202310,11400,26999,6961,17698,1070,3027,3551,7789,4621,10816
352350,202310,3409,8257,2178,5602,172,529,1313,2998,1485,3527
352360,202310,2100,4838,1400,3456,194,526,795,1716,989,2242
352370,202310,1367,3390,979,2640,93,292,648,1595,741,1887
352380,202310,1287,2973,754,1921,145,382,251,562,396,944
352390,202310,20577,46876,12354,30882,1828,5081,6721,14784,8549,19865
352400,202310,5416,13936,3319,9309,781,2253,997,2377,1778,4630
352410,202310,5205,11544,3375,8117,568,1379,1679,3710,2247,5089
352420,202310,1090,2578,601,1582,95,242,273,621,368,863
352430,202310,12134,25595,7593,17187,984,2480,4336,8894,5320,11374
352440,202310,27019,65851,16846,44543,3994,10441,5506,13428,9500,23869
352450,202310,1042,2454,477,1351,76,231,197,480,273,711
352460,202310,3229,8059,2227,6143,425,1268,986,2416,1411,3684
352470,202310,3849,9472,2461,6656,290,910,1307,3129,1597,4039
352480,202310,6145,13303,3328,8002,526,1346,1533,3197,2059,4543
352490,202310,1131,2805,677,1817,130,344,266,651,396,995
352500,202310,16040,37819,8484,22510,2767,7697,1351,2324,4118,10021
352510,202310,6404,15058,4304,10942,523,1378,2674,6318,3197,7696
352520,202310,3832,9477,2404,6611,450,1293,1107,2619,1557,3912
352530,202310,16211,37374,9263,23311,2209,5968,3011,6118,5220,12086
352540,202310,743,1875,475,1287,62,174,230,548,292,722
352550,202310,1475,3594,901,2541,185,595,302,678,487,1273
352560,202310,900,2124,563,1381,30,92,377,813,407,905
352570,202310,2878,7333,1703,4976,475,1469,232,452,707,1921
352580,202310,1025,2310,714,1709,102,278,427,917,529,1195
352585,202310,508,1276,255,715,39,115,89,183,128,298
352590,202310,17297,42464,10351,28173,1927,5800,4709,10827,6636,16627
352600,202310,2604,6300,1754,4542,329,927,909,2021,1238,2948
352610,202310,3960,9334,2683,7038,445,1248,1310,3111,1755,4359
352620,202310,8148,17841,5305,13048,1467,3457,2255,5381,3722,8838
352630,202310,1086,2407,696,1760,110,319,322,722,432,1041
352640,202310,4553,10504,2779,6865,300,803,1518,3261,1818,4064
352650,202310,717,1875,394,1148,66,211,153,377,219,588
352660,202310,1487,3816,1023,2781,81,272,676,1646,757,1918
352670,202310,14371,34001,8802,22217,1669,4413,4038,8875,5707,13288
352680,202310,4471,11789,2823,7900,541,1726,1226,2661,1767,4387
352690,202310,36252,83005,23384,57781,1469,4383,16103,36167,17572,40550
352700,202310,1102,2550,676,1739,93,270,342,780,435,1050
352710,202310,7465,17480,4561,11792,1441,3776,1428,3104,2869,6880
352720,202310,14096,31420,9715,22888,1298,3309,5858,12580,7156,15889
352725,202310,671,1448,299,783,22,74,157,337,179,411
352730,202310,4496,12133,3196,8916,519,1545,1386,3089,1905,4634
352740,202310,3061,6912,1770,4442,275,762,812,1718,1087,2480
352750,202310,549,1259,244,654,33,97,101,213,134,310
352760,202310,1831,4562,1256,3362,203,573,637,1533,840,2106
352770,202310,1220,2883,741,1894,93,238,410,965,503,1203
352780,202310,843,2223,416,1224,103,250,114,313,217,563
352790,202310,527,1273,304,777,52,133,129,277,181,410
352800,202310,1795,4856,926,2758,153,443,225,499,378,942
352810,202310,2149,4664,1428,3260,162,390,935,2014,1097,2404
352820,202310,551,1453,318,953,58,175,75,189,133,364
352830,202310,681,1618,255,687,39,107,78,176,117,283
352840,202310,5207,13370,3473,9694,793,2288,1313,3312,2106,5600
352850,202310,18235,38654,11415,26855,1854,4695,6283,13163,8137,17858
352860,202310,1551,3884,885,2434,171,455,307,766,478,1221
352870,202310,1053,2543,584,1506,78,199,311,728,389,927
352880,202310,2264,5007,1208,2859,208,519,500,1006,708,1525
352885,202310,459,1148,289,790,32,92,159,385,191,477
352890,202310,898,1903,480,1048,53,125,332,648,385,773
352900,202310,26493,62322,15181,39143,2635,6998,5935,13781,8570,20779
352910,202310,464,1141,211,613,13,39,88,217,101,256
352920,202310,3688,8545,2393,6000,159,484,1672,3814,1831,4298
352930,202310,7878,18517,5306,13084,921,2565,2594,5427,3515,7992
352940,202310,39711,94584,27910,69544,4351,11494,15792,35763,20143,47257
352950,202310,705,1800,364,1095,75,230,113,280,188,510
352960,202310,928,2259,435,1171,66,178,135,293,201,471
352965,202310,313,795,156,466,38,113,39,106,77,219
352970,202310,5247,9694,3785,7454,126,320,3086,5687,3212,6007
352980,202310,2057,4490,1372,3373,370,975,625,1363,995,2338
352990,202310,5923,13576,3918,9920,721,1879,2051,4858,2772,6737
353000,202310,554,1366,266,740,34,97,93,224,127,321
353010,202310,3640,8134,2014,4927,347,913,948,2010,1295,2923
353020,202310,3765,8942,2040,5398,369,1083,849,1988,1218,3071
353030,202310,6394,15001,3579,9650,884,2484,928,2209,1812,4693
353040,202310,973,2130,605,1477,53,132,402,899,455,1031
353050,202310,6917,17667,4262,11929,747,2277,2013,4933,2760,7210
353060,202310,70106,156860,50199,120764,3975,11215,35022,76757,38997,87972
353070,202310,15711,39068,9436,24747,1666,4678,4298,9646,5964,14324
353080,202310,7064,16814,4310,11118,840,2369,1763,3732,2603,6101
353090,202310,755,2058,459,1381,55,178,231,602,286,780
353100,202310,405,979,149,435,30,87,51,119,81,206
353110,202310,11495,25993,8264,20828,1855,4648,3963,9866,5818,14514
353120,202310,683,1595,439,1115,78,230,208,427,286,657
353130,202310,4181,9140,2285,5443,506,1282,947,1823,1453,3105
353140,202310,4242,9214,2648,6290,468,1260,1421,2978,1889,4238
353150,202310,2296,5259,1394,3529,275,710,640,1435,915,2145
353160,202310,806,1934,424,1139,49,143,183,404,232,547
353170,202310,930,2108,611,1576,57,181,368,829,425,1010
353180,202310,13234,30596,8168,20650,1896,5039,3341,7472,5237,12511
353190,202310,4771,11317,2903,7265,390,1027,1639,3711,2029,4738
353200,202310,2330,5748,1216,3347,167,526,497,1187,664,1713
353205,202310,631,1628,388,1024,45,130,219,490,264,620
353210,202310,1162,2283,617,1375,22,60,464,953,486,1013
353215,202310,503,1228,306,791,48,139,127,274,175,413
353220,202310,992,2502,489,1351,104,288,171,409,275,697
353230,202310,1104,2800,767,2194,201,643,169,426,370,1069
353240,202310,3449,8049,2479,6297,367,1069,1425,3261,1792,4330
353250,202310,1791,3590,1025,2285,120,287,631,1266,751,1553
353260,202310,1539,3315,757,1967,171,493,301,680,472,1173
353270,202310,1129,2566,749,1785,105,291,421,869,526,1160
353280,202310,982,2377,592,1616,126,345,195,480,321,825
353282,202310,2072,5454,1451,4100,166,528,752,1857,918,2385
353284,202310,466,1056,208,544,16,53,87,187,103,240
353286,202310,205,514,93,281,23,58,14,40,37,98
353290,202310,1681,4084,707,1922,182,447,189,479,371,926
353300,202310,2946,7185,1686,4417,347,981,732,1616,1079,2597
353310,202310,505,1111,308,703,24,64,214,445,238,509
353320,202310,848,2105,489,1328,73,224,238,554,311,778
353325,202310,1046,2661,529,1447,85,253,234,554,319,807
353330,202310,834,1890,395,1003,50,115,189,408,239,523
353340,202310,4349,10699,2947,7721,537,1541,1401,3099,1938,4640
353350,202310,6055,13437,3545,8552,1010,2553,931,1908,1941,4461
353360,202310,913,2312,591,1586,48,133,347,835,395,968
353370,202310,806,2093,544,1608,74,216,289,786,363,1002
353380,202310,394,992,259,708,33,104,144,328,177,432
353390,202310,8520,19570,4901,12498,509,1491,2756,6176,3265,7667
353400,202310,766,1859,467,1219,77,207,197,401,274,608
353410,202310,688,1638,415,1071,139,368,146,301,285,669
353420,202310,665,1549,386,985,87,254,117,247,204,501
353430,202310,3024,7647,1939,5364,468,1309,736,1850,1204,3159
353440,202310,111650,263672,71222,180039,10265,27720,39844,89411,50109,117131
353450,202310,478,1159,262,748,51,136,86,221,137,357
353460,202310,4308,10689,2247,6192,469,1426,566,1209,1035,2635
353470,202310,12776,29932,7763,19893,1444,3910,3391,7473,4835,11383
353475,202310,2057,4749,1028,2634,163,467,393,841,556,1308
353480,202310,2098,4764,1421,3488,95,243,942,2140,1037,2383
353490,202310,1423,3311,871,2196,116,331,492,1085,608,1416
353500,202310,1659,3698,1064,2582,224,553,486,1076,710,1629
353510,202310,1365,3458,732,1912,141,394,297,630,438,1024
353520,202310,1362,3266,732,2022,146,390,254,578,400,968
353530,202310,3330,7658,2265,5474,255,689,1431,3079,1686,3768
353540,202310,2981,6992,2013,5176,314,856,1192,2800,1506,3656
353550,202310,8341,18500,5340,12663,782,1987,3155,6665,3937,8652
353560,202310,3143,7575,2079,5642,590,1741,619,1297,1209,3038
353570,202310,825,2066,391,1118,66,202,132,289,198,491
353580,202310,3280,7834,2138,5485,417,1037,1079,2586,1496,3623
353590,202310,947,2215,580,1503,87,219,305,747,392,966
353600,202310,2005,4768,1144,3038,194,531,496,1192,690,1723
353610,202310,1124,2974,655,1942,95,297,277,717,372,1014
353620,202310,3912,9110,2336,6171,562,1525,688,1527,1250,3052
353625,202310,829,1863,391,1020,44,139,208,465,252,604
353630,202310,2147,5580,1509,4147,220,642,778,1853,998,2495
353640,202310,1840,4344,1163,2983,161,397,686,1662,847,2059
353650,202310,9339,23272,5812,15718,921,2701,2953,7019,3874,9720
353657,202310,471,1158,246,674,26,79,106,248,132,327
353660,202310,1760,3406,1099,2419,150,363,719,1467,869,1830
353670,202310,5961,14635,3542,9305,705,2049,1411,3102,2116,5151
353680,202310,954,2204,601,1609,111,324,290,693,401,1017
353690,202310,531,1363,188,563,31,94,44,105,75,199
353700,202310,3001,6768,1980,4925,208,537,1181,2693,1389,3230
353710,202310,5363,11573,3208,7412,581,1415,1691,3297,2272,4712
353715,202310,532,1329,247,690,25,67,117,283,142,350
353720,202310,2519,5983,1651,4360,389,1084,669,1611,1058,2695
353730,202310,7151,16468,4936,12217,736,2029,2832,6268,3568,8297
353740,202310,2953,6997,1890,4875,374,1058,874,1902,1248,2960
353750,202310,1193,3212,679,2094,168,511,99,269,267,780
353760,202310,20260,40007,13763,30349,2913,6603,7059,14639,9972,21242
353770,202310,828,2225,389,1235,70,236,39,99,109,335
353780,202310,9563,22262,6759,16602,1380,3677,3547,7823,4927,11500
353790,202310,3615,9775,2243,6622,568,1754,437,991,1005,2745
353800,202310,25813,60192,17685,44816,2554,6893,10421,24166,12975,31059
353810,202310,1702,4105,971,2482,197,491,381,915,578,1406
353820,202310,2541,6018,1421,3776,426,1126,370,856,796,1982
353830,202310,789,1819,459,1214,57,170,238,544,295,714
353850,202310,2121,5159,1393,3681,255,692,620,1464,875,2156
353860,202310,3763,8996,2593,6878,635,1906,1013,2167,1648,4073
353870,202310,40145,96816,24296,63664,4474,12105,9740,22442,14214,34547
353880,202310,3985,9691,2823,7341,228,682,1807,4282,2035,4964
353890,202310,4400,8285,2674,5574,223,576,1853,3408,2076,3984
353900,202310,980,2492,540,1485,88,274,200,465,288,739
353910,202310,4282,9904,3030,7569,261,727,1945,4396,2206,5123
353920,202310,2626,6523,1553,4263,447,1343,317,589,764,1932
353930,202310,7616,17919,4804,12296,906,2480,2054,4538,2960,7018
353940,202310,1799,4668,971,2758,205,580,315,750,520,1330
353950,202310,4677,11247,2993,7747,992,2567,722,1747,1714,4314
353960,202310,964,2341,520,1422,120,322,79,188,199,510
353970,202310,914,1892,584,1347,53,136,414,878,467,1014
353980,202310,24394,53214,16211,37988,891,2606,11917,25407,12808,28013
353990,202310,1306,2788,774,1815,114,305,465,977,579,1282
354000,202310,3389,7694,1474,3690,249,678,645,1376,894,2054
354010,202310,435,1040,267,723,49,142,152,381,201,523
354020,202310,5470,12766,3496,8498,851,2169,1360,2943,2211,5112
354025,202310,919,2367,486,1366,92,273,148,372,240,645
354030,202310,676,1425,273,671,45,121,135,299,180,420
354040,202310,976,2086,518,1285,65,179,295,646,360,825
354050,202310,1391,3568,839,2495,191,623,286,754,477,1377
354060,202310,5719,14056,3533,9115,564,1621,1790,3902,2354,5523
354070,202310,5513,12741,3218,8050,599,1514,1212,2600,1811,4114
354075,202310,3857,9502,2768,7408,616,1714,1404,3334,2020,5048
354080,202310,2057,5144,1239,3408,179,494,589,1406,768,1900
354085,202310,533,981,322,645,4,14,252,463,256,477
354090,202310,2286,5584,1677,4259,110,297,1182,2771,1292,3068
354100,202310,36204,88103,24474,66184,4740,13849,11695,28373,16435,42222
354105,202310,1465,3536,806,2207,131,373,370,888,501,1261
354110,202310,635,1571,359,1003,51,148,157,374,208,522
354120,202310,1888,4617,1028,2707,231,628,371,833,602,1461
354130,202310,8054,18952,4444,11427,1251,3298,1112,2376,2363,5674
354140,202310,25878,59640,15626,38872,2521,6612,7783,16880,10304,23492
354150,202310,3634,8038,2419,5872,646,1546,673,1606,1319,3152
354160,202310,3633,9384,2592,7112,648,1813,1064,2620,1712,4433
354165,202310,945,2403,628,1711,77,250,384,916,461,1166
354170,202310,2649,6589,1516,4066,309,932,663,1442,972,2374
354180,202310,593,1538,340,935,38,110,156,375,194,485
354190,202310,2008,5099,1168,3253,82,266,685,1684,767,1950
354200,202310,1198,2736,725,1821,109,302,389,847,498,1149
354210,202310,1471,3443,877,2163,100,265,543,1220,643,1485
354220,202310,4191,9993,2639,6802,590,1616,967,2158,1557,3774
354230,202310,1061,2393,766,1924,59,176,503,1147,562,1323
354240,202310,2426,6105,1360,3727,268,756,523,1207,791,1963
354250,202310,904,2106,480,1282,112,311,155,374,267,685
354260,202310,12258,27609,8073,19753,1418,3523,3662,8360,5080,11883
354270,202310,1285,3389,849,2378,129,358,394,940,523,1298
354280,202310,1032,2340,707,1729,62,171,468,1021,530,1192
354290,202310,1295,3573,877,2586,142,440,431,1131,573,1571
354300,202310,4298,11342,3238,9186,918,2651,1203,3060,2121,5711
354310,202310,1077,2698,734,1978,96,291,438,1046,534,1337
354320,202310,1197,2658,637,1613,126,328,288,623,414,951
354323,202310,562,1249,286,727,39,108,150,333,189,441
354325,202310,1670,4759,779,2447,171,570,110,250,281,820
354330,202310,13779,31001,8164,19429,1201,3085,4560,9722,5761,12807
354340,202310,59769,135427,37886,94848,6720,17348,18826,42856,25546,60204
354350,202310,1528,3438,1121,2696,164,444,660,1393,824,1837
354360,202310,845,1834,447,1122,115,288,156,343,271,631
354370,202310,1203,2976,831,2281,147,427,444,1118,591,1545
354380,202310,668,1688,420,1231,59,212,145,341,204,553
354390,202310,21318,46299,12337,29180,1859,4689,6507,13533,8366,18222
354400,202310,2134,6135,1310,4074,222,724,397,1098,619,1822
354410,202310,9736,21695,6235,14563,1086,2666,3378,7115,4464,9781
354420,202310,1837,4374,1090,2863,194,572,491,1138,685,1710
354425,202310,3837,8374,2317,5534,367,916,1298,2852,1665,3768
354430,202310,2335,5358,1490,3733,140,388,924,2087,1064,2475
354440,202310,742,1784,330,846,42,120,174,388,216,508
354450,202310,661,1631,304,860,37,110,119,276,156,386
354460,202310,959,2352,570,1602,165,514,132,277,297,791
354470,202310,494,1248,207,568,14,43,83,173,97,216
354480,202310,1817,3801,1008,2371,82,237,639,1334,721,1571
354490,202310,1069,2877,636,1844,141,387,262,694,403,1081
354500,202310,3205,7772,2158,5754,544,1550,726,1727,1270,3277
354510,202310,963,2457,558,1516,78,220,246,543,324,763
354515,202310,570,1526,304,902,53,164,84,196,137,360
354520,202310,11566,28000,6992,18043,1003,2855,3748,8339,4751,11194
354530,202310,7225,17402,4593,11790,1219,3122,1767,4078,2986,7200
354540,202310,1640,3954,982,2640,177,500,434,1038,611,1538
354550,202310,746,1871,451,1245,66,203,221,515,287,718
354560,202310,2828,6302,1267,3208,176,416,683,1602,859,2018
354570,202310,1099,2559,373,1056,59,168,55,142,114,310
354580,202310,11287,28081,6681,18358,1035,3063,3245,7923,4280,10986
354600,202310,2793,6781,1726,4574,320,832,844,2079,1164,2911
354610,202310,597,1489,259,734,28,83,112,283,140,366
354620,202310,639,1652,331,984,34,116,169,440,203,556
354625,202310,395,1040,176,534,19,66,57,126,76,192
354630,202310,3419,8550,2389,6325,824,2092,615,1500,1439,3592
354640,202310,5099,12646,3342,8946,489,1410,1668,3931,2157,5341
354650,202310,1116,2644,610,1519,179,404,270,652,449,1056
354660,202310,4513,9930,2105,5571,307,892,838,1903,1145,2795
354670,202310,1603,3982,1002,2697,211,607,341,758,552,1365
354680,202310,8881,19761,5999,14544,971,2482,3418,7559,4389,10041
354690,202310,691,1929,380,1157,63,195,146,372,209,567
354700,202310,1219,2863,711,1815,104,292,382,867,486,1159
354710,202310,607,1490,305,819,31,76,146,332,177,408
354720,202310,392,875,162,433,61,148,36,81,97,229
354730,202310,15782,40791,10260,28880,1588,4557,5145,12919,6733,17476
354740,202310,383,989,133,410,30,91,15,34,45,125
354750,202310,3176,7482,1762,4532,280,748,811,1789,1091,2537
354760,202310,3038,7144,1790,4673,338,911,710,1556,1048,2467
354765,202310,438,1095,151,451,12,45,44,101,56,146
354770,202310,3267,7405,2006,4864,423,1146,957,2011,1380,3157
354780,202310,89153,193989,58033,131844,4361,11805,40005,80785,44366,92590
354790,202310,1169,3009,849,2440,86,260,471,1263,557,1523
354800,202310,3628,8586,2118,5608,478,1288,685,1560,1163,2848
354805,202310,1851,3962,1087,2582,81,216,719,1515,800,1731
354810,202310,651,1845,363,1208,82,298,91,249,173,547
354820,202310,1239,3297,768,2303,160,490,212,512,372,1002
354830,202310,692,1531,313,790,62,172,120,241,182,413
354840,202310,1057,2558,498,1302,46,114,275,632,321,746
354850,202310,32806,72370,21209,50935,1916,5333,14161,30237,16077,35570
354860,202310,2135,5185,1206,3319,170,509,513,1227,683,1736
354870,202310,98457,217832,62001,145012,5711,15011,39274,81022,44985,96033
354880,202310,8630,19934,4030,10023,585,1589,1857,3651,2442,5240
354890,202310,26386,58200,17523,41410,2484,6283,9596,20343,12080,26626
354900,202310,493,1157,273,744,81,225,74,172,155,397
354910,202310,8405,20242,4356,12108,946,2793,1354,3162,2300,5955
354920,202310,597,1533,200,592,25,81,55,129,80,210
354925,202310,332,890,135,437,14,52,26,53,40,105
354930,202310,444,1016,208,507,21,54,122,269,143,323
354940,202310,3861,10087,2501,6967,703,2026,984,2328,1687,4354
354950,202310,2038,4536,1317,3215,67,206,918,2039,985,2245
354960,202310,1069,2589,668,1861,77,254,319,767,396,1021
354970,202310,5976,14415,3972,10661,309,961,2480,6003,2789,6964
354980,202310,49913,108463,30436,72541,4066,10914,18017,37778,22083,48692
354990,202310,111198,245154,67827,162507,5336,15205,43858,92886,49194,108091
354995,202310,4632,8619,3128,6406,182,427,2448,4669,2630,5096
355000,202310,1980,4543,1237,3235,232,669,530,1203,762,1872
355010,202310,5517,13436,2928,7815,886,2272,801,1906,1687,4178
355020,202310,3964,10684,2880,8581,765,2446,857,2128,1622,4574
355030,202310,1873239,4181103,1134850,2692683,178421,451823,600866,1278100,779287,1729923
355040,202310,4940,10503,3326,7967,498,1270,2072,4541,2570,5811
355050,202310,1510,3262,909,2223,211,525,329,725,540,1250
355060,202310,9534,23149,6023,15975,1019,2870,2932,6816,3951,9686
355070,202310,15672,34927,10844,25845,1347,3506,6657,14192,8004,17698
355080,202310,1288,3371,634,1968,170,521,97,263,267,784
355090,202310,1831,4419,1190,3121,203,541,604,1388,807,1929
355100,202310,47061,104755,35269,83835,3334,8902,24853,54382,28187,63284
355110,202310,1348,3358,774,2259,147,437,51,132,198,569
355120,202310,926,2208,520,1462,81,234,242,584,323,818
355130,202310,1135,2258,510,1090,24,59,377,750,401,809
355140,202310,3051,5599,2265,4439,114,268,1824,3331,1938,3599
355150,202310,6958,15878,4768,11647,652,1664,2845,6415,3497,8079
355160,202310,3303,8053,1883,5212,413,1179,534,1249,947,2428
355170,202310,17274,38752,11258,27284,1885,4893,6234,13662,8119,18555
355180,202310,3801,8637,2509,6451,660,1765,1064,2498,1724,4263
355190,202310,2463,6038,1443,3933,546,1444,279,786,825,2230
355200,202310,1205,3230,871,2593,235,761,294,755,529,1516
355210,202310,4357,10606,2680,7031,790,2013,878,2088,1668,4101
355220,202310,76819,177345,52025,126185,6591,18228,30591,65393,37182,83621
355230,202310,1529,3687,618,1665,143,412,245,547,388,959
355240,202310,34812,82930,21174,54348,2626,7338,12543,28994,15169,36332
355250,202310,57562,136332,37330,94191,9681,23810,16584,39046,26265,62856
355255,202310,854,1955,360,948,46,137,160,346,206,483
355260,202310,2042,4342,1205,2819,123,353,792,1667,915,2020
355270,202310,1682,4392,1093,3077,260,690,397,1026,657,1716
355280,202310,46188,103806,27920,67743,3698,9699,15451,33724,19149,43423
355290,202310,1280,3071,782,2062,159,400,362,869,521,1269
355300,202310,1923,4955,1350,3730,240,697,563,1316,803,2013
355310,202310,1169,2916,709,1972,93,288,358,899,451,1187
355320,202310,729,1803,408,1097,87,260,148,320,235,580
355330,202310,4176,9409,2662,6457,147,448,1918,4209,2065,4657
355340,202310,5340,11257,3162,7504,670,1591,1254,3006,1924,4597
355350,202310,1855,4715,1211,3373,244,764,555,1351,799,2115
355360,202310,1647,3807,1036,2695,167,468,503,1089,670,1557
355365,202310,434,986,169,469,39,91,51,132,90,223
355370,202310,7724,17536,4993,12521,1072,2362,2355,5836,3427,8198
355380,202310,3914,9493,2477,6555,452,1296,870,1880,1322,3176
355385,202310,1802,4259,1151,2936,119,343,643,1410,762,1753
355390,202310,930,2325,591,1594,106,303,268,575,374,878
355395,202310,2265,6080,1158,3439,193,633,453,1120,646,1753
355400,202310,13378,33680,9225,24655,1785,5281,4170,9345,5955,14626
355410,202310,33588,83709,20339,55429,3952,11296,8527,20602,12479,31898
355420,202310,759,2188,516,1625,124,415,140,385,264,800
355430,202310,4760,11068,2944,7331,560,1480,1534,3580,2094,5060
355440,202310,889,2191,422,1154,90,264,136,308,226,572
355450,202310,5010,11625,2690,6744,368,1015,1295,2654,1663,3669
355460,202310,607,1390,342,887,46,135,152,340,198,475
355465,202310,577,1342,385,1002,68,186,202,479,270,665
355470,202310,1546,3615,714,1924,200,580,243,588,443,1168
355475,202310,454,987,274,662,23,58,175,384,198,442
355480,202310,5606,14183,3874,10943,627,1895,2100,5449,2727,7344
355490,202310,1142,2889,510,1512,70,227,210,549,280,776
355495,202310,1315,3125,772,2127,103,335,358,792,461,1127
355500,202310,9511,21895,5082,12822,665,1884,2369,5104,3034,6988
355510,202310,1865,4269,1021,2617,178,482,466,1005,644,1487
355520,202310,391,883,172,496,23,59,27,75,50,134
355530,202310,374,806,148,376,9,25,89,195,98,220
355535,202310,712,1762,460,1245,103,329,192,394,295,723
355540,202310,18676,40213,13762,32185,1469,3728,9347,20274,10816,24002
355550,202310,825,2200,563,1637,76,245,281,700,357,945
355560,202310,1366,3326,652,1873,182,560,23,69,205,629
355570,202310,392,943,172,478,37,88,66,167,103,255
355580,202310,1534,3508,687,1837,127,340,119,281,246,621
355590,202310,201,499,131,364,15,42,69,161,84,203
355600,202310,1727,4090,959,2585,131,384,279,631,410,1015
355610,202310,2693,6126,1455,3705,314,808,615,1374,929,2182
355620,202310,7221,17107,4494,11352,615,1765,2511,5482,3126,7247
355630,202310,3487,8478,2100,5540,271,770,1228,2921,1499,3691
355635,202310,1395,3589,777,2208,107,322,313,769,420,1091
355640,202310,4596,11680,2637,7608,769,2231,441,1271,1210,3502
355645,202310,4733,12159,2790,8066,401,1248,1295,3314,1696,4562
355650,202310,11379,26932,7262,18413,1281,3349,3426,7729,4707,11078
355660,202310,1670,4277,753,2328,165,482,126,322,291,804
355670,202310,6403,15248,3617,9028,488,1394,1832,3832,2320,5226
355680,202310,3198,8349,1188,3562,312,997,121,326,433,1323
355690,202310,922,2520,516,1601,186,559,17,40,203,599
355695,202310,327,831,155,453,22,61,34,71,56,132
355700,202310,12519,30711,8818,22492,1091,3157,5055,11386,6146,14543
355710,202310,13596,29897,7681,17972,1242,3165,3833,7625,5075,10790
355715,202310,620,1566,277,777,68,185,82,182,150,367
355720,202310,1946,4768,1273,3415,245,665,618,1470,863,2135
355730,202310,1444,3507,907,2400,89,268,531,1265,620,1533
410010,202310,1511,3930,922,2589,209,582,217,535,426,1117
410020,202310,1475,3777,900,2506,273,746,231,567,504,1313
410030,202310,2246,5421,1557,4120,261,741,804,2024,1065,2765
410040,202310,20076,49936,11888,32925,2524,7224,3519,8701,6043,15925
410045,202310,872,2180,523,1423,126,350,139,319,265,669
410050,202310,2672,6588,1513,4233,255,793,420,989,675,1782
410060,202310,2612,6710,1739,4917,423,1298,563,1384,986,2682
410070,202310,2471,5816,1266,3363,215,567,458,1051,673,1618
410080,202310,1758,4316,1043,2876,281,810,261,621,542,1431
410090,202310,1441,3139,943,2223,262,613,288,737,550,1350
410100,202310,2640,6897,1237,3557,211,671,82,216,293,887
410105,202310,745,1685,367,941,56,132,167,365,223,497
410110,202310,4084,9007,2473,5936,380,959,1402,3012,1782,3971
410115,202310,671,1627,382,1031,51,153,132,265,183,418
410120,202310,4337,9894,3282,7992,772,1587,1756,4223,2528,5810
410130,202310,1711,4038,1281,3145,217,596,741,1666,958,2262
410140,202310,22900,51664,11914,30386,2510,6642,3902,8686,6412,15328
410150,202310,20119,44930,8796,22237,1490,4120,3136,6581,4626,10701
410160,202310,3814,9900,2464,6936,577,1785,850,2111,1427,3896
410165,202310,775,1943,527,1384,94,276,246,568,340,844
410170,202310,3759,8986,1623,4223,329,884,399,895,728,1779
410180,202310,23443,58925,14007,37746,2596,7389,6092,14202,8688,21591
410185,202310,589,1567,351,1013,60,186,132,320,192,506
410190,202310,2775,6529,1496,3912,325,827,269,622,594,1449
410200,202310,7342,15644,3153,7994,762,2029,555,1106,1317,3135
410210,202310,3910,9295,1983,5482,343,1034,616,1379,959,2413
410220,202310,808,1941,361,914,86,217,113,243,199,460
410230,202310,2697,6515,1518,3953,246,677,659,1443,905,2120
410240,202310,6365,15768,3340,9287,741,2435,602,1391,1343,3826
410250,202310,2633,6010,1611,4084,225,598,723,1671,948,2269
410260,202310,2596,5874,1367,3525,297,788,614,1391,911,2179
410270,202310,634,1540,319,863,50,152,150,326,200,478
410275,202310,743,1916,387,1125,90,295,142,348,232,643
410280,202310,2917,7144,1533,4219,227,679,653,1521,880,2200
410290,202310,4130,10508,2373,6760,987,2704,448,1251,1435,3955
410300,202310,866,1989,553,1388,70,213,272,573,342,786
410302,202310,414,983,216,609,36,106,87,221,123,327
410304,202310,1880,4095,1341,3132,182,438,699,1574,881,2012
410305,202310,2199,4863,1284,3327,178,505,752,1760,930,2265
410310,202310,4166,9467,2769,6763,218,676,1852,4059,2070,4735
410315,202310,877,1906,493,1233,138,349,147,326,285,675
410320,202310,1114,2993,522,1548,70,227,93,236,163,463
410322,202310,766,1971,278,818,38,103,77,166,115,269
410330,202310,1757,4109,939,2453,183,482,273,619,456,1101
410335,202310,1049,2624,588,1609,130,369,164,374,294,743
410337,202310,1006,2366,501,1289,80,214,170,372,250,586
410340,202310,592,1513,298,763,27,82,151,299,178,381
410345,202310,3625,8832,1682,4455,423,1093,587,1394,1010,2487
410347,202310,983,2357,534,1421,108,282,112,286,220,568
410350,202310,2055,4669,1147,2987,127,369,609,1352,736,1721
410360,202310,4893,11778,2728,7312,549,1528,731,1752,1280,3280
410370,202310,18726,46415,9217,23649,1320,3764,3967,8285,5287,12049
410380,202310,2231,5129,1125,2895,182,516,339,756,521,1272
410390,202310,3618,7941,2030,5062,432,1224,806,1647,1238,2871
410395,202310,1113,2947,727,2135,155,447,241,703,396,1150
410400,202310,10577,23809,6394,15480,680,1882,3903,8342,4583,10224
410405,202310,1160,2508,649,1655,79,249,323,726,402,975
410410,202310,2041,4814,1450,3695,136,378,918,2201,1054,2579
410420,202310,16796,40590,10018,26096,1787,4944,4402,9819,6189,14763
410425,202310,5016,12523,2872,7912,537,1549,966,2310,1503,3859
410430,202310,17350,39704,9277,23414,1529,4168,3688,8125,5217,12293
410440,202310,3097,7839,2288,6148,439,1144,1140,2844,1579,3988
410442,202310,3252,8685,2021,5828,518,1517,388,958,906,2475
410445,202310,2841,7430,1578,4802,383,1267,161,484,544,1751
410450,202310,2075,4747,1146,3055,218,601,298,667,516,1268
410460,202310,3371,7465,1899,4610,320,827,924,1964,1244,2791
410465,202310,3787,9974,2089,6035,556,1590,449,1062,1005,2652
410470,202310,3119,7885,1858,5424,685,2270,113,300,798,2570
410480,202310,54279,121267,24151,63996,3952,11170,7629,17079,11581,28249
410490,202310,15346,38076,8990,23907,1609,4599,4282,9925,5891,14524
410500,202310,2297,5552,1132,3144,222,589,182,393,404,982
410510,202310,2256,5180,1198,3055,291,696,372,922,663,1618
410520,202310,3917,10778,3077,8978,965,2940,1110,3027,2075,5967
410530,202310,1848,4358,605,1631,74,213,165,354,239,567
410540,202310,3610,8743,2005,5358,398,1140,867,2016,1265,3156
410550,202310,9753,24320,5193,13965,901,2587,1602,3431,2503,6018
410560,202310,1874,4544,1019,2698,198,590,250,509,448,1099
410570,202310,3494,8528,1944,5509,686,2195,176,419,862,2614
410580,202310,38047,89413,23542,60845,4102,11118,10543,24312,14645,35430
410590,202310,2112,5441,1162,3212,190,551,323,702,513,1253
410600,202310,2317,5489,1552,3999,363,901,626,1482,989,2383
410610,202310,879,2079,515,1340,50,142,262,604,312,746
410620,202310,3811,9241,2324,6020,569,1528,747,1770,1316,3298
410630,202310,2938,7129,1537,4187,316,952,235,451,551,1403
410640,202310,5842,12871,3334,8154,840,2156,632,1456,1472,3612
410645,202310,1800,4065,1224,3134,124,359,800,1935,924,2294
410650,202310,3409,8414,1754,4815,420,1139,613,1481,1033,2620
410655,202310,1084,2474,532,1359,139,345,169,385,308,730
410657,202310,743,1873,385,1046,62,191,187,415,249,606
410660,202310,4772,10961,2261,5664,369,984,834,1793,1203,2777
410670,202310,1208,2859,539,1427,87,254,187,419,274,673
410680,202310,3052,8392,1887,5598,571,1682,509,1454,1080,3136
410685,202310,655,1572,395,1070,104,301,140,324,244,625
410690,202310,189502,427073,104768,256987,17897,47296,43265,89468,61162,136764
410700,202310,3086,7291,1986,5128,499,1322,683,1556,1182,2878
410710,202310,1132,2676,556,1497,151,437,204,458,355,895
410712,202310,1084,2757,535,1513,94,267,224,586,318,853
410715,202310,1091,2879,556,1650,76,250,226,601,302,851
410720,202310,5032,11568,3117,7791,521,1579,1127,2495,1648,4074
410725,202310,1468,3372,691,1840,161,444,168,383,329,827
410730,202310,1141,2692,587,1556,106,333,117,252,223,585
410740,202310,1058,2750,562,1653,50,169,298,816,348,985
410750,202310,2491,5602,1508,3656,248,642,644,1413,892,2055
410752,202310,486,1130,193,538,78,197,23,61,101,258
410753,202310,433,1168,210,646,35,106,61,164,96,270
410754,202310,1488,3293,987,2437,94,258,676,1595,770,1853
410755,202310,670,1627,385,1034,54,167,172,390,226,557
410760,202310,4451,10875,2601,7195,804,2612,552,1260,1356,3872
410765,202310,25420,62017,15827,41659,3252,9244,5446,11960,8698,21204
410770,202310,1237,2808,673,1753,75,175,308,730,383,905
410773,202310,1666,3974,1142,2960,286,747,523,1194,809,1941
410775,202310,2108,4228,1526,3229,53,145,1181,2288,1234,2433
410780,202310,730,1725,394,1033,59,155,140,328,199,483
410785,202310,1053,2341,624,1598,109,330,317,733,426,1063
410790,202310,1520,4086,948,2761,200,637,218,529,418,1166
410800,202310,4358,8573,2431,5126,100,266,1754,3383,1854,3649
410810,202310,572,1436,328,916,39,100,149,377,188,477
410820,202310,1268,3284,520,1454,113,327,118,270,231,597
410830,202310,61224,132154,36182,86065,5944,15384,18114,38154,24058,53538
410832,202310,1379,3361,844,2239,94,286,451,1013,545,1299
410840,202310,11724,27621,5211,14104,1439,3823,899,1961,2338,5784
410845,202310,1534,3229,1008,2340,107,316,666,1403,773,1719
410850,202310,2663,6839,1886,5198,415,1201,820,2111,1235,3312
410855,202310,887,2093,474,1267,78,233,205,452,283,685
410860,202310,6281,13347,4100,9308,204,584,2865,5789,3069,6373
410865,202310,1792,4565,1295,3595,262,735,609,1717,871,2452
410870,202310,1472,3693,939,2646,137,428,478,1213,615,1641
410880,202310,6097,14870,3262,9252,544,1630,496,1460,1040,3090
410890,202310,1491,3719,950,2539,196,497,436,1058,632,1555
410895,202310,1238,3560,898,2772,257,870,256,687,513,1557
410900,202310,1094,2748,576,1661,115,374,109,242,224,616
410910,202310,548,1199,253,604,18,53,148,315,166,368
410920,202310,1181,2553,621,1479,52,140,402,870,454,1010
410930,202310,2250,5330,1209,3365,268,818,181,396,449,1214
410940,202310,33231,81394,19620,53607,4184,12453,7768,18650,11952,31103
410950,202310,2503,6191,2006,5278,209,478,1435,3622,1644,4100
410960,202310,11476,25314,7114,17740,2236,5854,2199,4831,4435,10685
410965,202310,1380,3335,640,1787,124,337,233,573,357,910
410970,202310,5502,13701,3034,8341,805,2590,570,1154,1375,3744
410975,202310,1879,4208,1000,2556,223,565,345,797,568,1362
410980,202310,9916,22519,5429,13800,664,1937,2729,5938,3393,7875
410990,202310,1963,4207,1178,2881,245,639,554,1266,799,1905
411000,202310,850,2161,462,1329,101,299,138,331,239,630
411005,202310,601,1406,269,701,38,102,104,219,142,321
411007,202310,3188,7672,1849,4956,374,1111,659,1496,1033,2607
411010,202310,6140,15969,3492,10006,919,2707,761,1759,1680,4466
411020,202310,2962,7548,1980,5586,566,1623,575,1549,1141,3172
411030,202310,843,1983,433,1110,48,131,186,390,234,521
411040,202310,1278,3023,500,1334,88,215,153,353,241,568
411050,202310,2565,7320,1653,5202,361,1203,256,632,617,1835
411060,202310,2979,7175,1473,3885,294,833,539,1139,833,1972
411065,202310,474,1134,216,590,19,54,86,211,105,265
411070,202310,10107,23028,6343,15784,1172,3038,2918,6463,4090,9501
411080,202310,2666,6331,1611,4210,384,1085,551,1203,935,2288
411090,202310,981,2532,447,1308,61,209,130,319,191,528
411095,202310,2962,6738,1169,3107,244,626,176,378,420,1004
411100,202310,1489,3582,772,2102,165,514,252,573,417,1087
411110,202310,773,1939,269,793,30,85,28,53,58,138
411120,202310,2174,5197,1250,3314,217,677,500,1109,717,1786
411125,202310,7024,18236,4747,13291,1434,4049,1486,3766,2920,7815
411130,202310,935,2284,493,1333,144,383,126,326,270,709
411140,202310,2708,7715,1771,5499,471,1484,448,1352,919,2836
411150,202310,5182,12148,2686,6905,590,1579,240,519,830,2098
411155,202310,1404,3191,749,1850,126,356,404,839,530,1195
411160,202310,509,1081,257,656,41,113,73,183,114,296
411170,202310,985,2555,649,1841,135,428,302,776,437,1204
411180,202310,6995,16180,4783,11761,731,1962,2530,5431,3261,7393
411190,202310,2807,6667,1552,3998,212,587,694,1556,906,2143
411200,202310,6440,15789,4022,10681,883,2605,1347,2904,2230,5509
411210,202310,4523,9638,2338,5458,270,749,1153,2281,1423,3030
411220,202310,1233,2837,647,1677,124,344,244,535,368,879
411230,202310,1046,2611,602,1668,121,330,148,369,269,699
411240,202310,1907,4229,1031,2559,233,597,336,732,569,1329
411250,202310,2865,6954,1619,4446,450,1268,384,898,834,2166
411260,202310,409,981,211,566,25,74,99,209,124,283
411270,202310,2575,6336,1492,4037,221,618,688,1644,909,2262
411275,202310,2074,4266,1153,2625,113,329,641,1201,754,1530
411280,202310,1961,4816,1096,2937,255,691,381,869,636,1560
411290,202310,1025,2463,544,1461,73,213,250,602,323,815
411295,202310,1620,3853,915,2405,183,465,315,712,498,1177
411300,202310,1227,2938,537,1425,70,217,199,392,269,609
411310,202310,1231,2506,727,1664,128,318,370,728,498,1046
411320,202310,7497,17074,4669,11483,754,2054,2136,4353,2890,6407
411325,202310,1941,4744,1380,3663,211,573,787,2023,998,2596
411330,202310,4002,9873,2566,7139,695,2079,640,1632,1335,3711
411340,202310,1009,2546,452,1259,77,216,166,397,243,613
411342,202310,1272,2924,547,1430,157,428,174,361,331,789
411345,202310,1506,3490,888,2310,77,209,559,1351,636,1560
411350,202310,3804,9498,1918,5453,444,1341,212,482,656,1823
411360,202310,859,1982,521,1286,85,246,214,463,299,709
411370,202310,77404,176578,45035,113098,4586,12802,25498,56664,30084,69466
411373,202310,1770,4038,1137,2876,200,494,470,1134,670,1628
411375,202310,1342,3153,653,1723,124,322,205,454,329,776
411380,202310,1475,3193,702,1615,43,116,448,916,491,1032
411390,202310,1945,4789,1159,2964,212,617,488,1007,700,1624
411400,202310,2976,6709,1800,4423,219,598,973,2113,1192,2711
411410,202310,3956,10303,2168,6206,563,1617,493,1178,1056,2795
411420,202310,5312,12298,2034,5532,327,964,394,751,721,1715
411430,202310,5389,12672,3431,8775,683,1937,1235,2594,1918,4531
411435,202310,544,1358,219,626,36,103,35,67,71,170
411440,202310,3476,8535,2040,5582,607,1578,457,1153,1064,2731
411450,202310,3140,7685,2034,5494,356,905,1080,2833,1436,3738
411460,202310,5816,13973,2664,7397,416,1272,715,1590,1131,2862
411470,202310,1186,2633,772,1891,60,202,491,1047,551,1249
411480,202310,7130,17432,3793,10418,759,2273,1130,2734,1889,5007
411490,202310,2160,4916,1339,3393,190,557,725,1635,915,2192
411500,202310,1739,4246,907,2368,197,547,267,522,464,1069
411510,202310,2830,6405,1687,4237,347,1012,443,1013,790,2025
411520,202310,47937,109078,21984,55410,2910,8289,10073,21262,12983,29551
411530,202310,1161,2782,511,1441,111,324,132,313,243,637
411535,202310,644,1802,308,982,40,139,75,203,115,342
411540,202310,3547,7867,1860,4592,194,531,1035,2336,1229,2867
411545,202310,1098,2892,797,2255,78,233,482,1314,560,1547
411550,202310,849,1980,536,1334,106,283,202,430,308,713
411560,202310,2392,6325,930,2828,152,497,68,159,220,656
411570,202310,9958,21326,5816,14232,1329,3443,2054,4524,3383,7967
411573,202310,978,2391,686,1804,96,313,388,895,484,1208
411575,202310,2589,6258,1547,4115,325,938,549,1315,874,2253
411580,202310,5531,12868,2562,7112,397,1237,481,963,878,2200
411585,202310,723,2026,255,805,31,98,24,47,55,145
411590,202310,611,1497,341,911,45,138,166,361,211,499
411600,202310,436,998,198,528,42,104,71,161,113,265
411605,202310,2021,4351,980,2488,120,377,475,1159,595,1536
411610,202310,3657,7388,2131,4586,85,237,1559,2981,1644,3218
411620,202310,3829,8893,2691,6813,594,1542,1097,2662,1691,4204
411630,202310,1103,2615,579,1553,77,252,266,581,343,833
411640,202310,568,1434,276,724,38,96,84,192,122,288
411650,202310,245,654,131,391,20,58,39,87,59,145
411660,202310,1055,2537,551,1456,95,274,218,473,313,747
411670,202310,1946,4284,1062,2620,133,353,538,1172,671,1525
411680,202310,1764,4248,1031,2751,208,584,385,935,593,1519
411690,202310,5126,11900,2876,7422,604,1559,981,2268,1585,3827
411695,202310,823,2243,441,1275,48,137,194,516,242,653
411700,202310,2032,4863,1077,2858,261,684,271,603,532,1287
411705,202310,3169,7762,2287,6081,385,1074,1326,3420,1711,4494
411710,202310,2732,6343,1424,3657,306,826,497,1048,803,1874
411720,202310,1267,2963,651,1710,113,294,190,442,303,736
411721,202310,1235,2886,752,1941,147,368,212,504,359,872
411722,202310,1249,3272,559,1629,96,271,182,444,278,715
411725,202310,1601,4229,827,2544,228,782,155,388,383,1170
411727,202310,1827,4659,1005,2883,219,641,125,219,344,860
411729,202310,719,1747,331,939,87,290,77,147,164,437
411730,202310,7223,17273,4455,11587,1142,3204,1529,3623,2671,6827
411740,202310,586,1432,261,740,72,179,43,104,115,283
411745,202310,935,2474,499,1457,74,239,115,262,189,501
411750,202310,8740,20694,4893,12814,707,1946,2233,5365,2940,7311
411760,202310,9748,22813,5932,15797,1981,5320,1184,3133,3165,8453
411770,202310,3969,10548,2345,6676,522,1562,535,1294,1057,2856
411780,202310,3160,8354,2242,6545,652,1939,479,1440,1131,3379
411790,202310,4130,9256,2048,5216,319,865,742,1536,1061,2401
411800,202310,1501,3996,854,2359,168,520,265,614,433,1134
411810,202310,1975,4725,1083,2766,224,580,395,892,619,1472
411820,202310,23197,54191,17110,42630,3997,9795,8557,20270,12554,30065
411830,202310,553,1361,309,839,63,159,70,152,133,311
411840,202310,16729,40023,8902,23359,1533,4190,3473,7701,5006,11891
411845,202310,812,2152,373,1118,72,242,80,194,152,436
411850,202310,10394,24797,5294,14384,1462,4254,811,1584,2273,5838
411860,202310,961,2510,556,1592,155,424,96,242,251,666
411870,202310,750,1966,459,1307,129,413,99,199,228,612
411880,202310,3082,6730,1813,4411,362,900,755,1613,1117,2513
411885,202310,1287,3198,640,1784,98,298,167,387,265,685
411890,202310,1872,4612,1089,3019,225,643,147,378,372,1021
411900,202310,1094,2787,488,1455,172,516,23,72,195,588
411910,202310,1463,3944,873,2619,175,587,295,743,470,1330
411915,202310,21493,48762,11817,29302,1814,4804,5113,10681,6927,15485
411920,202310,1530,3910,1027,2858,262,789,387,919,649,1708
411925,202310,624,1502,367,987,104,273,131,327,235,600
411930,202310,6622,17637,4737,13720,2409,7183,462,1428,2871,8611
411940,202310,4207,11001,2727,7626,656,1836,921,2214,1577,4050
411950,202310,20773,49773,14244,36865,1883,5328,7869,18293,9752,23621
411960,202310,7512,18064,4735,12244,1117,3089,1783,3945,2900,7034
411965,202310,654,1652,345,964,55,154,151,340,206,494
411970,202310,1462,2977,826,1904,153,281,360,890,513,1171
411980,202310,2152,4619,1187,2931,343,798,352,843,695,1641
411990,202310,52823,126056,29088,78591,5700,16207,11286,26675,16986,42882
411995,202310,6709,14795,4351,10721,1333,3547,1191,2670,2524,6217
412000,202310,2544,5239,1461,3198,67,200,1068,2065,1135,2265
412010,202310,789,2144,364,1054,41,135,118,271,159,406
412015,202310,631,1632,442,1254,123,353,165,460,288,813
412020,202310,570,1529,288,923,46,161,76,203,122,364
412030,202310,792,2044,505,1426,110,295,205,532,315,827
412033,202310,1134,2774,553,1491,68,196,240,557,308,753
412035,202310,865,2199,426,1280,100,286,148,403,248,689
412040,202310,894,2206,414,1123,63,172,157,353,220,525
412050,202310,1801,4232,1003,2665,303,865,165,413,468,1278
412060,202310,9185,23685,6025,16868,1839,5611,1448,3386,3287,8997
412065,202310,763,1908,387,1096,72,215,101,243,173,458
412070,202310,1727,3964,1058,2595,119,320,533,1046,652,1366
412080,202310,3578,8428,2088,5246,288,736,1062,2259,1350,2995
412085,202310,423,1008,116,359,14,45,32,77,46,122
412090,202310,8358,18981,5030,12838,1158,3217,2034,4926,3192,8143
412100,202310,2403,5844,1447,4077,416,1239,257,726,673,1965
412110,202310,1188,2942,577,1595,86,257,160,360,246,617
412120,202310,2986,7555,1928,5432,428,1300,553,1294,981,2594
412125,202310,1016,2635,438,1300,71,216,103,262,174,478
412130,202310,982,2285,479,1269,116,316,127,311,243,627
412135,202310,667,1665,267,750,35,102,112,260,147,362
412140,202310,2599,5875,1379,3477,273,700,298,711,571,1411
412150,202310,3481,8168,2388,5979,680,1730,963,2103,1643,3833
412160,202310,1217,3516,398,1321,35,132,27,57,62,189
412170,202310,5920,14337,4233,11076,901,2460,1986,4591,2887,7051
412175,202310,1620,4312,1109,3197,259,750,321,890,580,1640
412180,202310,2139,5469,1202,3455,252,768,386,947,638,1715
412190,202310,3865,9279,2131,5750,325,968,883,2131,1208,3099
412200,202310,2445,6391,1389,3938,411,1205,193,483,604,1688
412210,202310,803,1819,391,1022,60,158,171,386,231,544
412215,202310,4165,10161,2550,7001,506,1448,1078,2893,1584,4341
412217,202310,1278,2912,904,2192,23,74,682,1510,705,1584
412220,202310,7710,20603,4602,13510,1097,3125,959,2617,2056,5742
412230,202310,3580,9365,2043,5840,365,1142,547,1307,912,2449
412240,202310,10499,25542,5050,13801,956,2794,1576,3353,2532,6147
412250,202310,2370,5787,1357,3707,375,1034,197,433,572,1467
412260,202310,1720,4047,874,2176,176,434,314,676,490,1110
412265,202310,1323,3125,860,2234,116,320,496,1167,612,1487
412270,202310,1433,3656,754,2090,79,236,325,752,404,988
412280,202310,530,1377,304,873,73,197,66,167,139,364
412290,202310,1344,3096,818,2095,149,401,341,791,490,1192
412300,202310,2398,5522,1389,3556,285,790,470,1037,755,1827
412310,202310,782,2126,425,1323,76,258,118,289,194,547
412320,202310,853,2071,465,1272,57,194,154,362,211,556
412330,202310,2008,4875,1088,3006,259,766,288,709,547,1475
412340,202310,1553,3838,835,2331,129,395,76,192,205,587
412350,202310,3892,9805,1867,5375,312,977,577,1329,889,2306
412360,202310,379,883,221,558,17,55,139,314,156,369
412370,202310,1544,3744,783,2147,158,454,178,429,336,883
412380,202310,1752,4541,996,2864,241,755,69,169,310,924
412382,202310,632,1455,357,933,43,134,175,381,218,515
412385,202310,2976,7042,1980,5103,642,1644,569,1497,1211,3141
412390,202310,3104,7071,1742,4459,388,961,501,1192,889,2153
412395,202310,937,2318,536,1422,65,169,263,644,328,813
412400,202310,1181,2806,673,1767,129,377,226,459,355,836
412402,202310,3145,7196,1666,4359,364,894,547,1393,911,2287
412405,202310,3883,9778,1913,5594,581,1636,319,844,900,2480
412410,202310,8438,20374,4871,13474,932,2802,1637,3978,2569,6780
412420,202310,646,1537,301,793,39,120,113,253,152,373
412430,202310,639,1544,254,688,51,130,86,220,137,350
412440,202310,3771,9023,2124,5710,472,1279,660,1632,1132,2911
412450,202310,681,1847,331,958,38,120,40,81,78,201
412460,202310,1473,3344,864,2150,189,487,344,772,533,1259
412470,202310,2015,5670,1498,4505,375,1209,427,1127,802,2336
412480,202310,1823,4153,936,2278,182,478,331,671,513,1149
412490,202310,1622,3695,983,2453,89,244,539,1172,628,1416
412500,202310,2564,5970,1404,3600,267,713,434,917,701,1630
412510,202310,2359,6575,1428,4304,342,1128,199,425,541,1553
412520,202310,1743,4180,803,2200,148,403,81,192,229,595
412530,202310,858,2159,419,1174,94,235,90,236,184,471
412535,202310,988,2473,453,1294,82,248,61,121,143,369
412540,202310,1255,3137,728,2091,154,547,134,313,288,860
412545,202310,934,2246,463,1277,85,243,153,392,238,635
412550,202310,49949,119969,28282,72991,4151,11705,13109,29079,17260,40784
412555,202310,372,884,160,396,16,42,63,116,79,158
412560,202310,6993,17830,4091,11204,1167,3516,609,1344,1776,4860
412570,202310,5424,12440,2691,7034,563,1695,741,1590,1304,3285
412575,202310,1464,3278,939,2283,278,656,373,757,651,1413
412580,202310,2003,4587,1068,2691,138,331,566,1259,704,1590
412590,202310,561,1389,244,694,54,142,33,64,87,206
412600,202310,2176,4986,1470,3566,97,307,950,2017,1047,2324
412610,202310,1031,2593,538,1437,102,254,199,452,301,706
412620,202310,1685,3939,1079,2778,226,610,495,1144,721,1754
412625,202310,13593,33464,7276,20147,1466,4333,1775,4099,3241,8432
412627,202310,1368,3573,707,2102,163,495,171,445,334,940
412630,202310,3352,9135,1746,5258,325,1049,392,989,717,2038
412635,202310,621,1502,294,787,104,279,34,67,138,346
412640,202310,1186,3023,532,1521,70,210,115,261,185,471
412650,202310,2154,5366,1309,3505,245,693,478,1106,723,1799
412660,202310,3700,8553,2128,5380,284,787,812,1733,1096,2520
412665,202310,536,1230,321,813,74,195,112,245,186,440
412667,202310,2066,5126,1219,3358,238,710,464,1178,702,1888
412670,202310,1160,2457,632,1507,102,264,273,549,375,813
412680,202310,2755,6701,1343,3640,219,690,413,863,632,1553
412690,202310,1430,3388,773,2017,160,436,257,556,417,992
412700,202310,2187,5365,1484,3918,350,973,631,1521,981,2494
412710,202310,6798,17970,3924,11235,784,2383,1109,2520,1893,4903
412720,202310,1669,4489,1064,3007,187,558,264,559,451,1117
412730,202310,3456,8206,1999,5114,299,884,1028,2289,1327,3173
412740,202310,2618,6769,1341,3980,256,843,249,703,505,1546
412750,202310,4969,12164,3251,8772,528,1588,1607,3822,2135,5410
412760,202310,4052,9739,2753,7182,554,1571,1346,3137,1900,4708
412770,202310,16179,39340,6982,19976,1026,3120,1798,4099,2824,7219
412780,202310,1584,3820,943,2538,243,742,260,542,503,1284
412785,202310,2807,6020,1666,4060,311,838,889,1937,1200,2775
412788,202310,1742,4500,1190,3389,348,964,401,1023,749,1987
412790,202310,1744,4218,872,2397,153,440,324,704,477,1144
412795,202310,1501,3609,670,1914,129,334,153,401,282,735
412796,202310,2765,7366,1842,5324,471,1326,494,1301,965,2627
412800,202310,5434,11654,3082,7160,332,954,1710,3334,2042,4288
412810,202310,17692,41332,9196,23641,1123,3204,4308,9426,5431,12630
412820,202310,8002,20347,4525,12837,1192,3402,1005,2654,2197,6056
412830,202310,485,1222,255,691,49,132,85,189,134,321
412840,202310,2534,5298,1556,3427,131,356,1021,1940,1152,2296
412850,202310,3473,8275,2272,6053,274,846,1233,2887,1507,3733
412853,202310,2049,4514,1423,3242,182,464,812,1631,994,2095
412855,202310,1690,4102,686,1896,116,342,150,314,266,656
412860,202310,986,2297,527,1426,99,308,201,449,300,757
412862,202310,807,1961,461,1295,84,249,207,512,291,761
412863,202310,1655,4361,1245,3482,268,824,593,1436,861,2260
412865,202310,795,2065,496,1412,121,361,93,235,214,596
412870,202310,1244,2990,711,1979,227,665,160,398,387,1063
412880,202310,1243,3161,707,2066,148,435,238,629,386,1064
420005,202310,592,1608,280,846,37,110,118,345,155,455
420010,202310,3822,8764,2160,5719,202,578,1386,3460,1588,4038
420020,202310,529,1544,339,1064,60,194,86,206,146,400
420030,202310,179,591,109,396,30,113,25,77,55,190
420040,202310,730,2102,321,1079,53,190,29,73,82,263
420050,202310,1003,2382,529,1344,100,283,271,571,371,854
420055,202310,256,702,101,304,17,54,39,101,56,155
420060,202310,320,833,210,578,32,100,102,253,134,353
420070,202310,1143,3101,776,2308,150,476,396,1068,546,1544
420075,202310,96,249,49,142,8,26,15,26,23,52
420080,202310,532,1454,282,809,59,169,67,164,126,333
420090,202310,588,1683,311,1013,74,254,68,172,142,426
420100,202310,1884,4260,1261,3111,160,393,699,1637,859,2030
420110,202310,387,1139,271,859,46,149,112,317,158,466
420120,202310,849,2215,434,1254,69,216,158,354,227,570
420125,202310,501,1434,272,883,61,189,78,204,139,393
420127,202310,400,1028,134,406,12,40,52,133,64,173
420130,202310,6945,17959,4278,12259,857,2712,1561,3627,2418,6339
420140,202310,6534,16102,4082,11215,1076,3228,1054,2405,2130,5633
420150,202310,882,2182,495,1378,62,206,244,597,306,803
420160,202310,268,659,82,246,9,27,26,74,35,101
420165,202310,220,650,89,302,8,26,25,74,33,100
420170,202310,455,1240,316,938,38,138,168,426,206,564
420180,202310,184,563,80,280,12,49,23,73,35,122
420190,202310,269,739,132,403,24,69,38,96,62,165
420195,202310,2812,6773,1809,4828,280,848,955,2235,1235,3083
420200,202310,11442,25211,5822,14246,799,2145,2472,4918,3271,7063
420205,202310,2873,6995,1596,4349,257,756,758,1824,1015,2580
420207,202310,3125,7386,1729,4647,359,1043,650,1507,1009,2550
420208,202310,461,1245,200,637,67,224,46,109,113,333
420209,202310,231,673,109,339,17,65,55,141,72,206
420210,202310,6380,15244,3832,10258,622,1804,1836,4337,2458,6141
420213,202310,994,2738,675,2004,122,377,243,651,365,1028
420215,202310,315,856,178,528,46,147,39,100,85,247
420220,202310,475,1334,255,803,46,165,92,203,138,368
420230,202310,8704,21008,5453,14241,792,2202,2764,6346,3556,8548
420240,202310,21987,56779,11389,31365,1617,4867,4753,10533,6370,15400
420243,202310,681,1571,473,1193,114,286,248,602,362,888
420245,202310,2910,6790,1891,4851,211,600,1091,2471,1302,3071
420250,202310,928,2018,672,1573,59,168,465,983,524,1151
420253,202310,576,1356,329,890,52,134,181,459,233,593
420257,202310,217,528,122,347,16,58,56,136,72,194
420260,202310,1614,3773,1015,2773,93,288,637,1611,730,1899
420270,202310,801,2019,275,731,37,98,123,295,160,393
420280,202310,2207,5767,1377,3878,209,685,576,1383,785,2068
420285,202310,141,391,87,271,13,47,15,25,28,72
420287,202310,593,1307,313,817,51,149,133,311,184,460
420290,202310,7688,19933,4626,12765,742,2266,2232,5213,2974,7479
420300,202310,10933,28718,4855,14035,998,2925,1535,3726,2533,6651
420310,202310,943,2109,434,1152,49,134,154,368,203,502
420315,202310,1216,3134,605,1806,95,302,281,749,376,1051
420320,202310,8930,22391,5508,15761,1478,4327,1433,3690,2911,8017
420325,202310,418,1141,236,722,36,123,71,160,107,283
420330,202310,1504,4107,747,2276,167,509,184,483,351,992
420340,202310,1814,4143,1114,2788,248,652,486,1050,734,1702
420350,202310,1833,4004,1214,2877,189,436,741,1656,930,2092
420360,202310,3937,10294,1630,4925,256,863,148,390,404,1253
420370,202310,1956,4560,1428,3587,109,353,1029,2366,1138,2719
420380,202310,6012,14743,3500,9490,671,1967,1523,3593,2194,5560
420390,202310,1505,3684,815,2156,138,399,272,503,410,902
420395,202310,1828,4770,999,2920,176,549,200,451,376,1000
420400,202310,1618,4002,889,2447,142,420,450,1084,592,1504
420410,202310,751,1857,400,1096,72,219,182,448,254,667
420415,202310,462,1218,265,749,49,166,108,273,157,439
420417,202310,821,2272,492,1496,107,306,199,611,306,917
420419,202310,154,492,89,313,24,89,5,21,29,110
420420,202310,21144,51965,11582,32069,2905,8645,3078,7044,5983,15689
420425,202310,846,2217,461,1309,66,217,201,477,267,694
420430,202310,4596,11531,2336,6558,362,1135,900,2048,1262,3183
420435,202310,466,1169,226,676,45,128,102,290,147,418
420440,202310,1117,2810,597,1649,200,504,155,423,355,927
420445,202310,263,648,147,406,32,92,36,71,68,163
420450,202310,1173,3173,658,1921,133,403,256,616,389,1019
420455,202310,2790,6235,1692,4285,498,1227,529,1313,1027,2540
420460,202310,14101,34247,8810,23322,1416,4144,4302,9741,5718,13885
420470,202310,940,2344,406,1092,61,174,131,268,192,442
420475,202310,93,237,32,98,5,21,9,18,14,39
420480,202310,7488,17572,3987,10782,822,2270,1448,3599,2270,5869
420490,202310,531,1418,293,840,48,153,123,319,171,472
420500,202310,1801,4656,1017,3069,203,681,427,1129,630,1810
420510,202310,161,465,90,274,16,53,29,61,45,114
420515,202310,184,531,97,301,12,50,34,80,46,130
420517,202310,948,2219,637,1579,89,224,362,837,451,1061
420519,202310,382,967,201,592,28,90,89,240,117,330
420520,202310,354,925,144,467,16,60,3,7,19,67
420530,202310,976,2844,478,1518,95,321,146,361,241,682
420535,202310,282,794,78,258,12,39,20,55,32,94
420540,202310,58000,128682,32483,79172,4471,12138,13625,26925,18096,39063
420543,202310,330,911,179,541,31,106,68,174,99,280
420545,202310,2244,6246,1357,4039,232,731,565,1407,797,2138
420550,202310,5807,13937,2854,7868,499,1441,1112,2667,1611,4108
420555,202310,437,1172,238,711,33,111,124,324,157,435
420560,202310,568,1232,331,828,48,124,157,371,205,495
420570,202310,4426,10442,2793,7204,534,1416,1294,3036,1828,4452
420580,202310,2361,6338,1259,3982,260,832,312,842,572,1674
420590,202310,4528,11532,2435,6757,463,1394,702,1492,1165,2886
420600,202310,1971,4916,1292,3455,107,347,829,2012,936,2359
420610,202310,808,2075,422,1229,75,202,195,514,270,716
420620,202310,1110,2737,569,1633,100,304,200,512,300,816
420630,202310,1437,4074,900,2724,173,575,324,841,497,1416
420640,202310,636,1671,242,770,43,146,22,53,65,199
420650,202310,4909,11907,2686,7009,456,1322,1116,2422,1572,3744
420660,202310,593,1436,258,703,46,119,39,72,85,191
420665,202310,954,2331,476,1311,95,266,153,312,248,578
420670,202310,1606,4407,763,2394,102,378,150,358,252,736
420675,202310,290,732,161,489,17,69,94,248,111,317
420680,202310,354,808,157,458,23,76,72,171,95,247
420690,202310,1264,3419,645,1881,106,339,214,462,320,801
420700,202310,4493,11004,2924,7810,303,937,1829,4482,2132,5419
420710,202310,1459,4020,1072,3105,159,509,522,1245,681,1754
420720,202310,1799,4436,1181,3173,176,531,676,1626,852,2157
420730,202310,5213,12596,3405,8979,664,1950,1485,3366,2149,5316
420740,202310,560,1530,283,844,62,202,95,253,157,455
420750,202310,3091,8408,1655,4876,306,994,517,1223,823,2217
420757,202310,166,423,71,222,12,39,26,72,38,111
420760,202310,480,1323,184,548,40,118,53,135,93,253
420765,202310,822,2142,316,920,50,172,148,370,198,542
420768,202310,1862,4645,1266,3428,177,450,738,1913,915,2363
420770,202310,278,807,97,353,12,49,13,26,25,75
420775,202310,397,994,194,583,38,111,60,152,98,263
420780,202310,1308,3469,574,1682,127,358,103,270,230,628
420785,202310,297,735,150,393,11,37,71,143,82,180
420790,202310,1469,3899,1009,2859,250,854,498,1159,748,2013
420800,202310,1024,2364,492,1331,104,286,226,556,330,842
420810,202310,1789,5005,1283,3839,320,1003,429,1074,749,2077
420820,202310,19924,47492,11975,31903,1723,4959,5708,13130,7431,18089
420830,202310,7133,17184,4184,11360,874,2585,1540,3652,2414,6237
420840,202310,801,2439,326,1158,64,264,45,138,109,402
420845,202310,4251,10209,2516,6898,487,1515,1036,2564,1523,4079
420850,202310,1361,3863,850,2592,166,533,264,633,430,1166
420860,202310,471,1206,235,724,77,230,53,137,130,367
420870,202310,1034,2751,580,1732,115,378,185,477,300,855
420880,202310,1625,4507,1073,3234,260,860,386,954,646,1814
420890,202310,10676,27500,5480,15856,993,3051,1858,4362,2851,7413
420895,202310,258,721,123,382,20,59,56,159,76,218
420900,202310,2303,5407,1023,2856,141,450,410,913,551,1363
420910,202310,48521,119953,27480,75564,4746,14036,11288,25930,16034,39966
420915,202310,586,2036,442,1663,67,259,194,687,261,946
420917,202310,617,1506,220,569,44,100,91,213,135,313
420920,202310,119,307,29,88,6,22,4,6,10,28
420930,202310,25421,58635,15301,38994,2202,6161,7763,17334,9965,23495
420940,202310,5186,11896,2829,7363,598,1773,904,1734,1502,3507
420945,202310,270,803,102,322,14,44,35,97,49,141
420950,202310,565,1490,294,867,58,198,84,204,142,402
420960,202310,1422,3335,778,2024,127,371,305,664,432,1035
420970,202310,2930,7414,1674,4867,357,1029,454,1288,811,2317
420980,202310,318,1041,228,809,63,236,28,84,91,320
420985,202310,494,1279,200,628,36,105,44,116,80,221
420990,202310,488,1416,248,806,51,175,42,98,93,273
421000,202310,763,2226,417,1340,104,333,66,148,170,481
421003,202310,541,1303,110,317,14,41,8,15,22,56
421005,202310,137,389,80,246,13,45,22,64,35,109
421010,202310,5304,12922,3186,8659,509,1589,1298,2804,1807,4393
421020,202310,529,1533,343,1077,54,199,176,462,230,661
421030,202310,1372,3623,889,2560,186,550,304,789,490,1339
421040,202310,898,2147,412,1201,51,161,210,542,261,703
421050,202310,1622,4245,793,2244,171,495,216,485,387,980
421055,202310,187,532,96,287,18,57,41,110,59,167
421060,202310,978,2651,590,1754,104,330,248,617,352,947
421070,202310,883,2391,437,1307,86,252,177,470,263,722
421080,202310,663,1784,420,1241,71,250,164,395,235,645
421085,202310,395,1091,115,387,10,26,15,37,25,63
421090,202310,381,967,168,447,20,70,72,156,92,226
421100,202310,1127,2388,405,1091,50,139,79,158,129,297
421105,202310,2025,5064,1067,3029,241,658,308,765,549,1423
421110,202310,1721,4071,1162,3027,121,376,711,1685,832,2061
421120,202310,1503,4213,841,2605,125,391,252,635,377,1026
421125,202310,521,1269,312,808,63,168,108,233,171,401
421130,202310,9297,24169,6499,18047,1251,3747,2891,7072,4142,10819
421140,202310,460,1196,246,710,54,141,94,244,148,385
421145,202310,452,1201,266,761,92,265,49,121,141,386
421150,202310,1084,2835,612,1741,126,398,229,496,355,894
421160,202310,903,2308,567,1536,60,196,306,689,366,885
421165,202310,302,843,137,408,23,68,38,79,61,147
421170,202310,1617,3987,1082,2876,108,309,651,1606,759,1915
421175,202310,1482,3640,717,2104,171,544,254,666,425,1210
421180,202310,524,1254,236,632,32,106,113,226,145,332
421185,202310,406,989,241,639,41,118,96,205,137,323
421187,202310,313,935,120,392,27,78,46,141,73,219
421189,202310,560,1445,310,909,57,182,98,254,155,436
421190,202310,21264,52567,13346,35709,2396,6941,5819,13537,8215,20478
421200,202310,1111,2752,674,1815,88,277,351,852,439,1129
421205,202310,332,853,200,579,42,109,77,214,119,323
421210,202310,1414,3410,647,1904,209,586,121,331,330,917
421220,202310,1807,4864,1175,3444,289,853,325,838,614,1691
421223,202310,556,1326,299,802,53,161,130,300,183,461
421225,202310,1509,3922,1082,3062,98,309,668,1744,766,2053
421227,202310,922,2443,459,1382,98,285,175,511,273,796
421230,202310,896,2257,552,1544,98,299,234,581,332,880
421240,202310,362,1031,135,465,20,82,30,74,50,156
421250,202310,3646,8731,2246,6076,394,1097,1170,2890,1564,3987
421260,202310,342,1060,61,187,15,42,8,21,23,63
421265,202310,1338,2957,916,2219,111,235,548,1253,659,1488
421270,202310,459,1218,216,712,50,173,72,219,122,392
421280,202310,3836,9212,2415,6479,372,1171,1193,2768,1565,3939
421290,202310,1458,3809,533,1538,87,263,76,183,163,446
421300,202310,428,1111,120,370,15,46,23,52,38,98
421310,202310,316,847,195,575,59,179,47,115,106,294
421315,202310,440,1139,206,602,44,131,58,144,102,275
421320,202310,825,2504,319,1025,20,54,54,85,74,139
421330,202310,801,2218,423,1311,77,235,100,260,177,495
421335,202310,542,1531,347,1099,42,140,145,414,187,554
421340,202310,1791,4833,942,2987,169,537,344,951,513,1488
421350,202310,2384,5630,1264,3466,270,719,381,914,651,1633
421360,202310,2786,7083,1430,4193,379,1254,339,661,718,1915
421370,202310,976,3000,510,1712,87,301,118,335,205,636
421380,202310,1133,2623,807,2039,88,285,497,1115,585,1400
421390,202310,199,510,62,196,14,42,18,52,32,94
421400,202310,877,2230,440,1281,75,233,173,421,248,654
421410,202310,247,639,109,336,28,77,19,60,47,137
421415,202310,256,695,144,411,21,63,46,115,67,178
421420,202310,799,2066,422,1197,86,253,188,461,274,714
421430,202310,172,466,74,223,14,37,9,21,23,58
421440,202310,991,2516,469,1405,100,297,162,437,262,734
421450,202310,490,1518,276,934,42,163,18,66,60,229
421460,202310,378,1139,160,581,7,17,8,18,15,35
421470,202310,505,1369,253,790,53,155,61,184,114,339
421480,202310,4564,11529,2650,7279,388,1192,1137,2615,1525,3807
421490,202310,163,489,80,250,7,27,28,76,35,103
421500,202310,3444,9112,1972,5762,404,1271,723,1686,1127,2957
421505,202310,420,1040,289,793,30,88,141,363,171,451
421507,202310,561,1392,258,706,43,113,79,177,122,290
421510,202310,654,1728,346,993,42,146,179,408,221,554
421520,202310,592,1533,269,745,54,147,84,184,138,331
421530,202310,439,1274,209,720,35,138,45,110,80,248
421535,202310,577,1434,290,797,53,165,142,322,195,487
421540,202310,485,1101,209,581,30,84,68,168,98,252
421545,202310,914,2561,555,1713,125,403,197,514,322,917
421550,202310,2953,7425,1787,5015,356,1067,713,1759,1069,2826
421555,202310,284,783,53,173,10,38,7,16,17,54
421560,202310,129,409,70,237,12,39,20,54,32,93
421565,202310,1380,3402,821,2297,224,661,330,814,554,1475
421567,202310,592,1704,384,1150,102,313,107,310,209,623
421568,202310,400,1103,155,485,31,113,39,92,70,205
421569,202310,192,524,65,197,10,29,27,66,37,95
421570,202310,2233,5867,1304,3648,214,680,550,1243,764,1923
421575,202310,429,1244,211,633,26,79,61,150,87,229
421580,202310,7093,17909,3427,9466,552,1632,1347,2984,1899,4616
421590,202310,282,722,194,538,48,137,72,173,120,310
421600,202310,813,2012,415,1090,53,152,185,409,238,561
421605,202310,896,2223,517,1464,109,316,184,463,293,779
421610,202310,1318,3256,706,1974,150,443,249,647,399,1090
421620,202310,5261,12923,3287,9065,696,2132,1294,3057,1990,5189
421625,202310,162,446,73,206,11,36,19,38,30,74
421630,202310,3886,9829,1935,5519,330,1017,504,1162,834,2179
421635,202310,592,1486,336,910,32,104,191,448,223,552
421640,202310,997,2390,671,1826,186,499,299,765,485,1264
421650,202310,3751,9302,2142,6096,430,1316,689,1712,1119,3028
421660,202310,18301,46045,11502,31607,1733,5252,5589,13329,7322,18581
421670,202310,1203,3184,653,1816,135,403,248,589,383,992
421680,202310,2311,4996,1621,3767,145,369,1090,2343,1235,2712
421690,202310,1969,5522,1053,3319,204,665,218,538,422,1203
421700,202310,811,2329,369,1188,50,170,76,181,126,351
421710,202310,275,829,117,377,15,53,43,118,58,171
421715,202310,231,540,140,336,22,63,74,137,96,200
421720,202310,2803,7270,1358,3892,310,931,414,947,724,1878
421725,202310,372,889,156,421,20,60,72,148,92,208
421730,202310,754,2098,320,921,50,155,124,293,174,448
421740,202310,1146,3036,575,1674,142,403,165,419,307,822
421750,202310,1306,3022,575,1571,135,408,178,408,313,816
421755,202310,209,551,80,228,15,45,28,66,43,111
421760,202310,1506,3614,705,1919,114,335,262,597,376,932
421770,202310,3320,8090,1924,5320,336,977,696,1639,1032,2616
421775,202310,261,684,113,336,15,43,28,61,43,104
421780,202310,1233,3208,744,2106,132,386,298,719,430,1105
421790,202310,1218,3105,444,1333,80,232,130,325,210,557
421795,202310,326,942,144,444,16,63,46,126,62,189
421800,202310,4107,10670,2457,7160,470,1418,855,2157,1325,3575
421810,202310,741,1961,374,1124,57,217,160,416,217,633
421820,202310,1537,4177,742,2160,130,399,238,547,368,946
421825,202310,2135,4706,1519,3666,124,316,1011,2305,1135,2621
421830,202310,2597,7104,1569,4793,312,1010,361,1028,673,2038
421835,202310,334,774,199,496,26,79,130,289,156,368
421840,202310,518,1549,328,1040,55,184,99,263,154,447
421850,202310,525,1495,239,814,49,176,34,84,83,260
421860,202310,287,734,126,388,16,54,38,91,54,145
421870,202310,7912,18379,4794,11837,701,2002,2499,5036,3200,7038
421875,202310,397,1148,120,387,17,47,18,48,35,95
421880,202310,947,2505,474,1391,96,263,131,337,227,600
421885,202310,381,1039,154,477,27,94,33,80,60,174
421890,202310,1451,3608,955,2640,123,399,555,1341,678,1740
421895,202310,554,1336,376,1002,37,97,235,620,272,717
421900,202310,1501,3735,778,2024,137,390,314,674,451,1064
421910,202310,451,1308,175,614,35,112,21,63,56,175
421915,202310,477,1283,226,683,61,180,45,110,106,290
421917,202310,821,1781,345,927,79,211,76,187,155,398
421920,202310,553,1557,321,993,88,252,74,219,162,471
421930,202310,4538,10791,2049,5604,360,1035,603,1321,963,2356
421935,202310,510,1458,352,1118,75,239,129,386,204,625
421940,202310,440,1235,150,463,30,101,47,109,77,210
421950,202310,4114,10263,2037,5803,375,1118,570,1345,945,2463
421960,202310,187,459,81,239,13,33,30,88,43,121
421970,202310,2862,7118,1323,3651,257,717,486,1120,743,1837
421985,202310,418,1108,223,645,24,74,110,294,134,368
422000,202310,2680,6313,1663,4443,157,497,1011,2506,1168,3003
430003,202310,895,2137,499,1381,67,196,258,687,325,883
430005,202310,509,1177,335,848,17,51,225,509,242,560
430010,202310,2359,4968,1511,3552,338,781,657,1498,995,2279
430020,202310,699,1506,445,1074,60,158,231,483,291,641
430030,202310,1325,2850,668,1576,118,299,376,769,494,1068
430040,202310,12589,27390,6750,16999,1977,5083,1818,4114,3795,9197
430045,202310,694,1512,423,1041,26,70,284,628,310,698
430047,202310,298,658,80,208,18,43,29,70,47,113
430050,202310,1078,2538,496,1337,129,305,119,301,248,606
430055,202310,309,699,123,320,16,45,54,117,70,162
430057,202310,118,259,44,112,8,12,13,28,21,40
430060,202310,29890,69671,20454,52647,3587,9480,10400,24592,13987,34072
430063,202310,835,2165,643,1791,150,416,325,864,475,1280
430064,202310,1442,3542,909,2508,214,615,387,983,601,1598
430066,202310,124,300,71,195,9,24,31,72,40,96
430070,202310,671,1694,129,382,23,74,20,50,43,124
430080,202310,1188,2879,506,1373,88,272,194,403,282,675
430085,202310,1133,2265,589,1386,118,267,240,564,358,831
430087,202310,1179,2779,671,1796,75,216,335,823,410,1039
430090,202310,567,1417,186,580,54,183,33,89,87,272
430100,202310,1972,4429,707,1762,89,237,312,655,401,892
430105,202310,2049,4656,1250,3236,175,523,672,1573,847,2096
430107,202310,219,594,92,268,13,40,28,69,41,109
430110,202310,2765,6275,1766,4466,357,958,868,2030,1225,2988
430120,202310,1500,3878,894,2415,154,401,386,965,540,1366
430130,202310,4425,9053,2759,6443,1049,2365,551,1476,1600,3841
430140,202310,1318,3113,772,2022,131,351,355,876,486,1227
430150,202310,726,1796,332,994,81,254,77,196,158,450
430155,202310,270,625,92,243,16,43,33,64,49,107
430160,202310,28635,57575,19395,42989,1558,3880,13583,28004,15141,31884
430163,202310,4545,8913,2777,6218,82,256,2119,4327,2201,4583
430165,202310,424,1058,101,309,16,40,13,36,29,76
430170,202310,1156,2833,289,909,80,292,51,107,131,399
430175,202310,1054,2394,796,1892,114,269,496,1144,610,1413
430180,202310,845,1971,476,1247,110,264,179,462,289,726
430185,202310,796,1930,292,846,75,200,49,123,124,323
430187,202310,1111,2165,690,1581,79,179,451,980,530,1159
430190,202310,1893,4296,1226,3119,279,712,512,1196,791,1908
430192,202310,138,346,39,111,9,25,11,26,20,51
430195,202310,535,1453,61,182,7,19,13,27,20,46
430200,202310,1390,3604,921,2652,246,764,123,340,369,1104
430205,202310,743,1409,588,1161,24,61,489,934,513,995
430210,202310,9598,22954,4198,10872,607,1669,1236,2507,1843,4176
430215,202310,470,1050,230,591,23,69,107,230,130,299
430220,202310,714,1705,237,709,49,147,74,178,123,325
430222,202310,323,804,156,430,36,96,55,138,91,234
430223,202310,363,865,235,614,28,76,137,316,165,392
430225,202310,46,103,31,77,5,12,16,34,21,46
430230,202310,2845,6477,1950,4906,153,430,1302,3005,1455,3435
430235,202310,588,1467,281,795,42,127,63,135,105,262
430237,202310,693,1390,389,877,23,71,268,541,291,612
430240,202310,1779,3934,688,1799,105,277,261,562,366,839
430245,202310,911,2205,661,1729,129,312,338,899,467,1211
430250,202310,1355,3027,783,1985,246,646,221,498,467,1144
430258,202310,160,397,85,234,16,37,42,111,58,148
430260,202310,893,2049,487,1253,66,199,259,624,325,823
430265,202310,297,805,173,556,30,93,55,171,85,264
430270,202310,4283,8848,2872,6440,552,1156,1659,3554,2211,4710
430280,202310,6559,13477,3980,8979,684,1611,2038,4255,2722,5866
430290,202310,2816,5652,1999,4472,205,460,1443,3060,1648,3520
430300,202310,14129,30425,9085,21177,1486,3436,5149,11087,6635,14523
430310,202310,19120,43057,11196,27579,1490,3860,6312,14110,7802,17970
430320,202310,1115,2682,540,1525,47,140,293,768,340,908
430330,202310,803,1833,367,953,93,243,118,257,211,500
430340,202310,889,1786,509,1158,63,132,339,738,402,870
430350,202310,11357,25095,7296,17622,1158,2893,4132,9268,5290,12161
430355,202310,458,1187,114,337,32,89,10,21,42,110
430360,202310,1138,2608,560,1527,140,412,149,344,289,756
430367,202310,451,915,239,550,40,97,148,315,188,412
430370,202310,581,1518,173,509,43,112,50,120,93,232
430380,202310,775,1812,310,887,52,156,96,243,148,399
430390,202310,4602,10517,2304,5910,429,1140,272,467,701,1607
430400,202310,1295,2540,784,1739,114,294,452,898,566,1192
430410,202310,731,1536,475,1107,42,109,324,697,366,806
430420,202310,3753,8583,2512,6096,394,1139,1367,2791,1761,3930
430430,202310,595,1412,186,533,31,85,27,71,58,156
430435,202310,2462,5452,1457,3582,256,646,686,1612,942,2258
430440,202310,6463,14678,4045,9838,438,1180,2423,5241,2861,6421
430450,202310,10371,21594,7399,16380,1262,3157,4172,8271,5434,11428
430460,202310,54728,120534,32504,80415,5346,13782,16389,37475,21735,51257
430461,202310,230,583,70,213,12,43,32,83,44,126
430462,202310,396,967,180,521,42,130,59,148,101,278
430463,202310,9564,22707,6173,16056,1138,3281,2987,7029,4125,10310
430465,202310,714,1588,414,1015,70,194,231,531,301,725
430466,202310,6476,14251,4353,10585,666,1713,2539,5564,3205,7277
430467,202310,641,1448,376,938,43,115,210,485,253,600
430468,202310,1996,4280,1307,3109,74,209,893,1929,967,2138
430469,202310,729,1918,106,304,16,45,31,68,47,113
430470,202310,7497,17716,3983,10840,1024,3019,891,1920,1915,4939
430471,202310,1075,2474,809,1969,89,228,523,1145,612,1373
430480,202310,817,2112,398,1117,67,219,120,242,187,461
430485,202310,210,513,82,220,20,50,22,45,42,95
430490,202310,651,1516,258,696,47,150,96,181,143,331
430495,202310,495,1258,256,762,51,156,108,293,159,449
430500,202310,1202,2814,697,1875,208,583,211,479,419,1062
430510,202310,36299,87252,21294,55058,4328,12010,8393,18254,12721,30264
430511,202310,394,1032,119,363,22,60,23,48,45,108
430512,202310,1321,2695,894,2016,225,512,327,695,552,1207
430513,202310,981,2148,441,1052,64,154,242,500,306,654
430515,202310,491,1191,264,718,48,132,123,325,171,457
430517,202310,1787,4423,1193,3143,274,662,588,1534,862,2196
430520,202310,1630,3854,751,1958,136,356,196,454,332,810
430530,202310,1124,2621,377,1057,71,214,121,302,192,516
430535,202310,4634,10577,2658,6729,387,1015,1297,3033,1684,4048
430537,202310,686,1491,531,1202,71,150,367,787,438,937
430540,202310,719,1636,338,930,73,184,126,338,199,522
430543,202310,1377,2372,705,1522,200,435,141,318,341,753
430544,202310,831,2175,458,1341,112,342,128,351,240,693
430545,202310,3158,7287,2029,5390,430,1139,977,2432,1407,3571
430550,202310,497,1227,259,706,80,204,77,204,157,408
430558,202310,194,423,59,142,4,10,37,83,41,93
430560,202310,364,825,132,385,18,66,48,114,66,180
430570,202310,1009,2269,532,1270,155,403,206,386,361,789
430580,202310,974,2323,658,1764,159,403,207,605,366,1008
430583,202310,217,523,32,84,9,34,9,14,18,48
430585,202310,261,622,104,280,20,57,35,77,55,134
430587,202310,260,661,135,385,23,71,49,124,72,195
430590,202310,1668,3741,1035,2611,118,310,581,1369,699,1679
430593,202310,38,100,20,55,2,8,12,26,14,34
430595,202310,516,1275,91,269,16,32,15,31,31,63
430597,202310,574,1346,173,457,18,37,59,122,77,159
430600,202310,2325,5782,800,2269,151,436,128,332,279,768
430605,202310,1734,3998,1028,2661,149,397,514,1230,663,1627
430607,202310,864,1803,439,1022,71,132,244,559,315,691
430610,202310,7612,16557,4743,11848,1436,3798,1693,3717,3129,7515
430613,202310,306,683,65,171,14,35,17,38,31,73
430620,202310,1435,3165,668,1577,109,280,292,532,401,812
430630,202310,503,1327,156,435,24,66,40,96,64,162
430632,202310,513,1262,151,428,22,61,57,141,79,202
430635,202310,703,1453,412,917,69,130,252,556,321,686
430637,202310,660,1449,397,979,45,127,249,550,294,677
430640,202310,1370,3553,612,1803,88,263,179,423,267,686
430642,202310,472,1222,206,589,30,79,81,206,111,285
430645,202310,196,448,73,198,16,42,17,34,33,76
430650,202310,2265,5546,1533,4279,464,1231,548,1638,1012,2869
430655,202310,405,926,183,465,23,68,107,233,130,301
430660,202310,6756,15122,4286,10691,717,1930,2174,4939,2891,6869
430670,202310,718,1614,393,983,69,172,183,429,252,601
430673,202310,599,1280,226,611,49,130,73,169,122,299
430675,202310,305,852,61,198,12,33,15,48,27,81
430676,202310,7818,17415,5306,13052,873,2259,2961,6848,3834,9107
430680,202310,1854,4418,832,2263,207,619,252,487,459,1106
430690,202310,4324,9821,2956,7261,982,2464,1072,2460,2054,4924
430692,202310,244,656,172,528,11,41,118,343,129,384
430693,202310,1139,2842,528,1555,143,449,118,304,261,753
430695,202310,530,1228,268,661,46,126,147,308,193,434
430697,202310,675,1507,424,1078,63,186,261,611,324,797
430700,202310,10735,24528,5256,13571,1151,3109,1371,2900,2522,6009
430705,202310,426,968,162,456,26,78,57,127,83,205
430710,202310,2636,4449,1548,3015,70,181,1243,2255,1313,2436
430720,202310,974,2178,433,1183,61,178,212,517,273,695
430730,202310,1152,2910,629,1798,130,361,217,580,347,941
430740,202310,858,2161,343,981,58,165,123,322,181,487
430745,202310,631,1374,394,920,53,156,249,477,302,633
430750,202310,2172,4890,1243,3119,263,691,628,1414,891,2105
430755,202310,578,1309,322,776,38,116,193,399,231,515
430760,202310,3414,7678,2143,5321,442,1118,952,2123,1394,3241
430770,202310,10157,22216,6760,16182,906,2257,4002,8859,4908,11116
430780,202310,3749,8448,1844,4800,196,557,973,2194,1169,2751
430781,202310,851,1985,470,1156,156,393,169,365,325,758
430783,202310,445,950,248,612,66,149,108,245,174,394
430786,202310,45,135,19,73,3,11,3,5,6,16
430790,202310,6309,14103,3610,8851,414,1172,2036,4259,2450,5431
430800,202310,1100,2115,708,1509,50,129,515,1013,565,1142
430805,202310,475,1033,294,671,17,47,216,445,233,492
430807,202310,753,1724,344,912,57,152,130,282,187,434
430810,202310,887,2062,359,961,71,201,118,259,189,460
430820,202310,1798,4658,774,2273,133,398,231,573,364,971
430825,202310,323,737,109,251,19,46,45,90,64,136
430830,202310,2623,5728,1823,4218,136,344,1296,2767,1432,3111
430840,202310,1593,3341,905,2175,168,384,533,1237,701,1621
430843,202310,247,584,81,231,6,13,26,62,32,75
430845,202310,622,1343,336,815,70,167,157,342,227,509
430850,202310,3089,7417,1698,4643,533,1532,357,839,890,2371
430860,202310,1554,3613,643,1729,89,285,252,527,341,812
430865,202310,790,1771,396,1009,119,322,162,374,281,696
430870,202310,630,1600,204,603,50,155,35,88,85,243
430880,202310,1912,3910,1153,2614,153,375,692,1448,845,1823
430885,202310,221,547,110,303,15,45,47,108,62,153
430890,202310,1415,3311,682,1873,191,603,70,126,261,729
430900,202310,4444,8141,2436,5102,133,370,1721,3211,1854,3581
430905,202310,1173,2737,632,1652,122,341,241,578,363,919
430910,202310,2971,7360,1621,4264,250,731,682,1484,932,2215
430912,202310,674,1746,348,1014,66,185,158,456,224,641
430915,202310,648,1690,358,1060,100,302,82,231,182,533
430920,202310,37319,83187,24846,60192,3234,8231,14829,33340,18063,41571
430925,202310,114,241,52,132,8,23,24,49,32,72
430930,202310,16264,33998,9831,22916,1127,2907,6170,12991,7297,15898
430940,202310,1692,3930,957,2491,200,529,357,816,557,1345
430950,202310,1026,2094,578,1314,76,213,352,688,428,901
430955,202310,550,1382,123,336,19,46,36,71,55,117
430957,202310,257,714,209,603,43,110,100,290,143,400
430960,202310,1767,3933,780,2006,197,522,228,521,425,1043
430965,202310,1982,4140,1334,3102,73,189,970,2234,1043,2423
430970,202310,495,1141,213,579,30,79,84,219,114,298
430975,202310,616,1575,422,1156,88,266,138,321,226,587
430980,202310,567,1244,274,700,43,106,120,277,163,383
430990,202310,728,1798,467,1252,83,232,202,489,285,721
430995,202310,680,1514,363,917,76,190,171,384,247,574
431000,202310,1851,4115,568,1535,78,212,80,160,158,372
431010,202310,3655,8664,2102,5580,370,1119,896,1967,1266,3086
431020,202310,11833,24195,5750,13826,1030,2642,2574,5390,3604,8032
431030,202310,403,1062,171,548,45,168,19,56,64,224
431033,202310,5528,12063,3098,7777,742,1793,1159,2728,1901,4521
431036,202310,354,782,73,221,9,31,18,52,27,83
431040,202310,1128,2570,629,1615,69,221,382,857,451,1078
431041,202310,494,1084,268,663,50,121,111,219,161,340
431043,202310,403,973,249,629,21,59,150,322,171,381
431046,202310,121,298,39,100,5,12,8,16,13,28
431050,202310,1550,3368,982,2390,185,449,494,1122,679,1571
431053,202310,889,2082,413,1141,85,231,136,315,221,546
431055,202310,805,1753,498,1216,70,158,304,727,374,885
431057,202310,246,705,118,364,31,93,34,104,65,197
431060,202310,7293,16025,4340,10800,1111,2884,1718,3773,2829,6657
431065,202310,580,1310,300,801,35,96,162,388,197,484
431070,202310,521,1289,231,651,52,139,60,191,112,330
431075,202310,329,802,156,416,26,72,74,171,100,243
431080,202310,876,2213,422,1180,64,208,140,311,204,519
431085,202310,982,2369,403,1085,74,191,157,401,231,592
431087,202310,505,1279,336,909,59,170,177,451,236,621
431090,202310,484,1095,136,412,28,86,29,72,57,158
431100,202310,5763,11018,3757,8195,434,1005,2410,4788,2844,5793
431110,202310,1826,3882,1122,2583,178,447,608,1248,786,1695
431112,202310,791,1813,569,1399,73,219,352,782,425,1001
431113,202310,707,1610,483,1190,112,265,253,587,365,852
431115,202310,1420,3366,940,2479,96,316,615,1467,711,1783
431120,202310,3465,7860,2006,5075,484,1365,804,1716,1288,3081
431123,202310,444,1067,247,657,39,87,120,302,159,389
431125,202310,1591,3667,985,2540,233,618,530,1324,763,1942
431127,202310,305,743,55,163,10,28,9,21,19,49
431130,202310,4294,9607,2766,6866,508,1318,1364,3034,1872,4352
431140,202310,8811,19476,3963,9791,563,1451,1738,3482,2301,4933
431142,202310,824,1796,486,1196,60,139,292,677,352,816
431150,202310,1285,3071,839,2232,104,312,497,1240,601,1552
431160,202310,874,2125,469,1294,131,375,142,340,273,715
431162,202310,777,1788,394,1032,45,140,215,506,260,646
431164,202310,202,461,35,104,7,25,10,21,17,46
431170,202310,577,1411,356,952,96,249,85,192,181,441
431171,202310,1215,2407,874,1907,124,282,645,1346,769,1628
431173,202310,571,1346,360,1014,115,354,85,198,200,552
431175,202310,1676,3592,856,2118,129,311,421,968,550,1279
431177,202310,1248,2876,797,2079,175,483,400,968,575,1451
431179,202310,377,819,94,273,26,81,28,73,54,154
431180,202310,3287,7953,1601,4351,383,992,482,1141,865,2133
431190,202310,748,1758,229,640,30,84,57,119,87,203
431198,202310,518,1374,394,1103,88,246,152,417,240,663
431200,202310,352,839,88,227,21,58,16,31,37,89
431205,202310,289,722,135,370,31,89,38,90,69,179
431210,202310,821,1773,558,1329,129,291,251,598,380,889
431213,202310,429,1057,236,665,22,69,120,300,142,369
431215,202310,777,1736,283,764,37,107,116,287,153,394
431217,202310,215,500,127,333,28,72,36,77,64,149
431220,202310,829,1858,415,1059,98,245,193,447,291,692
431225,202310,2008,4118,1276,2872,147,348,841,1784,988,2132
431230,202310,1012,2439,565,1452,96,281,286,591,382,872
431235,202310,219,585,28,83,2,8,6,9,8,17
431237,202310,475,1324,287,879,41,134,125,360,166,494
431238,202310,45,129,25,79,3,15,9,19,12,34
431240,202310,7098,15508,4688,11060,515,1401,2791,5817,3306,7218
431242,202310,397,890,261,607,29,73,147,306,176,379
431244,202310,495,1168,179,472,42,94,54,125,96,219
431245,202310,1634,3532,831,2052,113,284,364,801,477,1085
431247,202310,354,800,151,393,15,36,62,130,77,166
431250,202310,2583,5496,1778,4225,345,860,992,2222,1337,3082
431260,202310,441,1073,177,499,18,46,68,152,86,198
431261,202310,362,971,235,690,37,136,124,316,161,452
431262,202310,340,897,158,500,28,95,71,208,99,303
431265,202310,1983,4438,597,1583,151,430,147,285,298,715
431267,202310,291,674,156,415,22,58,78,191,100,249
431270,202310,3753,7570,1688,4047,497,1189,515,1155,1012,2344
431275,202310,200,500,93,248,15,45,52,124,67,169
431280,202310,329,872,117,363,24,76,28,69,52,145
431290,202310,473,1346,203,639,39,130,42,112,81,242
431295,202310,129,315,36,112,8,22,8,26,16,48
431300,202310,401,1029,82,237,19,54,25,61,44,115
431301,202310,324,879,66,216,8,26,8,15,16,41
431303,202310,865,1960,426,1078,35,88,218,465,253,553
431306,202310,2988,6718,1308,3416,200,568,547,1180,747,1748
431308,202310,46,121,34,93,12,37,8,17,20,54
431310,202310,694,1612,361,912,64,141,173,416,237,557
431320,202310,858,2207,411,1193,81,250,117,258,198,508
431330,202310,2649,5809,1173,2938,175,487,549,1156,724,1643
431333,202310,248,618,110,318,22,63,30,80,52,143
431335,202310,40,120,27,92,7,22,4,13,11,35
431337,202310,5621,11635,3981,8950,224,619,2957,6171,3181,6790
431339,202310,595,1397,320,853,73,203,124,296,197,499
431340,202310,26026,58241,15250,37991,2334,6198,7745,17141,10079,23339
431342,202310,483,1065,292,730,54,130,166,398,220,528
431344,202310,459,1113,215,615,45,127,100,264,145,391
431346,202310,257,602,80,231,22,66,24,64,46,130
431349,202310,1302,2724,669,1507,116,279,384,786,500,1065
431350,202310,6442,14515,4189,10488,665,1712,2342,5307,3007,7019
431360,202310,745,1704,290,776,85,250,73,149,158,399
431365,202310,3056,6028,2034,4504,147,380,1538,3148,1685,3528
431370,202310,6858,14493,4118,9783,735,1856,2125,4574,2860,6430
431380,202310,1201,2909,795,2122,191,481,378,986,569,1467
431390,202310,3320,7526,1640,4170,190,559,851,1798,1041,2357
431395,202310,2297,4688,1511,3443,163,393,1043,2213,1206,2606
431400,202310,399,1058,152,451,26,68,29,75,55,143
431402,202310,1101,2304,685,1629,101,235,385,868,486,1103
431403,202310,246,646,156,440,28,82,49,111,77,193
431405,202310,7656,17897,4705,12198,844,2336,2169,4977,3013,7313
431406,202310,728,1845,413,1161,118,315,96,286,214,601
431407,202310,663,1657,347,974,72,194,116,305,188,499
431410,202310,26020,57946,15282,37911,1927,5488,8653,18681,10580,24169
431413,202310,323,871,63,197,8,19,14,31,22,50
431415,202310,941,2195,504,1367,107,308,190,442,297,750
431417,202310,691,1393,365,843,82,206,181,401,263,607
431420,202310,2171,4338,1369,3132,103,269,929,1935,1032,2204
431430,202310,695,1648,268,756,47,139,93,226,140,365
431440,202310,53252,108029,35879,79544,6143,14464,19875,39052,26018,53516
431442,202310,208,560,64,211,8,30,5,12,13,42
431445,202310,431,1191,113,364,17,51,22,52,39,103
431446,202310,346,887,249,694,35,97,134,347,169,444
431447,202310,944,2258,427,1192,75,216,159,402,234,618
431449,202310,990,2259,504,1294,104,264,248,574,352,838
431450,202310,3306,5847,2166,4154,223,370,1556,2852,1779,3222
431454,202310,66,215,42,146,5,20,18,59,23,79
431455,202310,627,1405,273,690,42,83,127,316,169,399
431460,202310,4216,8663,2362,5410,446,1122,1194,2474,1640,3596
431470,202310,1711,4264,986,2751,255,712,282,763,537,1475
431475,202310,298,781,41,125,2,7,5,7,7,14
431477,202310,619,1445,287,781,94,232,94,236,188,468
431478,202310,294,797,51,152,13,38,10,23,23,61
431480,202310,4161,9923,2475,6593,534,1411,813,1943,1347,3354
431490,202310,188061,382381,123372,274699,8037,22384,86089,172458,94126,194842
431500,202310,616,1429,328,860,60,150,152,373,212,523
431505,202310,307,682,177,451,27,75,101,239,128,314
431507,202310,351,800,117,338,36,109,26,72,62,181
431510,202310,2121,5013,1123,2982,421,1064,207,521,628,1585
431513,202310,256,536,110,270,32,92,27,48,59,140
431514,202310,146,352,87,231,12,27,38,90,50,117
431515,202310,706,1512,447,1034,99,225,213,463,312,688
431517,202310,96,261,61,177,11,36,26,68,37,104
431520,202310,436,1007,145,393,29,89,54,107,83,196
431530,202310,6810,13912,3412,8293,728,1863,1417,3118,2145,4981
431531,202310,264,608,118,319,28,72,27,81,55,153
431532,202310,798,1670,395,952,77,191,182,409,259,600
431535,202310,445,1087,215,544,59,147,82,190,141,337
431540,202310,2495,6489,1825,5260,136,447,1175,3127,1311,3574
431545,202310,441,1019,92,216,10,21,41,87,51,108
431550,202310,2969,6716,1703,4235,247,624,821,1866,1068,2490
431555,202310,898,1888,427,1046,50,126,241,576,291,702
431560,202310,34451,76353,18978,48718,3256,8541,8030,19217,11286,27758
431570,202310,7069,13912,5007,10656,553,1231,3333,6471,3886,7702
431575,202310,509,1115,321,752,51,140,175,330,226,470
431580,202310,1352,3166,524,1347,56,158,246,513,302,671
431590,202310,1112,2817,558,1589,141,437,181,432,322,869
431595,202310,458,1123,224,625,47,138,82,190,129,328
431600,202310,2382,5479,1329,3524,220,657,502,1088,722,1745
431610,202310,1933,4216,951,2385,203,529,311,819,514,1348
431620,202310,589,1355,281,714,65,176,142,286,207,462
431630,202310,1602,3694,615,1696,152,426,153,376,305,802
431640,202310,9016,18129,6131,13697,1095,2423,3613,7657,4708,10080
431642,202310,833,1771,384,925,94,220,133,279,227,499
431643,202310,493,1149,157,411,21,45,55,131,76,176
431645,202310,3142,5429,2168,4079,61,164,1779,3133,1840,3297
431647,202310,385,893,91,249,14,43,12,21,26,64
431650,202310,166,447,97,292,17,50,39,105,56,155
431660,202310,1041,2561,440,1280,71,221,106,244,177,465
431670,202310,1622,3555,778,1923,127,330,400,877,527,1207
431673,202310,261,669,90,282,8,25,25,66,33,91
431675,202310,435,1081,85,279,8,30,8,16,16,46
431680,202310,13396,29214,7798,18470,1677,4211,3238,6643,4915,10854
431690,202310,37199,80805,22823,54089,4520,11125,11250,23814,15770,34939
431695,202310,285,676,130,349,17,51,58,118,75,169
431697,202310,571,1210,357,844,65,129,183,436,248,565
431700,202310,1943,4169,1305,3009,245,530,646,1499,891,2029
431710,202310,20076,40398,12762,29259,1465,3720,8162,17428,9627,21148
431720,202310,9200,20362,4109,10458,1137,3000,668,1409,1805,4409
431725,202310,41,103,19,57,6,22,4,6,10,28
431730,202310,6010,12690,3483,8528,650,1713,1726,3725,2376,5438
431740,202310,6603,14776,3532,9139,765,2110,1122,2516,1887,4626
431750,202310,11210,25850,6200,16429,1743,4819,1641,3873,3384,8692
431755,202310,419,1080,65,210,7,20,7,24,14,44
431760,202310,6991,14604,4104,9456,487,1333,2459,4871,2946,6204
431770,202310,2892,5804,1793,4086,376,778,980,2194,1356,2972
431775,202310,313,718,111,303,24,65,34,69,58,134
431780,202310,2731,6097,1380,3496,292,793,412,898,704,1691
431790,202310,969,2434,512,1458,154,453,134,348,288,801
431795,202310,313,765,138,400,21,59,34,95,55,154
431800,202310,10539,23085,5448,14161,1772,4875,582,1358,2354,6233
431805,202310,301,775,42,152,3,9,1,5,4,14
431810,202310,4064,8461,2375,5433,457,1095,1259,2633,1716,3728
431820,202310,2868,6702,1843,4890,455,1261,765,1862,1220,3123
431830,202310,11012,23051,6479,15847,2059,5394,1146,2656,3205,8050
431840,202310,3719,8176,2510,6073,403,1027,1461,3306,1864,4333
431842,202310,625,1466,181,506,35,101,28,61,63,162
431843,202310,371,966,189,536,52,161,75,190,127,351
431844,202310,224,588,61,201,13,45,19,58,32,103
431845,202310,587,1380,307,790,44,110,151,388,195,498
431846,202310,379,821,270,633,24,67,198,428,222,495
431848,202310,179,450,61,179,9,28,12,22,21,50
431849,202310,422,1029,53,158,7,23,8,19,15,42
431850,202310,5463,13426,3184,8598,950,2564,714,1818,1664,4382
431860,202310,867,1931,410,1013,65,162,227,523,292,685
431861,202310,122,303,61,168,10,31,23,52,33,83
431862,202310,639,1867,436,1436,95,343,188,555,283,898
431870,202310,32806,72160,21324,51421,2904,7279,12433,27613,15337,34892
431880,202310,5261,12134,3301,8510,554,1526,1627,3742,2181,5268
431890,202310,6289,14522,3235,8447,1016,2569,743,1836,1759,4405
431900,202310,1320,3055,708,1833,137,395,292,604,429,999
431910,202310,961,2135,304,778,78,174,68,153,146,327
431912,202310,746,1638,523,1247,80,177,317,720,397,897
431915,202310,1484,3100,998,2269,91,222,713,1512,804,1734
431920,202310,1720,3267,1192,2495,50,119,965,1926,1015,2045
431930,202310,1006,2352,545,1473,170,459,171,426,341,885
431935,202310,133,328,49,138,9,30,8,14,17,44
431936,202310,375,953,170,474,41,112,70,180,111,292
431937,202310,249,575,99,266,23,48,26,66,49,114
431940,202310,3857,8174,2023,4843,261,591,1067,2423,1328,3014
431950,202310,3006,6791,1770,4476,419,1093,623,1414,1042,2507
431960,202310,3808,8543,2401,5879,766,1952,462,1065,1228,3017
431970,202310,528,1267,177,470,38,106,52,95,90,201
431971,202310,114,276,45,132,14,39,13,30,27,69
431973,202310,733,1990,469,1441,36,97,324,977,360,1074
431975,202310,145,312,33,83,10,33,10,17,20,50
431980,202310,1615,3425,1118,2587,112,321,745,1501,857,1822
431990,202310,9372,20047,5648,13958,399,1210,3600,8037,3999,9247
432000,202310,21502,44278,13704,31023,1764,4528,8570,17596,10334,22124
432010,202310,3688,7904,1838,4549,448,1111,647,1456,1095,2567
432020,202310,1933,4823,976,2695,354,976,135,359,489,1335
432023,202310,701,1564,264,710,28,77,107,233,135,310
432026,202310,1273,3071,891,2312,278,721,313,822,591,1543
432030,202310,567,1284,241,643,20,62,143,344,163,406
432032,202310,381,910,214,563,22,69,104,231,126,300
432035,202310,873,2175,619,1679,167,453,249,635,416,1088
432040,202310,1292,3044,419,1161,46,138,177,405,223,543
432045,202310,227,539,103,288,11,33,45,114,56,147
432050,202310,708,1599,417,1049,57,156,209,465,266,621
432055,202310,918,2109,534,1386,179,423,161,458,340,881
432057,202310,181,444,133,331,32,64,68,157,100,221
432060,202310,551,1265,122,378,19,55,20,52,39,107
432065,202310,293,710,187,489,33,85,104,246,137,331
432067,202310,1065,2623,767,1991,162,412,366,907,528,1319
432070,202310,2002,4584,1234,3099,194,570,589,1246,783,1816
432080,202310,6751,13948,3766,8765,750,2030,1619,3128,2369,5158
432085,202310,500,1270,339,929,54,151,150,374,204,525
432090,202310,3603,8270,1544,4035,310,790,629,1383,939,2173
432100,202310,1078,2539,428,1257,70,240,58,118,128,358
432110,202310,2726,6307,1699,4355,396,1095,573,1235,969,2330
432120,202310,4899,11868,3207,8603,508,1495,1574,3739,2082,5234
432130,202310,3596,7918,2287,5593,507,1264,990,2331,1497,3595
432132,202310,365,884,162,419,24,72,71,167,95,239
432135,202310,1230,2594,688,1649,119,252,363,907,482,1159
432140,202310,2548,6025,1770,4516,245,632,1078,2539,1323,3171
432143,202310,2084,4901,1315,3521,154,429,727,1850,881,2279
432145,202310,2403,5797,1079,2909,179,483,343,725,522,1208
432146,202310,171,431,97,274,30,70,22,57,52,127
432147,202310,712,1774,320,926,86,240,49,147,135,387
432149,202310,648,1407,228,578,36,83,102,232,138,315
432150,202310,5650,12484,3621,8850,878,2249,1604,3372,2482,5621
432160,202310,9118,20316,5931,15027,1466,3765,2322,5556,3788,9321
432162,202310,245,529,33,89,3,12,8,8,11,20
432163,202310,210,486,31,89,2,4,6,14,8,18
432166,202310,830,2089,501,1371,116,317,152,350,268,667
432170,202310,1964,4914,984,2869,203,604,312,787,515,1391
432180,202310,3743,8260,1625,4175,259,698,730,1594,989,2292
432183,202310,541,1366,351,955,60,197,192,463,252,660
432185,202310,1102,2547,531,1412,120,317,236,565,356,882
432190,202310,3010,6482,1693,4139,141,418,1074,2281,1215,2699
432195,202310,1252,2974,546,1505,103,280,151,387,254,667
432200,202310,4873,10856,3038,7536,327,814,1837,4282,2164,5096
432210,202310,523,1211,299,776,50,152,118,252,168,404
432215,202310,815,2061,543,1516,121,325,197,578,318,903
432218,202310,292,666,95,247,14,41,38,75,52,116
432220,202310,4908,10260,2933,6785,526,1261,1604,3387,2130,4648
432225,202310,188,458,116,318,31,76,26,65,57,141
432230,202310,907,2068,371,1023,96,277,76,159,172,436
432232,202310,600,1371,326,836,49,140,157,343,206,483
432234,202310,329,788,149,403,30,72,44,103,74,175
432235,202310,63,141,30,71,4,10,18,38,22,48
432237,202310,361,832,277,682,24,48,198,478,222,526
432240,202310,22549,47960,14421,35581,1503,4136,9113,20938,10616,25074
432250,202310,9740,23466,5853,15339,946,2686,2902,6746,3848,9432
432252,202310,594,1352,335,817,39,108,166,345,205,453
432253,202310,1213,3165,729,2032,240,684,155,393,395,1077
432254,202310,708,1642,139,387,20,64,38,86,58,150
432255,202310,122,313,53,152,5,13,24,56,29,69
432260,202310,7773,17447,4399,10872,787,2068,1940,4132,2727,6200
432270,202310,3137,7270,1960,4995,567,1449,625,1504,1192,2953
432280,202310,1485,3562,544,1561,87,255,132,286,219,541
432285,202310,166,489,18,47,3,4,3,10,6,14
432290,202310,449,1085,223,571,40,118,87,187,127,305
432300,202310,42957,92580,28550,67722,2563,7053,18737,40112,21300,47165
432310,202310,1371,2956,918,2206,152,313,603,1470,755,1783
432320,202310,204,467,88,237,16,43,35,88,51,131
432330,202310,204,451,60,170,20,50,12,36,32,86
432335,202310,222,614,62,201,4,9,12,35,16,44
432340,202310,410,951,136,372,16,38,50,134,66,172
432345,202310,1166,2073,895,1722,29,71,737,1367,766,1438
432350,202310,372,884,154,450,31,99,49,118,80,217
432360,202310,284,814,47,149,10,29,11,30,21,59
432370,202310,505,1128,214,586,13,34,110,282,123,316
432375,202310,621,1409,341,847,122,310,63,160,185,470
432377,202310,214,621,42,146,3,11,10,29,13,40
432380,202310,2471,6402,1377,4111,232,752,548,1469,780,2221
500020,202310,4690,10278,2407,6304,317,932,1249,3018,1566,3950
500025,202310,1486,3358,740,1910,88,225,397,938,485,1163
500060,202310,11059,26960,7130,18911,963,2797,3936,9620,4899,12417
500070,202310,6766,15161,4038,10290,805,2157,1746,4235,2551,6392
500080,202310,1985,4516,1002,2660,176,475,429,1020,605,1495
500085,202310,2775,6235,1502,3822,337,890,574,1268,911,2158
500090,202310,2531,6061,1557,4411,277,810,418,1219,695,2029
500100,202310,5331,12208,3230,8370,534,1524,1340,3072,1874,4596
500110,202310,14238,31688,8370,21574,1979,5187,3601,8735,5580,13922
500124,202310,2930,7171,2120,5816,404,1044,1136,3061,1540,4105
500150,202310,2037,4269,1220,2964,192,479,671,1492,863,1971
500190,202310,6606,15596,3360,8855,854,2194,979,2320,1833,4514
500200,202310,3454,7347,1766,4274,241,641,898,1923,1139,2564
500210,202310,6755,14046,4138,10340,1016,2770,2109,4896,3125,7666
500215,202310,1874,4624,1117,3192,137,386,586,1613,723,1999
500220,202310,4636,11198,2915,7927,405,1220,1528,3705,1933,4925
500230,202310,2704,5996,1628,4103,263,686,851,1996,1114,2682
500240,202310,5376,14254,3379,9953,522,1703,1255,3431,1777,5134
500260,202310,4064,8109,2257,5287,263,706,1316,2803,1579,3509
500270,202310,196803,427054,106310,266324,15296,42410,48218,105708,63514,148118
500280,202310,1786,4037,1018,2781,176,451,521,1392,697,1843
500290,202310,4707,10620,2313,6186,384,1196,810,1854,1194,3050
500295,202310,5613,12382,3035,7573,468,1282,1245,2660,1713,3942
500310,202310,1313,2465,685,1589,129,240,316,718,445,958
500315,202310,6241,13366,4743,11233,312,854,3776,8542,4088,9396
500320,202310,26620,64485,15723,44585,3811,10095,6432,18851,10243,28946
500325,202310,8339,16805,4783,11142,649,1684,2819,5959,3468,7643
500330,202310,8795,18461,4888,12119,719,1907,2405,5708,3124,7615
500345,202310,2879,6600,1467,3895,320,841,466,1139,786,1980
500348,202310,3103,6971,2101,5271,378,1006,1275,2995,1653,4001
500350,202310,1509,3792,735,2129,136,404,248,610,384,1014
500370,202310,36892,88775,22727,62564,3618,10722,10045,25417,13663,36139
500375,202310,3175,7916,1575,4480,205,601,562,1348,767,1949
500380,202310,4661,10814,2433,6493,682,1777,329,897,1011,2674
500390,202310,941,1832,496,1210,64,182,294,641,358,823
500400,202310,2180,5184,1150,3063,201,584,388,894,589,1478
500410,202310,3078,6720,1808,4670,229,570,890,2301,1119,2871
500430,202310,3629,8337,1986,5470,343,923,701,2002,1044,2925
500440,202310,2035,4550,849,2330,156,448,300,795,456,1243
500450,202310,2591,6083,1330,3693,303,870,294,807,597,1677
500460,202310,4951,12070,2498,7058,462,1443,443,1063,905,2506
500470,202310,3878,9583,2141,5939,490,1491,627,1438,1117,2929
500480,202310,2411,6899,1767,5765,214,812,1054,3313,1268,4125
500490,202310,1494,3398,715,2040,152,490,162,424,314,914
500500,202310,5144,12745,2836,8601,860,2988,259,763,1119,3751
500510,202310,897,2136,499,1340,50,131,293,684,343,815
500515,202310,2061,4853,1247,3334,210,575,590,1544,800,2119
500520,202310,4356,11322,2873,8508,531,1549,1486,4313,2017,5862
500525,202310,1296,3452,868,2628,138,397,402,1170,540,1567
500540,202310,6881,16951,3430,10254,1039,3403,516,1195,1555,4598
500560,202310,7497,17770,5350,14401,443,1157,3833,10086,4276,11243
500568,202310,5997,12259,3202,7783,884,2105,1123,2498,2007,4603
500570,202310,11744,25099,6830,16407,958,2615,3744,7937,4702,10552
500580,202310,4093,9710,2441,6578,680,1817,837,2200,1517,4017
500600,202310,4880,11352,2772,7379,699,1839,776,1983,1475,3822
500620,202310,10947,25677,5867,15422,921,2467,2736,6482,3657,8949
500625,202310,731,1818,414,1165,66,181,172,428,238,609
500627,202310,970,2485,457,1379,93,299,94,240,187,539
500630,202310,10252,21550,4858,12115,1055,2862,1473,3227,2528,6089
500635,202310,3311,9812,2294,8250,367,1203,1284,4981,1651,6184
500640,202310,2193,4416,1282,3042,90,228,852,1895,942,2123
500660,202310,28759,64896,16289,44650,4312,12282,5234,14049,9546,26331
500690,202310,3555,8341,2152,5957,716,2163,672,1709,1388,3872
500710,202310,4417,10863,2337,6608,490,1450,524,1289,1014,2739
500720,202310,6590,15703,3533,9904,735,2202,1000,2511,1735,4713
500730,202310,1432,3208,658,1769,153,398,184,486,337,884
500740,202310,5742,12904,3113,8440,788,2118,920,2443,1708,4561
500750,202310,1559,3512,845,2217,136,390,364,819,500,1209
500755,202310,1468,3516,700,1951,129,383,194,436,323,819
500769,202310,6736,15609,2881,7945,714,1986,410,907,1124,2893
500770,202310,1753,4421,1135,3333,212,664,328,930,540,1594
500780,202310,1706,4120,816,2295,144,423,196,443,340,866
500790,202310,10480,25548,6023,16732,1065,3183,2173,5483,3238,8666
500793,202310,2840,6620,1594,4086,366,972,586,1329,952,2301
500795,202310,3842,8109,2732,6528,716,1760,1502,3414,2218,5174
500797,202310,1053,2420,547,1415,165,446,186,432,351,878
500800,202310,4643,9995,2336,6124,556,1553,674,1689,1230,3242
500830,202310,27703,63391,14543,37220,3360,8848,4746,10916,8106,19764
500840,202310,1886,4189,940,2295,111,276,468,1011,579,1287
510010,202310,2229,4485,1377,3249,186,409,880,2028,1066,2437
510020,202310,5702,13771,2162,6260,364,1059,617,1648,981,2707
510025,202310,10031,22827,5487,14763,729,2088,2871,7011,3600,9099
510030,202310,4012,8329,2052,4953,189,498,988,2299,1177,2797
510035,202310,1332,3453,765,2422,204,645,271,926,475,1571
510040,202310,3086,6258,1865,4401,266,616,1014,2379,1280,2995
510050,202310,2973,5558,1775,3908,208,564,1189,2369,1397,2933
510060,202310,1984,4821,1057,2840,278,798,262,573,540,1371
510080,202310,1988,4763,1149,3291,198,655,402,966,600,1621
510100,202310,864,1815,548,1296,67,170,327,710,394,880
510120,202310,364,625,188,408,9,25,137,273,146,298
510125,202310,2652,6392,1590,4328,247,735,587,1364,834,2099
510130,202310,2165,4866,1268,3301,236,699,596,1323,832,2022
510140,202310,3813,9739,2326,7276,1014,3320,520,1675,1534,4995
510160,202310,2650,5656,1820,4466,42,121,1568,3775,1610,3896
510170,202310,6526,15196,4075,10583,680,1896,2129,5039,2809,6935
510180,202310,19156,39087,10920,26308,1458,3745,5759,13350,7217,17095
510185,202310,2130,5227,1224,3696,395,1247,425,1373,820,2620
510190,202310,3240,8391,1679,5435,370,1246,484,1547,854,2793
510250,202310,23040,52458,14316,37682,2172,6099,7655,19000,9827,25099
510260,202310,2414,9523,1912,8583,277,1294,1148,5584,1425,6878
510263,202310,5228,13490,2683,7735,478,1473,627,1400,1105,2873
510267,202310,7453,19939,3391,10169,669,2105,668,1683,1337,3788
510268,202310,1596,3986,853,2487,221,670,147,393,368,1063
510269,202310,1215,3038,689,1990,133,441,301,771,434,1212
510270,202310,3645,9855,2148,6864,394,1297,742,2272,1136,3569
510279,202310,2370,5734,1083,3187,193,595,287,704,480,1299
510285,202310,1386,3371,787,2241,202,628,256,645,458,1273
510300,202310,5393,11689,3544,8846,323,864,2396,5643,2719,6507
510305,202310,1948,4968,1132,3348,264,815,372,1065,636,1880
510310,202310,1398,3191,879,2272,228,578,348,894,576,1472
510320,202310,5377,12277,2795,7415,712,2007,726,1692,1438,3699
510325,202310,5611,15118,3480,10761,915,3077,535,1544,1450,4621
510330,202310,3541,8985,2185,6542,606,1793,927,2707,1533,4500
510335,202310,6405,16521,4213,12536,1079,3384,1577,4388,2656,7772
510336,202310,694,1822,432,1362,56,170,233,775,289,945
510337,202310,1880,4965,1093,3473,391,1277,217,610,608,1887
510340,202310,130738,274588,74345,182424,14607,39718,32433,70441,47040,110159
510343,202310,1562,3488,862,2243,131,376,411,978,542,1354
510345,202310,1892,4369,1059,2655,212,597,590,1330,802,1927
510350,202310,4109,9897,2053,5944,531,1517,450,1226,981,2743
510360,202310,2316,4378,1190,2908,48,111,864,2120,912,2231
510370,202310,2312,6003,1567,4711,321,885,821,2568,1142,3453
510380,202310,684,1537,347,949,53,180,166,413,219,593
510385,202310,1658,4901,1129,3837,83,354,773,2545,856,2899
510390,202310,1879,4135,1190,3258,224,633,695,1835,919,2468
510395,202310,856,1743,492,1194,41,92,312,750,353,842
510410,202310,7109,17047,4533,12443,544,1539,2835,7498,3379,9037
510420,202310,3433,6247,2063,4280,88,244,1592,3124,1680,3368
510450,202310,638,1458,321,869,62,161,150,382,212,543
510452,202310,1289,3252,873,2392,152,393,497,1351,649,1744
510454,202310,1500,3635,871,2473,157,406,427,1274,584,1680
510455,202310,1198,3032,644,1878,143,448,214,534,357,982
510460,202310,2469,5782,1393,3731,492,1462,404,778,896,2240
510480,202310,6328,14263,3375,8458,605,1635,1525,3315,2130,4950
510490,202310,2233,5096,1479,3967,208,526,885,2347,1093,2873
510500,202310,1816,4136,926,2588,226,650,245,653,471,1303
510510,202310,5148,13284,3046,9322,867,2871,867,2497,1734,5368
510515,202310,6826,16881,3992,11417,778,2287,1563,4147,2341,6434
510517,202310,2163,5140,1266,3606,416,1233,375,989,791,2222
510520,202310,2991,5886,1218,3064,194,536,517,1276,711,1812
510523,202310,1444,3202,847,2148,133,339,453,1050,586,1389
510525,202310,11151,28843,6028,17475,1247,3622,1819,4659,3066,8281
510530,202310,759,1756,509,1372,26,76,367,958,393,1034
510550,202310,3314,8689,2178,6499,418,1303,1058,2961,1476,4264
510558,202310,2819,7162,1802,5379,266,756,894,2702,1160,3458
510560,202310,2572,6868,1327,4170,283,909,195,591,478,1500
510562,202310,8004,17177,4844,11507,793,2063,2500,5225,3293,7288
510590,202310,4289,9615,2711,7177,386,1037,1671,4243,2057,5280
510600,202310,1647,3304,959,2187,212,612,469,872,681,1484
510610,202310,3686,8057,2173,5682,324,908,1199,2947,1523,3855
510615,202310,3623,8698,2175,6169,454,1349,949,2544,1403,3893
510617,202310,1408,3791,1029,3168,120,376,709,2236,829,2612
510618,202310,1685,3981,1042,2833,204,638,537,1319,741,1957
510619,202310,917,2237,436,1316,90,273,92,228,182,501
510620,202310,1773,3740,701,1914,246,749,88,220,334,969
510621,202310,2015,5082,1003,3038,251,802,235,562,486,1364
510622,202310,7391,19015,3390,9972,885,2644,377,887,1262,3531
510623,202310,3753,8347,2043,5180,384,1060,847,1968,1231,3028
510624,202310,1927,4885,836,2577,85,301,143,370,228,671
510625,202310,4807,10801,2538,6593,598,1630,824,2059,1422,3689
510626,202310,1685,4009,992,2793,320,1027,216,545,536,1572
510627,202310,832,1993,389,1118,127,392,93,261,220,653
510628,202310,1785,3803,1013,2647,326,948,295,664,621,1612
510629,202310,2299,5923,1226,3724,300,1005,226,625,526,1630
510630,202310,4494,11392,2396,7254,551,1649,711,2256,1262,3905
510631,202310,750,1638,494,1208,41,96,369,891,410,987
510637,202310,4641,10177,2473,6320,711,1905,780,1771,1491,3676
510642,202310,7470,18715,4920,14363,1054,3250,2324,6407,3378,9657
510645,202310,1265,2478,670,1630,183,448,253,632,436,1080
510650,202310,9947,21377,6544,16828,776,1448,4363,11867,5139,13315
510665,202310,2123,4376,1085,2597,273,577,371,942,644,1519
510670,202310,514,1081,286,741,37,89,153,404,190,493
510675,202310,8546,21870,4791,14084,1160,3611,954,2396,2114,6007
510677,202310,2656,6523,1729,4915,327,922,946,2609,1273,3531
510680,202310,893,2162,402,1194,66,219,99,246,165,465
510682,202310,2318,5926,1556,4561,389,1192,698,1920,1087,3112
510685,202310,701,1722,414,1152,45,123,229,610,274,733
510700,202310,5489,12144,3291,8662,393,1175,1999,4991,2392,6166
510704,202310,14930,32982,7819,19813,1756,4654,2583,5684,4339,10338
510706,202310,3452,9212,2204,6827,444,1354,985,3082,1429,4436
510710,202310,3812,8732,1965,5058,628,1571,448,1049,1076,2620
510715,202310,745,1623,389,1015,34,91,247,609,281,700
510718,202310,2795,6281,1489,4232,270,786,720,2164,990,2950
510719,202310,597,1180,312,743,51,136,147,281,198,417
510720,202310,1120,2404,637,1643,121,335,275,621,396,956
510724,202310,1119,2997,616,1914,97,330,219,580,316,910
510726,202310,1134,2057,549,1214,59,144,349,718,408,862
510729,202310,827,1779,322,867,48,129,96,244,144,373
510730,202310,3667,8286,2192,5696,591,1653,898,2040,1489,3693
510735,202310,1723,4425,1222,3561,141,390,877,2525,1018,2915
510740,202310,1243,2763,668,1637,46,127,450,994,496,1121
510757,202310,672,2011,451,1554,101,366,164,506,265,872
510760,202310,57444,120880,28079,70829,6762,18247,7537,16409,14299,34656
510770,202310,5528,10988,3525,8149,200,483,2495,5601,2695,6084
510774,202310,560,1358,362,990,63,173,208,571,271,744
510775,202310,870,2080,433,1264,98,284,105,279,203,563
510776,202310,1008,2444,534,1420,106,292,235,604,341,896
510777,202310,1747,4385,1129,3448,221,777,585,1643,806,2420
510779,202310,1050,2740,624,1907,70,207,369,1162,439,1369
510780,202310,5530,12554,3259,8786,514,1430,1644,4431,2158,5861
510785,202310,2595,6283,1334,3855,307,937,440,1218,747,2155
510787,202310,4644,12161,2384,7057,858,2568,275,727,1133,3295
510788,202310,597,1343,337,890,52,128,157,435,209,563
510790,202310,26319,64377,13167,38470,2905,9065,1486,3840,4391,12905
510792,202310,14955,38679,7967,23741,1975,6078,1883,4949,3858,11027
510794,202310,1568,4078,952,2865,275,881,138,326,413,1207
510795,202310,15151,35224,9010,23822,1990,5651,3127,7124,5117,12775
510800,202310,1919,4884,1073,3124,330,968,150,348,480,1316
510805,202310,1907,4918,998,3084,190,610,339,936,529,1546
510810,202310,851,1649,500,1150,143,292,253,618,396,910
510820,202310,935,1723,481,1101,30,93,321,658,351,751
510830,202310,970,2305,652,1823,128,376,326,929,454,1305
510835,202310,765,1676,430,1152,70,221,221,523,291,744
510840,202310,83707,163274,49989,114815,7993,18021,28369,62651,36362,80672
510850,202310,2221,5627,1036,3239,232,754,53,111,285,865
510860,202310,3524,8548,2104,6144,803,2506,416,1178,1219,3684
510880,202310,933,2506,558,1742,207,633,69,228,276,861
510885,202310,798,1854,413,1134,96,250,125,339,221,589
510890,202310,1041,2725,592,1801,181,579,112,309,293,888
510895,202310,1883,4440,1116,3042,266,786,474,1117,740,1903
520005,202310,5098,12369,3476,9738,1184,3046,1068,3400,2252,6446
520010,202310,3973,9593,2467,6510,566,1571,953,2219,1519,3790
520013,202310,4738,11042,2500,6645,729,1859,606,1683,1335,3542
520015,202310,616,1466,364,1025,87,223,121,354,208,577
520017,202310,1615,3707,930,2457,165,498,372,890,537,1388
520020,202310,710,1268,463,929,54,113,332,633,386,746
520025,202310,52236,125277,39001,102419,6644,17469,21446,53666,28090,71135
520030,202310,9326,19522,6640,15226,555,1240,4775,10502,5330,11742
520050,202310,526,1190,239,634,55,148,86,224,141,372
520055,202310,2257,5230,998,2508,172,441,448,989,620,1430
520060,202310,2532,5866,1482,3926,306,881,402,1027,708,1908
520080,202310,2406,5499,1548,4117,370,935,611,1619,981,2554
520082,202310,1032,2460,602,1623,165,463,196,512,361,975
520085,202310,1278,2910,832,2121,187,465,382,909,569,1374
520090,202310,1105,2013,701,1500,105,141,488,1088,593,1229
520110,202310,59467,144739,31311,89451,8378,25085,1769,4413,10147,29498
520120,202310,325,717,158,417,32,92,66,146,98,238
520130,202310,5190,11285,2953,7163,673,1632,1118,2465,1791,4097
520140,202310,69443,167491,40681,113560,12661,36797,4092,11109,16753,47906
520145,202310,805,1736,404,1059,92,238,103,246,195,484
520150,202310,929,2128,562,1474,74,183,286,702,360,885
520160,202310,1136,2567,627,1608,116,289,277,710,393,999
520170,202310,5881,11952,3267,8024,544,1362,1809,4177,2353,5539
520180,202310,3689,8281,2581,6504,337,938,1633,3871,1970,4809
520215,202310,2296,4980,1445,3568,146,410,949,2188,1095,2598
520235,202310,972,1885,530,1224,83,191,314,667,397,858
520250,202310,2303,5320,1375,3730,491,1417,98,293,589,1710
520260,202310,911,2036,449,1180,104,258,137,347,241,605
520280,202310,1055,2173,656,1513,154,337,295,666,449,1003
520310,202310,1165,2383,662,1589,159,412,292,689,451,1101
520320,202310,2804,6569,1548,4088,212,576,723,1832,935,2408
520330,202310,6617,15388,4403,11289,731,1963,2340,5517,3071,7480
520340,202310,2851,5778,1505,3708,238,512,697,1791,935,2303
520350,202310,4484,10212,2388,6388,721,1908,673,1764,1394,3672
520355,202310,2339,5932,1430,4017,433,1308,215,542,648,1850
520357,202310,1127,2465,729,1856,117,271,455,1162,572,1433
520360,202310,1040,2361,669,1653,86,232,317,685,403,917
520380,202310,1739,4122,811,2241,164,446,236,578,400,1024
520390,202310,1475,3298,818,2195,243,743,130,340,373,1083
520393,202310,914,1900,511,1238,62,173,249,520,311,693
520396,202310,1101,2487,765,1875,76,149,488,1140,564,1289
520400,202310,2023,4380,1365,3381,125,301,913,2243,1038,2544
520410,202310,2786,5733,1586,3711,268,668,817,1799,1085,2467
520420,202310,460,944,324,718,22,60,229,465,251,525
520425,202310,1967,4464,895,2260,267,720,182,358,449,1078
520430,202310,3142,6884,1507,3864,325,863,308,646,633,1509
520440,202310,3882,8842,1861,4958,391,1126,380,951,771,2077
520450,202310,19096,42637,10646,27573,2606,6787,2732,6617,5338,13404
520455,202310,1037,2455,579,1657,160,464,158,444,318,908
520460,202310,1309,2820,843,2094,249,520,315,824,564,1344
520465,202310,1138,2398,829,1936,44,117,611,1346,655,1463
520470,202310,3143,6924,2078,5222,703,1922,734,1689,1437,3611
520480,202310,1362,3315,809,2251,160,446,321,809,481,1255
520485,202310,2061,5615,1483,4507,227,717,846,2459,1073,3176
520490,202310,5563,13054,3631,9770,569,1567,2021,5195,2590,6762
520495,202310,2017,3869,1378,2961,140,289,968,2045,1108,2334
520500,202310,2320,5182,1397,3374,238,662,736,1561,974,2223
520505,202310,1218,2283,859,1795,98,180,595,1223,693,1403
520510,202310,13597,30553,8715,21891,1404,4089,4382,9794,5786,13883
520520,202310,1441,3372,977,2532,269,717,360,874,629,1591
520530,202310,3358,8023,2161,5854,448,1190,921,2632,1369,3822
520540,202310,3952,9420,2037,5504,329,908,712,1627,1041,2535
520545,202310,1931,4349,1176,3014,293,743,418,1053,711,1796
520547,202310,1953,4582,1266,3270,271,684,619,1578,890,2262
520549,202310,22767,52190,16542,41729,2208,5843,10071,23756,12279,29599
520551,202310,6761,15068,4953,12067,449,1291,3545,8034,3994,9325
520552,202310,1284,2972,836,2263,233,613,316,871,549,1484
520570,202310,687,1443,373,914,68,145,175,415,243,560
520580,202310,3104,6001,1844,4318,385,900,933,2081,1318,2981
520590,202310,1733,4006,990,2645,210,574,372,915,582,1489
520620,202310,12913,30021,8743,22826,1544,4153,4480,11022,6024,15175
520630,202310,1108,2570,699,1850,94,247,340,867,434,1114
520640,202310,2769,6310,1750,4331,507,1262,427,1035,934,2297
520650,202310,1349,2663,842,1905,174,393,460,1012,634,1405
520660,202310,649,1557,305,864,87,259,82,229,169,488
520670,202310,1250,2893,852,2172,93,209,535,1293,628,1502
520680,202310,1068,2278,714,1670,109,217,440,1017,549,1234
520690,202310,473,1100,288,756,83,207,93,223,176,430
520710,202310,562,1277,295,765,21,66,187,449,208,515
520725,202310,1724,3865,1020,2586,255,631,377,940,632,1571
520735,202310,1191,2535,712,1718,209,491,221,502,430,993
520740,202310,3303,7062,1904,4729,367,967,778,1880,1145,2847
520750,202310,962,1984,620,1434,147,288,300,707,447,995
520753,202310,1646,3884,1106,2895,209,603,517,1200,726,1803
520760,202310,1891,3654,1357,2955,55,149,1098,2248,1153,2397
520780,202310,2074,4522,1308,3247,237,583,644,1479,881,2062
520790,202310,3986,8724,2255,5712,365,882,1226,3152,1591,4034
520800,202310,25244,56672,16953,42678,3706,8830,8092,20148,11798,28978
520810,202310,1436,2960,910,2252,263,643,336,850,599,1493
520815,202310,735,2070,424,1324,85,265,113,347,198,612
520830,202310,2164,4381,1400,3310,95,221,1018,2299,1113,2520
520840,202310,3777,9224,2528,7059,655,1953,742,1983,1397,3936
520850,202310,1240,2520,695,1637,130,339,336,714,466,1053
520860,202310,12635,30558,7393,20048,1897,5265,2237,5394,4134,10659
520870,202310,208464,441741,124428,298296,23873,59305,54718,119668,78591,178973
520880,202310,13074,33930,8644,24681,1749,4922,3329,8986,5078,13908
520890,202310,6303,12763,3727,8467,607,1546,1979,4015,2586,5561
520910,202310,5952,13762,3359,8774,839,2321,741,1704,1580,4025
520915,202310,1083,2553,584,1514,97,279,281,642,378,921
520920,202310,5672,11652,3563,8511,754,1687,1880,4505,2634,6192
520929,202310,793,1748,509,1249,103,199,208,557,311,756
520940,202310,1223,2965,818,2245,97,232,494,1287,591,1519
520945,202310,590,1226,357,849,131,273,112,286,243,559
520960,202310,1466,2964,972,2233,360,767,339,821,699,1588
520970,202310,5037,11722,3163,8394,1072,2810,673,1823,1745,4633
520980,202310,960,2026,600,1454,99,235,284,640,383,875
520990,202310,4002,8604,2856,6924,428,905,1906,4607,2334,5512
520993,202310,1534,3506,787,1961,284,677,193,458,477,1135
520995,202310,3263,7572,1885,4962,574,1584,320,924,894,2508
521000,202310,12379,29196,6626,17427,1198,3212,2181,5153,3379,8365
521010,202310,5257,12178,3325,8476,575,1603,1627,3707,2202,5310
521015,202310,981,2223,543,1355,22,59,365,818,387,877
521020,202310,6363,14313,3336,8579,829,2113,906,2191,1735,4304
521030,202310,1041,1773,639,1213,39,79,515,930,554,1009
521040,202310,11351,25721,6711,17312,1712,4378,1872,4800,3584,9178
521056,202310,1336,3268,798,2253,245,675,115,342,360,1017
521060,202310,1245,2972,757,2038,285,766,126,343,411,1109
521080,202310,1306,2670,580,1482,109,280,153,349,262,629
521090,202310,3932,9838,2046,5690,442,1313,205,498,647,1811
521100,202310,2460,4999,1561,3632,214,536,909,2013,1123,2549
521120,202310,6383,14346,4128,10661,1374,3645,805,2192,2179,5837
521130,202310,1321,2995,621,1693,125,341,256,679,381,1020
521140,202310,2174,4890,1309,3216,194,527,749,1648,943,2175
521150,202310,18871,39785,10269,25715,2783,7343,3435,7720,6218,15063
521160,202310,1063,2009,585,1229,60,131,381,729,441,860
521170,202310,1363,2951,810,1994,172,463,312,683,484,1146
521180,202310,11201,26284,7537,19559,1636,4594,3236,7912,4872,12506
521190,202310,15491,35748,8463,22811,2016,5764,2691,6457,4707,12221
521200,202310,888,2020,503,1330,97,272,183,418,280,690
521205,202310,784,1698,546,1298,30,80,416,936,446,1016
521210,202310,1124,2754,533,1468,150,421,109,241,259,662
521220,202310,4866,10716,2812,7123,768,2151,1082,2275,1850,4426
521225,202310,565,1088,347,798,22,55,264,589,286,644
521230,202310,1894,4343,1324,3384,544,1463,374,883,918,2346
521250,202310,49149,111775,34136,87417,7471,19957,16620,39517,24091,59474
521260,202310,683,1413,448,1037,75,182,244,498,319,680
521270,202310,2748,5998,2032,4941,232,536,1352,3264,1584,3800
521280,202310,2357,5699,1482,4066,302,862,535,1355,837,2217
521290,202310,723,1509,369,924,39,114,210,472,249,586
521295,202310,1511,3099,903,2122,146,345,469,998,615,1343
521300,202310,2343,5262,1504,3813,307,814,691,1667,998,2481
521305,202310,856,1807,495,1203,46,116,322,731,368,847
521308,202310,6114,14706,3457,9370,367,1093,1956,4864,2323,5957
521310,202310,14570,33983,7799,20377,1685,4534,2601,6154,4286,10688
521340,202310,538,1140,296,739,22,56,171,389,193,445
521350,202310,2407,5727,1629,4435,126,395,1132,2921,1258,3316
521370,202310,1644,3973,840,2391,274,812,121,368,395,1180
521375,202310,2274,5446,1270,3463,287,734,355,952,642,1686
521377,202310,1560,3255,991,2406,120,255,658,1620,778,1875
521380,202310,8516,20950,4155,11953,743,2294,741,2018,1484,4312
521385,202310,881,1940,540,1416,72,183,299,795,371,978
521390,202310,918,2172,516,1446,116,379,97,199,213,578
521400,202310,3925,8469,2381,5866,384,974,1313,3079,1697,4053
521405,202310,1681,4113,865,2394,111,328,413,1050,524,1378
521410,202310,1180,2567,822,1979,198,422,426,1069,624,1491
521440,202310,1817,4130,1120,2880,291,682,437,1102,728,1784
521450,202310,5655,15073,3395,10049,939,2733,722,2043,1661,4776
521460,202310,8810,20195,4743,12484,1328,3491,1184,3030,2512,6521
521470,202310,1109,2519,620,1545,84,180,317,731,401,911
521480,202310,738,1439,391,859,52,118,218,407,270,525
521483,202310,2929,6576,1816,4725,625,1614,534,1410,1159,3024
521486,202310,2174,4857,1362,3444,139,283,826,2022,965,2305
521487,202310,622,1350,402,987,86,179,227,553,313,732
521490,202310,1037,2487,668,1788,48,169,444,1060,492,1229
521500,202310,2527,6180,1526,4201,225,682,701,1701,926,2383
521520,202310,1072,2262,742,1721,99,210,442,991,541,1201
521523,202310,19678,51230,13186,38057,4185,11740,4652,12775,8837,24515
521525,202310,1326,2950,857,2163,175,433,437,1040,612,1473
521530,202310,2849,6950,1586,4355,307,856,453,1099,760,1955
521540,202310,902,2178,588,1615,144,421,223,550,367,971
521550,202310,2237,5256,908,2475,179,526,193,517,372,1043
521560,202310,7604,17506,4778,13025,1350,3730,1622,4424,2972,8154
521565,202310,860,1975,502,1314,104,283,218,534,322,817
521570,202310,5942,14563,3316,9261,840,2487,546,1517,1386,4004
521580,202310,716,1561,358,896,70,171,145,327,215,498
521590,202310,1139,2340,695,1650,113,285,380,834,493,1119
521600,202310,572,1360,297,802,58,153,134,324,192,477
521630,202310,2166,4355,1092,2610,393,938,197,429,590,1367
521640,202310,2483,5506,1337,3517,302,874,345,815,647,1689
521645,202310,666,1618,306,903,134,372,25,67,159,439
521680,202310,1830,4439,1243,3348,322,906,507,1244,829,2150
521690,202310,644,1481,442,1140,57,167,236,562,293,729
521710,202310,4512,10075,2621,6689,577,1539,894,2082,1471,3621
521720,202310,3119,6677,1596,4077,202,522,746,1839,948,2361
521730,202310,5769,14007,3313,9267,914,2717,618,1394,1532,4111
521740,202310,6207,14161,3722,9548,1107,3018,1082,2185,2189,5203
521760,202310,24895,56503,17777,44851,3869,10162,9383,21936,13252,32098
521770,202310,4126,9064,2147,5580,439,1198,427,1084,866,2282
521800,202310,9278,21767,5433,14777,1775,4860,1174,3385,2949,8245
521805,202310,1439,2876,717,1730,146,328,317,775,463,1103
521810,202310,960,2051,592,1460,91,218,340,826,431,1044
521830,202310,7815,18902,5520,14735,843,2059,3202,8176,4045,10235
521839,202310,1098,2336,681,1592,58,148,453,941,511,1089
521850,202310,9493,20287,4925,12459,1651,4256,572,1313,2223,5569
521860,202310,2195,5538,1204,3440,259,757,320,811,579,1568
521870,202310,973,2406,580,1601,108,317,228,520,336,837
521878,202310,1153,2768,577,1546,55,155,304,734,359,889
521880,202310,34052,76895,20463,52622,3983,10831,8422,19396,12405,30227
521890,202310,4289,10012,2239,5936,608,1590,528,1252,1136,2842
521900,202310,1790,3976,843,2262,300,754,66,181,366,935
521910,202310,1729,3637,1100,2652,278,667,395,883,673,1550
521920,202310,724,1666,465,1186,59,183,256,573,315,756
521925,202310,1114,2524,642,1665,148,369,288,724,436,1093
521930,202310,7137,16005,3916,10536,1237,2884,1333,3858,2570,6742
521935,202310,1265,2835,738,1872,99,256,419,1003,518,1259
521940,202310,1659,3483,934,2303,157,412,496,1169,653,1581
521945,202310,895,2034,458,1200,92,213,221,571,313,784
521950,202310,965,2083,573,1408,136,283,248,621,384,904
521960,202310,837,2001,506,1331,60,167,280,644,340,811
521970,202310,3424,7227,2265,5503,332,734,1321,3171,1653,3905
521971,202310,1004,2290,459,1237,111,288,108,252,219,540
521973,202310,2176,5181,1274,3432,219,568,524,1312,743,1880
521975,202310,18507,42081,13076,32929,2151,5703,7572,17612,9723,23315
521980,202310,2777,6081,1831,4642,160,432,1287,3143,1447,3575
521990,202310,1830,4110,1272,3136,249,643,676,1594,925,2237
522000,202310,3338,7931,2246,6201,863,2440,602,1674,1465,4114
522005,202310,528,1079,279,686,45,136,99,231,144,367
522010,202310,5999,13908,3514,9234,857,2293,1089,2602,1946,4895
522015,202310,1368,3236,887,2357,268,671,303,791,571,1462
522020,202310,7009,15084,3944,9845,919,2354,1631,3918,2550,6272
522026,202310,1012,2439,592,1637,92,281,196,476,288,757
522028,202310,682,1522,381,937,53,158,198,415,251,573
522040,202310,4929,9866,2667,6162,656,1405,1170,2477,1826,3882
522045,202310,27948,70142,16972,48148,3908,11374,4058,10574,7966,21948
522050,202310,1580,3686,941,2426,190,552,427,967,617,1519
522060,202310,4254,10213,2505,6950,545,1428,930,2542,1475,3970
522068,202310,2279,4868,1538,3779,220,418,964,2342,1184,2760
522070,202310,1096,2127,811,1704,41,88,654,1316,695,1404
522100,202310,1124,2602,633,1714,121,337,237,604,358,941
522108,202310,1528,3025,1044,2335,60,141,798,1654,858,1795
522119,202310,2544,5360,1797,4269,254,552,1079,2516,1333,3068
522130,202310,703,1541,453,1124,40,104,309,740,349,844
522140,202310,33258,77898,19144,50209,4287,11641,5694,13331,9981,24972
522145,202310,925,2087,583,1523,151,414,268,661,419,1075
522150,202310,1412,3065,760,1913,177,430,213,539,390,969
522155,202310,1235,2895,723,1904,134,354,386,982,520,1336
522157,202310,948,1860,666,1463,47,98,486,1049,533,1147
522160,202310,8138,18928,4299,11474,1128,3149,437,1194,1565,4343
522170,202310,3508,8242,2378,6290,417,1049,1287,3347,1704,4396
522180,202310,976,2042,491,1115,92,200,128,284,220,484
522185,202310,33531,75235,20579,54590,8526,23976,2707,7133,11233,31109
522190,202310,1036,2214,602,1491,96,271,277,581,373,852
522200,202310,2807,6973,1747,4874,414,1152,578,1524,992,2676
522205,202310,2047,4679,1221,3143,531,1472,218,457,749,1929
522220,202310,1527,3271,918,2355,135,331,463,1193,598,1524
522230,202310,1769,3852,1078,2658,117,315,642,1456,759,1771
530010,202310,388493,887917,286163,706987,45159,114914,158403,363152,203562,478066
110001,202309,4915,12612,2928,8722,767,2456,778,2140,1545,4596
110002,202309,18703,43539,11757,30899,2896,8050,3437,8399,6333,16449
110003,202309,944,2555,601,1826,165,516,108,302,273,818
110004,202309,18183,42266,10319,27594,2338,6517,3496,8660,5834,15177
110005,202309,3183,7726,1923,5419,554,1588,553,1548,1107,3136
110006,202309,1832,4804,1012,3061,211,698,204,529,415,1227
110007,202309,1464,3498,743,2146,193,568,123,353,316,921
110008,202309,4417,10264,3019,8169,668,1620,1552,4655,2220,6275
110009,202309,5663,14664,3183,9851,702,2295,870,2476,1572,4771
110010,202309,10349,28175,7339,22745,2006,5508,3138,11100,5144,16608
110011,202309,9877,23807,6018,16544,1693,4867,1269,3185,2962,8052
110012,202309,23128,52980,13228,35129,3437,9031,3632,9085,7069,18116
110013,202309,7708,19915,4784,14113,1816,5577,743,2173,2559,7750
110014,202309,4706,11380,2726,7542,535,1581,1042,2738,1577,4319
110015,202309,7794,18179,4396,11744,1072,3215,1320,2812,2392,6027
110018,202309,5921,13813,3102,8321,745,2098,743,1745,1488,3843
110020,202309,123304,256476,84152,197287,17737,43108,43570,99324,61307,142432
110025,202309,5908,13371,3545,9047,616,1726,1726,3965,2342,5691
110026,202309,725,1795,437,1254,102,305,122,361,224,666
110028,202309,9525,22376,4995,13824,1310,4003,483,1196,1793,5199
110029,202309,1969,4564,1017,2830,216,607,400,1075,616,1682
110030,202309,18697,41022,9865,26087,3041,8551,1383,3464,4424,12015
110032,202309,4750,12021,2496,7359,800,2412,400,1174,1200,3586
110033,202309,5956,16053,4176,12660,1254,3841,1404,4396,2658,8237
110034,202309,3933,8768,2330,6251,869,2493,501,1394,1370,3887
110037,202309,1845,5151,1137,3712,313,1072,252,771,565,1843
110040,202309,3746,9539,2329,6809,676,2138,469,1207,1145,3345
110045,202309,5683,15001,3650,11054,1091,3477,1025,2958,2116,6435
110050,202309,2107,5280,1128,3402,376,1251,106,230,482,1481
110060,202309,1188,3232,655,1979,194,581,118,333,312,914
110070,202309,1809,5126,1168,3701,342,1158,248,642,590,1800
110080,202309,8179,18103,5513,14084,1372,3575,2557,6516,3929,10091
110090,202309,756,1928,460,1354,126,411,141,393,267,804
110092,202309,1780,4698,1120,3370,284,900,527,1512,811,2412
110094,202309,3695,9776,2438,7330,775,2409,444,1391,1219,3800
110100,202309,2153,5667,1534,4505,562,1717,423,1223,985,2940
110110,202309,2327,5770,1442,4180,428,1326,217,677,645,2003
110120,202309,1702,4391,1025,3021,289,874,276,764,565,1638
110130,202309,3291,7559,1713,4653,474,1361,198,518,672,1879
110140,202309,3151,8059,2131,6049,480,1479,955,2553,1435,4032
110143,202309,1774,4476,1150,3279,334,1035,369,974,703,2009
110145,202309,1148,2763,601,1693,200,531,190,562,390,1093
110146,202309,671,1653,388,1109,135,382,101,313,236,695
110147,202309,994,2331,519,1384,62,170,259,609,321,779
110148,202309,1212,3031,504,1502,129,417,56,102,185,519
110149,202309,4364,10380,2680,7419,901,2585,597,1654,1498,4239
110150,202309,2885,7290,1606,5010,600,2028,135,360,735,2388
110155,202309,1064,2846,652,1856,135,428,242,612,377,1040
110160,202309,1875,5119,1156,3557,419,1322,159,496,578,1818
110170,202309,2510,5913,1488,4001,279,828,795,1903,1074,2731
110175,202309,2755,6995,1655,4755,315,980,713,1902,1028,2882
110180,202309,1634,4061,1013,2860,274,808,272,741,546,1549
120001,202309,4523,11242,3332,9337,504,1608,2106,5629,2610,7237
120005,202309,2593,8619,2243,8023,274,1009,1573,5715,1847,6724
120010,202309,7873,18553,6548,16531,642,1533,4955,12395,5597,13928
120013,202309,3245,9005,2633,8049,1023,3113,906,3007,1929,6120
120017,202309,3835,9166,2944,7802,452,1177,1852,5056,2304,6233
120020,202309,19919,60320,17446,55557,1333,4498,13066,40983,14399,45481
120025,202309,4818,10794,3732,9406,629,1570,2312,6059,2941,7629
120030,202309,7727,27539,6818,25783,593,2474,4791,18266,5384,20740
120032,202309,2169,8512,1990,8127,109,665,1636,6493,1745,7158
120033,202309,5607,16144,5093,15243,142,574,4364,12740,4506,13314
120034,202309,3703,11059,3107,10060,165,693,2513,7909,2678,8602
120035,202309,5243,16229,4726,15331,251,941,4035,12803,4286,13744
120038,202309,4204,10698,3360,9306,625,1781,1915,5335,2540,7116
120039,202309,2556,9527,2307,9008,173,896,1759,6684,1932,7580
120040,202309,80745,192292,63693,163939,8621,22621,39281,97494,47902,120115
120042,202309,4345,13142,3822,12148,160,651,3136,9746,3296,10397
120043,202309,1827,6444,1501,5919,69,440,1176,4465,1245,4905
120045,202309,7296,16471,5630,14195,730,1918,3747,9302,4477,11220
120050,202309,12386,36348,10934,33993,507,1979,8836,27102,9343,29081
120060,202309,12479,40864,10983,38405,572,2697,8974,30648,9546,33345
120070,202309,4546,12239,3666,10857,792,2227,2017,6305,2809,8532
120080,202309,7068,16169,6064,14626,699,1633,4563,10921,5262,12554
130002,202309,4404,13731,3774,12843,448,1218,2977,10611,3425,11829
130006,202309,3263,9978,2575,8845,463,1479,1605,5878,2068,7357
130008,202309,3347,9943,2795,9119,204,680,2211,7318,2415,7998
130010,202309,5500,12886,4590,11754,172,467,4029,10181,4201,10648
130014,202309,5001,12456,3427,9916,777,2289,1719,5158,2496,7447
130020,202309,3415,12070,2820,11047,215,1182,2074,7809,2289,8991
130030,202309,20153,41284,17951,38694,242,625,16920,36035,17162,36660
130040,202309,5049,13633,3961,12181,629,1786,2695,8612,3324,10398
130050,202309,8769,29133,7160,26657,661,2500,5334,19889,5995,22389
130060,202309,9013,32368,7534,30209,309,1801,6169,24159,6478,25960
130063,202309,8182,23043,7056,21644,232,968,6323,19052,6555,20020
130068,202309,4869,13454,3967,12199,257,903,3233,9885,3490,10788
130070,202309,9075,23542,7145,21142,891,2219,5068,15597,5959,17816
130080,202309,9609,27937,7967,25874,331,1119,6769,22019,7100,23138
130083,202309,3753,10285,3116,9447,245,748,2492,7788,2737,8536
130090,202309,5102,12526,4367,11610,103,310,3800,10261,3903,10571
130100,202309,9073,25567,7404,23666,207,740,6425,20598,6632,21338
130110,202309,11074,26419,8574,23098,1858,4391,5025,14957,6883,19348
130115,202309,6342,17125,5148,15521,174,518,4343,13175,4517,13693
130120,202309,21068,57721,17785,53094,1865,5858,13731,40821,15596,46679
130130,202309,7249,19387,5466,16931,765,2259,3682,12011,4447,14270
130140,202309,9127,27596,7734,25812,367,1550,6546,21667,6913,23217
130150,202309,5006,14679,4525,14022,272,1107,3800,11661,4072,12768
130160,202309,8130,21771,6851,20082,341,959,5947,17480,6288,18439
130165,202309,4297,13621,3886,13025,129,557,3361,11160,3490,11717
130170,202309,18379,41064,14674,36506,578,1528,12756,31168,13334,32696
130180,202309,5439,15353,5073,14907,53,321,4817,14007,4870,14328
130185,202309,25792,53682,20234,47206,1576,2520,16656,40072,18232,42592
130190,202309,27041,74955,21246,66077,2577,7510,15129,47539,17706,55049
130195,202309,3063,10093,2560,9417,133,593,2068,7707,2201,8300
130200,202309,3771,8969,2920,7766,239,744,2171,5614,2410,6358
130210,202309,2004,6621,1775,6333,185,748,1383,4901,1568,5649
130220,202309,3356,8967,2702,8161,122,354,2342,7157,2464,7511
130230,202309,6482,22340,5594,21077,198,1077,4907,18392,5105,19469
130240,202309,18289,40531,14858,36204,215,950,13639,32379,13854,33329
130250,202309,32566,85849,26463,77866,1711,4426,20968,62603,22679,67029
130255,202309,6214,16407,4975,14251,301,784,3911,11120,4212,11904
130260,202309,504417,1099685,395060,939017,71207,178536,251206,574092,322413,752628
130270,202309,12685,37868,10081,33749,2088,6294,6231,21798,8319,28092
130280,202309,4704,15263,4176,14609,178,752,3660,12706,3838,13458
130290,202309,22076,52625,19034,48858,576,1783,17288,43675,17864,45458
130300,202309,6277,17654,5277,16214,219,837,4313,13007,4532,13844
130310,202309,10674,25101,9012,22933,558,1454,7425,18663,7983,20117
130320,202309,4330,12779,3392,11309,543,1782,2092,7064,2635,8846
130330,202309,5669,15647,4399,13982,256,844,3546,11394,3802,12238
130340,202309,31685,80237,26172,73466,1796,4351,21321,61343,23117,65694
130350,202309,4623,15111,4059,14326,163,821,3462,12034,3625,12855
130353,202309,9548,23261,7219,19926,1356,3510,4320,12301,5676,15811
130356,202309,7025,18952,5559,16601,1396,3852,2872,9028,4268,12880
130360,202309,3612,10847,2735,9632,241,1014,2164,7437,2405,8451
130370,202309,6448,25192,5232,23178,694,3751,3071,13454,3765,17205
130380,202309,10303,39387,9304,37579,800,3579,7027,28083,7827,31662
130390,202309,9310,31228,7790,28804,539,2537,6410,23183,6949,25720
130395,202309,3151,8582,2490,7493,158,568,1998,5838,2156,6406
130400,202309,3684,9689,2957,8663,95,308,2582,7464,2677,7772
130406,202309,14929,45863,12280,42282,3384,10203,6793,25084,10177,35287
130410,202309,5654,17037,4692,15510,1288,4242,2558,8797,3846,13039
130420,202309,19934,57126,16442,52512,2574,7522,11096,36728,13670,44250
130423,202309,5420,15617,4576,14519,233,927,3965,12342,4198,13269
130426,202309,3957,12174,3483,11600,111,366,3007,10453,3118,10819
130430,202309,6317,13864,5189,12382,222,586,4468,10374,4690,10960
130440,202309,7331,17246,6066,15668,169,504,5520,14097,5689,14601
140002,202309,3114,8232,2525,7459,404,992,1725,5405,2129,6397
140005,202309,4278,11264,3457,10172,2064,6246,779,2318,2843,8564
140010,202309,74296,191092,55516,159603,14805,44261,18801,53975,33606,98236
140015,202309,7919,15770,6547,14245,276,590,5819,12538,6095,13128
140017,202309,7273,16693,5759,14671,419,1014,4454,11406,4873,12420
140020,202309,7141,17518,5763,15678,788,2050,3820,10689,4608,12739
140023,202309,3642,9160,2756,7835,366,1100,1979,5603,2345,6703
140028,202309,2550,6040,2010,5308,142,376,1527,4065,1669,4441
140030,202309,7911,16455,6514,14727,363,704,5554,12488,5917,13192
140040,202309,3711,13004,3342,12505,155,847,2843,10430,2998,11277
140045,202309,6237,19420,5331,18055,1996,5759,2487,9723,4483,15482
140047,202309,7895,20171,6244,17518,981,2719,3720,10648,4701,13367
140050,202309,2345,5904,1817,5047,359,848,1051,3035,1410,3883
140060,202309,2913,6220,2417,5531,229,446,1907,4346,2136,4792
140070,202309,2562,11911,2414,11589,169,1135,1898,8872,2067,10007
150010,202309,66068,135583,54739,119869,1391,2858,48093,102827,49484,105685
150013,202309,2760,5626,2175,4930,75,160,1873,4200,1948,4360
150020,202309,19473,48844,16984,45213,1775,3808,13241,36048,15016,39856
150030,202309,11727,36465,10192,34395,843,2262,7968,28525,8811,30787
150034,202309,5337,11486,3848,9364,261,622,2979,7112,3240,7734
150040,202309,20306,47563,16625,42969,1059,1819,14286,37979,15345,39798
150050,202309,10000,26533,8682,24663,277,883,7697,21889,7974,22772
150060,202309,31095,74496,23067,61568,3742,9785,13612,36489,17354,46274
150070,202309,11000,30967,9249,28658,294,1177,8195,25018,8489,26195
150080,202309,116883,246975,84381,197292,23387,53197,29366,74591,52753,127788
150085,202309,12434,28627,10576,26268,182,516,9844,24134,10026,24650
150090,202309,16114,40466,14414,37638,598,1497,12550,32243,13148,33740
150095,202309,9356,19849,7625,17590,854,1461,5967,14104,6821,15565
150100,202309,3836,11421,3203,10374,188,649,2641,8462,2829,9111
150110,202309,5917,19434,5351,18727,170,674,4806,16810,4976,17484
150120,202309,10197,26809,8859,24805,385,893,7633,21399,8018,22292
150125,202309,1173,2733,800,2168,101,310,504,1315,605,1625
150130,202309,32508,80822,25389,68824,5075,12317,14847,41750,19922,54067
150140,202309,391519,739132,299809,607441,24953,51068,222064,429618,247017,480686
150145,202309,5303,14927,3925,12562,1562,5033,901,3487,2463,8520
150150,202309,23495,50631,18172,43213,1907,4260,12542,29432,14449,33692
150157,202309,4490,11015,3277,9176,510,1511,1907,5333,2417,6844
150160,202309,5248,10796,4446,9577,326,766,3557,7259,3883,8025
150170,202309,36416,90973,30881,81328,5873,13356,19119,53437,24992,66793
150172,202309,7376,16225,5576,13579,419,1012,4232,10221,4651,11233
150175,202309,2578,6210,2051,5328,168,569,1619,3967,1787,4536
150178,202309,16196,33682,11727,28247,1072,1520,9103,23365,10175,24885
150180,202309,36671,92340,31722,86278,2864,5048,25117,73374,27981,78422
150190,202309,9899,23931,8642,22328,154,490,7788,19768,7942,20258
150195,202309,6578,17450,5803,16280,178,560,5190,14378,5368,14938
150200,202309,7411,18556,6387,17258,79,259,5735,15380,5814,15639
150210,202309,42287,107197,38067,101212,1276,3316,33516,88832,34792,92148
150215,202309,14984,37986,11377,30923,1915,5447,6598,17266,8513,22713
150220,202309,18212,42679,14508,36747,850,1958,10911,27054,11761,29012
150230,202309,18462,42634,15560,38343,1682,3562,11493,28483,13175,32045
150240,202309,46435,112296,35267,91864,7715,20050,15634,38545,23349,58595
150250,202309,5540,17946,5034,17332,366,1272,4345,15024,4711,16296
150260,202309,3875,9877,3185,8806,109,347,2654,7102,2763,7449
150270,202309,11186,28555,6958,20430,1993,5974,1784,5312,3777,11286
150275,202309,9888,24486,8669,22727,212,805,7604,19245,7816,20050
150276,202309,3025,7471,2402,6581,266,707,1629,4623,1895,5330
150277,202309,7069,15498,4914,12493,735,1768,3137,7887,3872,9655
150280,202309,9554,30203,8835,29030,815,2243,7002,23815,7817,26058
150285,202309,4466,12928,3730,11658,240,695,2867,8853,3107,9548
150290,202309,14157,32454,11886,29590,432,949,10397,25958,10829,26907
150293,202309,11962,26412,8609,21515,990,2550,5693,13623,6683,16173
150295,202309,9275,22168,5673,16560,1894,5366,1888,6045,3782,11411
150300,202309,4258,8685,3694,7985,53,137,3445,7373,3498,7510
150304,202309,5541,14271,4328,12300,902,2443,2552,7394,3454,9837
150307,202309,7215,19909,6144,18078,271,799,4826,14030,5097,14829
150309,202309,8020,20517,5883,16699,1023,2849,3282,9395,4305,12244
150310,202309,9201,30997,8417,29860,501,2107,6996,24920,7497,27027
150320,202309,12069,27751,10025,24453,1356,2885,6842,16830,8198,19715
150330,202309,19721,51138,17265,47545,2865,6453,11282,33920,14147,40373
150340,202309,3038,7969,2467,7031,270,670,1747,4974,2017,5644
150345,202309,11701,27578,9806,24990,461,1307,8276,20648,8737,21955
150350,202309,12920,26251,10835,23444,1055,1746,8725,19065,9780,20811
150360,202309,32565,79766,23986,67378,2257,4960,17494,50098,19751,55058
150370,202309,14512,36965,11061,31853,1538,3827,7589,22827,9127,26654
150375,202309,5046,18176,4420,17128,304,1230,3535,13503,3839,14733
150380,202309,12828,28490,9539,23799,472,1288,7554,18290,8026,19578
150390,202309,10150,35656,8543,32750,2118,6784,4722,20105,6840,26889
150400,202309,8255,25408,7513,24091,176,568,6321,20659,6497,21227
150405,202309,11263,25502,8917,22239,862,1516,6759,17505,7621,19021
150410,202309,2389,6388,1903,5564,170,467,1308,3787,1478,4254
150420,202309,61371,146136,43828,118136,9786,27626,21497,57037,31283,84663
150430,202309,10328,25758,8592,23153,764,1615,6543,17543,7307,19158
150440,202309,8750,20141,7382,18161,539,1270,6068,14730,6607,16000
150442,202309,39690,79300,29935,65869,1698,3875,23029,48323,24727,52198
150445,202309,10157,23860,8517,21488,180,535,7562,18749,7742,19284
150450,202309,8222,24417,7534,23454,256,1256,6870,20729,7126,21985
150460,202309,11217,29655,9804,27724,542,1230,8128,23514,8670,24744
150470,202309,25641,61608,21283,55649,590,2231,18251,45874,18841,48105
150475,202309,7083,18946,5519,16291,1004,2661,3330,10224,4334,12885
150480,202309,18245,48175,15639,44173,4408,11006,8766,26876,13174,37882
150490,202309,10213,31362,8815,29136,862,2421,6602,22582,7464,25003
150495,202309,6832,18435,6048,17248,226,880,5219,14459,5445,15339
150497,202309,3400,9442,2394,7585,449,1449,1246,3978,1695,5427
150500,202309,3830,9074,3097,7864,197,524,2382,5797,2579,6321
150503,202309,7608,17823,5076,14313,1687,4194,1858,5861,3545,10055
150506,202309,17484,42825,14335,38359,2337,5897,9716,27019,12053,32916
150510,202309,16540,42559,13400,37107,1207,2949,10366,28752,11573,31701
150520,202309,10826,31421,10089,30384,122,664,9480,28116,9602,28780
150530,202309,16427,48336,13594,43972,1364,3788,10175,33411,11539,37199
150540,202309,6604,14798,5425,13005,369,845,4383,10332,4752,11177
150543,202309,9128,23278,6820,19720,677,2080,4709,13537,5386,15617
150548,202309,13336,35210,11278,32062,593,1601,9443,26846,10036,28447
150549,202309,2371,5847,1869,5068,126,394,1419,3759,1545,4153
150550,202309,25862,67485,18432,53502,5510,16111,6208,17955,11718,34066
150553,202309,52924,129251,35503,97118,10465,28545,13508,36656,23973,65201
150555,202309,2612,6152,1853,4952,162,423,1274,3419,1436,3842
150560,202309,2534,6089,2015,5169,205,529,1337,3319,1542,3848
150563,202309,3462,8965,2567,7344,615,1850,1287,3583,1902,5433
150565,202309,5760,16244,4659,14247,197,612,3636,11101,3833,11713
150570,202309,9995,23516,8695,21666,218,711,7713,18717,7931,19428
150580,202309,15019,50306,12436,47188,1753,5497,9075,36476,10828,41973
150590,202309,10718,30546,8888,28274,431,1389,7623,24378,8054,25767
150600,202309,13418,34826,11865,32652,500,1398,10328,28327,10828,29725
150610,202309,4129,9143,3446,8106,140,386,2882,6544,3022,6930
150611,202309,4091,9609,3307,8416,105,370,2764,6716,2869,7086
150613,202309,18667,46538,12660,35740,2799,8447,5524,14675,8323,23122
150616,202309,4818,12010,3123,8802,645,1889,1488,4049,2133,5938
150618,202309,9399,23089,7068,19185,1155,3302,4242,11257,5397,14559
150619,202309,8199,20770,6294,17913,1195,3057,3844,11360,5039,14417
150620,202309,9757,28055,7965,24617,1952,5510,3918,12535,5870,18045
150630,202309,9322,18991,8137,17410,143,357,7387,15360,7530,15717
150635,202309,6928,16199,5251,13283,635,1466,3344,8396,3979,9862
150640,202309,2578,6792,2233,6326,71,229,1950,5490,2021,5719
150650,202309,15633,37128,12433,31758,3866,9635,4728,12717,8594,22352
150655,202309,7046,17295,5965,15638,186,732,4983,12587,5169,13319
150658,202309,5472,14536,3585,11135,1096,3563,1362,4156,2458,7719
150660,202309,7115,17965,5739,15698,1429,3789,2932,7907,4361,11696
150670,202309,12885,25214,9363,20765,1314,3078,6366,13904,7680,16982
150680,202309,101020,248903,74392,205596,17213,43535,37797,110520,55010,154055
150690,202309,3293,7086,2566,6083,154,342,2079,4881,2233,5223
150700,202309,8952,22040,7321,19600,1041,2158,5027,14022,6068,16180
150710,202309,4788,13434,3992,12096,845,2583,2293,7001,3138,9584
150715,202309,6722,15631,5090,13205,434,1185,3900,9876,4334,11061
150720,202309,10683,25947,9206,23713,366,1200,7844,19425,8210,20625
150730,202309,17574,45908,13762,39809,2433,7358,8634,25135,11067,32493
150740,202309,5123,12411,4083,10719,472,995,2874,7647,3346,8642
150745,202309,7118,17275,5283,14459,733,2156,3487,9375,4220,11531
150746,202309,2194,5467,1815,4881,73,213,1462,3828,1535,4041
150747,202309,6926,16594,5811,14868,422,958,4620,11773,5042,12731
150750,202309,4866,12646,3637,10756,381,1140,2523,7579,2904,8719
150760,202309,14837,37812,12375,33844,2540,6418,7216,20431,9756,26849
150770,202309,9054,26408,8046,25114,265,615,7120,22755,7385,23370
150775,202309,1525,3522,1114,2960,112,349,757,1944,869,2293
150780,202309,6457,16879,5462,15585,243,739,4726,13527,4969,14266
150790,202309,7973,18444,6306,16421,557,1157,4253,12698,4810,13855
150795,202309,21856,55243,17809,48868,3459,9249,10566,29170,14025,38419
150796,202309,5121,10465,4034,9076,311,704,3226,7127,3537,7831
150797,202309,5788,14650,4622,12823,463,1237,3597,9892,4060,11129
150800,202309,18900,50915,15803,46281,3229,8897,9359,28437,12588,37334
150803,202309,11230,25233,9561,22802,304,871,8363,19235,8667,20106
150805,202309,4612,12410,3537,10667,516,1484,2329,7087,2845,8571
150808,202309,8339,22328,5616,17447,1926,6655,788,2431,2714,9086
150810,202309,27611,60922,19662,50154,4740,11784,9890,27005,14630,38789
150812,202309,8571,19286,6976,16612,490,1379,5289,11765,5779,13144
150815,202309,11852,31519,9414,28204,1743,5146,6207,18864,7950,24010
150820,202309,19188,38868,15601,34104,1532,2417,12209,27671,13741,30088
150830,202309,16642,45621,14801,42931,608,1609,12876,37365,13484,38974
150835,202309,4667,12279,3820,10937,448,1328,2625,7421,3073,8749
150840,202309,11061,27347,8044,22069,1119,3329,4784,12399,5903,15728
160005,202309,1841,3832,1502,3418,49,125,1298,2868,1347,2993
160010,202309,2799,6779,2429,6327,45,183,2213,5614,2258,5797
160015,202309,5139,10637,4402,9771,445,804,3737,8430,4182,9234
160020,202309,3243,8329,2683,7543,331,844,1933,5640,2264,6484
160021,202309,1641,5139,1338,4745,65,336,905,3265,970,3601
160023,202309,1790,5387,1488,4842,293,909,855,2889,1148,3798
160025,202309,2412,6233,2171,5940,276,482,1788,5159,2064,5641
160027,202309,14687,29909,12433,26899,1049,2151,10023,21694,11072,23845
160030,202309,118382,273079,91467,234677,16709,40451,53365,140514,70074,180965
160040,202309,7974,22604,6804,20916,561,1523,5459,16951,6020,18474
160050,202309,8730,20777,7083,18634,2521,5959,3466,10107,5987,16066
160053,202309,5751,14496,4751,12960,255,626,3884,10728,4139,11354
160055,202309,2229,4246,2031,4011,26,64,1913,3720,1939,3784
160060,202309,40000,84171,31492,73577,4181,7945,22840,54915,27021,62860
160070,202309,4162,12108,3443,11000,440,1213,2512,8414,2952,9627
160080,202309,4098,10493,3428,9706,76,251,3058,8680,3134,8931
170025,202309,792,1963,408,1223,110,327,86,249,196,576
170030,202309,1384,3776,903,2794,188,561,327,1027,515,1588
170035,202309,1733,4087,1101,2926,121,352,616,1531,737,1883
170040,202309,2206,5415,1511,4278,258,719,750,2188,1008,2907
170070,202309,2366,4987,1481,3670,122,343,883,2096,1005,2439
170100,202309,3037,7444,2177,5904,320,768,1355,3691,1675,4459
170105,202309,765,2045,445,1384,107,325,127,344,234,669
170110,202309,1345,3414,874,2550,77,266,489,1331,566,1597
170130,202309,1798,4409,1200,3344,110,358,772,2050,882,2408
170190,202309,1862,4371,1290,3386,160,500,797,1928,957,2428
170200,202309,2372,5267,1309,3377,349,831,407,1029,756,1860
170210,202309,34281,84759,22042,61864,5926,17307,4368,12161,10294,29468
170215,202309,1530,3676,1043,2893,104,342,678,1773,782,2115
170220,202309,6880,19407,5169,16192,2513,7881,884,3222,3397,11103
170230,202309,1523,3912,1022,2906,188,564,488,1291,676,1855
170240,202309,3590,8123,2583,6462,263,716,1760,4183,2023,4899
170255,202309,4471,11813,2990,9013,553,1711,1416,4164,1969,5875
170270,202309,991,2294,624,1667,71,189,370,938,441,1127
170290,202309,3742,9246,3008,8106,330,646,2201,6165,2531,6811
170300,202309,2585,5841,1835,4647,134,380,1322,3136,1456,3516
170305,202309,810,1993,551,1473,90,245,257,672,347,917
170307,202309,1360,3679,1016,3001,118,397,648,1758,766,2155
170310,202309,1964,4342,1233,3153,206,531,600,1475,806,2006
170320,202309,1258,3042,801,2230,104,314,448,1194,552,1508
170330,202309,1213,3232,1009,2861,48,196,769,2023,817,2219
170360,202309,715,1643,473,1255,45,118,274,648,319,766
170370,202309,1618,3645,988,2564,139,404,530,1226,669,1630
170380,202309,2236,5773,1527,4566,173,491,832,2523,1005,3014
170382,202309,573,1535,424,1268,19,78,264,703,283,781
170384,202309,2098,6317,1560,5192,314,1016,751,2375,1065,3391
170386,202309,1162,2981,565,1732,78,266,197,526,275,792
170388,202309,841,2040,550,1522,95,273,302,786,397,1059
170389,202309,995,2884,701,2332,115,414,366,1218,481,1632
170390,202309,2124,4282,1420,3350,66,192,1106,2558,1172,2750
170410,202309,726,1653,475,1207,34,97,316,740,350,837
170460,202309,505,1246,331,923,44,128,184,485,228,613
170510,202309,1071,2701,656,1900,43,163,421,1110,464,1273
170550,202309,8316,19767,5599,15087,1442,4170,2009,5031,3451,9201
170555,202309,1627,3893,1099,2946,146,359,530,1406,676,1765
170560,202309,1146,2910,769,2278,111,318,391,1190,502,1508
170600,202309,1666,4050,1121,3138,164,423,633,1759,797,2182
170610,202309,1989,4544,1281,3315,96,304,848,2013,944,2317
170625,202309,521,1264,309,847,51,121,125,312,176,433
170650,202309,1835,4484,1369,3695,146,453,893,2263,1039,2716
170700,202309,4345,11488,2885,8416,592,1780,1184,3178,1776,4958
170710,202309,2097,4519,1387,3408,141,364,931,2192,1072,2556
170720,202309,2249,4957,1498,3748,163,403,1006,2419,1169,2822
170730,202309,1337,3175,864,2365,123,297,501,1362,624,1659
170740,202309,2458,7072,1883,5963,168,635,1344,4072,1512,4707
170755,202309,996,2410,625,1753,123,366,278,697,401,1063
170765,202309,1336,3156,829,2239,148,380,411,1066,559,1446
170770,202309,2253,5694,1664,4696,127,394,1227,3325,1354,3719
170820,202309,4745,12289,3164,9328,652,1942,1447,4070,2099,6012
170825,202309,1332,2734,922,2122,94,202,671,1501,765,1703
170830,202309,1621,3790,1089,2885,374,1030,371,840,745,1870
170900,202309,3877,10355,3154,9256,480,1218,2112,6368,2592,7586
170930,202309,4949,12024,3323,8881,774,2177,1215,3003,1989,5180
170950,202309,14340,36748,8422,24967,2547,7965,1089,3071,3636,11036
170980,202309,627,1442,345,925,48,138,158,402,206,540
171050,202309,2009,5571,1573,4776,149,456,1118,3400,1267,3856
171070,202309,1637,4015,1275,3436,267,611,660,2002,927,2613
171090,202309,1172,2873,838,2325,148,433,428,1132,576,1565
171110,202309,667,1693,389,1123,69,197,168,446,237,643
171150,202309,1134,2581,618,1694,117,377,291,676,408,1053
171180,202309,766,2054,407,1301,78,250,143,450,221,700
171190,202309,2524,7057,1985,6067,323,1020,1118,3377,1441,4397
171195,202309,1022,2810,694,2137,90,292,401,1135,491,1427
171200,202309,734,1918,451,1386,116,383,114,307,230,690
171215,202309,503,1193,370,940,51,160,168,383,219,543
171240,202309,917,2654,628,2099,15,87,438,1381,453,1468
171245,202309,901,2404,595,1761,65,234,283,721,348,955
171250,202309,1099,2841,642,1952,92,292,245,728,337,1020
171270,202309,580,1830,398,1417,75,303,186,617,261,920
171280,202309,1040,2780,741,2241,64,195,449,1337,513,1532
171320,202309,4778,12172,3085,8886,651,1875,1131,3174,1782,5049
171330,202309,3670,8987,2371,6575,635,1772,955,2513,1590,4285
171360,202309,1927,4676,1230,3568,142,370,718,2219,860,2589
171370,202309,816,1939,552,1533,82,255,311,811,393,1066
171380,202309,1650,4054,1197,3328,176,447,722,2008,898,2455
171395,202309,1186,2808,753,2089,118,333,406,1081,524,1414
171420,202309,2409,5864,1577,4262,266,718,829,2111,1095,2829
171430,202309,1311,3411,912,2609,87,278,544,1419,631,1697
171488,202309,3027,7544,2077,5836,381,1125,1015,2695,1396,3820
171500,202309,1044,2432,615,1626,92,281,325,807,417,1088
171510,202309,1020,2845,773,2355,65,270,513,1434,578,1704
171515,202309,581,1294,384,977,35,101,246,566,281,667
171525,202309,852,2068,527,1468,63,196,313,798,376,994
171550,202309,404,1046,264,815,37,155,119,308,156,463
171570,202309,1333,3453,995,2798,150,432,582,1552,732,1984
171575,202309,1860,4495,1148,3201,186,523,560,1468,746,1991
171610,202309,7322,19001,4581,13784,1224,3953,761,2283,1985,6236
171620,202309,3637,8087,2888,6942,201,455,2243,5291,2444,5746
171630,202309,1335,3187,905,2505,139,387,527,1467,666,1854
171650,202309,2786,7336,1819,5409,492,1572,360,1013,852,2585
171660,202309,2762,6348,1709,4520,128,368,1171,2962,1299,3330
171665,202309,1551,3912,1049,3006,260,821,362,991,622,1812
171670,202309,2247,5371,1506,4034,311,897,670,1657,981,2554
171700,202309,1397,3514,923,2575,142,377,528,1430,670,1807
171720,202309,883,2030,557,1459,69,179,342,870,411,1049
171750,202309,1625,4519,1010,3256,211,677,296,1077,507,1754
171780,202309,1521,3453,973,2531,95,290,598,1451,693,1741
171790,202309,1622,4760,1205,3887,184,613,622,1914,806,2527
171800,202309,860,2065,568,1546,69,187,317,795,386,982
171820,202309,14667,37178,9145,26785,2139,6555,2313,6680,4452,13235
171830,202309,1911,5355,1497,4547,389,1110,635,2139,1024,3249
171840,202309,852,2013,539,1449,28,85,332,827,360,912
171845,202309,882,1937,556,1413,59,158,348,828,407,986
171850,202309,1258,3215,968,2628,49,204,769,1945,818,2149
171855,202309,1194,3317,817,2527,112,355,451,1313,563,1668
171865,202309,590,1508,421,1175,72,227,227,550,299,777
171870,202309,958,2411,572,1695,124,400,239,669,363,1069
171875,202309,1773,4240,1331,3520,68,285,1035,2571,1103,2856
171880,202309,1821,4203,1426,3619,66,208,1122,2755,1188,2963
171884,202309,1380,3158,928,2359,149,371,559,1391,708,1762
171886,202309,1738,4318,1104,3253,345,1066,273,826,618,1892
171888,202309,670,1786,423,1268,34,122,247,668,281,790
171889,202309,512,1457,303,1004,82,270,91,292,173,562
171890,202309,1581,4081,994,2979,115,371,568,1602,683,1973
171900,202309,717,2097,480,1609,64,213,234,774,298,987
172000,202309,670,1864,440,1367,82,261,148,436,230,697
172010,202309,1616,4329,1189,3515,110,290,775,2273,885,2563
172015,202309,441,1388,297,1064,58,224,131,430,189,654
172020,202309,3495,8815,2713,7547,344,942,1748,4900,2092,5842
172025,202309,869,2121,542,1520,48,142,360,936,408,1078
172030,202309,1485,3977,1090,3264,106,361,729,2089,835,2450
172049,202309,1383,3293,823,2411,108,303,435,1288,543,1591
172065,202309,1795,4104,1233,3269,172,407,631,1832,803,2239
172080,202309,2753,7302,2002,5858,129,411,1321,3759,1450,4170
172085,202309,493,1258,269,795,45,133,88,234,133,367
172090,202309,4968,10619,3626,8640,159,499,2834,6321,2993,6820
172093,202309,537,1472,350,1082,25,124,203,562,228,686
172097,202309,748,1822,412,1187,62,195,163,433,225,628
172100,202309,65852,148690,41201,105400,7810,21482,17746,42640,25556,64122
172110,202309,2123,6475,1654,5653,121,522,1231,4072,1352,4594
172120,202309,6341,16364,4344,12756,629,1766,2420,7022,3049,8788
172125,202309,488,1193,299,830,23,80,168,397,191,477
172130,202309,650,1549,418,1130,21,67,241,564,262,631
172208,202309,3019,6581,2121,5273,174,412,1481,3565,1655,3977
172210,202309,3245,7120,2248,5646,239,565,1525,3864,1764,4429
210005,202309,24662,62309,16438,47719,4715,14123,6080,17282,10795,31405
210010,202309,2684,6702,2361,6263,53,211,2121,5512,2174,5723
210015,202309,3867,10152,3140,9050,149,451,2580,7386,2729,7837
210020,202309,9564,18649,7730,16388,410,729,6615,13935,7025,14664
210030,202309,5570,16417,4768,15095,540,1748,3528,10948,4068,12696
210040,202309,2567,5084,2125,4528,76,203,1861,3845,1937,4048
210043,202309,6815,17495,5342,15230,365,1143,4002,11224,4367,12367
210047,202309,8506,21976,6356,18938,178,712,5272,15487,5450,16199
210050,202309,3007,8119,2258,6688,194,740,1642,4595,1836,5335
210055,202309,2576,6562,2123,5855,63,160,1804,5046,1867,5206
210060,202309,8808,28888,7406,26184,1068,3792,4746,17007,5814,20799
210070,202309,8072,18665,7039,17242,155,394,6335,15349,6490,15743
210080,202309,5390,14582,4874,13910,79,362,4340,12196,4419,12558
210083,202309,7204,16461,5882,14907,122,450,5386,13418,5508,13868
210087,202309,3148,8085,2532,7205,155,461,2049,5768,2204,6229
210090,202309,10951,29830,9575,27461,683,1503,7801,22477,8484,23980
210095,202309,7334,22806,6281,21109,755,2494,4483,15527,5238,18021
210100,202309,7727,20932,6179,18010,951,2592,3890,11352,4841,13944
210110,202309,3775,9233,3301,8595,57,242,2933,7455,2990,7697
210120,202309,35581,75600,27536,64365,1283,2630,21961,50091,23244,52721
210125,202309,5556,13038,4528,11697,943,1949,2992,8291,3935,10240
210130,202309,4969,11379,3799,9813,57,178,3359,8553,3416,8731
210135,202309,2161,4697,1683,3975,64,157,1456,3370,1520,3527
210140,202309,25771,61640,17916,49255,2659,7036,10264,27585,12923,34621
210150,202309,5597,12000,4520,10437,103,301,3849,8592,3952,8893
210160,202309,26919,60357,21481,52902,2697,5672,15335,38081,18032,43753
210170,202309,21443,54366,18279,49692,2388,5641,12881,35784,15269,41425
210173,202309,2603,8355,2368,7943,92,376,2056,6773,2148,7149
210177,202309,3843,9554,3132,8569,465,1162,2224,6222,2689,7384
210180,202309,1849,4085,1502,3604,44,118,1298,3103,1342,3221
210190,202309,6929,15083,5427,12866,105,230,4751,11012,4856,11242
210193,202309,1603,4042,1294,3539,92,261,958,2619,1050,2880
210197,202309,2370,6529,1992,5941,170,460,1527,4607,1697,5067
210200,202309,9770,26499,8101,23837,881,2602,5856,16975,6737,19577
210203,202309,8248,21901,6481,19393,731,2088,4659,14210,5390,16298
210207,202309,4593,10176,3449,8683,209,590,2658,6625,2867,7215
210210,202309,8908,24656,7688,22864,211,983,6373,18475,6584,19458
210215,202309,2907,8143,2431,7397,186,730,1933,5751,2119,6481
210220,202309,8647,23543,7809,22218,259,1281,6888,18762,7147,20043
210230,202309,6909,17278,5954,15715,249,607,5229,13701,5478,14308
210232,202309,14842,39256,11577,34129,1568,4407,7773,23157,9341,27564
210235,202309,4009,10696,3251,9446,150,522,2658,7581,2808,8103
210237,202309,5079,10802,4172,9723,67,185,3874,8891,3941,9076
210240,202309,3049,8145,2565,7334,128,326,2042,5829,2170,6155
210250,202309,7272,17580,6328,16330,130,464,5634,14237,5764,14701
210255,202309,3159,8598,2373,7012,301,918,1427,4044,1728,4962
210260,202309,6384,16612,5262,14867,565,1677,4005,11044,4570,12721
210270,202309,5712,13727,4754,12434,174,638,4007,10234,4181,10872
210275,202309,3959,9046,3154,7997,203,479,2535,6445,2738,6924
210280,202309,7646,17187,5957,14563,150,626,4780,10909,4930,11535
210290,202309,9947,21667,8459,19812,190,471,7736,17855,7926,18326
210300,202309,38152,96990,28701,81745,8627,24921,9984,31365,18611,56286
210310,202309,3609,7999,2968,7073,36,110,2690,6312,2726,6422
210312,202309,3467,7197,2923,6564,38,137,2626,5702,2664,5839
210315,202309,4351,9621,3738,8907,126,314,3429,8111,3555,8425
210317,202309,5178,14251,4546,13392,137,537,4010,11684,4147,12221
210320,202309,33251,69656,29360,64562,376,1422,26859,57433,27235,58855
210325,202309,4207,10766,3184,9245,569,1800,2115,6021,2684,7821
210330,202309,33553,77202,24767,65662,3418,7350,16325,46778,19743,54128
210340,202309,15223,33406,12672,29849,613,1275,10442,24727,11055,26002
210350,202309,11759,28038,9816,25299,187,582,8600,21731,8787,22313
210355,202309,4400,13313,3691,12077,95,501,3014,9685,3109,10186
210360,202309,14776,42416,12173,37679,646,2616,8664,25683,9310,28299
210370,202309,14613,27305,10453,22806,316,525,9508,20861,9824,21386
210375,202309,3845,9762,2500,7470,1062,3205,461,1372,1523,4577
210380,202309,6683,15355,5311,13472,255,684,4353,10784,4608,11468
210390,202309,3895,9743,3474,9075,107,396,3099,7922,3206,8318
210400,202309,5471,13735,4441,12302,281,631,3717,10394,3998,11025
210405,202309,8972,20607,6606,16979,976,2290,4050,10351,5026,12641
210407,202309,2470,6940,1941,5921,202,544,1386,4248,1588,4792
210408,202309,3284,10502,2930,9949,190,798,2326,7851,2516,8649
210409,202309,4586,13760,3852,12506,284,1133,2831,9162,3115,10295
210410,202309,4367,11288,3367,9374,81,308,2680,7135,2761,7443
210420,202309,4616,13143,3780,11597,242,706,3018,9163,3260,9869
210430,202309,2754,7047,2275,6312,197,530,1840,5070,2037,5600
210440,202309,4995,12213,3984,10742,201,437,3399,9116,3600,9553
210450,202309,2701,7082,2160,6202,296,663,1488,4402,1784,5065
210455,202309,5903,13607,4155,11088,1098,3017,1752,4555,2850,7572
210460,202309,3927,10324,3039,8996,141,485,2394,6941,2535,7426
210462,202309,2003,5398,1540,4621,66,201,1185,3533,1251,3734
210465,202309,3159,8082,2595,7245,140,472,2144,5838,2284,6310
210467,202309,7334,19057,6001,17115,954,2575,4143,11990,5097,14565
210470,202309,2035,5333,1461,4401,201,552,974,2953,1175,3505
210480,202309,20267,54183,15888,48010,2321,5306,10436,34270,12757,39576
210490,202309,3829,8711,2817,7289,115,317,2311,5913,2426,6230
210500,202309,7677,25041,6773,23349,429,1611,5455,18502,5884,20113
210510,202309,8291,20804,6976,19116,163,641,6345,17071,6508,17712
210515,202309,4373,11604,3539,10444,240,774,2829,8352,3069,9126
210520,202309,3102,8101,2528,7203,178,513,1995,5561,2173,6074
210530,202309,68836,154141,47241,119186,9848,25685,21708,54840,31556,80525
210535,202309,4576,12313,3927,11303,178,560,3363,9606,3541,10166
210540,202309,18232,46843,14098,40275,2483,6402,8263,24756,10746,31158
210542,202309,7650,16538,5326,13571,594,1542,3843,9645,4437,11187
210545,202309,2479,7035,2114,6350,64,263,1721,5030,1785,5293
210547,202309,4431,14036,3742,12780,330,1022,2777,9774,3107,10796
210550,202309,6905,19221,4880,15658,737,2376,2682,8664,3419,11040
210560,202309,4389,12346,3634,11024,131,392,3005,8971,3136,9363
210565,202309,1774,4593,1378,4001,106,332,986,2850,1092,3182
210570,202309,12879,32184,10736,29133,539,1410,8919,24077,9458,25487
210580,202309,3402,7909,2466,6566,223,572,1758,4844,1981,5416
210590,202309,4793,12916,3810,11503,93,425,3216,9487,3309,9912
210592,202309,3354,8208,2930,7463,45,172,2514,6197,2559,6369
210594,202309,2873,7523,2030,6055,235,683,1340,4015,1575,4698
210596,202309,3504,10399,2949,9415,363,1172,2136,6923,2499,8095
210598,202309,2394,5827,2043,5332,120,322,1715,4431,1835,4753
210600,202309,3570,8978,2674,7555,368,976,1681,4737,2049,5713
210610,202309,3725,8606,2864,7356,71,267,2392,5932,2463,6199
210620,202309,3558,7788,2757,6739,146,309,2321,5620,2467,5929
210630,202309,3759,10578,3121,9361,286,913,2285,6698,2571,7611
210632,202309,7309,16600,6252,15145,180,561,5487,12948,5667,13509
210635,202309,1839,6025,1649,5638,221,656,1173,4126,1394,4782
210637,202309,3279,8976,2620,7951,198,637,1990,6065,2188,6702
210640,202309,5930,16694,5350,15972,81,396,4795,14090,4876,14486
210650,202309,8181,20531,6870,18644,140,458,5959,15972,6099,16430
210660,202309,9402,24417,7848,21784,172,758,6723,17928,6895,18686
210663,202309,3678,8220,3084,7438,335,624,2256,5794,2591,6418
210667,202309,2241,6374,1897,5817,88,325,1560,4756,1648,5081
210670,202309,6975,17341,6001,15798,158,590,5237,13398,5395,13988
210675,202309,6566,14410,5245,12651,694,1495,3919,9515,4613,11010
210680,202309,5901,11808,4768,10424,91,206,4418,9546,4509,9752
210690,202309,11400,25519,9010,22448,246,662,8015,19397,8261,20059
210700,202309,3239,7883,2452,6681,184,413,1835,4979,2019,5392
210710,202309,6403,16428,5368,14952,109,405,4709,12898,4818,13303
210720,202309,3663,10080,3024,9208,121,465,2571,7755,2692,8220
210725,202309,1540,4358,1153,3611,47,125,842,2683,889,2808
210730,202309,1749,3595,1365,3062,47,95,1201,2677,1248,2772
210735,202309,5312,13250,4193,11675,440,1062,3188,9165,3628,10227
210740,202309,6342,14119,5005,12421,127,278,4218,10287,4345,10565
210745,202309,4953,11955,4134,10759,119,423,3527,8941,3646,9364
210750,202309,32404,76757,25676,66143,4450,9931,15219,40519,19669,50450
210760,202309,7759,15831,6295,14165,131,294,5777,12989,5908,13283
210770,202309,7339,16217,5850,14308,86,329,5245,12529,5331,12858
210780,202309,8712,23955,6912,20753,544,1644,5109,15011,5653,16655
210790,202309,5222,14204,4354,12902,364,1049,3320,10020,3684,11069
210800,202309,5852,13803,4751,12231,88,357,4156,10371,4244,10728
210805,202309,5053,15445,4396,14319,261,956,3446,11076,3707,12032
210810,202309,5974,15416,5021,14010,578,1398,3810,10903,4388,12301
210820,202309,8481,21916,6542,18565,1203,3183,3497,10076,4700,13259
210825,202309,10699,23807,9341,21954,239,696,8505,19487,8744,20183
210830,202309,10676,24684,9166,22616,942,1690,7253,18565,8195,20255
210840,202309,6075,10422,5282,9416,36,133,5021,8715,5057,8848
210845,202309,7351,17440,5899,15584,155,411,5251,13757,5406,14168
210850,202309,8622,21967,6838,19226,490,1442,5335,14735,5825,16177
210860,202309,25937,56620,20001,48824,1751,3553,15369,38425,17120,41978
210870,202309,8841,19196,6668,16502,210,454,5778,14144,5988,14598
210880,202309,4953,13041,4017,11554,313,1027,2974,8398,3287,9425
210890,202309,6064,13120,5214,11904,173,455,4655,10328,4828,10783
210900,202309,5858,15209,4088,11841,1502,4310,839,2719,2341,7029
210905,202309,2750,5627,2252,4985,55,122,2106,4631,2161,4753
210910,202309,8809,24628,6586,20493,1389,4119,3367,10390,4756,14509
210920,202309,3724,10267,3151,9426,84,347,2757,8066,2841,8413
210923,202309,2330,5211,1893,4534,92,207,1514,3500,1606,3707
210927,202309,5457,16333,4486,14844,845,2596,2639,9102,3484,11698
210930,202309,3503,9006,2910,7985,106,324,2457,6493,2563,6817
210940,202309,4020,10841,3419,10036,278,1202,2682,7261,2960,8463
210945,202309,10230,23120,8706,21181,668,1226,6916,17164,7584,18390
210950,202309,6418,15822,4647,13180,662,1486,2958,8881,3620,10367
210955,202309,1794,4871,1374,4133,180,524,872,2573,1052,3097
210960,202309,11089,29447,8640,25143,3745,10703,2167,7182,5912,17885
210970,202309,2095,4805,1612,3969,93,249,1293,3021,1386,3270
210975,202309,1984,5517,1672,4972,236,723,1145,3339,1381,4062
210980,202309,12712,24624,10870,22522,307,489,9930,20480,10237,20969
210990,202309,21857,52920,15938,44304,1870,4731,10629,30044,12499,34775
211000,202309,17286,44021,13351,38494,3363,8452,7768,23973,11131,32425
211003,202309,7593,17454,6072,15533,146,594,5155,12879,5301,13473
211010,202309,8429,23680,7372,22250,164,734,6484,19431,6648,20165
211020,202309,11427,26178,9595,23926,234,660,8425,20936,8659,21596
211023,202309,2471,7030,2116,6440,132,355,1651,4954,1783,5309
211027,202309,4751,11560,4260,10797,96,342,3862,9557,3958,9899
211030,202309,4557,11348,3811,10210,456,1184,2788,7578,3244,8762
211040,202309,5330,16568,4680,15432,149,691,4044,13094,4193,13785
211050,202309,10894,24577,9166,22263,174,549,8022,19126,8196,19675
211060,202309,9288,22456,8039,20622,272,916,7005,17484,7277,18400
211065,202309,2952,6782,2289,5866,123,279,1935,4958,2058,5237
211070,202309,10277,27170,8259,23929,390,1225,6777,19288,7167,20513
211080,202309,1568,3748,1156,3067,32,135,889,2165,921,2300
211085,202309,2668,6539,2043,5668,236,552,1489,4311,1725,4863
211090,202309,3712,9090,3179,8369,53,189,2850,7380,2903,7569
211100,202309,9071,18500,7983,17163,86,202,7361,15612,7447,15814
211102,202309,3902,10981,3350,10097,621,1886,2259,6751,2880,8637
211105,202309,2756,7652,2224,6694,123,366,1726,5074,1849,5440
211107,202309,5480,15465,4315,13513,183,592,3407,10806,3590,11398
211110,202309,7712,17760,5805,14740,448,1125,4530,11252,4978,12377
211120,202309,62807,136565,47334,115164,8198,17884,28657,71242,36855,89126
211125,202309,2154,5858,1668,5061,33,135,1366,4059,1399,4194
211130,202309,226182,484980,181237,416468,25594,52423,117380,270876,142974,323299
211140,202309,5599,14694,4465,12944,179,507,3624,10395,3803,10902
211150,202309,11621,27192,9074,23609,585,1190,6932,18581,7517,19771
211153,202309,3669,8791,2341,6964,480,1255,1296,4128,1776,5383
211157,202309,1526,4174,1225,3612,114,358,809,2323,923,2681
211160,202309,6575,14201,4932,11728,190,648,3885,8602,4075,9250
211163,202309,1730,4954,1477,4536,82,270,1180,3646,1262,3916
211167,202309,2040,5180,1774,4771,38,115,1547,4097,1585,4212
211170,202309,8869,17135,7693,15634,104,283,7148,14168,7252,14451
211172,202309,3023,7597,2339,6472,102,320,1887,5007,1989,5327
211174,202309,3477,8691,3002,8114,47,195,2761,7363,2808,7558
211176,202309,4964,12540,3649,10501,241,767,2837,7973,3078,8740
211178,202309,6575,12298,5477,11089,47,186,5206,10321,5253,10507
211180,202309,4924,14223,4230,13062,170,664,3402,10261,3572,10925
211190,202309,3830,9414,3095,8281,50,214,2710,7063,2760,7277
211195,202309,1903,4370,1529,3778,74,172,1292,3165,1366,3337
211200,202309,2477,6778,1728,5357,185,596,1157,3465,1342,4061
211210,202309,7191,20014,5990,18081,628,1880,4399,13202,5027,15082
211220,202309,53415,113750,40939,96450,3953,8721,29798,68786,33751,77507
211223,202309,6282,15333,4618,12787,686,1929,2650,7211,3336,9140
211227,202309,2001,5557,1652,5027,67,262,1338,4056,1405,4318
211230,202309,10506,25186,8459,22103,328,751,7144,18485,7472,19236
211240,202309,12886,28376,11785,26985,157,563,11104,24929,11261,25492
211245,202309,8995,18703,7452,16972,194,455,6893,15465,7087,15920
211250,202309,18402,46934,15795,42682,1442,3868,12100,32171,13542,36039
211260,202309,9977,26974,8182,24711,293,977,7028,21173,7321,22150
211270,202309,11961,33028,9792,29983,458,1534,7689,23517,8147,25051
211280,202309,19490,40860,16398,36682,340,870,14802,32276,15142,33146
211285,202309,2448,6818,2040,6171,208,689,1424,4228,1632,4917
211290,202309,8565,22638,7095,20221,434,1316,5426,15136,5860,16452
211300,202309,8382,22363,6729,19404,487,1495,4846,13537,5333,15032
211400,202309,13889,33929,10538,28873,1628,4126,6639,18786,8267,22912
220005,202309,2374,5328,1968,4685,87,212,1624,3712,1711,3924
220010,202309,1781,4415,1311,3551,83,178,990,2656,1073,2834
220020,202309,5677,11808,4533,10146,274,544,3828,8367,4102,8911
220025,202309,2735,5302,2146,4401,55,98,1821,3601,1876,3699
220027,202309,1679,3522,1320,2982,36,95,1121,2437,1157,2532
220030,202309,4750,9816,3983,8659,123,260,3521,7458,3644,7718
220040,202309,10329,27025,8257,23023,1780,4537,4395,12578,6175,17115
220045,202309,1969,4841,1505,4056,51,221,1210,3057,1261,3278
220050,202309,6842,14299,5518,12491,85,289,4927,10666,5012,10955
220060,202309,3468,5875,2732,4999,89,180,2494,4480,2583,4660
220070,202309,2819,6474,2150,5479,100,280,1684,4141,1784,4421
220080,202309,883,2251,678,1905,23,90,537,1435,560,1525
220090,202309,2037,4259,1502,3425,50,128,1231,2735,1281,2863
220095,202309,1271,2233,1073,1967,27,67,965,1696,992,1763
220100,202309,1677,3946,1195,3147,41,126,933,2308,974,2434
220105,202309,2370,6416,1871,5545,194,604,1295,3780,1489,4384
220110,202309,4241,9873,3348,8409,81,313,2803,6825,2884,7138
220115,202309,3507,8816,2900,7829,190,557,2248,5866,2438,6423
220117,202309,1592,3395,1161,2740,28,83,945,2139,973,2222
220120,202309,20925,39543,18124,35946,197,535,16703,32299,16900,32834
220130,202309,1321,3066,1034,2660,32,123,892,2197,924,2320
220140,202309,2841,5127,2153,4290,87,151,1807,3604,1894,3755
220150,202309,7965,19630,6663,17305,195,618,5423,13514,5618,14132
220155,202309,1423,3685,1043,2973,33,103,736,2015,769,2118
220157,202309,1297,2771,1009,2340,51,122,781,1738,832,1860
220160,202309,3515,8256,2666,6714,77,251,2134,5142,2211,5393
220170,202309,1808,4370,1363,3675,41,146,1095,2865,1136,3011
220173,202309,2501,6316,1792,5006,62,206,1412,3813,1474,4019
220177,202309,2861,6130,2552,5747,38,141,2389,5238,2427,5379
220180,202309,1399,2839,1057,2250,6,23,911,1814,917,1837
220190,202309,10271,20327,7948,17141,676,1222,5761,12545,6437,13767
220191,202309,2029,5198,1708,4637,147,439,1247,3251,1394,3690
220192,202309,2403,5666,1628,4312,57,190,1289,3347,1346,3537
220194,202309,2295,5312,1828,4474,40,156,1537,3559,1577,3715
220196,202309,2557,5767,2152,5089,25,104,1802,4084,1827,4188
220198,202309,1556,3398,1254,2999,19,55,1126,2688,1145,2743
220200,202309,6068,15644,5034,14080,211,692,4061,11108,4272,11800
220202,202309,2576,6193,2027,5274,36,139,1693,4226,1729,4365
220205,202309,3304,7537,2728,6502,72,219,2279,5231,2351,5450
220207,202309,960,2494,753,2130,86,222,451,1270,537,1492
220208,202309,2158,5951,1649,4951,589,1883,503,1411,1092,3294
220209,202309,1871,4938,1416,4022,23,96,1119,3086,1142,3182
220210,202309,2276,4594,1780,3832,44,100,1513,3126,1557,3226
220211,202309,1973,4152,1654,3705,38,126,1395,3031,1433,3157
220213,202309,2148,4958,1639,4024,46,136,1278,2919,1324,3055
220217,202309,2959,6993,2574,6527,173,363,2230,5787,2403,6150
220220,202309,16863,33188,13435,28067,381,917,11474,23069,11855,23986
220225,202309,1222,2651,948,2280,18,71,844,1960,862,2031
220230,202309,6966,15050,5429,12757,397,799,4378,10158,4775,10957
220240,202309,4004,9682,3078,8053,102,353,2468,6165,2570,6518
220245,202309,2494,4319,1763,3429,26,77,1594,3017,1620,3094
220250,202309,3674,8720,3014,7845,51,166,2684,6865,2735,7031
220253,202309,2025,4856,1565,4112,50,142,1274,3253,1324,3395
220255,202309,2439,4987,1961,4302,63,195,1671,3485,1734,3680
220260,202309,6317,15072,5014,12793,277,709,3934,9843,4211,10552
220265,202309,1923,4849,1624,4375,83,267,1317,3395,1400,3662
220270,202309,7417,21121,6497,19293,206,790,5353,15089,5559,15879
220271,202309,1812,3949,1465,3396,62,146,1225,2778,1287,2924
220272,202309,2076,5352,1666,4566,77,229,1242,3242,1319,3471
220273,202309,1501,3935,1127,3237,80,251,803,2264,883,2515
220275,202309,3135,5932,2309,4808,81,139,2007,4104,2088,4243
220277,202309,2832,5844,2141,4779,101,207,1789,3851,1890,4058
220280,202309,2413,4361,1909,3721,20,41,1722,3287,1742,3328
220285,202309,2030,4025,1635,3529,26,78,1477,3097,1503,3175
220290,202309,8470,20609,6153,17008,595,1485,4114,11480,4709,12965
220300,202309,2276,5883,1633,4924,86,313,1206,3529,1292,3842
220310,202309,3906,8989,2856,7583,110,343,2355,6140,2465,6483
220320,202309,3740,9353,2697,7518,64,289,2130,5644,2194,5933
220323,202309,2065,5056,1473,4055,55,199,1185,3083,1240,3282
220325,202309,1483,3988,1114,3292,33,119,842,2405,875,2524
220327,202309,2035,4893,1624,4193,73,263,1288,3120,1361,3383
220330,202309,6635,13152,5319,11496,142,411,4647,9692,4789,10103
220335,202309,2236,5488,1917,4998,132,293,1552,4039,1684,4332
220340,202309,2082,5192,1418,3992,195,522,737,2034,932,2556
220342,202309,1487,3640,1223,3198,116,227,913,2445,1029,2672
220345,202309,3601,7232,2516,5691,31,82,2179,4771,2210,4853
220350,202309,3901,8994,2790,7145,243,623,1875,4658,2118,5281
220360,202309,1612,3560,1152,2795,29,90,914,2092,943,2182
220370,202309,11067,27347,9307,24387,511,1396,7549,19338,8060,20734
220375,202309,2090,4811,1756,4377,34,114,1638,4029,1672,4143
220380,202309,1879,3742,1377,3024,27,60,1197,2598,1224,2658
220385,202309,1126,2204,815,1677,8,25,727,1444,735,1469
220390,202309,16360,34031,11876,27089,2211,4965,6495,14376,8706,19341
220400,202309,1822,3902,1243,2955,30,97,965,2130,995,2227
220410,202309,1429,3468,1044,2782,32,113,832,2106,864,2219
220415,202309,985,2323,732,1867,22,43,550,1367,572,1410
220420,202309,2226,5770,1592,4510,193,541,980,2656,1173,3197
220430,202309,3561,7570,2898,6641,66,145,2520,5641,2586,5786
220435,202309,2508,5333,1989,4477,50,130,1650,3565,1700,3695
220440,202309,3957,8990,3194,7839,70,302,2765,6395,2835,6697
220450,202309,3354,7345,2618,6304,61,214,2229,5184,2290,5398
220455,202309,1756,4176,1553,3893,29,90,1369,3384,1398,3474
220460,202309,1388,2794,1171,2468,28,54,1007,2049,1035,2103
220465,202309,2982,7878,2465,7014,188,485,1855,5191,2043,5676
220470,202309,4703,11131,3720,9388,202,442,2786,6847,2988,7289
220480,202309,3164,7486,2230,5892,265,555,1419,3755,1684,4310
220490,202309,2889,6344,2241,5398,37,122,1938,4537,1975,4659
220500,202309,4063,8667,3050,7031,183,358,2323,5163,2506,5521
220510,202309,3263,7553,2426,6064,154,374,1865,4646,2019,5020
220515,202309,2217,4501,1880,3985,72,110,1605,3365,1677,3475
220520,202309,6358,13907,5285,12213,115,308,4496,10101,4611,10409
220525,202309,1679,3545,1306,3051,42,102,1136,2643,1178,2745
220527,202309,2034,4274,1578,3546,86,181,1377,3061,1463,3242
220530,202309,2020,4044,1534,3414,166,341,1101,2484,1267,2825
220535,202309,950,2356,826,2135,16,56,640,1539,656,1595
220540,202309,3841,10636,3258,9482,246,702,2465,7088,2711,7790
220545,202309,1836,4681,1518,4159,82,268,1266,3376,1348,3644
220550,202309,10544,29743,8518,25643,663,2064,5708,16401,6371,18465
220551,202309,1759,4147,1414,3541,21,60,1185,2870,1206,2930
220552,202309,1895,4943,1410,4022,29,116,1119,3009,1148,3125
220553,202309,2602,5069,2013,4253,25,53,1838,3819,1863,3872
220554,202309,1172,2521,843,2006,66,126,622,1447,688,1573
220555,202309,4763,8592,3923,7535,56,164,3462,6563,3518,6727
220556,202309,1575,3884,1145,3024,43,180,785,1850,828,2030
220557,202309,2306,5978,1566,4455,104,354,1144,3083,1248,3437
220558,202309,1777,4067,1334,3405,36,125,1101,2687,1137,2812
220559,202309,2236,4756,1734,3921,63,109,1426,3182,1489,3291
220560,202309,2369,4478,1876,3871,38,105,1685,3392,1723,3497
220570,202309,9918,25380,8381,22816,817,2038,6020,16142,6837,18180
220580,202309,8143,19373,6878,17384,165,493,5927,14695,6092,15188
220585,202309,2522,6860,1886,5558,76,219,1471,4237,1547,4456
220590,202309,2042,4240,1581,3530,112,240,1264,2742,1376,2982
220595,202309,3378,8020,2775,7089,85,309,2280,5552,2365,5861
220600,202309,2229,3753,1773,3214,23,33,1652,2942,1675,2975
220605,202309,1704,4569,1336,3828,29,122,1029,2838,1058,2960
220610,202309,3566,8425,3091,7724,41,115,2860,7033,2901,7148
220620,202309,10962,26025,9337,23579,152,631,8309,20297,8461,20928
220630,202309,412,1104,293,888,31,104,174,476,205,580
220635,202309,2160,5583,1729,4716,55,170,1409,3722,1464,3892
220640,202309,2897,7091,2316,6135,79,270,1817,4632,1896,4902
220650,202309,3028,6657,2414,5705,66,151,2042,4768,2108,4919
220660,202309,3183,8481,2440,7130,75,303,1998,5659,2073,5962
220665,202309,1720,4197,1360,3590,31,140,1192,3010,1223,3150
220667,202309,1904,4968,1609,4431,72,210,1278,3429,1350,3639
220669,202309,1985,5202,1727,4750,42,137,1499,4011,1541,4148
220670,202309,2863,5979,2122,4900,46,135,1831,4104,1877,4239
220672,202309,4128,9035,3191,7790,113,351,2661,6243,2774,6594
220675,202309,1574,3830,1291,3299,109,298,949,2339,1058,2637
220680,202309,3786,7841,3406,7357,159,261,3031,6535,3190,6796
220690,202309,1875,4366,1416,3590,108,305,1036,2500,1144,2805
220695,202309,1105,2743,924,2421,31,85,766,1967,797,2052
220700,202309,15530,29552,11798,24263,441,990,9672,18932,10113,19922
220710,202309,1066,2558,713,1950,31,106,548,1431,579,1537
220720,202309,2708,5379,2213,4685,34,88,1929,3950,1963,4038
220730,202309,1722,3907,1334,3255,17,68,1129,2608,1146,2676
220735,202309,1214,2438,841,1828,53,114,643,1338,696,1452
220740,202309,1627,3755,1177,3093,82,206,913,2365,995,2571
220750,202309,5367,10974,4353,9551,251,405,3793,8368,4044,8773
220755,202309,1839,3683,1360,2963,48,99,1117,2369,1165,2468
220760,202309,4205,8969,3459,7987,60,197,3147,7087,3207,7284
220770,202309,35570,87822,27868,73877,8771,23148,9803,26156,18574,49304
220775,202309,1775,3665,1490,3311,20,57,1406,3082,1426,3139
220777,202309,1826,4105,1345,3334,33,70,954,2425,987,2495
220779,202309,1466,3524,1161,3036,133,235,877,2366,1010,2601
220780,202309,7345,15687,6165,13935,471,1008,4663,10461,5134,11469
220785,202309,1757,3481,1448,3076,26,55,1358,2843,1384,2898
220790,202309,12824,30608,10763,27401,335,1049,8880,22088,9215,23137
220793,202309,1196,2647,903,2156,24,76,780,1819,804,1895
220795,202309,1646,3771,1320,3278,57,156,1121,2709,1178,2865
220800,202309,26704,50143,20879,41816,2095,4310,15576,29721,17671,34031
220810,202309,3795,9032,2937,7603,84,212,2279,5892,2363,6104
220820,202309,7446,15375,6097,13346,338,593,5063,11009,5401,11602
220830,202309,9410,20933,7741,18274,450,1007,6011,13675,6461,14682
220840,202309,16914,41266,13248,34226,1607,3987,8828,21865,10435,25852
220850,202309,3570,9605,3008,8781,73,295,2601,7477,2674,7772
220855,202309,1052,1953,861,1707,22,50,788,1550,810,1600
220860,202309,1512,2903,1201,2463,28,68,1089,2169,1117,2237
220865,202309,2688,6647,1876,5132,52,217,1352,3469,1404,3686
220870,202309,3989,8808,3001,7420,60,208,2575,6153,2635,6361
220880,202309,8286,14560,6739,12668,195,409,6017,11054,6212,11463
220885,202309,1831,4350,1450,3762,140,346,1107,2852,1247,3198
220887,202309,1981,3593,1522,2969,50,68,1405,2717,1455,2785
220890,202309,1681,4470,1291,3775,54,191,994,2817,1048,3008
220900,202309,2628,5206,2055,4404,41,116,1783,3658,1824,3774
220910,202309,2170,4670,1690,3921,361,634,1100,2717,1461,3351
220915,202309,1083,2687,745,2053,42,125,516,1330,558,1455
220920,202309,1996,5002,1605,4410,131,359,1229,3340,1360,3699
220930,202309,2425,5060,1880,4313,43,129,1630,3750,1673,3879
220935,202309,1259,3300,919,2583,24,102,612,1607,636,1709
220937,202309,1767,4056,1323,3278,36,127,1063,2482,1099,2609
220940,202309,2291,4739,1744,3849,56,147,1433,3025,1489,3172
220945,202309,593,1810,422,1449,37,154,258,850,295,1004
220950,202309,1645,3336,1056,2433,13,38,868,1870,881,1908
220955,202309,2039,4325,1515,3456,39,120,1276,2792,1315,2912
220960,202309,882,2075,582,1550,62,196,348,836,410,1032
220965,202309,2271,5079,1820,4364,30,133,1593,3651,1623,3784
220970,202309,2611,4993,1835,3879,23,84,1600,3230,1623,3314
220975,202309,925,2122,690,1771,27,87,579,1422,606,1509
220980,202309,1628,3639,1366,3244,33,96,1173,2676,1206,2772
220985,202309,1800,3764,1408,3097,102,177,1087,2355,1189,2532
220987,202309,1845,4575,1530,4030,47,173,1277,3266,1324,3439
220990,202309,1990,4860,1611,4232,45,146,1296,3325,1341,3471
220995,202309,1723,3816,1332,3174,21,61,1143,2652,1164,2713
220997,202309,2910,7385,2509,6699,61,226,2128,5439,2189,5665
221000,202309,5931,13585,4688,11627,234,647,3657,8706,3891,9353
221005,202309,2002,4380,1711,3879,33,106,1441,3083,1474,3189
221010,202309,1550,2937,1134,2410,32,80,964,1966,996,2046
221020,202309,1817,4968,1466,4286,35,133,1117,3173,1152,3306
221030,202309,2081,4124,1634,3513,24,71,1456,3080,1480,3151
221035,202309,1896,4129,1423,3428,59,126,1179,2804,1238,2930
221037,202309,848,2010,621,1578,19,53,465,1090,484,1143
221038,202309,622,1529,449,1228,41,94,293,783,334,877
221039,202309,990,2408,762,2029,35,109,583,1484,618,1593
221040,202309,5503,13628,4126,11159,303,824,3046,8017,3349,8841
221050,202309,5662,11061,4701,9710,92,232,4293,8707,4385,8939
221060,202309,12093,28412,9073,23171,657,1367,6741,16978,7398,18345
221062,202309,1654,4099,1302,3521,129,289,933,2542,1062,2831
221063,202309,1532,3538,1164,2880,43,119,944,2235,987,2354
221065,202309,3596,7550,2883,6405,38,82,2557,5530,2595,5612
221070,202309,4014,11039,3001,8976,537,1517,1687,5151,2224,6668
221080,202309,4449,9411,3428,7890,70,216,2797,6043,2867,6259
221090,202309,1686,3603,1309,2996,18,41,1140,2537,1158,2578
221093,202309,2091,4617,1718,3956,187,375,1207,2702,1394,3077
221095,202309,1079,2462,833,2095,39,89,663,1643,702,1732
221097,202309,1000,2254,698,1741,22,66,518,1211,540,1277
221100,202309,190371,415379,147211,341777,11339,28059,104453,227080,115792,255139
221110,202309,14179,33145,11998,30001,422,1139,10142,24756,10564,25895
221120,202309,6135,15495,4967,13555,204,635,3964,10523,4168,11158
221130,202309,7318,15590,5233,11831,1421,2753,2656,6041,4077,8794
221135,202309,2431,5100,1976,4484,97,168,1668,3812,1765,3980
221140,202309,1928,3515,1479,2933,73,134,1247,2404,1320,2538
221150,202309,1355,3000,905,2241,32,98,700,1615,732,1713
221160,202309,903,1966,723,1691,37,56,551,1281,588,1337
221170,202309,1368,3019,1202,2729,18,46,1106,2465,1124,2511
230010,202309,3598,8436,2673,6815,220,502,1989,4934,2209,5436
230015,202309,4505,11701,3718,10095,247,702,2544,6712,2791,7414
230020,202309,18871,47761,16539,43847,1495,3452,12505,33077,14000,36529
230030,202309,15598,34253,12073,29029,687,1403,9190,22296,9877,23699
230040,202309,5702,12060,4518,10257,101,300,3574,8182,3675,8482
230050,202309,3030,8690,2056,6341,383,1119,922,2607,1305,3726
230060,202309,3026,7002,2130,5395,51,187,1709,4151,1760,4338
230070,202309,5521,12017,3918,9197,716,1562,2394,5549,3110,7111
230075,202309,12321,32356,10519,29112,1126,2660,7593,20848,8719,23508
230080,202309,3694,6792,2693,5531,18,47,2467,4945,2485,4992
230090,202309,5627,11596,4259,9398,171,375,3558,7523,3729,7898
230100,202309,28193,59809,22477,51132,2586,5583,15013,33549,17599,39132
230110,202309,17741,45823,13614,37652,3384,8609,5802,15965,9186,24574
230120,202309,9888,22969,7587,19034,1079,2530,4768,11773,5847,14303
230125,202309,3803,8856,2993,7498,134,360,2271,5407,2405,5767
230130,202309,6935,18506,5080,14623,500,1255,3393,9591,3893,10846
230140,202309,4334,11223,3287,9097,103,369,2469,6443,2572,6812
230150,202309,1923,5031,1456,4066,258,676,777,2185,1035,2861
230160,202309,8889,17889,7152,15320,317,598,5917,12373,6234,12971
230170,202309,7522,19164,5581,15320,550,1398,3718,9937,4268,11335
230180,202309,2006,4760,1483,3782,26,91,1220,2961,1246,3052
230185,202309,5787,13341,4376,11002,589,1378,2878,7243,3467,8621
230190,202309,18394,49727,13202,38852,2455,6725,6248,17932,8703,24657
230195,202309,7158,18052,5971,15937,373,929,4504,11854,4877,12783
230200,202309,5971,14760,4608,12162,368,877,3288,8369,3656,9246
230205,202309,5652,13213,4695,11790,595,1196,3331,8470,3926,9666
230210,202309,13297,26824,10645,23031,429,921,8675,18053,9104,18974
230220,202309,19133,41138,15716,36096,1360,2846,11863,26625,13223,29471
230230,202309,8795,21826,7474,19268,866,1787,5254,13629,6120,15416
230240,202309,17003,37786,13218,31574,1013,1996,9612,22387,10625,24383
230250,202309,11769,28177,9972,25001,2270,4972,5123,12623,7393,17595
230260,202309,18704,46823,14960,39983,2212,5514,9031,23653,11243,29167
230270,202309,8690,20882,6012,15877,985,2387,3311,8890,4296,11277
230280,202309,24744,55806,19156,46220,565,1885,15285,34268,15850,36153
230290,202309,6043,13718,4966,11799,238,562,3971,9116,4209,9678
230300,202309,6229,13850,5189,12359,97,319,4416,10238,4513,10557
230310,202309,5909,14767,4358,11762,195,600,3097,7905,3292,8505
230320,202309,9361,23740,7239,20004,268,979,5389,14159,5657,15138
230330,202309,5915,13915,4116,10519,245,574,3034,7468,3279,8042
230340,202309,4625,12866,3685,10924,356,996,2386,6878,2742,7874
230350,202309,23674,54240,19066,46806,1362,3643,13516,31777,14878,35420
230360,202309,3765,8500,2748,6815,159,377,2019,4972,2178,5349
230365,202309,3745,7808,2981,6681,93,247,2599,5728,2692,5975
230370,202309,105740,220676,86804,191577,6266,14129,66674,140477,72940,154606
230380,202309,7486,18312,5435,14465,148,465,4105,10355,4253,10820
230390,202309,4127,10331,3301,8950,86,352,2595,6757,2681,7109
230393,202309,4239,10249,3133,8133,70,305,2501,6088,2571,6393
230395,202309,6910,16919,5203,13698,528,1387,3362,8393,3890,9780
230400,202309,7117,16602,5710,14239,151,509,4631,10849,4782,11358
230410,202309,16586,43352,12711,36264,1575,4137,8125,22888,9700,27025
230420,202309,39125,91073,28871,72545,3598,8726,17300,41126,20898,49852
230423,202309,5435,14390,4405,12278,346,964,3084,8326,3430,9290
230425,202309,7736,20195,6654,17999,789,1957,4483,11937,5272,13894
230426,202309,3299,7532,2158,5376,81,232,1612,3824,1693,4056
230427,202309,2179,5454,1345,3719,105,304,868,2203,973,2507
230428,202309,12680,30436,9924,25708,1647,4114,5300,13055,6947,17169
230430,202309,5977,15213,4276,12074,225,565,3135,8612,3360,9177
230435,202309,7989,17674,5548,13419,851,1968,3135,7343,3986,9311
230440,202309,632055,1270051,494115,1057440,38400,86488,355272,716645,393672,803133
230445,202309,4956,12207,3713,9930,383,910,2361,6013,2744,6923
230450,202309,4652,11312,3670,9657,203,587,2643,6472,2846,7059
230460,202309,2731,6275,2240,5516,84,258,1820,4346,1904,4604
230465,202309,5050,12258,3911,10133,384,778,2780,7110,3164,7888
230470,202309,14487,40227,12243,35990,1275,3093,8502,24543,9777,27636
230480,202309,1912,4607,1397,3653,86,253,999,2470,1085,2723
230490,202309,3411,8332,2539,6636,239,669,1599,3808,1838,4477
230495,202309,7641,18249,6026,15323,1019,2386,3575,8816,4594,11202
230500,202309,11508,32506,9323,28329,780,2139,6679,20284,7459,22423
230510,202309,2187,5194,1587,4015,185,495,1000,2352,1185,2847
230520,202309,5939,13860,4762,11797,385,905,3527,8434,3912,9339
230523,202309,21299,55434,13894,39243,3270,8842,3479,10138,6749,18980
230526,202309,4820,11419,3713,9535,271,536,2680,6960,2951,7496
230530,202309,6728,18827,5218,15852,1341,3922,2604,8018,3945,11940
230533,202309,6071,11372,4318,8779,96,271,3642,6966,3738,7237
230535,202309,5866,15142,4469,12601,414,1166,2794,7654,3208,8820
230540,202309,18569,45270,14569,38477,378,1245,11645,29537,12023,30782
230550,202309,28539,63762,21054,50745,3190,6216,13073,31200,16263,37416
230560,202309,9229,19262,6778,15551,699,952,5038,12180,5737,13132
230565,202309,3745,8966,2937,7519,139,367,2264,5554,2403,5921
230570,202309,4054,9264,3152,7854,82,267,2572,6150,2654,6417
230580,202309,15202,32458,12040,27621,894,1617,9700,22020,10594,23637
230590,202309,11881,28638,9085,23668,853,2081,6366,16211,7219,18292
230600,202309,4675,10305,3419,8190,327,614,2221,5404,2548,6018
230610,202309,8388,20132,6852,17523,589,1438,5144,12905,5733,14343
230620,202309,2795,6136,2047,4765,74,216,1548,3276,1622,3492
230625,202309,13349,31123,10467,25822,2142,5374,5170,12049,7312,17423
230630,202309,14364,35392,11529,30115,1741,3978,6867,18028,8608,22006
230640,202309,32825,89581,27244,79229,1882,5636,19727,54983,21609,60619
230650,202309,6337,14941,4959,12579,409,912,3770,9314,4179,10226
230655,202309,12187,33620,10982,31465,864,2173,8675,24797,9539,26970
230660,202309,7258,18749,5500,15580,179,719,4293,11688,4472,12407
230670,202309,7190,15186,4778,11347,251,539,3763,8634,4014,9173
230680,202309,3499,8311,2562,6638,174,395,1751,4467,1925,4862
230690,202309,8579,22442,6421,18056,578,1579,3900,10755,4478,12334
230700,202309,12992,28189,9374,21664,363,1023,7324,16008,7687,17031
230710,202309,8191,22892,6436,18979,763,2177,4042,11411,4805,13588
230720,202309,2319,6081,1685,4832,134,373,1051,2871,1185,3244
230725,202309,5927,15129,5033,13542,760,1938,3014,7923,3774,9861
230730,202309,76567,176452,54513,140886,12365,30850,22609,58870,34974,89720
230740,202309,7302,18041,5601,15122,184,583,4287,11282,4471,11865
230750,202309,10308,24049,7373,18771,154,519,5971,14301,6125,14820
230760,202309,14645,33641,11439,28183,674,1818,8261,19126,8935,20944
230763,202309,5839,13783,4409,11280,104,417,3511,8413,3615,8830
230765,202309,59610,137962,46488,114838,4874,12430,30195,70255,35069,82685
230770,202309,36089,71043,28035,59686,1934,4215,21100,42830,23034,47045
230780,202309,8260,24513,6868,21247,1041,2864,4096,12745,5137,15609
230790,202309,3951,9403,3369,8458,149,430,2598,6181,2747,6611
230800,202309,11094,29607,8827,24847,1192,3087,5292,14252,6484,17339
230810,202309,13114,35273,10690,30714,1028,2401,7371,20872,8399,23273
230820,202309,4418,12542,3213,9839,468,1396,1826,5358,2294,6754
230830,202309,9168,21572,7095,17891,393,887,5271,12759,5664,13646
230835,202309,4932,10431,3523,8211,132,312,2944,6603,3076,6915
230837,202309,5055,11103,4176,9736,85,280,3690,8205,3775,8485
230840,202309,11641,30515,9267,26161,887,2402,6504,18101,7391,20503
230850,202309,12420,29778,9737,24993,640,1481,7190,18132,7830,19613
230860,202309,7998,14707,6254,12209,178,341,5550,10493,5728,10834
230870,202309,22684,44662,17468,36189,1009,1773,13909,27802,14918,29575
230880,202309,2366,6368,2026,5692,75,273,1553,4121,1628,4394
230890,202309,5636,15639,4737,13942,310,1034,3320,9495,3630,10529
230900,202309,4130,10180,3179,8293,335,793,2088,5266,2423,6059
230910,202309,4248,9268,3126,7550,77,298,2617,6091,2694,6389
230920,202309,5791,14220,4293,11619,161,517,3234,8373,3395,8890
230930,202309,8411,20823,6247,16949,1038,2216,3626,10017,4664,12233
230940,202309,10243,22257,8074,18859,222,513,6862,15659,7084,16172
230945,202309,7899,19798,6270,16747,589,1289,4250,11065,4839,12354
230950,202309,7800,16713,6286,14479,217,536,5219,11761,5436,12297
230960,202309,15797,40605,12092,33043,2129,5700,5889,15172,8018,20872
230970,202309,19888,46090,15355,38396,2098,4958,9327,22543,11425,27501
230980,202309,4369,9262,3458,7727,294,591,2574,5598,2868,6189
230990,202309,2048,5047,1557,4111,84,293,1153,2846,1237,3139
231000,202309,3728,8089,2626,6148,79,221,2068,4581,2147,4802
231010,202309,4463,8985,3153,6905,77,213,2659,5562,2736,5775
231020,202309,11397,28411,9455,24759,1811,4155,5531,14674,7342,18829
231025,202309,10637,24139,8902,21327,645,1454,6806,15931,7451,17385
231030,202309,8769,23634,6100,18174,849,2489,3506,10273,4355,12762
231040,202309,3812,8717,3047,7379,117,315,2496,5758,2613,6073
231050,202309,14869,32334,10641,24795,665,1686,8234,18326,8899,20012
231060,202309,3604,8627,2971,7603,138,381,2322,5813,2460,6194
231070,202309,9845,24921,7918,21407,862,2072,5191,13771,6053,15843
231080,202309,4549,11382,3358,9178,258,685,2262,6022,2520,6707
231085,202309,9035,19144,6642,15868,390,867,4814,11045,5204,11912
231090,202309,5238,12221,3621,9160,190,486,2556,6134,2746,6620
231095,202309,2651,7269,1877,5579,174,503,1221,3529,1395,4032
231100,202309,3606,9214,2756,7611,150,458,2043,5406,2193,5864
231110,202309,4479,11828,3769,10415,1452,3531,1395,3953,2847,7484
231120,202309,2969,7229,2335,6152,100,233,1744,4472,1844,4705
231123,202309,2432,5563,1758,4373,111,265,1231,2936,1342,3201
231126,202309,6711,16156,4883,12764,376,842,3615,9343,3991,10185
231130,202309,31360,62823,24168,52778,1338,3437,18679,37824,20017,41261
231135,202309,5046,12561,3833,10213,288,679,2665,6939,2953,7618
231140,202309,21794,51439,16441,42019,1700,4195,11061,27030,12761,31225
231150,202309,7041,17264,4333,11746,831,2208,1666,4262,2497,6470
231160,202309,8717,22039,7105,18885,969,2341,4541,11878,5510,14219
231170,202309,5653,14298,4342,11823,342,925,3075,7971,3417,8896
231180,202309,19628,47316,14211,36375,2252,5424,7568,18540,9820,23964
231190,202309,5159,12360,3665,9637,92,298,2847,7067,2939,7365
231195,202309,5967,16276,4548,13483,310,937,3173,9353,3483,10290
231200,202309,10446,25171,8635,21819,153,591,7271,17375,7424,17966
231210,202309,5957,15020,4614,12672,148,556,3684,9592,3832,10148
231220,202309,16309,35029,11550,26570,852,1569,8449,18646,9301,20215
231230,202309,12208,34179,10024,29957,911,2746,6983,20417,7894,23163
231240,202309,14636,38674,11250,31526,1669,4374,6350,17076,8019,21450
231250,202309,2515,5336,1430,3166,91,186,1059,2190,1150,2376
231260,202309,4085,9636,3161,8063,389,872,2061,5239,2450,6111
231270,202309,7825,17452,5785,13996,165,577,4394,9855,4559,10432
231280,202309,2282,6095,1816,5238,151,429,1216,3485,1367,3914
231290,202309,44964,119306,32827,93643,4913,12960,16683,45347,21596,58307
231300,202309,5135,12352,3539,9186,388,919,2178,5435,2566,6354
231310,202309,10746,22201,7718,16848,495,1270,5777,11734,6272,13004
231320,202309,7866,20282,5789,16331,370,783,4273,12004,4643,12787
231325,202309,2903,6728,2052,5256,131,274,1446,3656,1577,3930
231330,202309,14172,34694,10670,28256,1342,3363,6945,17945,8287,21308
231335,202309,6722,15639,5343,13534,185,542,4446,10971,4631,11513
231340,202309,22830,61676,18550,53656,1834,5296,12961,37285,14795,42581
231350,202309,19883,47174,16629,42088,593,1574,13975,34504,14568,36078
231355,202309,5523,14158,4552,12369,328,872,3479,9122,3807,9994
231360,202309,9829,25973,7756,22145,455,1435,5918,16324,6373,17759
231370,202309,2447,6054,1769,4796,52,178,1353,3530,1405,3708
231375,202309,4981,13433,4185,11999,198,607,3089,8844,3287,9451
231380,202309,7431,16717,6227,15039,207,463,5120,12170,5327,12633
231390,202309,4113,10692,3389,9345,108,407,2576,6726,2684,7133
231395,202309,5411,13401,4195,11247,272,665,3002,7809,3274,8474
231400,202309,12203,29564,9532,24661,382,1177,7240,17664,7622,18841
231410,202309,20210,50175,16972,44758,828,2177,13893,35785,14721,37962
240010,202309,3026,7061,2089,5313,341,883,1000,2398,1341,3281
240020,202309,17899,40884,13592,33000,876,2498,9561,21524,10437,24022
240030,202309,4891,8962,3975,7621,77,223,3525,6367,3602,6590
240040,202309,943,2443,699,1986,25,76,468,1248,493,1324
240050,202309,4212,9924,3046,7813,85,217,2234,5477,2319,5694
240060,202309,1814,4174,1300,3255,45,102,999,2434,1044,2536
240070,202309,3298,8133,2472,6280,218,555,1673,3878,1891,4433
240080,202309,3515,8500,2465,6563,158,475,1641,4081,1799,4556
240090,202309,2810,5763,2108,4621,45,101,1798,3831,1843,3932
240100,202309,13531,27911,9860,21554,289,783,7852,15921,8141,16704
240110,202309,6251,15286,4664,12209,314,907,3265,7914,3579,8821
240120,202309,4134,10396,3156,8753,315,929,2067,5440,2382,6369
240130,202309,4920,8404,3767,6873,45,112,3441,6095,3486,6207
240140,202309,2154,5955,1617,4861,189,637,957,2638,1146,3275
240145,202309,8646,21473,6465,17516,633,1790,4146,10697,4779,12487
240150,202309,1332,3077,999,2451,67,173,711,1644,778,1817
240160,202309,1796,4533,1336,3669,54,215,1000,2579,1054,2794
240165,202309,1179,2836,847,2178,21,74,684,1666,705,1740
240170,202309,3469,7957,2630,6461,307,733,1717,4020,2024,4753
240180,202309,3680,9654,2720,7662,545,1479,1297,3654,1842,5133
240185,202309,1775,4707,1485,4160,54,188,1191,3187,1245,3375
240190,202309,1382,3232,1027,2625,41,126,772,1859,813,1985
240200,202309,16438,34386,11893,26559,1857,3814,6797,14535,8654,18349
240210,202309,4239,8518,3225,6852,44,139,2752,5533,2796,5672
240220,202309,8818,23459,7303,20765,580,1939,5288,14400,5868,16339
240230,202309,6961,15554,5099,12414,383,762,3549,8694,3932,9456
240240,202309,2159,5726,1363,3961,238,724,476,1159,714,1883
240250,202309,3716,8182,2838,6713,73,262,2268,5022,2341,5284
240260,202309,20231,51245,16353,44454,4705,12223,6480,19149,11185,31372
240270,202309,3085,7797,2221,6172,144,418,1459,4034,1603,4452
240280,202309,1913,4406,1430,3570,72,168,1082,2628,1154,2796
240290,202309,1341,3467,1010,2742,27,88,675,1688,702,1776
240300,202309,2632,6057,1773,4545,118,317,1128,2754,1246,3071
240310,202309,10454,24964,7395,19202,1287,3106,3489,8773,4776,11879
240320,202309,2271,5669,1472,4107,111,327,927,2414,1038,2741
240325,202309,48829,109397,36183,87224,4681,11491,21549,48316,26230,59807
240330,202309,2181,5284,1516,4028,86,282,1022,2546,1108,2828
240340,202309,2484,4852,1789,3742,51,112,1469,2885,1520,2997
240350,202309,3088,6338,2563,5667,87,255,2240,4805,2327,5060
240360,202309,16615,38691,13470,33274,2018,4826,8288,19817,10306,24643
240370,202309,2687,5693,1843,4161,142,311,1311,2754,1453,3065
240375,202309,1158,2459,862,1961,31,85,647,1348,678,1433
240380,202309,2806,6933,2017,5296,275,710,1165,2903,1440,3613
240390,202309,1141,2570,694,1743,33,72,416,958,449,1030
240400,202309,1684,3808,1171,2926,57,173,796,1827,853,2000
240410,202309,712,1900,515,1513,62,201,273,733,335,934
240420,202309,6433,18459,5238,15796,408,1461,3475,9756,3883,11217
240430,202309,4232,9483,3117,7474,146,381,2342,5258,2488,5639
240440,202309,3409,6796,2632,5609,223,493,1999,4083,2222,4576
240450,202309,5366,13032,3692,9748,261,808,2350,5540,2611,6348
240460,202309,4234,9746,3465,8487,308,730,2560,6076,2868,6806
240470,202309,4086,11178,2713,8161,854,2232,958,3119,1812,5351
240480,202309,673,1681,377,1039,25,62,180,479,205,541
240485,202309,2493,6357,1799,5002,166,514,1036,2785,1202,3299
240490,202309,2002,4364,1401,3297,83,177,1036,2323,1119,2500
240500,202309,2626,6218,2076,5220,129,332,1615,3931,1744,4263
240510,202309,2048,4864,1611,4091,121,377,1224,2902,1345,3279
240520,202309,1974,3965,1357,3072,120,246,1057,2328,1177,2574
240530,202309,2883,6813,2373,5965,182,353,1818,4518,2000,4871
240540,202309,2751,5861,2260,5091,57,186,1953,4243,2010,4429
240550,202309,1068,2336,890,2031,122,243,671,1530,793,1773
240560,202309,4769,9989,3976,8903,165,316,3297,7253,3462,7569
240570,202309,3345,8052,1908,4933,285,763,732,1586,1017,2349
240580,202309,10770,26442,8765,22767,626,1683,6778,16909,7404,18592
240590,202309,1124,2184,867,1790,39,101,666,1280,705,1381
240600,202309,2113,5038,1405,3638,52,134,973,2350,1025,2484
240610,202309,5532,12456,4387,10358,331,830,3066,6826,3397,7656
240615,202309,1568,3488,1149,2777,80,212,823,1833,903,2045
240620,202309,2400,5701,1879,4781,55,189,1546,3745,1601,3934
240630,202309,2915,6298,2434,5524,236,398,1814,4172,2050,4570
240640,202309,1081,2578,771,2029,34,103,579,1447,613,1550
240650,202309,4823,12854,3621,10363,381,1047,2265,6430,2646,7477
240660,202309,5447,9558,4522,8410,152,394,3911,7042,4063,7436
240670,202309,3146,7593,2134,5522,208,513,1344,3229,1552,3742
240680,202309,1933,4452,1417,3552,108,272,1037,2488,1145,2760
240690,202309,1483,3110,1094,2460,25,84,906,1907,931,1991
240700,202309,2836,7436,2096,6051,130,374,1486,4154,1616,4528
240710,202309,25396,51969,19938,43141,2196,4610,13815,28749,16011,33359
240720,202309,6328,14425,4780,11810,770,1944,2801,6666,3571,8610
240725,202309,1288,3355,922,2669,58,171,582,1594,640,1765
240730,202309,2683,6643,1956,5256,85,288,1437,3654,1522,3942
240740,202309,2272,5643,1636,4352,104,332,1132,2749,1236,3081
240750,202309,2691,7702,2157,6543,262,808,1300,3767,1562,4575
240760,202309,2059,4114,1343,3052,118,229,939,2194,1057,2423
240770,202309,4031,9439,3160,8101,118,395,2537,6195,2655,6590
240780,202309,6624,15666,5084,12970,722,1718,3149,7725,3871,9443
240790,202309,1072,2640,773,2073,28,117,529,1295,557,1412
240800,202309,74352,148757,52926,113510,6247,12869,33388,66549,39635,79418
240810,202309,141314,297190,113973,252056,11732,25043,78672,166093,90404,191136
240820,202309,8155,21108,6557,18009,1222,3198,3647,9850,4869,13048
240830,202309,10673,25937,8582,22510,501,1441,6594,16793,7095,18234
240840,202309,1301,2933,930,2278,46,97,646,1504,692,1601
240850,202309,1662,4133,1036,2781,89,218,608,1549,697,1767
240860,202309,1855,3943,1331,3049,41,133,1115,2415,1156,2548
240870,202309,1259,2843,884,2184,193,458,430,1057,623,1515
240880,202309,1560,4410,1247,3763,91,328,855,2446,946,2774
240890,202309,6714,14731,4764,11193,478,1220,3061,6438,3539,7658
240895,202309,3637,9634,3049,8621,401,1118,2088,5851,2489,6969
240910,202309,4165,10080,3222,8424,86,309,2466,6100,2552,6409
240920,202309,1310,2826,912,2183,110,217,590,1413,700,1630
240930,202309,4379,8877,3127,7100,309,515,2027,4897,2336,5412
240933,202309,1906,4350,1487,3706,54,216,1199,2837,1253,3053
240940,202309,9001,18718,6474,14390,891,1771,4079,8711,4970,10482
240950,202309,1329,3551,1017,2910,59,210,721,1911,780,2121
240960,202309,844,2075,694,1746,26,95,525,1236,551,1331
240970,202309,2407,5060,1783,4024,70,193,1466,3171,1536,3364
240980,202309,4889,10970,4135,9729,95,358,3541,7917,3636,8275
240990,202309,3640,8214,2879,6784,272,685,2030,4390,2302,5075
241000,202309,1303,2756,921,2059,14,43,778,1647,792,1690
241010,202309,3924,9964,3241,8609,128,417,2536,6348,2664,6765
241020,202309,2561,6031,1798,4545,102,307,1271,2947,1373,3254
241025,202309,1978,5027,1400,3872,52,183,1004,2592,1056,2775
241030,202309,3079,8409,2272,6742,237,756,1567,4447,1804,5203
241040,202309,2723,7402,2117,6308,197,598,1509,4398,1706,4996
241050,202309,1730,4254,1270,3371,76,199,884,2279,960,2478
241060,202309,1003,2387,771,1923,37,94,545,1252,582,1346
241070,202309,866,2018,647,1642,20,55,506,1214,526,1269
241080,202309,1301,3294,943,2582,37,119,653,1682,690,1801
241090,202309,2510,6180,1847,5034,67,276,1354,3452,1421,3728
241100,202309,1386,3444,969,2612,111,213,578,1558,689,1771
241105,202309,1461,3740,1104,3072,186,542,548,1385,734,1927
241110,202309,1071,2737,711,1983,46,151,450,1140,496,1291
241120,202309,9285,23459,7298,19853,782,2178,4807,12666,5589,14844
241140,202309,3922,9453,2738,7130,245,569,1788,4576,2033,5145
241142,202309,885,2195,557,1512,49,137,296,709,345,846
241150,202309,7208,16590,5705,14055,253,625,4441,10621,4694,11246
241160,202309,1316,3388,823,2389,127,371,397,1052,524,1423
241170,202309,1594,3543,1232,2877,39,126,1004,2209,1043,2335
241180,202309,1234,2780,831,2022,54,160,499,1153,553,1313
241190,202309,1430,3203,1036,2459,43,106,744,1673,787,1779
241200,202309,33209,69648,26662,58746,3274,7213,17807,36886,21081,44099
241210,202309,2041,4510,1325,3182,179,368,793,1885,972,2253
241220,202309,12515,30855,10009,26231,2600,6519,4507,11918,7107,18437
241230,202309,3518,8147,2733,6854,226,480,2057,5053,2283,5533
241240,202309,1466,3750,777,2228,115,363,278,707,393,1070
241250,202309,7835,18109,5723,14280,140,477,4483,10416,4623,10893
241255,202309,3385,8818,2666,7411,260,760,1762,4689,2022,5449
241260,202309,5837,13467,4322,10854,165,502,3219,7541,3384,8043
241270,202309,1891,4959,1440,4051,125,364,946,2533,1071,2897
241280,202309,3201,6226,2561,5130,85,154,2251,4385,2336,4539
241290,202309,3773,8302,2614,6452,99,303,2017,4711,2116,5014
241300,202309,1913,4467,1390,3522,49,150,973,2314,1022,2464
241310,202309,2826,5740,2208,4871,59,160,1841,3885,1900,4045
241320,202309,1157,3380,879,2796,133,417,445,1378,578,1795
241330,202309,2066,4621,1539,3860,38,111,1319,3221,1357,3332
241335,202309,4607,11252,3665,9490,142,418,2811,6895,2953,7313
241340,202309,2081,4867,1488,3733,253,677,768,1754,1021,2431
241350,202309,2582,6151,2063,5225,109,289,1552,3788,1661,4077
241355,202309,1686,3942,1233,3089,60,152,901,2148,961,2300
241360,202309,2510,5699,1639,4025,73,179,1219,2814,1292,2993
241370,202309,1625,3862,1173,2998,49,152,844,1993,893,2145
241380,202309,883,2037,634,1597,98,197,364,929,462,1126
241390,202309,3397,8606,2700,7446,184,474,1953,5265,2137,5739
241400,202309,4426,10638,3614,9282,290,785,2668,6578,2958,7363
241410,202309,3058,8124,2297,6578,271,796,1454,4035,1725,4831
241415,202309,2293,5411,1781,4454,113,283,1338,3163,1451,3446
241420,202309,3993,10131,3286,8844,636,1682,1777,4726,2413,6408
241430,202309,869,1914,532,1267,16,38,363,788,379,826
241440,202309,10533,27202,8908,24191,273,894,7199,18781,7472,19675
241445,202309,1656,3360,1309,2861,33,92,1150,2440,1183,2532
241450,202309,3834,7625,2842,6059,173,356,2263,4654,2436,5010
241460,202309,4795,11487,3313,8395,347,853,2107,4942,2454,5795
241470,202309,1760,4028,1285,3319,44,165,1033,2551,1077,2716
241475,202309,1423,3421,988,2619,24,69,723,1788,747,1857
241480,202309,3785,10321,2861,8390,899,2604,966,2913,1865,5517
241490,202309,905,1827,588,1331,30,91,459,981,489,1072
241500,202309,975,2407,805,2173,36,114,621,1617,657,1731
250010,202309,3228,8236,2406,6563,81,263,1799,4638,1880,4901
250020,202309,1926,4482,1322,3356,237,477,833,2172,1070,2649
250030,202309,8604,20492,6883,17602,1289,3142,4327,10846,5616,13988
250040,202309,5517,14452,4384,12353,866,2425,2365,6423,3231,8848
250050,202309,4475,10482,3652,9258,200,554,2819,7101,3019,7655
250053,202309,1567,3939,1312,3470,140,308,892,2317,1032,2625
250057,202309,906,2454,808,2308,23,88,718,2028,741,2116
250060,202309,7528,16777,6126,14621,857,1773,4051,9618,4908,11391
250070,202309,4888,11803,3774,9821,71,268,2998,7434,3069,7702
250073,202309,965,2233,720,1808,12,41,578,1395,590,1436
250077,202309,3261,6831,2361,5380,36,109,2028,4437,2064,4546
250080,202309,7463,14229,5855,12196,83,271,5315,10763,5398,11034
250090,202309,4719,8833,3808,7568,147,232,3279,6368,3426,6600
250100,202309,4198,11237,3466,9816,248,654,2557,7008,2805,7662
250110,202309,6031,14827,5109,13380,386,1014,3709,9394,4095,10408
250115,202309,926,1909,606,1386,23,60,498,1103,521,1163
250120,202309,2193,5726,1825,5075,30,139,1439,3814,1469,3953
250130,202309,7414,15623,5953,13502,242,492,5026,11185,5268,11677
250135,202309,1683,3943,1384,3415,218,577,972,2292,1190,2869
250140,202309,2896,7321,2387,6551,231,666,1682,4524,1913,5190
250150,202309,5712,15754,4798,14064,211,759,3668,10272,3879,11031
250153,202309,1642,3966,1272,3357,56,114,978,2545,1034,2659
250157,202309,2698,6167,2201,5310,57,144,1839,4299,1896,4443
250160,202309,4444,9802,3403,8197,72,195,2899,6807,2971,7002
250170,202309,2214,5203,1863,4681,43,133,1499,3626,1542,3759
250180,202309,31569,60950,25083,51839,2664,5066,18027,35472,20691,40538
250190,202309,5206,11959,4096,10189,477,1128,2685,6410,3162,7538
250200,202309,3143,5916,2472,4979,128,276,2118,4081,2246,4357
250205,202309,1001,2782,768,2336,23,95,574,1689,597,1784
250210,202309,1690,4474,1369,3871,115,334,977,2676,1092,3010
250215,202309,1902,4673,1361,3658,81,246,773,2050,854,2296
250220,202309,818,2015,598,1625,35,116,405,1021,440,1137
250230,202309,1934,3924,1239,2871,27,76,989,2198,1016,2274
250240,202309,3801,8206,3139,7096,116,253,2655,5839,2771,6092
250250,202309,6048,13887,4909,12193,400,712,3735,9665,4135,10377
250260,202309,1859,4782,1423,3966,84,217,1001,2737,1085,2954
250270,202309,1410,3795,1179,3386,100,287,749,2226,849,2513
250280,202309,4963,10448,4120,9247,374,599,3039,7012,3413,7611
250290,202309,2360,4710,1854,3926,52,126,1521,3070,1573,3196
250300,202309,7407,15801,6042,13852,291,829,4789,10456,5080,11285
250310,202309,1514,3862,1123,3130,110,261,750,2070,860,2331
250320,202309,18696,34413,15010,29856,335,982,12897,24337,13232,25319
250330,202309,3182,7233,2477,6116,72,257,2041,4719,2113,4976
250340,202309,1557,3196,1244,2739,23,60,1095,2349,1118,2409
250350,202309,4574,11877,3595,10134,270,631,2663,7646,2933,8277
250355,202309,2813,6429,2317,5770,31,138,2090,5095,2121,5233
250360,202309,2130,4944,1778,4409,135,397,1354,3166,1489,3563
250370,202309,21075,41684,17038,35642,338,995,14709,29272,15047,30267
250375,202309,1544,3289,1142,2778,31,63,999,2451,1030,2514
250380,202309,2204,4588,1909,4189,87,210,1618,3382,1705,3592
250390,202309,2372,5176,1872,4357,123,311,1472,3335,1595,3646
250400,202309,94705,210679,64178,159601,20046,52354,18409,42390,38455,94744
250403,202309,2982,6033,2401,5299,56,266,2028,4112,2084,4378
250407,202309,1903,3739,1251,2740,143,236,871,2022,1014,2258
250410,202309,864,1995,708,1734,25,71,587,1367,612,1438
250415,202309,2479,5705,2020,4969,38,130,1760,4203,1798,4333
250420,202309,1751,3576,1473,3161,25,84,1304,2676,1329,2760
250430,202309,9506,18521,7376,15422,322,727,6009,11806,6331,12533
250435,202309,1990,4973,1395,3900,79,241,1023,2756,1102,2997
250440,202309,5363,12813,4372,11287,108,307,3730,9377,3838,9684
250450,202309,2189,4955,1694,4224,91,172,1329,3324,1420,3496
250460,202309,9827,23605,7843,20399,571,1644,5645,13975,6216,15619
250470,202309,2218,4600,1716,3805,71,178,1391,2922,1462,3100
250480,202309,4766,11324,3754,9909,298,663,2885,7630,3183,8293
250485,202309,854,1754,561,1275,51,78,395,883,446,961
250490,202309,6931,13504,5811,12125,129,352,5078,10257,5207,10609
250500,202309,2460,6006,2008,5214,65,213,1568,3948,1633,4161
250510,202309,7134,14683,5672,12519,385,574,4409,9889,4794,10463
250520,202309,2222,5375,1754,4645,72,230,1337,3374,1409,3604
250523,202309,2661,5651,2147,4884,172,411,1618,3511,1790,3922
250527,202309,2121,4508,1833,4139,23,72,1668,3713,1691,3785
250530,202309,817,1859,653,1599,21,55,513,1187,534,1242
250535,202309,1666,4247,1381,3711,17,57,1139,2937,1156,2994
250540,202309,4004,7354,3112,6280,336,399,2465,5215,2801,5614
250550,202309,943,2739,763,2365,58,195,511,1515,569,1710
250560,202309,2102,5032,1665,4329,126,324,1230,3070,1356,3394
250570,202309,3333,8640,2708,7502,184,565,1965,5288,2149,5853
250580,202309,1251,2920,1026,2567,73,168,789,1903,862,2071
250590,202309,1267,2639,1085,2381,38,102,933,1940,971,2042
250600,202309,9143,22385,6888,18678,344,942,5060,13226,5404,14168
250610,202309,3428,8774,2786,7678,153,494,2138,5735,2291,6229
250620,202309,1143,2387,880,1947,27,57,716,1516,743,1573
250625,202309,2736,7191,2315,6441,61,250,1945,5236,2006,5486
250630,202309,15698,34127,12391,28640,1119,2750,8812,19146,9931,21896
250640,202309,4578,10492,3700,9133,101,364,2997,6986,3098,7350
250650,202309,1279,2696,929,2208,12,59,791,1820,803,1879
250660,202309,1885,4156,1353,3325,61,138,1096,2550,1157,2688
250670,202309,2981,7617,2562,6828,44,146,2177,5532,2221,5678
250680,202309,7604,14431,6024,12442,137,416,5208,10223,5345,10639
250690,202309,8808,17145,6801,14504,157,337,5811,11958,5968,12295
250700,202309,5756,14200,4593,12043,733,1901,2888,7232,3621,9133
250710,202309,5387,13830,4221,11920,487,1297,2784,7809,3271,9106
250720,202309,3539,8332,2844,7247,81,277,2317,5665,2398,5942
250730,202309,5453,12293,4457,10768,364,779,3416,7993,3780,8772
250740,202309,2503,5419,1899,4513,120,255,1401,3237,1521,3492
250750,202309,168811,350073,132758,294042,8906,21659,98360,203027,107266,224686
250760,202309,3691,6868,3087,5985,61,160,2778,5202,2839,5362
250770,202309,4921,13239,3976,11584,520,1301,2547,7408,3067,8709
250780,202309,2275,5192,1752,4249,53,162,1443,3359,1496,3521
250790,202309,3166,7921,2518,6748,111,431,1846,4556,1957,4987
250800,202309,2938,6861,2340,5845,131,301,1816,4434,1947,4735
250810,202309,1767,3823,1290,3049,143,235,879,2145,1022,2380
250820,202309,2559,5888,2214,5420,45,143,1895,4524,1940,4667
250830,202309,7382,19406,5562,15696,251,834,3872,10130,4123,10964
250840,202309,870,2509,697,2140,42,145,502,1534,544,1679
250850,202309,2188,5555,1781,4816,30,115,1456,3770,1486,3885
250855,202309,1425,3385,1166,2950,42,131,974,2367,1016,2498
250860,202309,4328,11117,3252,9175,464,1350,1864,4962,2328,6312
250870,202309,1283,2950,993,2440,56,134,728,1723,784,1857
250880,202309,1936,4387,1465,3616,140,349,1057,2513,1197,2862
250890,202309,14843,30268,11998,26367,307,1020,10099,20723,10406,21743
250900,202309,3979,9085,3143,7614,102,319,2616,6015,2718,6334
250905,202309,3124,7572,2702,6982,91,306,2335,5898,2426,6204
250910,202309,9084,17264,7291,15002,106,374,6532,12969,6638,13343
250915,202309,2664,5293,1750,4165,54,126,1482,3438,1536,3564
250920,202309,4834,10162,3909,8662,554,883,2688,6026,3242,6909
250930,202309,2840,6841,2256,5963,148,480,1708,4256,1856,4736
250933,202309,1505,3921,1206,3352,51,180,924,2462,975,2642
250937,202309,970,2251,766,1919,39,86,575,1419,614,1505
250939,202309,2526,5527,2016,4723,30,89,1738,3971,1768,4060
250940,202309,4704,10955,3748,9517,83,264,3125,7737,3208,8001
250950,202309,2047,4766,1542,4025,50,170,1224,3043,1274,3213
250960,202309,1381,3483,1133,3016,41,151,898,2277,939,2428
250970,202309,11498,24991,9183,21079,489,1014,7275,16214,7764,17228
250980,202309,2837,6657,2330,5818,39,140,1977,4737,2016,4877
250990,202309,2597,6877,2086,5939,112,383,1501,4083,1613,4466
251000,202309,2309,5897,1781,4936,50,163,1399,3779,1449,3942
251010,202309,3004,7373,2480,6537,68,238,2049,5218,2117,5456
251020,202309,1927,4665,1564,4049,44,162,1276,3128,1320,3290
251030,202309,1213,2919,922,2392,53,140,592,1500,645,1640
251040,202309,2202,5315,1722,4506,33,123,1439,3610,1472,3733
251050,202309,1157,3032,877,2428,53,177,611,1573,664,1750
251060,202309,1374,2731,904,2035,47,83,672,1498,719,1581
251065,202309,565,1428,382,1064,76,166,198,559,274,725
251070,202309,902,1955,685,1620,22,81,551,1206,573,1287
251080,202309,27012,57701,20695,47605,4068,8943,11450,26417,15518,35360
251090,202309,3478,8780,2710,7410,64,213,2214,5853,2278,6066
251100,202309,944,2699,730,2242,53,137,499,1437,552,1574
251110,202309,2244,5166,1716,4163,275,508,1135,2795,1410,3303
251120,202309,10055,22652,7879,19448,347,1032,6064,14214,6411,15246
251130,202309,6096,10303,5111,9122,50,121,4744,8218,4794,8339
251140,202309,4801,12344,3986,11011,176,572,2971,8008,3147,8580
251150,202309,3415,8506,2930,7689,82,355,2325,5782,2407,6137
251160,202309,2942,6893,2436,6086,47,177,2112,5082,2159,5259
251170,202309,2301,4900,1895,4334,33,112,1672,3672,1705,3784
251180,202309,3344,7648,2610,6548,370,747,1628,4247,1998,4994
251190,202309,7073,13772,5996,12361,159,333,5257,10448,5416,10781
251200,202309,5699,13659,4701,12192,201,531,3813,9780,4014,10311
251203,202309,1261,3517,997,2908,74,224,642,1759,716,1983
251207,202309,1344,3186,909,2378,24,69,637,1588,661,1657
251210,202309,9878,21880,7318,17830,706,1422,4903,12116,5609,13538
251220,202309,1621,3379,1119,2660,74,159,841,1962,915,2121
251230,202309,5645,14195,4565,12106,143,430,3504,8896,3647,9326
251240,202309,4445,11457,3286,9177,342,946,2069,5621,2411,6567
251250,202309,15143,34366,11917,28522,1295,2925,8270,19105,9565,22030
251260,202309,649,1491,517,1263,8,22,418,959,426,981
251270,202309,5502,14273,4585,12769,312,801,3463,9658,3775,10459
251272,202309,1736,3889,1499,3547,37,138,1318,2972,1355,3110
251274,202309,1008,2564,728,2034,77,229,386,1025,463,1254
251275,202309,1968,4131,1486,3340,93,221,1175,2484,1268,2705
251276,202309,1617,3944,1322,3505,40,152,1028,2583,1068,2735
251278,202309,818,1900,639,1573,45,115,486,1127,531,1242
251280,202309,3394,6935,2883,6172,68,199,2483,4998,2551,5197
251290,202309,10384,18116,8638,15913,256,563,7599,13399,7855,13962
251300,202309,987,2516,784,2148,18,67,653,1750,671,1817
251310,202309,3446,8511,2773,7397,47,212,2186,5577,2233,5789
251315,202309,2275,6158,1912,5432,112,298,1461,4048,1573,4346
251320,202309,1923,4552,1400,3615,50,167,1061,2599,1111,2766
251330,202309,2565,5189,1930,4370,41,108,1613,3555,1654,3663
251335,202309,1391,3373,1153,2973,14,45,1032,2586,1046,2631
251340,202309,4603,9726,3349,7847,209,429,2520,5710,2729,6139
251350,202309,1334,3333,1085,2891,80,135,822,2199,902,2334
251360,202309,2250,5367,1614,4332,32,103,1258,3251,1290,3354
251365,202309,929,2217,621,1611,18,49,465,1173,483,1222
251370,202309,36613,82727,28378,69580,5994,13724,14008,34615,20002,48339
251380,202309,1889,3979,1477,3298,53,146,1221,2609,1274,2755
251385,202309,931,2161,643,1611,19,49,469,1088,488,1137
251390,202309,9767,22131,8120,19481,669,1611,5944,13787,6613,15398
251392,202309,1266,3013,981,2553,44,115,744,1908,788,2023
251394,202309,835,2117,628,1729,66,184,405,1076,471,1260
251396,202309,861,2119,630,1667,30,93,445,1083,475,1176
251398,202309,1216,2859,764,2044,20,68,554,1392,574,1460
251400,202309,1768,3433,1291,2713,71,114,1027,2081,1098,2195
251410,202309,1905,3835,1412,3084,35,133,1194,2436,1229,2569
251420,202309,2562,5644,1947,4795,49,143,1559,3680,1608,3823
251430,202309,1834,4791,1505,4167,47,133,1247,3365,1294,3498
251440,202309,1318,3175,1018,2651,97,210,712,1864,809,2074
251445,202309,2066,4861,1719,4321,39,147,1387,3325,1426,3472
251450,202309,5708,14054,4658,12133,112,341,3841,9652,3953,9993
251455,202309,1029,2713,841,2344,36,123,661,1767,697,1890
251460,202309,1184,2904,892,2382,85,228,634,1652,719,1880
251465,202309,613,1510,468,1228,13,47,346,854,359,901
251470,202309,1309,3367,931,2572,164,492,476,1183,640,1675
251480,202309,1284,2944,903,2259,26,85,681,1600,707,1685
251490,202309,2400,5426,1849,4589,154,307,1363,3380,1517,3687
251500,202309,2673,5991,2225,5324,134,323,1732,3960,1866,4283
251510,202309,3112,8572,2310,6912,162,468,1436,4084,1598,4552
251520,202309,1205,2842,846,2186,51,118,579,1427,630,1545
251530,202309,19129,38633,15027,33303,242,883,12971,27479,13213,28362
251540,202309,3649,9300,2940,7970,127,506,2344,6019,2471,6525
251550,202309,5411,10040,4066,8214,170,326,3425,6727,3595,7053
251560,202309,664,1842,534,1598,36,125,387,1060,423,1185
251570,202309,1092,2795,796,2175,30,111,598,1548,628,1659
251580,202309,2869,5470,2291,4602,32,93,1979,3731,2011,3824
251590,202309,1977,4180,1519,3507,59,163,1289,2843,1348,3006
251593,202309,1162,3117,954,2730,103,291,599,1652,702,1943
251597,202309,2842,6383,2433,5796,30,109,2166,5039,2196,5148
251600,202309,7640,18860,6224,16517,416,1045,4744,12331,5160,13376
251610,202309,4249,10219,3375,8552,485,1090,2253,5591,2738,6681
251615,202309,1658,3524,1190,2737,38,103,1020,2265,1058,2368
251620,202309,24364,47600,18099,39492,389,994,15303,32816,15692,33810
251630,202309,6443,12623,4943,10412,282,658,3914,7739,4196,8397
251640,202309,2646,6236,2178,5507,48,186,1805,4324,1853,4510
251650,202309,5152,11469,4051,9864,105,289,3316,7712,3421,8001
251660,202309,4507,11214,3608,9498,94,363,2912,7298,3006,7661
251670,202309,5794,12466,4912,11225,87,296,4397,9704,4484,10000
251675,202309,1137,2370,951,2075,31,65,824,1747,855,1812
251680,202309,3163,7174,2400,5977,121,267,1864,4600,1985,4867
251690,202309,3976,9788,3008,7912,174,493,2268,5784,2442,6277
251700,202309,2849,6776,2206,5763,57,234,1794,4427,1851,4661
251710,202309,963,2176,598,1441,40,116,410,899,450,1015
251720,202309,1545,3919,1131,3153,41,141,822,2188,863,2329
251740,202309,813,1955,612,1589,24,72,460,1125,484,1197
260005,202309,38754,73200,29031,59294,1880,3839,22444,43654,24324,47493
260010,202309,12781,29599,9618,23989,665,1762,6182,14587,6847,16349
260020,202309,8432,16729,6097,13404,116,417,4979,10277,5095,10694
260030,202309,10293,19904,8191,16915,134,451,7098,13999,7232,14450
260040,202309,8821,19765,6670,16452,357,988,4882,11549,5239,12537
260050,202309,17899,37768,14712,33869,282,794,13314,30152,13596,30946
260060,202309,5242,11093,4064,9178,430,717,2914,6791,3344,7508
260070,202309,14732,29120,11747,24714,236,740,9917,19715,10153,20455
260080,202309,8527,16099,6937,13966,140,328,5930,11456,6070,11784
260090,202309,6851,14527,5597,12659,569,987,4091,9316,4660,10303
260100,202309,4056,8504,3252,7310,56,221,2799,5997,2855,6218
260105,202309,6358,14537,5185,12640,110,394,4300,9957,4410,10351
260110,202309,26260,66703,21390,58695,1268,3716,16269,43113,17537,46829
260120,202309,20196,43668,16134,37348,1979,4030,11224,25792,13203,29822
260130,202309,4061,8845,3273,7675,78,192,2616,5816,2694,6008
260140,202309,16847,31721,13315,27047,411,906,11172,21692,11583,22598
260150,202309,4557,8718,3774,7697,107,248,3313,6593,3420,6841
260160,202309,9206,17665,7548,15557,181,476,6737,13461,6918,13937
260170,202309,27417,55253,21327,46241,1330,2909,16309,33864,17639,36773
260180,202309,4481,9868,3500,8415,99,319,2870,6575,2969,6894
260190,202309,27492,44410,21733,37381,245,499,19783,32924,20028,33423
260200,202309,13496,28883,10937,25341,515,1081,9328,21273,9843,22354
260210,202309,13594,33822,10821,29120,529,1404,8412,22197,8941,23601
260220,202309,15160,28413,12875,25399,317,636,11244,21508,11561,22144
260230,202309,16560,30710,13457,26614,337,652,11535,22142,11872,22794
260240,202309,3439,8753,2737,7417,63,243,2134,5528,2197,5771
260250,202309,2985,6445,2354,5419,95,230,1844,4050,1939,4280
260260,202309,18016,39442,14976,34902,1385,2805,10822,25481,12207,28286
260270,202309,6249,11693,5097,10243,86,255,4509,8717,4595,8972
260280,202309,16807,39633,14206,35485,351,1264,12294,29361,12645,30625
260290,202309,57361,125627,44358,103836,4015,9811,30833,67611,34848,77422
260300,202309,13527,28513,10876,24589,355,1051,9025,19421,9380,20472
260310,202309,8220,16292,6887,14437,404,720,5691,11764,6095,12484
260320,202309,8894,23279,6805,19580,152,532,5460,15339,5612,15871
260330,202309,2852,7848,2273,6691,114,360,1696,4819,1810,5179
260340,202309,2672,6017,2160,5195,53,189,1774,4037,1827,4226
260345,202309,39763,84331,30838,70012,3392,7574,20347,43531,23739,51105
260350,202309,8239,14482,6524,12468,39,155,5977,11062,6016,11217
260360,202309,2935,6700,2229,5405,73,221,1672,3849,1745,4070
260370,202309,7007,16480,5493,13826,193,577,4398,10472,4591,11049
260380,202309,6176,15668,4814,13293,251,651,3561,9565,3812,10216
260390,202309,5728,15157,4087,11723,257,704,2679,7407,2936,8111
260392,202309,5131,12276,4384,11227,70,372,3787,9366,3857,9738
260400,202309,28556,52847,22992,44716,462,1304,19282,35047,19744,36351
260410,202309,107397,225365,79929,183719,15830,36426,39917,90332,55747,126758
260415,202309,6091,12857,4784,10887,83,260,4089,8954,4172,9214
260420,202309,16676,28084,13124,24016,163,495,12018,21332,12181,21827
260430,202309,3288,9246,2578,7787,186,614,1673,4887,1859,5501
260440,202309,5352,10815,4218,9205,89,278,3558,7375,3647,7653
260450,202309,7062,15732,5866,13956,352,702,4763,11257,5115,11959
260460,202309,7099,17034,5480,13982,365,1067,3778,8886,4143,9953
260470,202309,6170,12799,4922,11281,135,343,4234,9788,4369,10131
260480,202309,4554,10382,3495,8683,328,888,2442,5832,2770,6720
260490,202309,7144,13341,5697,11386,85,307,5002,9507,5087,9814
260500,202309,7638,16580,6052,14144,804,1674,3983,9301,4787,10975
260510,202309,14347,27805,11530,23693,216,593,10095,20067,10311,20660
260515,202309,5655,12954,4177,10254,108,321,3065,6884,3173,7205
260520,202309,20328,41071,16031,34740,1055,2318,12347,25380,13402,27698
260530,202309,12762,29396,10390,25689,154,624,8987,21304,9141,21928
260540,202309,9766,17324,8233,15421,126,315,7530,13752,7656,14067
260545,202309,193,475,121,331,24,61,40,85,64,146
260550,202309,3864,9293,2760,7269,190,575,1797,4306,1987,4881
260560,202309,6906,15710,5288,13126,180,578,4189,9881,4369,10459
260570,202309,11532,23174,9457,20358,209,625,8172,16779,8381,17404
260580,202309,6491,11998,5603,10789,100,215,5050,9498,5150,9713
260590,202309,9426,16650,7429,14236,116,331,6523,12004,6639,12335
260600,202309,44781,95360,34729,79195,1630,4224,26949,57255,28579,61479
260610,202309,9836,22555,7594,19059,339,1007,5911,14247,6250,15254
260620,202309,28704,56406,22769,47343,1470,3323,17711,34484,19181,37807
260630,202309,2825,6755,2245,5777,62,160,1813,4511,1875,4671
260640,202309,33575,60955,26430,51784,1619,2714,21153,40587,22772,43301
260650,202309,7572,16890,5690,14329,434,868,4526,11278,4960,12146
260660,202309,9604,19910,7712,17299,259,708,6687,14469,6946,15177
260670,202309,2824,6310,2119,5093,92,301,1611,3618,1703,3919
260680,202309,40250,81828,30185,65826,2520,5301,21931,45513,24451,50814
260690,202309,4266,9562,3154,7758,75,255,2536,5973,2611,6228
260700,202309,9535,18997,8552,17872,122,357,8069,16616,8191,16973
260710,202309,1673,3849,1238,3130,48,158,936,2233,984,2391
260720,202309,40345,77960,31169,65105,1670,3971,24577,48556,26247,52527
260730,202309,10264,25219,8485,22487,265,810,7120,18262,7385,19072
260740,202309,1634,3894,1218,3175,31,130,936,2321,967,2451
260750,202309,9770,21100,7392,18050,213,481,6319,15509,6532,15990
260760,202309,8762,16651,7173,14637,121,342,6296,12331,6417,12673
260765,202309,10735,25895,8652,22455,772,2108,5845,14372,6617,16480
260770,202309,4920,10651,3739,8752,120,359,3041,6827,3161,7186
260775,202309,7860,17218,6445,14816,199,577,5188,11164,5387,11741
260780,202309,4758,11856,3572,9479,286,889,2271,5372,2557,6261
260790,202309,201965,371708,157524,308624,19122,38103,110396,205270,129518,243373
260795,202309,4572,8689,3555,7345,153,433,2790,5382,2943,5815
260800,202309,8003,14342,6891,12796,290,458,6039,10912,6329,11370
260805,202309,4784,10815,3694,8859,120,382,2991,6723,3111,7105
260810,202309,8420,19116,6707,15924,363,892,5092,11347,5455,12239
260820,202309,6140,11408,4967,9932,106,305,4290,8332,4396,8637
260825,202309,3539,9283,2856,8020,149,522,2112,5670,2261,6192
260830,202309,5338,13495,4165,11414,432,1015,2839,7756,3271,8771
260840,202309,5845,11947,4823,10483,217,512,4102,8592,4319,9104
260845,202309,5700,12849,4546,10835,207,642,3448,7672,3655,8314
260850,202309,6115,14263,4541,11226,477,1088,2859,6684,3336,7772
260860,202309,4077,10430,3177,8746,232,627,2343,6221,2575,6848
260870,202309,5757,11090,4726,9748,148,283,4089,8256,4237,8539
260875,202309,10929,21325,8080,17235,667,1403,5579,11516,6246,12919
260880,202309,14429,31786,11904,27698,587,1239,9547,21586,10134,22825
260890,202309,16807,36441,13249,30580,1793,3873,7933,17983,9726,21856
260900,202309,6947,17176,5351,14636,650,1700,3017,7957,3667,9657
260910,202309,4290,9510,3593,8462,203,423,2762,6401,2965,6824
260915,202309,7383,15066,6423,13826,91,241,5912,12495,6003,12736
260920,202309,4377,8225,3471,7137,146,345,2941,5834,3087,6179
260930,202309,5217,12987,4016,10849,190,628,3116,7950,3306,8578
260940,202309,20010,39597,15792,33166,1349,2821,11831,23815,13180,26636
260950,202309,9678,21246,7101,16627,377,1043,5008,10663,5385,11706
260960,202309,121537,217271,94920,180330,8034,15238,71318,128036,79352,143274
260970,202309,7025,15911,5419,13423,374,669,3938,9690,4312,10359
260980,202309,6019,14199,4966,12757,118,365,4255,10700,4373,11065
260990,202309,20770,50868,16210,43839,966,2572,12160,31730,13126,34302
261000,202309,21671,41533,16476,34272,755,1717,13125,25771,13880,27488
261010,202309,2689,5950,2166,5198,86,217,1820,4265,1906,4482
261020,202309,8631,18756,6985,16000,292,733,5636,12158,5928,12891
261030,202309,5123,12713,4067,10767,133,445,3118,7756,3251,8201
261040,202309,6717,16280,5136,13431,216,718,3863,9481,4079,10199
261050,202309,10030,21809,8186,18910,196,469,6667,14788,6863,15257
261060,202309,19133,40290,15371,35050,404,1186,12605,27388,13009,28574
261070,202309,97624,185599,73354,149740,8138,15929,51482,100699,59620,116628
261080,202309,9127,18050,7715,16180,93,256,7185,14719,7278,14975
261090,202309,26083,49894,21100,42928,970,1821,17341,34126,18311,35947
261100,202309,11194,25885,9023,22437,537,1339,6869,16466,7406,17805
261110,202309,101111,235280,76267,188742,9229,24021,45543,105357,54772,129378
261120,202309,4969,9915,4034,8532,102,247,3508,7146,3610,7393
261130,202309,9845,19641,8013,17002,228,437,6798,14041,7026,14478
261140,202309,4938,9469,3875,7890,281,474,2975,5973,3256,6447
261150,202309,7029,14771,5647,12717,220,504,4501,9782,4721,10286
261153,202309,2343,6158,1736,4928,90,265,1187,3282,1277,3547
261160,202309,324316,641375,243499,521739,71886,149085,91105,203031,162991,352116
261170,202309,10213,19120,8329,16535,312,562,7153,13682,7465,14244
261180,202309,11826,25233,9311,21354,437,1003,7178,15751,7615,16754
261190,202309,6777,14888,5440,12640,180,648,4417,9509,4597,10157
261200,202309,4461,8601,3510,7246,159,360,2847,5682,3006,6042
261210,202309,2279,4904,1827,4207,135,195,1449,3334,1584,3529
261220,202309,19288,43798,14940,36017,1204,3077,10488,23411,11692,26488
261230,202309,4747,11648,3666,9985,80,318,2922,7727,3002,8045
261240,202309,7976,15339,6610,13302,234,452,5736,11199,5970,11651
261245,202309,4888,11341,3746,9426,114,421,2928,6883,3042,7304
261247,202309,3831,9946,2899,8200,318,866,1889,5246,2207,6112
261250,202309,38947,72433,31683,63250,5391,10250,21366,42984,26757,53234
261255,202309,4902,12543,3593,10002,162,556,2600,6816,2762,7372
261260,202309,20450,39961,16780,35225,385,1097,14836,29825,15221,30922
261270,202309,6750,12421,5533,10812,209,374,4868,9251,5077,9625
261280,202309,3296,7743,2695,6738,120,391,2098,4941,2218,5332
261290,202309,3744,7885,2869,6757,80,219,2323,5329,2403,5548
261300,202309,17620,38881,13773,32467,434,1265,10912,24128,11346,25393
261310,202309,12948,26741,10378,22838,861,1896,7801,16421,8662,18317
261320,202309,7537,18138,6097,15704,145,414,4899,12119,5044,12533
261330,202309,8042,15722,6757,13975,186,457,5907,11803,6093,12260
261340,202309,7828,15381,6468,13511,272,589,5517,11127,5789,11716
261350,202309,10399,27050,8259,23043,368,1023,6178,16780,6546,17803
261360,202309,11342,21971,9041,18527,611,1097,7082,14036,7693,15133
261370,202309,33692,70898,25804,58713,2077,4815,18519,39742,20596,44557
261380,202309,5589,13225,4572,11520,495,1173,3005,7443,3500,8616
261390,202309,22764,55320,16987,45369,1764,4493,10974,28073,12738,32566
261400,202309,6278,15297,5064,13020,209,757,3919,9358,4128,10115
261410,202309,12736,26082,9694,21504,256,743,7997,16627,8253,17370
261420,202309,11104,26033,8996,22797,565,1539,6962,16783,7527,18322
261430,202309,5566,11142,4556,9643,53,160,4097,8313,4150,8473
261440,202309,1666,4463,1278,3701,51,229,898,2451,949,2680
261450,202309,19168,42597,15524,36840,742,1787,12003,27947,12745,29734
261460,202309,9736,22605,7652,19187,304,815,5951,14549,6255,15364
261470,202309,4678,10297,3642,8673,62,221,3014,6831,3076,7052
261480,202309,6929,17544,5526,15092,284,964,4093,10373,4377,11337
261485,202309,7327,17304,5845,14833,411,1192,4270,10281,4681,11473
261500,202309,8852,19021,7186,16518,825,1511,4954,11682,5779,13193
261510,202309,2230,5833,1771,4978,74,281,1350,3677,1424,3958
261520,202309,2968,7492,2398,6335,133,399,1738,4341,1871,4740
261530,202309,15479,38080,11430,30657,785,2487,7072,17116,7857,19603
261540,202309,12294,30289,10627,27657,2899,6747,5036,14426,7935,21173
261550,202309,4647,10667,3674,8979,273,703,2637,6081,2910,6784
261560,202309,12108,27134,9998,23879,345,966,8196,18703,8541,19669
261570,202309,4585,10938,3275,8593,313,898,2156,5322,2469,6220
261580,202309,9150,19360,7401,16825,94,356,6677,14638,6771,14994
261590,202309,3409,7318,2645,6137,60,202,2139,4680,2199,4882
261600,202309,7682,14615,6305,12634,155,354,5396,10328,5551,10682
261610,202309,2765,7057,2082,5757,258,690,1232,3376,1490,4066
261618,202309,3607,6816,2922,5861,73,179,2495,4811,2568,4990
261620,202309,6186,14278,5415,13099,624,1296,3881,9653,4505,10949
261630,202309,7388,18591,5655,15095,424,1218,3530,8615,3954,9833
261640,202309,49546,93925,37977,78104,2226,3845,28784,58311,31010,62156
261650,202309,5556,11116,4247,9355,321,636,3359,7343,3680,7979
270010,202309,5127,15156,3989,12887,181,827,2864,8765,3045,9592
270020,202309,5185,10566,4117,9109,210,651,3319,6782,3529,7433
270030,202309,47159,111974,37777,96470,2534,6727,28098,69011,30632,75738
270040,202309,12114,28614,9417,24784,714,2037,6909,17456,7623,19493
270050,202309,6736,13699,5358,12037,195,502,4604,10089,4799,10591
270060,202309,2765,6363,2154,5494,144,383,1568,3811,1712,4194
270070,202309,6571,14451,5415,12769,149,461,4694,10640,4843,11101
270080,202309,1807,4221,1327,3432,89,228,984,2473,1073,2701
270090,202309,2257,5798,1902,5170,67,212,1630,4343,1697,4555
270100,202309,8934,16484,7275,14247,186,428,6419,12163,6605,12591
270110,202309,3926,8434,2923,7088,172,321,2327,5711,2499,6032
270120,202309,3040,7495,2495,6671,101,294,1884,4879,1985,5173
270130,202309,6132,13859,4827,11992,176,589,3975,9429,4151,10018
270135,202309,2411,5099,1916,4500,44,175,1652,3721,1696,3896
270140,202309,10308,22891,7245,18008,455,1204,5200,12077,5655,13281
270150,202309,3881,8800,3419,8136,49,178,3182,7452,3231,7630
270160,202309,6112,15385,4967,13756,180,613,4257,11478,4437,12091
270170,202309,3799,10030,2917,8503,185,692,1966,5264,2151,5956
270180,202309,2887,7572,2434,6897,88,367,2018,5533,2106,5900
270190,202309,3039,6062,2615,5528,36,126,2368,4837,2404,4963
270200,202309,3368,8706,2639,7394,531,1264,1536,4479,2067,5743
270210,202309,7078,14323,5761,12689,148,513,5059,10737,5207,11250
270220,202309,2090,4475,1530,3573,117,285,1155,2542,1272,2827
270230,202309,12637,29962,9935,25525,984,2706,7257,17763,8241,20469
270235,202309,7667,20491,6161,17807,313,967,4691,13136,5004,14103
270240,202309,14314,33794,10860,28200,1008,2813,7679,19022,8687,21835
270250,202309,4212,8278,3388,7093,176,450,2760,5505,2936,5955
270255,202309,5211,13336,3903,10954,167,532,2996,8105,3163,8637
270260,202309,6620,18075,5541,16132,132,527,4553,12822,4685,13349
270270,202309,1226,2898,922,2465,106,275,666,1749,772,2024
270280,202309,4522,9617,3258,7958,242,526,2323,5728,2565,6254
270290,202309,9729,26755,8342,24376,240,939,7026,20053,7266,20992
270300,202309,4851,11429,3508,9578,220,639,2592,6871,2812,7510
270310,202309,7963,20170,6321,17458,188,663,4943,13155,5131,13818
270320,202309,6650,17486,5138,14479,230,798,3669,9517,3899,10315
270330,202309,5291,14419,4373,12956,215,869,3576,10227,3791,11096
270340,202309,1961,4594,1542,3926,102,175,1258,3224,1360,3399
270350,202309,2262,4563,1678,3806,203,355,1066,2520,1269,2875
270360,202309,4330,8251,3689,7479,64,191,3385,6674,3449,6865
270370,202309,1595,4462,1330,3970,40,177,1079,3118,1119,3295
270375,202309,4854,8708,3877,7621,119,313,3360,6418,3479,6731
270380,202309,6988,15777,5412,13609,649,1440,3906,9872,4555,11312
270390,202309,1523,3304,1136,2835,13,65,983,2422,996,2487
270400,202309,7719,18383,5787,15193,372,1000,4041,10173,4413,11173
270410,202309,6349,15581,5139,13665,155,531,4225,10799,4380,11330
270420,202309,8426,19527,7304,17783,179,600,6214,14502,6393,15102
270430,202309,222809,446520,164927,363466,19633,43420,105378,220719,125011,264139
270440,202309,5649,13576,4605,12057,296,999,3554,9073,3850,10072
270450,202309,11376,23569,9434,20998,508,1022,7643,16844,8151,17866
270460,202309,4697,9340,3629,7955,230,418,3065,6641,3295,7059
270470,202309,14865,35523,11870,30688,709,2046,9005,22242,9714,24288
270480,202309,3749,8466,2851,7135,194,506,2178,5194,2372,5700
270490,202309,1070,2663,862,2350,52,161,651,1697,703,1858
270500,202309,5864,15498,5003,13908,294,805,3990,10882,4284,11687
270510,202309,7738,16964,5969,14414,310,917,4667,10708,4977,11625
270520,202309,4926,12064,3455,9451,692,1896,1672,4485,2364,6381
270530,202309,1635,4208,1261,3538,88,232,860,2377,948,2609
270540,202309,2703,6474,2104,5597,91,270,1760,4552,1851,4822
270550,202309,7975,18284,5807,15492,661,1612,3873,10388,4534,12000
270560,202309,3643,8093,2815,6878,164,521,2172,4971,2336,5492
270570,202309,6804,14430,5492,12421,491,1219,4308,9158,4799,10377
270580,202309,2947,7105,2478,6365,106,291,2071,5173,2177,5464
270590,202309,1701,4601,1480,4243,47,166,1270,3581,1317,3747
270600,202309,3358,8872,2902,8101,103,313,2465,6771,2568,7084
270610,202309,4317,10295,3547,9149,228,589,2653,6625,2881,7214
270620,202309,1422,3897,1213,3506,54,158,982,2754,1036,2912
270630,202309,24108,48881,19695,42566,629,1738,16808,34421,17437,36159
270640,202309,6784,16791,5341,14416,162,593,4137,10608,4299,11201
270642,202309,3150,8672,2583,7611,229,720,1807,5083,2036,5803
270644,202309,4782,10598,3771,9181,327,818,2824,6724,3151,7542
270650,202309,4588,10550,3749,9320,230,639,2928,6867,3158,7506
270660,202309,2360,5184,1947,4587,97,214,1496,3430,1593,3644
270670,202309,23561,45563,18295,38451,1076,2155,14669,29553,15745,31708
270680,202309,7750,14483,6624,13141,293,449,5938,11811,6231,12260
270690,202309,12803,27306,9817,22946,279,845,8034,17844,8313,18689
270700,202309,702,1804,565,1558,79,218,374,984,453,1202
270710,202309,7137,18672,5781,16313,407,1236,4325,11850,4732,13086
270720,202309,4488,11197,3705,9834,125,392,3039,7753,3164,8145
270730,202309,9433,18988,7176,16322,723,1171,5353,12688,6076,13859
270740,202309,2808,6764,2253,5943,120,388,1722,4299,1842,4687
270750,202309,6818,15268,5653,13525,115,425,5055,11651,5170,12076
270760,202309,4018,9664,3147,8349,68,285,2566,6561,2634,6846
270770,202309,29727,65196,21885,53231,2993,7130,13940,32489,16933,39619
270780,202309,2500,5390,2143,4898,60,162,1895,4205,1955,4367
270790,202309,2204,4998,1704,4207,107,269,1336,3156,1443,3425
270800,202309,14651,32619,12091,28698,640,1665,9411,21410,10051,23075
270810,202309,4203,9936,3127,8236,391,884,2165,5664,2556,6548
270820,202309,1915,5107,1532,4451,63,218,1189,3338,1252,3556
270830,202309,6296,13427,4733,11284,475,932,3461,8170,3936,9102
270840,202309,9854,26473,7958,23224,550,2239,5960,16422,6510,18661
270850,202309,10884,21999,8588,19066,604,1437,6864,14800,7468,16237
270860,202309,17830,35733,12805,29012,842,2010,9955,21830,10797,23840
270870,202309,2862,7370,2043,5875,198,618,1247,3366,1445,3984
270880,202309,9556,25592,7772,22352,239,889,6113,16922,6352,17811
270890,202309,4267,10272,3265,8542,578,1497,1693,4275,2271,5772
270895,202309,4716,11110,4006,10066,176,517,3323,8103,3499,8620
270900,202309,1852,4367,1352,3576,54,174,1012,2529,1066,2703
270910,202309,5631,13713,4489,11884,324,764,3419,8834,3743,9598
270915,202309,11495,28545,8470,23088,892,2725,5354,13508,6246,16233
270920,202309,7430,18509,6079,16374,123,496,5072,13262,5195,13758
270930,202309,22207,45007,16383,37559,2184,4778,11139,25304,13323,30082
270940,202309,7284,17314,5578,14903,178,682,4275,10754,4453,11436
280010,202309,673,1783,492,1414,20,85,324,833,344,918
280020,202309,6574,13935,5139,11651,460,1009,3825,8287,4285,9296
280030,202309,128814,249627,97653,201925,18418,35372,54519,110831,72937,146203
280040,202309,3778,8614,2998,7330,200,520,2285,5353,2485,5873
280050,202309,5235,13242,3858,10607,885,2428,1818,4741,2703,7169
280060,202309,10006,21118,7403,16991,1135,2691,4435,9576,5570,12267
280067,202309,8920,18369,6885,15082,639,1057,4988,10748,5627,11805
280070,202309,2209,5882,1887,5331,129,419,1406,3743,1535,4162
280100,202309,5436,12120,4229,10110,698,1418,2438,5974,3136,7392
280110,202309,2021,4208,1624,3637,40,131,1425,3054,1465,3185
280120,202309,10064,23818,8278,20845,1179,2630,5530,14044,6709,16674
280130,202309,10590,22244,8175,18793,745,1747,5940,13299,6685,15046
280140,202309,7655,14824,6337,12846,832,1325,4509,9364,5341,10689
280150,202309,4856,11046,3551,8771,559,1109,2199,5357,2758,6466
280160,202309,1624,3869,1254,3209,133,289,811,1945,944,2234
280170,202309,7202,15091,5854,13073,217,553,4832,10342,5049,10895
280190,202309,2084,3422,1736,2960,31,67,1575,2597,1606,2664
280200,202309,1523,3590,1100,2925,66,247,755,1789,821,2036
280210,202309,22757,47268,17353,38542,2483,5228,11212,24087,13695,29315
280220,202309,2063,4574,1623,3930,87,185,1264,3001,1351,3186
280230,202309,5058,11503,3719,9332,250,542,2512,6131,2762,6673
280240,202309,3914,9211,3211,8090,41,186,2736,6584,2777,6770
280250,202309,1362,2514,919,1806,40,91,745,1371,785,1462
280260,202309,3113,6034,2488,5201,48,124,2229,4510,2277,4634
280270,202309,3115,7133,2552,6281,121,370,2169,5091,2290,5461
280280,202309,4717,12350,3783,10723,520,1194,2555,7381,3075,8575
280290,202309,27865,59624,21531,49513,2506,6243,12890,29163,15396,35406
280300,202309,16616,32121,13712,28694,1083,1600,10748,23209,11831,24809
280310,202309,1690,3808,1297,3155,45,132,1024,2358,1069,2490
280320,202309,11712,26216,9285,22218,975,2198,6613,15079,7588,17277
280330,202309,5567,12302,4017,9804,321,816,2805,6462,3126,7278
280340,202309,6425,11914,4749,9845,199,383,3974,8028,4173,8411
280350,202309,40453,74548,32257,62695,4174,6032,23149,45336,27323,51368
280360,202309,7257,17584,5278,13969,649,1706,3226,8030,3875,9736
280370,202309,2886,5963,2172,4774,233,398,1536,3385,1769,3783
280380,202309,1301,2962,993,2447,117,283,684,1646,801,1929
280390,202309,5107,10214,3921,8356,278,499,3094,6430,3372,6929
280400,202309,5163,10627,3956,8833,360,784,2937,6375,3297,7159
280410,202309,3529,8229,2688,6755,468,1090,1588,3830,2056,4920
280420,202309,5599,12328,4687,11082,131,325,4115,9604,4246,9929
280430,202309,2989,5871,2433,5099,101,274,2027,4003,2128,4277
280440,202309,5642,12210,4502,10402,367,801,3501,7736,3868,8537
280445,202309,2641,6310,2258,5624,194,317,1643,4071,1837,4388
280450,202309,12143,26918,9623,22944,2675,6037,4611,11300,7286,17337
280460,202309,8721,17868,7221,15712,575,1303,5619,11715,6194,13018
280470,202309,2031,5010,1535,4051,211,481,1027,2654,1238,3135
280480,202309,65829,132353,51335,109838,6349,13243,34235,70013,40584,83256
280490,202309,4137,10796,3192,9004,297,760,2134,5793,2431,6553
280500,202309,1312,2628,948,2114,36,105,754,1637,790,1742
280510,202309,4569,7608,3759,6528,272,384,3231,5526,3503,5910
280520,202309,2339,4770,1887,4103,173,337,1400,2978,1573,3315
280530,202309,2846,6402,2192,5356,108,283,1720,4033,1828,4316
280540,202309,10476,24803,8870,22272,411,1075,7420,18263,7831,19338
280550,202309,8331,16673,6408,13824,191,549,5294,10725,5485,11274
280560,202309,9319,21604,8102,19647,193,593,7009,16507,7202,17100
280570,202309,8732,17716,6666,14765,335,781,5183,10807,5518,11588
280580,202309,7846,16164,6440,13955,494,946,5157,10892,5651,11838
280590,202309,3354,7035,2435,5684,165,429,1770,3852,1935,4281
280600,202309,5301,11266,4272,9490,951,1650,2509,5805,3460,7455
280610,202309,3542,6928,2773,5795,118,272,2309,4614,2427,4886
280620,202309,7835,15958,6060,13400,469,768,4484,10012,4953,10780
280630,202309,5228,11489,4316,10054,388,756,3133,7204,3521,7960
280640,202309,3071,6593,2394,5686,88,255,2076,4792,2164,5047
280650,202309,1403,3328,1018,2653,124,329,610,1458,734,1787
280660,202309,4770,8917,3711,7502,304,571,2970,5867,3274,6438
280670,202309,25996,53266,19860,44080,3872,7871,11335,25073,15207,32944
280680,202309,3554,7491,2756,6235,261,473,1877,4302,2138,4775
280690,202309,1330,2622,1015,2162,52,129,825,1688,877,1817
280700,202309,1474,3025,1156,2528,20,53,976,2060,996,2113
280710,202309,18986,36099,14570,30524,862,1545,12048,24761,12910,26306
280720,202309,3108,6222,2236,5002,40,109,1845,4030,1885,4139
280730,202309,1261,2877,961,2359,110,265,636,1517,746,1782
280740,202309,21407,40099,17059,33597,883,1943,13833,25705,14716,27648
280750,202309,4129,10372,3259,8744,353,858,2210,5857,2563,6715
280760,202309,9260,19478,7273,16516,700,1393,5334,12029,6034,13422
290010,202309,3748,6776,2418,4791,23,58,2083,3890,2106,3948
290020,202309,7363,15096,6228,13559,426,721,5069,10968,5495,11689
290030,202309,5443,11087,4172,9451,409,837,3053,7049,3462,7886
290035,202309,6179,11736,4847,9912,198,343,3913,7819,4111,8162
290040,202309,7209,12214,5838,10516,207,336,5118,9069,5325,9405
290050,202309,2531,7136,1916,5765,147,472,1284,3632,1431,4104
290060,202309,1926,3626,1304,2757,147,311,958,1937,1105,2248
290070,202309,53260,100397,40750,82251,3454,6535,30350,59104,33804,65639
290080,202309,8710,19628,6983,16843,808,2006,4822,11270,5630,13276
290090,202309,2751,4360,1922,3458,40,70,1746,3071,1786,3141
290100,202309,12156,27582,8611,21578,1800,4287,3870,9990,5670,14277
290110,202309,6896,15672,5080,12287,968,2048,2687,6436,3655,8484
290115,202309,4911,13002,3852,11000,390,1113,2892,8085,3282,9198
290120,202309,8348,17488,6420,14570,240,606,5387,11750,5627,12356
290130,202309,5566,11539,3924,9167,265,523,2746,6599,3011,7122
290135,202309,5674,11536,4086,8780,318,686,3044,6132,3362,6818
290140,202309,5271,12076,3718,9721,200,515,2942,7509,3142,8024
290150,202309,4266,7894,3207,6521,127,332,2569,4891,2696,5223
290160,202309,4553,8599,3734,7390,235,390,3114,6052,3349,6442
290170,202309,4674,9273,3664,8022,138,315,3120,6651,3258,6966
290180,202309,3632,8515,2860,7231,88,284,2376,5801,2464,6085
290190,202309,6234,12990,5257,11603,115,314,4543,9748,4658,10062
290195,202309,3317,6701,2424,5515,165,335,1937,4357,2102,4692
290200,202309,5015,12409,3531,9711,232,542,2466,6632,2698,7174
290205,202309,4662,9729,3631,8000,167,429,2859,5994,3026,6423
290210,202309,17975,39686,14607,34216,1664,3324,10631,24914,12295,28238
290220,202309,4234,7748,3453,6726,109,270,2968,5562,3077,5832
290225,202309,3793,6645,2709,5433,51,150,2373,4525,2424,4675
290230,202309,3917,7493,3421,6869,190,284,2757,5634,2947,5918
290240,202309,5106,10091,3988,8671,174,417,3326,7034,3500,7451
290250,202309,5176,12151,3817,10016,200,495,3041,7923,3241,8418
290260,202309,6564,13931,5129,11658,255,623,4244,9198,4499,9821
290265,202309,3787,10293,2809,8305,406,1243,1629,4619,2035,5862
290270,202309,13232,39543,11174,35477,927,2957,8021,25043,8948,28000
290280,202309,7401,20364,5697,16592,746,2250,3482,9570,4228,11820
290290,202309,11992,31350,8448,24439,1017,3047,4938,13470,5955,16517
290300,202309,4975,12121,3374,9039,225,684,2383,6042,2608,6726
290310,202309,2870,4992,2252,4236,19,54,2080,3809,2099,3863
290320,202309,38522,84830,28090,67632,5243,12767,15444,35494,20687,48261
290323,202309,4647,11239,3610,9437,142,419,2774,7116,2916,7535
290327,202309,5200,12993,3857,10161,407,951,2553,6556,2960,7507
290330,202309,3159,5052,2403,4212,25,69,2208,3798,2233,3867
290340,202309,7952,16093,5897,13355,435,969,4618,10176,5053,11145
290350,202309,5807,14496,4440,12029,291,864,3224,8445,3515,9309
290360,202309,6653,13724,5267,11705,226,596,4439,9483,4665,10079
290370,202309,5659,12362,3678,9462,210,574,2573,6551,2783,7125
290380,202309,7324,15342,5586,12765,169,374,4707,10639,4876,11013
290390,202309,18986,47280,14208,38726,1414,3873,9502,25135,10916,29008
290395,202309,3649,8766,2630,6924,114,384,1997,4992,2111,5376
290400,202309,4517,11056,3198,8659,162,509,2375,6134,2537,6643
290405,202309,5484,14094,4303,11906,585,1555,2680,7464,3265,9019
290410,202309,6923,16030,4838,12623,184,706,3649,8995,3833,9701
290420,202309,3750,9069,2795,7468,146,388,2016,5322,2162,5710
290430,202309,4605,9686,3606,8176,158,434,2898,6219,3056,6653
290440,202309,3469,7679,2337,5809,185,426,1636,4039,1821,4465
290450,202309,5289,10042,3850,7883,79,222,3384,6608,3463,6830
290460,202309,15764,40139,10909,29978,2601,7260,4012,10483,6613,17743
290470,202309,6100,12012,4192,9252,372,789,2899,6227,3271,7016
290475,202309,8116,19835,6195,16504,166,646,5085,13011,5251,13657
290480,202309,2302,4871,1701,3890,63,192,1258,2613,1321,2805
290485,202309,5701,14248,4643,12574,273,835,3524,9348,3797,10183
290490,202309,12089,23451,10032,20453,608,1198,7990,15867,8598,17065
290500,202309,5180,13723,3512,10120,830,2466,1248,3450,2078,5916
290510,202309,4446,9151,3475,7817,104,251,2961,6602,3065,6853
290515,202309,4202,10297,3279,8771,84,343,2618,6657,2702,7000
290520,202309,15243,37333,10617,28079,597,1973,7106,16994,7703,18967
290530,202309,5878,15051,4573,12775,124,447,3736,10183,3860,10630
290540,202309,5106,11333,4320,10308,160,400,3634,8475,3794,8875
290550,202309,5435,11578,4421,10271,125,384,3822,8704,3947,9088
290560,202309,7663,17478,5326,13721,541,1527,3256,7718,3797,9245
290570,202309,76988,160276,62840,138519,5761,13833,47415,99175,53176,113008
290580,202309,11482,25916,9463,22945,856,1939,6990,16973,7846,18912
290590,202309,8376,23141,6607,19970,182,651,5199,15660,5381,16311
290600,202309,23354,57458,18312,48482,1289,3524,13968,35626,15257,39150
290610,202309,2928,8152,2129,6518,102,351,1492,4405,1594,4756
290620,202309,7291,18996,5738,16178,475,1243,4344,12083,4819,13326
290630,202309,13264,25047,10375,21267,693,1463,8273,16535,8966,17998
290640,202309,3295,6978,2268,5325,238,494,1583,3770,1821,4264
290650,202309,24385,45795,20549,40535,706,1843,18007,33970,18713,35813
290660,202309,4535,10595,3241,8267,190,540,2333,5809,2523,6349
290670,202309,10872,21228,8689,17985,194,521,7654,15276,7848,15797
290680,202309,13756,32164,10782,27611,273,961,8778,21602,9051,22563
290682,202309,6752,13624,5497,11887,438,653,4021,9319,4459,9972
290685,202309,4349,8844,2895,6637,446,936,1691,3933,2137,4869
290687,202309,10479,21901,8228,18330,1237,2508,5160,11569,6397,14077
290689,202309,3419,8200,2311,6221,356,921,1411,3733,1767,4654
290690,202309,7069,16076,5218,13032,426,1030,3660,8849,4086,9879
290700,202309,3870,7746,3149,6785,106,259,2635,5479,2741,5738
290710,202309,11292,25221,9002,21897,240,691,7779,18454,8019,19145
290720,202309,26255,59073,21278,51205,1599,3599,15798,36485,17397,40084
290730,202309,8843,18508,6852,15799,664,1288,4641,10813,5305,12101
290740,202309,1343,3037,966,2442,85,182,748,1877,833,2059
290750,202309,17955,34391,13584,26823,348,906,11359,20891,11707,21797
290755,202309,2364,6108,1719,4922,195,440,1086,3153,1281,3593
290760,202309,4495,11539,3415,9513,170,409,2410,6746,2580,7155
290770,202309,3944,8843,3378,8024,87,288,2897,6643,2984,6931
290780,202309,9433,21126,7004,17195,704,1350,4799,11915,5503,13265
290790,202309,6302,14876,5031,12889,310,857,3968,9969,4278,10826
290800,202309,8225,14687,5538,11317,520,901,3937,8149,4457,9050
290810,202309,6900,14811,5129,12066,218,542,3959,9104,4177,9646
290820,202309,6763,14904,5122,12065,283,655,3688,8297,3971,8952
290830,202309,5142,11480,3924,9273,156,551,2896,6134,3052,6685
290840,202309,22817,53037,17336,43486,2001,4292,10558,27512,12559,31804
290850,202309,11536,20879,8919,17526,641,1144,6927,13221,7568,14365
290860,202309,8120,18949,6663,16942,374,822,5481,13981,5855,14803
290870,202309,5848,14251,3955,10490,391,925,2583,6639,2974,7564
290880,202309,1719,3736,1237,3044,248,551,624,1661,872,2212
290890,202309,12326,21305,9665,18133,320,691,8355,15167,8675,15858
290900,202309,2766,6731,1846,4927,245,649,1052,2713,1297,3362
290910,202309,6248,12780,4390,9971,76,200,3783,8373,3859,8573
290920,202309,6381,13737,5228,12271,195,379,4265,10423,4460,10802
290930,202309,8633,22063,6356,17870,297,953,4546,12263,4843,13216
290940,202309,4136,10433,3140,8745,237,679,2310,6250,2547,6929
290950,202309,1705,3786,1233,3027,115,277,780,1921,895,2198
290960,202309,7518,16112,6098,14035,444,771,4869,11230,5313,12001
290970,202309,3666,10171,2706,8213,206,665,1915,5619,2121,6284
290980,202309,18732,37483,14464,30478,763,1820,10519,20456,11282,22276
290990,202309,12068,27951,9906,24322,481,1327,7915,18498,8396,19825
291000,202309,3986,8936,2902,7479,195,539,2198,5602,2393,6141
291005,202309,22054,46377,17504,39383,1074,2618,13667,29120,14741,31738
291010,202309,3597,10112,2522,7660,170,520,1590,4620,1760,5140
291020,202309,1538,3422,1115,2669,37,108,785,1697,822,1805
291030,202309,3093,6490,2036,4675,242,508,1224,2672,1466,3180
291040,202309,6501,15529,4874,13044,272,730,3651,9674,3923,10404
291050,202309,14812,28845,11989,24558,1488,2833,8571,17185,10059,20018
291060,202309,11287,24164,9077,20946,1286,2382,6255,14510,7541,16892
291070,202309,22841,48448,18167,41018,427,1175,15549,33732,15976,34907
291072,202309,36569,77289,24314,56634,3789,8653,13337,29783,17126,38436
291075,202309,6475,14418,5396,12578,110,308,4372,9674,4482,9982
291077,202309,2038,4794,1440,3741,103,214,939,2450,1042,2664
291080,202309,173848,361921,124620,284583,24665,56948,62672,136405,87337,193353
291085,202309,6876,15245,5163,12554,250,693,4137,9699,4387,10392
291090,202309,2573,4363,1704,3326,51,128,1417,2650,1468,2778
291100,202309,3899,7202,2638,5588,112,213,2075,4268,2187,4481
291110,202309,7092,19317,5264,15735,319,1094,3755,10572,4074,11666
291120,202309,10306,20521,8073,17407,603,1214,6055,12730,6658,13944
291125,202309,2827,4391,1997,3441,88,134,1734,2940,1822,3074
291130,202309,3834,9577,2561,7058,132,434,1871,4833,2003,5267
291140,202309,5767,13970,3684,9898,695,1573,2006,5517,2701,7090
291150,202309,3406,5831,2491,4774,98,162,2191,4167,2289,4329
291160,202309,6175,15137,4455,12085,607,1617,2567,6528,3174,8145
291165,202309,2486,6262,1543,4339,43,162,1037,2765,1080,2927
291170,202309,27700,62562,20150,48664,1702,4064,13144,29892,14846,33956
291180,202309,9675,16696,6982,13165,364,666,5927,10858,6291,11524
291185,202309,4317,9280,3530,8038,200,396,2819,6343,3019,6739
291190,202309,9377,20004,7270,17090,362,860,5392,12659,5754,13519
291200,202309,3251,8139,2149,5934,101,326,1400,3582,1501,3908
291210,202309,9766,17204,6766,13586,374,723,5346,10468,5720,11191
291220,202309,6046,14219,4810,12026,601,1418,3056,7383,3657,8801
291230,202309,6038,10198,4436,8317,97,176,4001,7346,4098,7522
291240,202309,5051,11676,3957,9819,117,329,3308,7930,3425,8259
291250,202309,3884,10479,2803,8424,236,627,1600,4919,1836,5546
291260,202309,1834,3643,1357,2990,31,71,1114,2383,1145,2454
291270,202309,6880,14939,5036,12321,647,1596,3438,8347,4085,9943
291280,202309,3417,7364,2173,5254,161,422,1512,3368,1673,3790
291290,202309,6656,15676,4517,12091,495,1372,2892,7397,3387,8769
291300,202309,4704,11061,3455,8898,277,593,2436,6185,2713,6778
291310,202309,6391,14675,4982,12164,150,432,4191,9861,4341,10293
291320,202309,7973,19006,5746,15083,1391,3485,2884,7639,4275,11124
291330,202309,2237,5143,1694,4212,71,219,1255,2974,1326,3193
291340,202309,5143,11754,3751,9344,293,692,2440,5973,2733,6665
291345,202309,3594,8765,3015,7821,244,627,2297,5898,2541,6525
291350,202309,8555,17685,6301,14640,337,788,4891,10992,5228,11780
291360,202309,56237,106608,40611,85871,6033,12002,24793,52399,30826,64401
291370,202309,10225,23953,8252,20585,1161,2488,5376,13092,6537,15580
291380,202309,5949,11741,4744,10104,137,434,3981,8051,4118,8485
291390,202309,16858,30596,11958,24470,922,1558,9383,18763,10305,20321
291400,202309,20925,41886,15776,33809,2041,3879,10211,22036,12252,25915
291410,202309,3620,8364,2591,6521,64,211,1925,4614,1989,4825
291420,202309,2239,4843,1652,4059,29,101,1416,3403,1445,3504
291430,202309,3152,7699,2437,6413,171,450,1786,4502,1957,4952
291440,202309,8212,20068,6464,17108,507,1276,4554,12110,5061,13386
291450,202309,13978,25041,10856,21256,329,607,9586,18696,9915,19303
291460,202309,23179,49474,18233,41134,2121,4397,12487,27116,14608,31513
291465,202309,10550,22961,7884,19587,361,1181,6254,14892,6615,16073
291470,202309,26200,47286,19626,38492,1163,2055,14788,27590,15951,29645
291480,202309,55424,108406,39328,83589,4746,10173,23554,47155,28300,57328
291490,202309,9494,18312,7966,16454,466,939,6683,13486,7149,14425
291500,202309,6824,12865,5346,10968,135,388,4728,9323,4863,9711
291510,202309,5930,11282,4319,9177,100,289,3733,7671,3833,7960
291520,202309,5640,11338,3787,8701,221,535,2910,6367,3131,6902
291530,202309,2766,5634,1804,4284,169,413,1214,2792,1383,3205
291535,202309,4733,11360,3662,9545,209,539,2862,7379,3071,7918
291540,202309,2702,5086,1800,3924,95,183,1494,3243,1589,3426
291550,202309,8309,15135,5881,11836,414,745,4408,8685,4822,9430
291560,202309,21752,47366,14223,35748,3793,9327,5405,13465,9198,22792
291570,202309,2866,5725,2045,4745,70,183,1732,3936,1802,4119
291580,202309,7722,17136,5422,13647,450,1115,3788,9170,4238,10285
291590,202309,3511,6396,2825,5527,69,173,2473,4610,2542,4783
291600,202309,6803,13634,4770,10490,509,1203,3085,6531,3594,7734
291610,202309,8685,16720,7168,14790,722,1093,5461,11481,6183,12574
291620,202309,3569,7001,2489,5633,203,419,1777,4057,1980,4476
291630,202309,4308,7800,3039,6209,546,884,2100,4497,2646,5381
291640,202309,23124,46000,15755,34653,1257,2946,10414,21501,11671,24447
291650,202309,12715,25634,10473,22607,812,1457,8204,17658,9016,19115
291660,202309,2370,5182,1640,4035,140,367,1079,2438,1219,2805
291670,202309,2416,5739,1826,4802,306,713,1071,2928,1377,3641
291680,202309,5065,10859,3697,8771,766,1780,2031,4840,2797,6620
291685,202309,5691,12850,4182,10419,395,877,2945,7280,3340,8157
291690,202309,5553,9768,3768,7286,170,334,3264,6101,3434,6435
291700,202309,11978,27554,9929,24161,286,880,8512,19950,8798,20830
291710,202309,6774,13092,4725,10165,377,815,3480,7080,3857,7895
291720,202309,5394,14529,4062,11786,1076,3070,1891,5440,2967,8510
291730,202309,9928,18396,8140,16046,453,937,6763,12982,7216,13919
291733,202309,3614,7974,2714,6631,125,306,1984,4906,2109,5212
291735,202309,3136,7896,2177,6066,106,279,1492,4153,1598,4432
291740,202309,4998,11570,3014,7881,117,264,2086,5317,2203,5581
291750,202309,27483,56218,20695,45271,2946,5661,13519,29362,16465,35023
291760,202309,13856,34518,9671,27309,3247,10231,1691,4319,4938,14550
291770,202309,9530,22200,6977,17306,475,1366,5085,11680,5560,13046
291780,202309,6523,14530,5564,13093,220,542,4655,10654,4875,11196
291790,202309,3800,8150,3286,7442,480,707,2279,5494,2759,6201
291800,202309,45717,94417,33087,75049,5288,11368,19127,40992,24415,52360
291810,202309,13441,27726,10492,23648,594,1049,8285,18735,8879,19784
291820,202309,4817,10941,3872,9518,162,417,3074,7394,3236,7811
291830,202309,6089,11480,4628,9508,508,729,3391,7116,3899,7845
291835,202309,7880,21133,5868,17292,1206,3383,3073,9185,4279,12568
291840,202309,68081,155897,54526,133301,7226,17345,35918,84872,43144,102217
291845,202309,4245,8182,3218,6829,395,739,2209,4802,2604,5541
291850,202309,5611,12971,4394,10987,133,357,3713,9192,3846,9549
291855,202309,2883,4693,2135,3851,81,164,1885,3337,1966,3501
291860,202309,2568,6250,1591,4307,73,212,1038,2669,1111,2881
291870,202309,1545,3538,904,2396,83,229,552,1393,635,1622
291875,202309,3559,9676,2764,7937,103,392,1951,5324,2054,5716
291880,202309,6840,16429,5340,13850,393,968,3933,10163,4326,11131
291890,202309,2112,3752,1237,2665,207,415,734,1525,941,1940
291900,202309,1654,3430,1167,2669,51,135,917,1959,968,2094
291905,202309,2520,6186,1856,5022,106,319,1358,3449,1464,3768
291910,202309,4557,8438,3566,7148,82,195,3156,6209,3238,6404
291915,202309,8895,22305,6663,18300,329,950,4572,12470,4901,13420
291920,202309,47425,100161,37865,85756,1935,5303,29024,61412,30959,66715
291930,202309,3447,7483,2719,6397,350,727,1859,4423,2209,5150
291940,202309,4498,10357,2706,7209,322,802,1588,4122,1910,4924
291950,202309,10986,30533,8295,24984,579,1715,5345,15776,5924,17491
291955,202309,27150,57519,21795,49545,1478,3550,16384,35652,17862,39202
291960,202309,4741,9441,3664,7951,346,553,2818,6289,3164,6842
291970,202309,6187,12475,4918,10794,220,551,3904,8264,4124,8815
291980,202309,12316,30816,9003,24749,935,2421,5806,15943,6741,18364
291990,202309,2780,6262,2158,5455,77,309,1845,4504,1922,4813
291992,202309,5787,11536,4476,9507,157,380,3715,7541,3872,7921
291995,202309,2877,6349,2125,5102,94,281,1668,3765,1762,4046
292000,202309,3412,6710,2666,5787,97,238,2241,4763,2338,5001
292010,202309,7205,14233,5457,11549,116,334,4710,9584,4826,9918
292020,202309,5827,13758,4567,11508,132,453,3730,8951,3862,9404
292030,202309,2674,6689,2055,5515,250,709,1231,3148,1481,3857
292040,202309,5803,12117,4309,9953,175,358,3533,8038,3708,8396
292045,202309,5532,10946,4142,9003,62,189,3771,8041,3833,8230
292050,202309,7954,19307,5671,14980,368,968,3723,9330,4091,10298
292060,202309,16316,30785,14111,27927,740,1408,11874,22692,12614,24100
292070,202309,8986,17793,7467,15857,585,1252,6085,12636,6670,13888
292080,202309,4718,8796,3736,7536,66,208,3375,6602,3441,6810
292090,202309,5291,10043,3491,7769,163,413,2715,5885,2878,6298
292100,202309,16617,34932,12222,28141,1872,4318,7281,16051,9153,20369
292105,202309,3952,9129,3021,7625,91,303,2361,5743,2452,6046
292110,202309,8351,16415,5687,12642,957,2160,3403,7369,4360,9529
292120,202309,8771,19408,6553,15459,842,1686,4306,10280,5148,11966
292130,202309,4046,8571,2991,7065,294,625,2023,4641,2317,5266
292140,202309,7271,13934,5682,11585,193,414,4967,9827,5160,10241
292145,202309,3266,7718,2461,6296,152,303,1810,4703,1962,5006
292150,202309,20266,43408,16274,36875,382,1038,13688,29610,14070,30648
292160,202309,3508,7397,2435,5941,33,112,1931,4849,1964,4961
292170,202309,10625,25145,7986,20677,608,1694,5688,13967,6296,15661
292180,202309,3465,8681,2320,6414,210,587,1460,3807,1670,4394
292190,202309,3811,8567,2847,6933,350,822,1822,4340,2172,5162
292200,202309,11690,25856,7473,18815,1948,5047,2888,7096,4836,12143
292205,202309,4743,11228,3780,9657,150,425,3120,7811,3270,8236
292210,202309,8269,15563,6550,13312,105,316,6021,11884,6126,12200
292220,202309,2799,5610,2108,4497,164,343,1552,3093,1716,3436
292225,202309,3853,9913,3095,8648,87,317,2510,6785,2597,7102
292230,202309,10865,22436,8472,18916,350,949,6652,13995,7002,14944
292240,202309,6319,15666,4985,13147,382,1014,3469,8994,3851,10008
292250,202309,7818,16846,6347,14527,437,968,4896,10834,5333,11802
292260,202309,4208,9735,3407,8602,113,302,2890,7200,3003,7502
292265,202309,4605,10465,3613,8863,86,272,3021,7128,3107,7400
292270,202309,6098,11236,4640,9360,274,530,3701,7279,3975,7809
292273,202309,3429,6649,2503,5406,141,293,1822,4031,1963,4324
292275,202309,2242,4912,1769,4225,52,150,1457,3361,1509,3511
292280,202309,3385,6843,2562,5834,101,227,2149,4882,2250,5109
292285,202309,3174,6415,2322,5236,130,261,1849,4181,1979,4442
292290,202309,9273,20348,6996,16970,565,1055,5410,13155,5975,14210
292300,202309,13189,29276,9211,22985,1667,4132,5031,12361,6698,16493
292303,202309,4200,9276,3409,8014,85,211,2916,6622,3001,6833
292305,202309,2816,6484,2387,5829,130,307,1998,4787,2128,5094
292310,202309,8512,17909,6815,15510,198,590,5838,12767,6036,13357
292320,202309,6971,16532,5139,13311,204,536,3975,9984,4179,10520
292330,202309,3948,6661,3090,5638,163,249,2587,4733,2750,4982
292335,202309,6267,14410,5084,12507,397,918,3947,9634,4344,10552
292340,202309,6404,16354,4733,12985,504,1237,3132,8501,3636,9738
292350,202309,3473,7868,2781,6862,158,409,2214,5312,2372,5721
292360,202309,6041,14260,4542,11598,298,737,3226,7994,3524,8731
292370,202309,13479,27073,10787,23385,153,578,9851,20655,10004,21233
292380,202309,8327,20358,6757,17404,527,1353,4988,12358,5515,13711
292390,202309,5909,9355,4334,7485,158,269,3881,6610,4039,6879
292400,202309,30140,71004,23508,59303,2707,6494,15526,38113,18233,44607
292405,202309,5533,11807,4205,9619,164,407,3263,7458,3427,7865
292410,202309,3096,5673,2431,4812,114,214,2078,4042,2192,4256
292420,202309,6295,12036,5287,10639,143,279,4710,9233,4853,9512
292430,202309,6055,15991,4067,12056,339,1009,2611,7384,2950,8393
292440,202309,11608,29227,10121,26962,168,748,8846,22964,9014,23712
292450,202309,5067,12666,3431,9448,228,631,2416,6397,2644,7028
292460,202309,8028,16264,6350,13640,339,926,5210,10605,5549,11531
292465,202309,3151,6903,2376,5658,86,208,1648,4060,1734,4268
292467,202309,2681,6160,2262,5546,304,670,1519,3881,1823,4551
292470,202309,3358,7954,2248,6083,174,484,1568,4202,1742,4686
292480,202309,8177,15061,6473,12906,293,473,5644,11178,5937,11651
292490,202309,3581,6746,2611,5418,57,136,2211,4378,2268,4514
292500,202309,9069,19692,6560,15495,363,807,4959,11320,5322,12127
292510,202309,17634,39490,12563,31010,1606,3376,8303,20552,9909,23928
292520,202309,9408,20553,7353,17014,431,1133,5604,12306,6035,13439
292525,202309,8230,16542,6374,14213,196,527,5512,12020,5708,12547
292530,202309,48469,107015,34909,84506,6792,17280,17903,40529,24695,57809
292540,202309,5153,8569,3815,7090,240,447,3257,5977,3497,6424
292550,202309,10666,25452,7470,20926,738,2072,4685,13273,5423,15345
292560,202309,5628,12365,4182,10117,168,501,3245,7449,3413,7950
292570,202309,4513,10324,3388,8336,91,319,2720,6329,2811,6648
292575,202309,8290,21190,7050,19110,1392,3631,4444,12172,5836,15803
292580,202309,9720,19935,7600,16767,379,621,6246,13579,6625,14200
292590,202309,8989,21131,6960,17406,494,1238,5533,13483,6027,14721
292593,202309,3581,7801,2521,5946,116,297,1954,4399,2070,4696
292595,202309,6905,15530,5644,13712,336,725,4437,10767,4773,11492
292600,202309,13919,32655,11086,28105,792,1779,8540,21564,9332,23343
292610,202309,5639,12164,4275,9839,225,523,3328,7339,3553,7862
292620,202309,8228,18491,6307,15941,163,510,5396,13379,5559,13889
292630,202309,11717,24153,8575,18985,1641,3639,5287,11205,6928,14844
292640,202309,9762,24902,7304,20322,644,1673,4710,13146,5354,14819
292650,202309,5085,11324,4147,9953,113,419,3634,8425,3747,8844
292660,202309,13201,32692,10343,27890,583,1591,7586,20191,8169,21782
292665,202309,2480,6323,1961,5529,136,343,1460,4169,1596,4512
292670,202309,4077,10322,2906,8075,286,867,1846,4818,2132,5685
292680,202309,4678,10959,3466,8799,132,328,2625,6350,2757,6678
292690,202309,2872,6920,1825,5163,265,699,1052,3033,1317,3732
292700,202309,13016,29448,10025,24345,813,1626,7248,17341,8061,18967
292710,202309,4365,9070,3913,8469,95,272,3592,7582,3687,7854
292720,202309,10502,21598,8055,18275,493,1037,6002,13735,6495,14772
292730,202309,6961,13203,5760,11432,284,477,4852,9532,5136,10009
292740,202309,569672,1093426,463079,931704,55843,108598,318400,612320,374243,720918
292750,202309,9313,19025,7324,16243,344,826,6005,12962,6349,13788
292760,202309,4743,11867,3760,10072,191,544,2806,7302,2997,7846
292770,202309,10111,21403,7574,17704,1031,2512,4952,11215,5983,13727
292780,202309,2555,4357,1776,3405,69,159,1457,2612,1526,2771
292790,202309,4727,8615,3223,6811,320,601,2418,5063,2738,5664
292800,202309,14868,31433,11732,26370,1211,2349,8538,19254,9749,21603
292805,202309,4625,9175,3469,7619,197,487,2778,5852,2975,6339
292810,202309,17072,32864,12899,26552,399,1095,10761,20691,11160,21786
292820,202309,8011,20708,5503,16168,652,1860,3497,9969,4149,11829
292830,202309,3648,7450,2921,6519,140,299,2374,5290,2514,5589
292840,202309,12772,25463,10089,21719,207,603,8950,18523,9157,19126
292850,202309,3209,7263,2466,6072,186,468,1753,4126,1939,4594
292860,202309,22641,42325,17863,35654,483,1296,14953,28123,15436,29419
292870,202309,29824,60569,22596,48811,2694,4958,14466,29963,17160,34921
292880,202309,14011,34763,10231,27695,440,1413,6856,16852,7296,18265
292890,202309,11058,23663,8926,20402,255,692,7350,15909,7605,16601
292895,202309,4133,7478,2984,5747,262,491,2293,4317,2555,4808
292900,202309,3740,8026,3049,6895,56,200,2456,5180,2512,5380
292905,202309,5508,12298,4023,9879,363,855,2838,6683,3201,7538
292910,202309,7179,15515,5896,13620,202,412,4784,10682,4986,11094
292920,202309,12693,28700,10347,24640,402,1244,8283,18665,8685,19909
292925,202309,6258,16206,4492,12584,434,1043,2940,8125,3374,9168
292930,202309,8907,22762,6694,18216,1045,2679,3396,8861,4441,11540
292935,202309,3327,6120,2511,5127,30,86,2241,4510,2271,4596
292937,202309,3266,7664,2563,6638,423,1153,1256,3541,1679,4694
292940,202309,3747,8186,2758,6622,513,1128,1629,3981,2142,5109
292950,202309,11219,26019,8198,20469,637,1558,5693,13361,6330,14919
292960,202309,6921,14255,5288,11791,214,457,4099,8768,4313,9225
292970,202309,5004,12119,4166,10827,140,388,3327,8560,3467,8948
292975,202309,5276,10399,4297,9101,114,295,3765,7690,3879,7985
292980,202309,4833,9086,3743,7483,73,210,3320,6395,3393,6605
292990,202309,13964,34607,10691,28661,642,1944,7786,19643,8428,21587
293000,202309,3237,7084,2381,5635,255,521,1616,3828,1871,4349
293010,202309,23988,51976,17634,41628,3039,6956,10634,24555,13673,31511
293015,202309,10510,28123,7697,22643,734,2134,5097,14783,5831,16917
293020,202309,12744,29961,10852,27030,197,677,9650,23405,9847,24082
293030,202309,6289,14946,4421,11779,342,666,2843,7808,3185,8474
293040,202309,5404,12122,3923,9897,147,374,3155,7784,3302,8158
293050,202309,32515,63058,25565,51976,1901,3649,19498,37947,21399,41596
293060,202309,4643,10890,3398,8553,234,619,2450,5841,2684,6460
293070,202309,43509,81839,34757,68712,2040,4179,27069,50715,29109,54894
293075,202309,4458,11850,3582,10320,96,421,3012,8505,3108,8926
293076,202309,4168,8724,3484,7810,131,242,2997,6750,3128,6992
293077,202309,8384,19334,6031,15241,1059,2219,3349,9009,4408,11228
293080,202309,5335,14035,4185,11843,116,442,3304,8956,3420,9398
293090,202309,3821,10155,2574,7744,242,730,1679,4873,1921,5603
293100,202309,7212,16800,5394,13561,473,1030,3992,9944,4465,10974
293105,202309,4733,13242,3731,11208,320,935,2498,7384,2818,8319
293110,202309,3228,6519,2465,5356,162,310,1944,4150,2106,4460
293120,202309,6539,13481,5484,11884,509,847,4213,9247,4722,10094
293130,202309,4561,10453,3687,9170,110,339,3193,7731,3303,8070
293135,202309,40402,86829,25557,63065,5523,14779,9439,21768,14962,36547
293140,202309,3613,6000,2830,5005,120,183,2381,4065,2501,4248
293150,202309,6291,16500,4498,12731,602,1462,2811,7746,3413,9208
293160,202309,5072,10281,4285,9320,533,751,3242,7585,3775,8336
293170,202309,6786,10893,4962,8662,113,256,4308,7152,4421,7408
293180,202309,5724,13485,4429,11200,145,457,3538,8542,3683,8999
293190,202309,21494,42443,18027,37440,238,850,16153,32202,16391,33052
293200,202309,11685,22946,8830,18558,624,1164,6998,14555,7622,15719
293210,202309,6972,15035,5344,12414,602,1259,3735,8637,4337,9896
293220,202309,7555,15078,5260,11443,829,1650,3343,7054,4172,8704
293230,202309,6045,11660,4297,9407,468,903,3057,6745,3525,7648
293240,202309,5510,12212,4181,10016,214,469,3063,7515,3277,7984
293245,202309,4889,11402,4014,9953,262,663,3080,7230,3342,7893
293250,202309,7021,14983,4978,11743,529,1263,3334,7463,3863,8726
293260,202309,6024,13224,4321,10367,225,549,3083,7335,3308,7884
293270,202309,9333,17741,6924,14961,500,770,5486,12264,5986,13034
293280,202309,5932,12597,4765,10811,303,691,3823,8379,4126,9070
293290,202309,22589,53645,18375,46493,1804,4605,12897,31472,14701,36077
293300,202309,8506,17098,6554,13908,829,1537,4519,9231,5348,10768
293305,202309,5741,11294,4124,9083,101,311,3595,7618,3696,7929
293310,202309,2774,6108,2111,5013,49,138,1725,3919,1774,4057
293315,202309,5768,10984,4435,9067,446,673,3479,7198,3925,7871
293317,202309,3430,7113,2758,5991,391,706,1879,4129,2270,4835
293320,202309,18539,34441,15281,30453,256,660,13632,26145,13888,26805
293325,202309,2343,4881,1666,3954,184,444,1073,2440,1257,2884
293330,202309,103145,231822,74009,178510,10616,25891,42923,95886,53539,121777
293340,202309,2685,6578,1944,5202,176,429,1318,3478,1494,3907
293345,202309,4823,10917,3397,8588,851,2062,1497,4150,2348,6212
293350,202309,7262,17446,5914,15553,369,920,4710,12338,5079,13258
293360,202309,19449,40438,15496,35170,583,1392,13013,29205,13596,30597
310010,202309,1236,2549,778,1865,128,336,335,679,463,1015
310020,202309,4198,9776,2758,6998,458,1288,1251,2782,1709,4070
310030,202309,2491,6186,1824,4928,259,735,1144,2911,1403,3646
310040,202309,1049,2453,715,1812,79,236,370,806,449,1042
310050,202309,2153,5196,1599,4200,151,446,994,2405,1145,2851
310060,202309,3821,9180,2867,7655,321,936,1823,4857,2144,5793
310070,202309,430,952,278,698,16,31,188,458,204,489
310080,202309,903,2283,582,1647,91,290,261,687,352,977
310090,202309,6764,14101,5110,11464,233,657,4038,8528,4271,9185
310100,202309,4773,10538,3574,8578,115,406,2858,6443,2973,6849
310110,202309,6034,14121,4221,10827,568,1600,2479,5924,3047,7524
310120,202309,873,1906,508,1322,78,242,230,488,308,730
310130,202309,522,1191,428,1033,38,127,321,704,359,831
310140,202309,466,1183,325,932,72,216,139,344,211,560
310150,202309,8259,17984,5380,12749,449,1279,3297,6968,3746,8247
310160,202309,14104,30425,9399,22170,2173,5022,4120,8912,6293,13934
310163,202309,1514,4093,974,2879,258,814,249,578,507,1392
310170,202309,12504,26769,9284,21609,1060,2333,6313,14221,7373,16554
310180,202309,2579,5469,1681,3970,186,490,1070,2362,1256,2852
310190,202309,3366,8667,2160,6193,532,1627,473,1165,1005,2792
310200,202309,2523,6396,1740,4905,512,1581,620,1434,1132,3015
310205,202309,1508,3668,1091,2972,147,395,669,1811,816,2206
310210,202309,2949,7134,2111,5449,120,284,1496,3698,1616,3982
310220,202309,1445,3579,973,2669,94,299,592,1491,686,1790
310230,202309,3064,7064,2261,5496,403,967,1255,2839,1658,3806
310240,202309,1319,3346,970,2649,116,334,564,1441,680,1775
310250,202309,1566,3239,1148,2537,38,116,885,1833,923,1949
310260,202309,5054,11950,2915,7723,642,1961,985,1996,1627,3957
310270,202309,3621,6818,2596,5405,95,220,2095,4170,2190,4390
310280,202309,3701,7125,2474,5225,180,419,1735,3301,1915,3720
310285,202309,2262,6310,1634,4996,210,640,942,2820,1152,3460
310290,202309,2121,4981,1572,3889,225,642,917,1964,1142,2606
310300,202309,2133,5280,1319,3605,138,424,648,1486,786,1910
310310,202309,416,876,249,593,41,105,126,260,167,365
310320,202309,593,1370,346,922,35,94,178,436,213,530
310330,202309,637,1386,323,791,69,168,129,284,198,452
310340,202309,10410,23414,6669,16402,1090,2495,3147,7590,4237,10085
310350,202309,17986,39942,11213,28009,1786,4927,5629,12553,7415,17480
310360,202309,811,1550,605,1234,23,66,455,860,478,926
310370,202309,1523,4314,1160,3587,302,987,360,1142,662,2129
310375,202309,1111,2500,678,1776,258,645,181,474,439,1119
310380,202309,438,978,203,545,11,33,117,289,128,322
310390,202309,813,2228,612,1817,96,321,303,791,399,1112
310400,202309,16509,36910,10437,26173,1235,3363,5930,13659,7165,17022
310410,202309,1334,3499,652,1899,84,266,278,659,362,925
310420,202309,6330,15238,3861,10143,493,1347,1944,4464,2437,5811
310430,202309,2247,5574,1368,3785,263,761,617,1429,880,2190
310440,202309,822,1890,463,1200,78,180,204,489,282,669
310445,202309,1653,4180,1114,3049,90,223,790,2071,880,2294
310450,202309,6006,12640,3979,9322,332,939,2743,5927,3075,6866
310460,202309,2217,5379,1368,3663,286,741,319,739,605,1480
310470,202309,4095,8576,2940,6919,716,1530,1563,3778,2279,5308
310480,202309,1253,2955,821,2191,86,274,461,1087,547,1361
310490,202309,3736,8994,2547,6757,419,1145,1208,2874,1627,4019
310500,202309,1942,4476,1430,3582,211,538,859,2016,1070,2554
310510,202309,3123,7123,1979,4912,360,981,851,1896,1211,2877
310520,202309,1520,3563,865,2261,141,412,364,887,505,1299
310530,202309,1073,2560,642,1700,79,231,244,499,323,730
310540,202309,3650,9534,2332,6603,434,1295,871,2078,1305,3373
310550,202309,1570,3415,1026,2462,111,277,593,1292,704,1569
310560,202309,22599,52802,14166,35688,1667,4787,7524,15856,9191,20643
310570,202309,1561,3284,1106,2615,42,140,865,1886,907,2026
310590,202309,5388,12380,3452,8293,211,630,2195,4692,2406,5322
310600,202309,1828,4568,1222,3175,146,385,653,1518,799,1903
310610,202309,616,1578,331,1030,70,225,66,188,136,413
310620,202309,313049,689508,208750,488299,23433,61801,121379,246912,144812,308713
310630,202309,6002,14649,3622,9525,542,1413,1967,4754,2509,6167
310640,202309,2059,4543,1427,3367,103,297,1011,2124,1114,2421
310650,202309,2934,7047,1860,4918,118,353,1135,2810,1253,3163
310660,202309,1764,4065,1343,3452,39,153,1102,2720,1141,2873
310665,202309,1752,3727,1304,3059,79,253,1025,2290,1104,2543
310670,202309,88850,196301,62663,146591,7353,18388,39083,83694,46436,102082
310680,202309,993,2041,753,1661,22,69,584,1186,606,1255
310690,202309,3397,6944,2214,5085,323,671,1358,2927,1681,3598
310700,202309,662,1228,468,972,14,35,375,743,389,778
310710,202309,8195,20785,4823,14235,1277,3922,798,2057,2075,5979
310720,202309,1498,3011,1073,2379,49,143,815,1674,864,1817
310730,202309,13099,29716,9589,23449,622,1819,6811,15376,7433,17195
310740,202309,9116,21837,5805,14849,693,2010,3013,6685,3706,8695
310750,202309,1762,3717,1164,2673,188,472,631,1257,819,1729
310760,202309,936,2118,595,1525,78,193,355,886,433,1079
310770,202309,1368,3360,845,2387,110,340,401,970,511,1310
310780,202309,5053,10539,3541,8154,334,829,2362,5168,2696,5997
310790,202309,2387,6760,1803,5407,431,1436,443,1085,874,2521
310800,202309,2916,7989,1688,5217,340,1129,120,291,460,1420
310810,202309,1924,4048,1420,3158,121,270,1000,2112,1121,2382
310820,202309,1498,3407,767,2111,172,460,212,536,384,996
310825,202309,3274,7996,2359,6433,70,303,1877,4801,1947,5104
310830,202309,2901,6935,1868,4937,351,989,928,2106,1279,3095
310840,202309,2855,6951,1791,4855,384,1115,604,1331,988,2446
310850,202309,1668,4028,1189,3213,106,333,791,1976,897,2309
310855,202309,4235,9759,2897,7420,303,755,1843,4481,2146,5236
310860,202309,8435,21590,6172,17238,968,2424,3301,9231,4269,11655
310870,202309,1200,2619,870,2096,77,210,631,1413,708,1623
310880,202309,1086,2933,711,2097,105,304,367,1020,472,1324
310890,202309,2733,7230,1510,4570,288,930,199,491,487,1421
310900,202309,5619,14337,3550,9627,692,2016,1463,3405,2155,5421
310910,202309,2788,6269,1584,4120,268,771,393,872,661,1643
310920,202309,2327,5418,1557,4086,255,677,887,2233,1142,2910
310925,202309,1369,3072,921,2289,60,151,640,1490,700,1641
310930,202309,7009,16212,4190,11522,906,2436,1709,4820,2615,7256
310940,202309,8751,18124,6071,13842,292,813,4626,9872,4918,10685
310945,202309,1845,4074,1198,2944,145,389,675,1520,820,1909
310950,202309,2297,6290,1291,4003,222,754,336,800,558,1554
310960,202309,849,2165,423,1198,63,193,127,318,190,511
310970,202309,1465,4120,890,2804,228,729,158,421,386,1150
310980,202309,454,959,220,532,12,35,124,259,136,294
310990,202309,1909,4415,1350,3406,168,499,789,1746,957,2245
311000,202309,5454,13345,3723,10000,858,2335,1726,4212,2584,6547
311010,202309,1229,2977,926,2430,230,627,428,1099,658,1726
311020,202309,1463,3366,822,2149,66,197,462,1105,528,1302
311030,202309,2409,5419,1482,3788,410,1167,525,1176,935,2343
311040,202309,379,1066,258,784,80,274,59,139,139,413
311050,202309,3581,8056,2457,6115,370,1072,1333,2918,1703,3990
311060,202309,4836,10985,2925,7240,349,979,1446,3073,1795,4052
311070,202309,3172,6909,2012,4939,274,792,1080,2306,1354,3098
311080,202309,1439,2798,1026,2190,42,115,789,1546,831,1661
311090,202309,2913,8082,1956,5952,471,1435,571,1662,1042,3097
311100,202309,3166,8086,1951,5703,368,1188,534,1304,902,2492
311110,202309,4658,9376,1963,4881,493,1250,294,669,787,1919
311115,202309,1757,3314,1238,2593,27,90,987,2047,1014,2137
311120,202309,9429,22021,5930,14833,950,2574,2695,5616,3645,8190
311130,202309,2370,5741,1535,4235,176,564,858,2103,1034,2667
311140,202309,2045,4622,1282,3300,293,710,601,1502,894,2212
311150,202309,1780,5100,1263,3975,205,702,584,1652,789,2354
311160,202309,5334,13505,3385,9678,569,1793,1377,3472,1946,5265
311170,202309,1233,2858,872,2286,82,227,539,1425,621,1652
311180,202309,2024,4184,1065,2622,166,409,482,1082,648,1491
311190,202309,1037,2700,658,1888,80,255,297,715,377,970
311200,202309,2985,7092,1903,4887,401,1091,774,1664,1175,2755
311205,202309,1135,2966,833,2387,46,145,494,1312,540,1457
311210,202309,1294,3395,1058,2991,134,336,701,2055,835,2391
311220,202309,1129,2442,892,1968,22,68,733,1488,755,1556
311230,202309,9719,26747,6366,19333,1533,4757,1822,5394,3355,10151
311240,202309,1522,3359,1051,2569,133,380,639,1346,772,1726
311250,202309,1774,4407,1138,3087,229,639,481,1137,710,1776
311260,202309,3284,7433,1705,4367,237,646,780,1670,1017,2316
311265,202309,1732,3631,1117,2626,61,149,818,1775,879,1924
311270,202309,3836,9870,2863,8004,212,782,1863,4724,2075,5506
311280,202309,1663,3955,887,2430,241,673,223,526,464,1199
311290,202309,2220,6223,1816,5359,153,458,1133,3255,1286,3713
311300,202309,5410,13100,4185,11006,240,740,3149,7877,3389,8617
311310,202309,650,1639,445,1193,35,92,290,727,325,819
311320,202309,3823,10672,2690,7887,399,1204,1229,3146,1628,4350
311330,202309,8002,17190,5195,12448,847,2199,2257,5346,3104,7545
311340,202309,13868,34553,9432,25681,2226,6166,2873,7142,5099,13308
311350,202309,2826,6374,1681,4167,382,880,614,1355,996,2235
311360,202309,1454,3242,884,2296,213,562,384,947,597,1509
311370,202309,5691,12720,3639,9173,525,1468,1778,3948,2303,5416
311380,202309,492,1402,342,1062,41,138,185,549,226,687
311390,202309,2100,5774,1470,4551,438,1396,353,942,791,2338
311400,202309,2107,5080,1237,3197,238,648,469,966,707,1614
311410,202309,2412,6565,1680,5030,271,905,686,1772,957,2677
311420,202309,2080,5409,1328,3841,267,801,398,934,665,1735
311430,202309,5781,13803,3344,8807,539,1468,1372,3307,1911,4775
311440,202309,3926,9902,2431,6853,601,1905,381,732,982,2637
311450,202309,3241,8620,1838,5481,451,1543,478,1067,929,2610
311455,202309,1348,2844,761,1848,72,193,486,1076,558,1269
311460,202309,762,2065,411,1263,75,249,103,244,178,493
311470,202309,585,1633,349,1110,84,290,52,135,136,425
311480,202309,1462,2912,1104,2341,107,208,850,1731,957,1939
311490,202309,366,978,238,696,38,133,103,237,141,370
311500,202309,667,1520,445,1121,48,129,246,552,294,681
311510,202309,4554,9870,2871,6935,462,1095,1500,3311,1962,4406
311520,202309,855,2040,633,1597,75,200,398,963,473,1163
311530,202309,12043,25215,7028,16751,2025,5548,2119,4085,4144,9633
311535,202309,1262,2992,734,1889,99,277,363,816,462,1093
311540,202309,667,1748,528,1485,92,264,317,882,409,1146
311545,202309,2526,6342,1978,5396,130,371,1434,3785,1564,4156
311547,202309,2220,4332,1657,3432,56,139,1430,2855,1486,2994
311550,202309,3696,8850,2616,6758,473,1288,1158,2538,1631,3826
311560,202309,365,742,182,429,32,86,69,134,101,220
311570,202309,1619,3480,983,2510,73,207,639,1647,712,1854
311580,202309,2730,4887,1648,3393,167,338,1099,2153,1266,2491
311590,202309,784,1831,584,1509,64,191,344,827,408,1018
311600,202309,1797,4122,1381,3505,174,509,947,2315,1121,2824
311610,202309,2883,7472,1903,5427,131,412,1226,3259,1357,3671
311615,202309,4633,10407,3396,8352,157,470,2614,6022,2771,6492
311620,202309,739,1818,473,1338,55,178,249,644,304,822
311630,202309,1559,3990,1086,2969,157,402,563,1507,720,1909
311640,202309,997,2381,621,1665,104,291,328,800,432,1091
311650,202309,2299,5095,1621,3955,314,765,861,1985,1175,2750
311660,202309,4193,10743,2541,7023,381,1178,892,1918,1273,3096
311670,202309,2080,4574,1315,3155,170,403,666,1465,836,1868
311680,202309,2892,6736,2017,5169,144,327,1389,3514,1533,3841
311690,202309,755,1497,470,1082,50,110,276,612,326,722
311700,202309,2460,5337,1719,4210,39,126,1377,3231,1416,3357
311710,202309,1977,5258,1285,3842,355,1159,337,888,692,2047
311720,202309,542,1452,397,1143,55,167,232,654,287,821
311730,202309,6157,13463,3820,9146,753,2059,1951,4164,2704,6223
311740,202309,1204,2965,926,2519,73,199,639,1751,712,1950
311750,202309,4864,12833,3363,9613,320,991,1990,5078,2310,6069
311760,202309,940,2372,646,1723,107,343,273,545,380,888
311770,202309,2777,7011,1829,5084,396,1104,599,1472,995,2576
311780,202309,1957,4942,1168,3285,252,709,418,1003,670,1712
311783,202309,2874,6511,2101,5187,63,229,1683,3882,1746,4111
311787,202309,997,2636,614,1738,91,271,204,454,295,725
311790,202309,1968,4995,1155,3258,320,986,328,782,648,1768
311800,202309,6911,18351,4061,11377,1064,3065,909,1933,1973,4998
311810,202309,1263,3049,950,2460,59,171,735,1764,794,1935
311820,202309,1322,2776,856,2007,72,186,585,1261,657,1447
311830,202309,11907,30155,7681,20998,2189,6187,1502,3750,3691,9937
311840,202309,5010,11021,3613,8905,366,933,2380,5753,2746,6686
311850,202309,443,998,317,777,14,53,226,488,240,541
311860,202309,103485,223717,70949,163769,7754,20047,44051,91379,51805,111426
311870,202309,2265,5527,1378,3814,232,761,591,1375,823,2136
311880,202309,7593,17774,5608,14533,470,1179,3838,9766,4308,10945
311890,202309,2378,4792,1720,3775,67,196,1312,2620,1379,2816
311900,202309,786,1982,525,1553,97,273,214,616,311,889
311910,202309,5404,12234,3875,9789,752,1939,2046,4859,2798,6798
311920,202309,2672,5877,1986,4767,147,333,1372,3193,1519,3526
311930,202309,6186,12501,4075,9119,740,1814,2189,4360,2929,6174
311940,202309,19756,46342,11414,29090,1782,4809,4865,10946,6647,15755
311950,202309,2978,6848,1972,4962,163,421,1192,2882,1355,3303
311960,202309,607,1400,372,956,51,142,150,326,201,468
311970,202309,491,1466,320,1036,48,179,70,170,118,349
311980,202309,575,1411,268,792,43,135,98,254,141,389
311990,202309,644,1464,337,910,61,175,139,311,200,486
311995,202309,1204,3220,436,1331,53,173,79,150,132,323
312000,202309,996,2074,667,1558,24,60,491,1059,515,1119
312010,202309,1464,3237,996,2384,55,134,684,1540,739,1674
312015,202309,1706,4005,1369,3479,75,247,1045,2502,1120,2749
312020,202309,2434,6598,1475,4309,256,766,385,941,641,1707
312030,202309,2678,5308,1991,4392,53,195,1694,3562,1747,3757
312040,202309,1042,2796,602,1800,120,364,235,610,355,974
312050,202309,1477,4124,1109,3361,211,727,367,931,578,1658
312060,202309,1204,2755,715,1958,188,538,205,492,393,1030
312070,202309,1124,2928,695,1956,27,80,439,1146,466,1226
312080,202309,3769,8180,2623,6203,149,426,1773,3633,1922,4059
312083,202309,1364,2845,1023,2333,52,130,801,1738,853,1868
312087,202309,3067,6799,2248,5440,137,418,1750,4048,1887,4466
312090,202309,15304,34931,10567,26482,1106,3238,6121,13527,7227,16765
312100,202309,2067,5042,1372,3650,94,299,874,2125,968,2424
312110,202309,1238,3475,924,2769,160,592,464,1170,624,1762
312120,202309,1355,3392,809,2335,217,684,227,513,444,1197
312125,202309,2632,5644,1937,4555,116,290,1459,3246,1575,3536
312130,202309,1533,3207,968,2202,62,185,610,1154,672,1339
312140,202309,952,2542,683,1951,196,576,207,517,403,1093
312150,202309,706,1693,533,1353,49,118,341,795,390,913
312160,202309,12553,28910,8348,20793,1058,2826,4328,9465,5386,12291
312170,202309,1065,2450,726,1803,60,142,456,1087,516,1229
312180,202309,1750,4077,1195,3013,126,336,700,1581,826,1917
312190,202309,1031,2431,688,1756,98,259,329,736,427,995
312200,202309,5812,14129,4032,10992,950,3138,1987,4528,2937,7666
312210,202309,1789,3332,1214,2500,129,233,885,1753,1014,1986
312220,202309,2032,5480,1566,4561,186,585,975,2772,1161,3357
312230,202309,28426,63801,17643,43095,3488,9241,6711,13447,10199,22688
312235,202309,2793,5683,2017,4487,261,462,1419,3066,1680,3528
312240,202309,996,2827,650,2048,135,432,204,561,339,993
312245,202309,4061,7497,3253,6335,61,171,2962,5590,3023,5761
312247,202309,1254,2613,740,1776,102,240,429,948,531,1188
312250,202309,1126,2741,585,1635,93,289,165,372,258,661
312260,202309,1267,2944,934,2307,61,144,699,1626,760,1770
312270,202309,948,2302,632,1615,20,80,405,891,425,971
312280,202309,537,1471,393,1149,95,318,154,388,249,706
312290,202309,1249,3219,872,2472,177,539,282,674,459,1213
312300,202309,1543,4088,991,2805,234,694,260,579,494,1273
312310,202309,1316,3475,880,2500,112,377,464,1154,576,1531
312320,202309,2702,6105,1540,3857,248,633,575,1207,823,1840
312330,202309,1184,2924,854,2281,150,462,467,1124,617,1586
312340,202309,288,681,187,488,23,72,101,227,124,299
312350,202309,284,559,186,423,9,26,123,233,132,259
312352,202309,1815,5269,1456,4513,293,959,641,2114,934,3073
312360,202309,4604,11495,2899,7967,557,1599,1241,2923,1798,4522
312370,202309,2717,5939,1935,4667,235,656,1173,2574,1408,3230
312380,202309,2607,5256,1848,4093,43,145,1494,3120,1537,3265
312385,202309,1564,3778,1074,2848,385,1038,345,920,730,1958
312390,202309,2447,6248,1555,4318,242,753,447,1001,689,1754
312400,202309,3912,10064,2874,8110,1065,3281,443,1149,1508,4430
312410,202309,20832,46918,14921,36180,1997,5002,9097,20446,11094,25448
312420,202309,5163,12396,3789,10015,923,2669,1564,3837,2487,6506
312430,202309,11114,24132,8074,18786,430,1212,5839,12470,6269,13682
312440,202309,1377,3873,1054,3190,571,1812,175,496,746,2308
312450,202309,1771,4637,1136,3347,316,984,388,1092,704,2076
312460,202309,621,1331,393,962,23,68,278,632,301,700
312470,202309,583,1316,316,824,50,144,103,206,153,350
312480,202309,1253,2916,816,2125,77,217,435,1056,512,1273
312490,202309,3318,6580,2259,4906,237,543,1376,2742,1613,3285
312500,202309,1353,2836,984,2246,39,113,720,1533,759,1646
312510,202309,6884,16750,3379,9199,570,1544,998,2264,1568,3808
312520,202309,484,1080,323,801,47,128,196,438,243,566
312530,202309,952,1904,707,1570,47,120,525,1114,572,1234
312540,202309,1842,4526,1160,3128,149,394,674,1691,823,2085
312550,202309,1008,2284,614,1479,36,95,408,875,444,970
312560,202309,2204,5170,1601,4188,94,284,1128,2844,1222,3128
312570,202309,3490,7246,2304,5510,382,932,1158,2614,1540,3546
312580,202309,817,1997,463,1241,61,187,226,528,287,715
312590,202309,1824,4749,1324,3697,242,744,612,1507,854,2251
312595,202309,2702,6844,2021,5679,412,1176,905,2639,1317,3815
312600,202309,1617,3722,876,2125,138,363,301,656,439,1019
312610,202309,9124,21441,5153,13438,1092,2983,1517,3313,2609,6296
312620,202309,3078,6761,2075,5210,59,239,1663,3957,1722,4196
312630,202309,416,1063,268,780,56,193,100,235,156,428
312640,202309,634,1592,457,1263,66,206,231,568,297,774
312650,202309,2532,5594,1500,3617,57,176,1132,2470,1189,2646
312660,202309,1657,3511,1125,2595,85,219,775,1618,860,1837
312670,202309,7551,15933,5740,13040,170,580,4612,9710,4782,10290
312675,202309,1418,3247,1079,2709,69,198,791,1875,860,2073
312680,202309,1983,4247,1620,3679,88,266,1333,2868,1421,3134
312690,202309,3687,6854,2465,5196,239,439,1801,3702,2040,4141
312695,202309,1289,2931,987,2398,49,103,818,1924,867,2027
312700,202309,2647,6414,1614,4365,199,623,882,2109,1081,2732
312705,202309,2162,3852,1764,3316,31,77,1657,3057,1688,3134
312707,202309,1672,4235,1035,2993,48,194,682,1773,730,1967
312710,202309,9907,21192,5593,14055,1591,4085,1421,3461,3012,7546
312720,202309,1297,3109,927,2447,102,244,553,1330,655,1574
312730,202309,1976,4244,1269,3151,120,298,821,1955,941,2253
312733,202309,1622,3921,1049,2814,40,147,684,1639,724,1786
312735,202309,1000,2305,633,1568,66,181,409,900,475,1081
312737,202309,1027,2090,659,1540,68,190,449,978,517,1168
312738,202309,1056,2347,661,1630,70,205,408,898,478,1103
312740,202309,518,1298,287,826,65,190,79,171,144,361
312750,202309,1759,4465,1099,3126,174,519,460,1162,634,1681
312760,202309,2222,5946,1414,4214,260,757,491,1360,751,2117
312770,202309,58094,127970,32899,82261,5761,15419,13286,29399,19047,44818
312780,202309,3319,8234,2520,6756,421,1092,1384,3589,1805,4681
312790,202309,290,664,120,344,9,25,35,67,44,92
312800,202309,7671,17841,5393,13395,396,1212,3466,7686,3862,8898
312810,202309,1961,4962,1151,3425,369,1126,303,768,672,1894
312820,202309,2132,5018,1494,3824,112,249,998,2471,1110,2720
312825,202309,1938,3710,1413,2957,52,125,1148,2305,1200,2430
312830,202309,3427,8683,1817,5245,486,1304,574,1392,1060,2696
312840,202309,1838,4227,1256,3166,161,434,615,1349,776,1783
312850,202309,1468,2740,919,1854,32,108,687,1203,719,1311
312860,202309,1290,3144,784,2194,206,568,242,618,448,1186
312870,202309,7589,18556,3928,11001,675,1957,1183,2880,1858,4837
312880,202309,1925,4182,1291,3050,194,435,710,1631,904,2066
312890,202309,2871,6248,1786,4291,167,401,1072,2412,1239,2813
312900,202309,1670,3824,1106,2865,317,843,435,1036,752,1879
312910,202309,1763,3123,924,1973,138,267,511,1060,649,1327
312920,202309,1190,2908,714,1998,99,326,238,513,337,839
312930,202309,3115,6720,1971,4766,304,771,1038,2466,1342,3237
312940,202309,1223,2988,836,2302,70,209,442,1087,512,1296
312950,202309,4324,9306,2741,6629,444,1142,1545,3410,1989,4552
312960,202309,2159,5091,1633,4231,145,334,1097,2875,1242,3209
312965,202309,1981,4791,1450,3882,204,496,809,2179,1013,2675
312970,202309,2271,5438,1537,4146,157,527,871,2059,1028,2586
312980,202309,33737,82819,22539,59386,4466,11841,8955,21573,13421,33414
312990,202309,638,1463,375,1017,73,213,150,368,223,581
313000,202309,613,1548,426,1209,24,93,256,628,280,721
313005,202309,2959,7663,2191,6228,145,427,1556,4265,1701,4692
313010,202309,7813,18703,5504,14312,828,2420,3002,7046,3830,9466
313020,202309,1275,3497,894,2674,200,651,156,353,356,1004
313030,202309,1485,3076,847,2039,135,310,481,1054,616,1364
313040,202309,1133,3082,812,2384,47,179,467,1220,514,1399
313050,202309,2280,5814,1427,4238,245,781,336,829,581,1610
313055,202309,2248,5515,1717,4594,724,2148,603,1394,1327,3542
313060,202309,1366,3077,857,2132,167,497,231,459,398,956
313065,202309,2123,5111,1706,4318,33,152,1421,3397,1454,3549
313070,202309,1055,2614,729,1992,167,467,262,652,429,1119
313080,202309,491,1222,300,818,61,202,113,234,174,436
313090,202309,7078,15778,4936,11932,231,602,3589,8252,3820,8854
313100,202309,1618,3763,1180,2980,60,197,846,1950,906,2147
313110,202309,1914,4567,1181,3149,155,438,557,1320,712,1758
313115,202309,3584,8791,2418,6353,235,696,1370,3134,1605,3830
313120,202309,4505,10016,2971,7646,612,1651,1590,3894,2202,5545
313130,202309,42108,96016,25427,63145,3172,8491,13936,30889,17108,39380
313140,202309,1028,1984,619,1398,67,148,427,911,494,1059
313150,202309,1744,4525,1056,3085,285,927,145,306,430,1233
313160,202309,1856,4103,1211,3009,78,204,818,1930,896,2134
313170,202309,14758,37922,8957,24758,1461,4157,3452,8264,4913,12421
313180,202309,3208,7327,2207,5344,224,506,1451,3335,1675,3841
313190,202309,5918,14962,3587,9889,670,1961,1416,3245,2086,5206
313200,202309,1436,3143,1035,2392,42,127,816,1762,858,1889
313210,202309,5438,12334,3963,9835,357,1014,2671,6062,3028,7076
313220,202309,2484,6001,1422,3752,233,634,595,1308,828,1942
313230,202309,3424,8465,2587,7226,67,269,2003,5422,2070,5691
313240,202309,14622,32204,9185,22657,1185,3167,4686,10178,5871,13345
313250,202309,7975,20710,5429,15151,1197,3408,2292,5780,3489,9188
313260,202309,997,2258,597,1575,65,220,309,659,374,879
313270,202309,8307,16208,5999,12887,562,1211,4431,9039,4993,10250
313280,202309,582,1395,351,947,48,141,163,383,211,524
313290,202309,1326,3885,958,3106,211,754,352,1026,563,1780
313300,202309,2425,5970,1578,4244,320,927,630,1486,950,2413
313310,202309,1936,5096,1299,3573,262,742,409,890,671,1632
313320,202309,2424,5825,1559,4317,362,1100,485,1298,847,2398
313330,202309,5277,11931,3438,8861,309,842,2111,5192,2420,6034
313340,202309,2268,4581,1470,3275,111,288,1054,2119,1165,2407
313350,202309,3804,9437,2195,5805,312,904,970,2167,1282,3071
313360,202309,2237,4942,1281,3226,207,605,646,1387,853,1992
313370,202309,2140,5223,1221,3237,247,664,400,826,647,1490
313375,202309,2361,5689,1181,3240,260,750,310,702,570,1452
313380,202309,8612,19717,5528,13581,924,2517,2399,4934,3323,7451
313390,202309,1025,2783,773,2268,47,181,523,1417,570,1598
313400,202309,4730,10278,3181,7747,152,398,2344,5467,2496,5865
313410,202309,1822,4141,1193,3055,285,729,621,1464,906,2193
313420,202309,20266,42009,9924,24330,2394,6228,2815,6047,5209,12275
313430,202309,1594,3563,1164,2709,47,159,926,1941,973,2100
313440,202309,9538,17441,6228,12840,233,644,4842,9347,5075,9991
313450,202309,914,2280,533,1474,90,275,190,401,280,676
313460,202309,3115,7798,2310,6370,420,1262,1003,2540,1423,3802
313470,202309,3406,7612,2489,6138,187,513,1842,4353,2029,4866
313480,202309,1524,3986,843,2471,147,418,337,872,484,1290
313490,202309,3942,9507,1699,4880,317,951,443,1047,760,1998
313500,202309,714,1682,397,1032,90,202,140,360,230,562
313505,202309,13362,30230,9931,24676,590,1559,7324,17504,7914,19063
313507,202309,1620,3693,1112,2828,49,171,809,1910,858,2081
313510,202309,19927,46981,13315,33570,1416,3688,7371,16739,8787,20427
313520,202309,20289,45714,15350,37595,800,2252,11615,26745,12415,28997
313530,202309,736,2017,423,1247,65,210,178,431,243,641
313535,202309,2783,7057,1988,5480,225,565,1148,3018,1373,3583
313540,202309,1134,2871,705,1871,95,297,352,787,447,1084
313545,202309,1407,4109,1011,3201,169,553,474,1391,643,1944
313550,202309,2734,6911,2054,5432,245,669,1362,3481,1607,4150
313560,202309,3723,5970,2634,4629,49,96,2304,3934,2353,4030
313570,202309,1212,3125,858,2440,193,573,354,866,547,1439
313580,202309,7821,16097,5700,12597,304,789,4258,8730,4562,9519
313590,202309,1465,3443,965,2575,155,434,493,1224,648,1658
313600,202309,5548,11516,4392,9783,137,377,3738,7925,3875,8302
313610,202309,1219,2751,854,2037,80,209,547,1182,627,1391
313620,202309,7385,17633,5271,13564,564,1670,3095,7118,3659,8788
313630,202309,11182,24807,7244,18123,740,2170,4363,9925,5103,12095
313640,202309,1664,3098,1087,2300,78,189,808,1656,886,1845
313650,202309,1965,5413,1425,4401,161,539,789,2340,950,2879
313652,202309,1100,2790,855,2285,86,240,571,1414,657,1654
313655,202309,1457,3083,1038,2488,77,202,732,1704,809,1906
313657,202309,1298,3092,926,2425,31,134,655,1546,686,1680
313660,202309,1545,3506,1142,2805,100,330,771,1695,871,2025
313665,202309,7520,17111,5190,12617,631,1684,3112,6736,3743,8420
313670,202309,75198,165606,46619,115064,6463,17072,23093,50899,29556,67971
313680,202309,1367,3100,954,2354,44,123,635,1426,679,1549
313690,202309,1295,3544,843,2602,172,578,161,405,333,983
313695,202309,2118,5089,1429,3896,136,362,872,2361,1008,2723
313700,202309,3664,9825,2828,8405,248,703,2073,6088,2321,6791
313710,202309,1771,3701,1062,2565,158,481,629,1351,787,1832
313720,202309,8507,20976,5250,13814,743,2059,2550,5882,3293,7941
313730,202309,1662,3277,1083,2391,70,157,759,1647,829,1804
313740,202309,2120,6884,1548,5351,343,1282,405,1197,748,2479
313750,202309,3041,6962,2184,5374,293,848,1347,2971,1640,3819
313753,202309,2545,5844,1463,3874,430,1219,304,715,734,1934
313760,202309,8312,20699,5753,15395,994,2862,2625,6090,3619,8952
313770,202309,5207,13288,3765,10746,847,2378,2135,6092,2982,8470
313780,202309,5166,12093,3185,8462,861,2149,911,2425,1772,4574
313790,202309,776,1974,569,1542,60,174,339,841,399,1015
313800,202309,1668,3470,1052,2485,118,289,576,1244,694,1533
313810,202309,2354,4867,1641,3707,62,183,1269,2667,1331,2850
313820,202309,21753,51512,11382,28695,2016,5112,3628,7827,5644,12939
313830,202309,504,1334,341,977,70,211,122,305,192,516
313835,202309,1176,2865,729,2016,63,203,365,894,428,1097
313840,202309,10725,24961,6903,18028,1767,4605,1870,4709,3637,9314
313850,202309,1244,2613,862,1992,150,353,451,911,601,1264
313860,202309,3752,8542,2511,6227,370,968,1261,2784,1631,3752
313862,202309,1394,2939,598,1597,59,156,292,716,351,872
313865,202309,3239,7382,2369,5918,89,275,1698,3870,1787,4145
313867,202309,1610,4698,1234,3901,369,1168,438,1400,807,2568
313868,202309,2066,5566,1490,4429,75,290,1103,3064,1178,3354
313870,202309,1348,3188,752,1987,148,389,290,682,438,1071
313880,202309,2929,6756,1904,4733,335,998,943,1915,1278,2913
313890,202309,2937,5192,2131,4136,61,138,1703,3110,1764,3248
313900,202309,7178,17986,4185,11599,1141,3222,1238,2830,2379,6052
313910,202309,967,2553,609,1755,132,392,160,416,292,808
313920,202309,3492,9176,2652,7504,556,1525,1198,3354,1754,4879
313925,202309,1958,4410,1310,3210,257,518,740,1765,997,2283
313930,202309,6509,15403,4676,12219,428,1130,3033,7623,3461,8753
313940,202309,12957,34558,8534,25817,2207,7320,1748,5353,3955,12673
313950,202309,7052,13703,4917,10689,292,775,3620,7389,3912,8164
313960,202309,7197,15675,4308,10634,608,1728,2008,4264,2616,5992
313970,202309,2050,4681,1487,3612,54,144,1017,2261,1071,2405
313980,202309,1845,4418,1216,3353,228,652,453,1135,681,1787
313990,202309,2885,7332,1953,5385,328,1062,1083,2628,1411,3690
314000,202309,13769,30608,9073,21758,676,1947,5627,12491,6303,14438
314010,202309,1651,3587,1161,2825,91,232,794,1807,885,2039
314015,202309,3126,7519,2179,5637,286,831,1235,2845,1521,3676
314020,202309,690,1663,367,1091,138,490,16,30,154,520
314030,202309,1083,2732,660,1810,110,328,259,633,369,961
314040,202309,768,1946,575,1571,70,237,371,931,441,1168
314050,202309,2739,6295,1826,4524,135,410,1198,2665,1333,3075
314053,202309,2662,6686,1898,5176,319,840,1089,2997,1408,3837
314055,202309,2930,6367,2273,5379,76,224,1823,4169,1899,4393
314060,202309,1590,3708,1029,2664,41,96,726,1810,767,1906
314070,202309,6349,14918,4487,11258,645,1680,2357,5294,3002,6974
314080,202309,2507,5963,1588,4205,157,441,828,1944,985,2385
314085,202309,2881,7011,2108,5763,255,726,1291,3413,1546,4139
314090,202309,6292,14739,4656,11928,475,1270,2783,6949,3258,8219
314100,202309,3580,7990,2505,6319,138,374,1789,4417,1927,4791
314110,202309,6415,16036,4323,11405,773,2153,1987,4610,2760,6763
314120,202309,956,2043,323,852,59,173,131,300,190,473
314130,202309,890,2072,587,1487,23,76,411,967,434,1043
314140,202309,5725,13661,3983,10309,490,1361,2289,5457,2779,6818
314150,202309,1754,3961,1092,2806,184,472,590,1447,774,1919
314160,202309,2934,6612,1781,4516,195,495,720,1706,915,2201
314170,202309,1180,2884,756,1940,86,270,458,1018,544,1288
314180,202309,6832,16705,4557,12438,723,2032,2074,5376,2797,7408
314190,202309,767,1744,516,1302,75,214,282,605,357,819
314200,202309,3746,9266,2723,7369,274,700,1681,4369,1955,5069
314210,202309,2385,5634,1529,3942,307,855,493,1093,800,1948
314220,202309,2256,5490,1572,4260,293,878,639,1541,932,2419
314225,202309,1263,3306,857,2483,187,530,390,1055,577,1585
314230,202309,1104,2682,682,1885,126,334,281,716,407,1050
314240,202309,1367,3445,941,2662,198,575,373,1025,571,1600
314250,202309,509,1356,292,878,56,175,103,257,159,432
314260,202309,1331,3169,922,2490,339,952,196,429,535,1381
314270,202309,4051,9985,2968,8055,119,331,2086,5499,2205,5830
314280,202309,4466,9672,2726,6804,300,830,1523,3486,1823,4316
314290,202309,5604,12623,4110,9808,228,588,3023,6782,3251,7370
314300,202309,2447,6379,1349,3914,355,1090,354,855,709,1945
314310,202309,4523,11105,2678,7591,758,2445,332,677,1090,3122
314315,202309,1251,3366,918,2678,76,267,618,1696,694,1963
314320,202309,4302,10268,2538,6761,397,1199,1114,2526,1511,3725
314330,202309,73450,187362,48486,137757,12038,33674,13145,34919,25183,68593
314340,202309,3486,7980,2181,5528,388,1185,1042,2139,1430,3324
314345,202309,2033,4842,1450,3761,153,356,951,2301,1104,2657
314350,202309,1265,3259,657,1948,100,285,159,352,259,637
314360,202309,710,1850,396,1192,46,127,126,342,172,469
314370,202309,942,2102,652,1617,68,167,432,997,500,1164
314380,202309,1555,3874,947,2678,224,678,318,822,542,1500
314390,202309,20428,45206,12463,30736,2029,5479,5546,11637,7575,17116
314400,202309,4902,13523,3390,10428,1235,4005,812,2455,2047,6460
314410,202309,3806,9952,2283,6651,597,2101,429,924,1026,3025
314420,202309,954,2139,587,1512,29,102,373,894,402,996
314430,202309,9898,21027,6063,14503,977,2429,2749,6064,3726,8493
314435,202309,2334,5629,1444,3899,267,683,654,1635,921,2318
314437,202309,1112,2517,746,1873,63,176,508,1202,571,1378
314440,202309,779,2031,480,1401,94,333,164,370,258,703
314450,202309,1812,4297,1190,3041,176,500,617,1368,793,1868
314460,202309,4420,11763,2986,8599,671,2090,1243,3060,1914,5150
314465,202309,2896,7057,2182,5690,153,339,1536,3817,1689,4156
314467,202309,1201,2834,875,2280,145,428,504,1247,649,1675
314470,202309,2979,7462,2033,5367,422,1208,895,2032,1317,3240
314480,202309,11638,28604,7492,19602,1163,3284,3333,7496,4496,10780
314490,202309,1310,3067,872,2252,105,288,528,1271,633,1559
314500,202309,2640,5764,1500,3903,520,1315,236,616,756,1931
314505,202309,2898,5671,2106,4483,128,219,1578,3281,1706,3500
314510,202309,2815,6866,1957,5536,720,2283,487,1214,1207,3497
314520,202309,10851,28918,7701,22186,1615,4865,1737,4451,3352,9316
314530,202309,6743,18127,5365,15415,617,1662,3425,9416,4042,11078
314535,202309,3581,7469,2624,5965,146,380,2079,4539,2225,4919
314537,202309,1474,3703,1024,2841,83,219,654,1730,737,1949
314540,202309,529,1188,323,830,21,76,178,388,199,464
314545,202309,2373,5011,1672,3963,68,225,1212,2678,1280,2903
314550,202309,923,2044,517,1302,49,140,266,582,315,722
314560,202309,6458,16286,4127,10932,458,1383,2100,4651,2558,6034
314570,202309,416,1070,281,827,51,158,125,356,176,514
314580,202309,636,1655,402,1165,95,271,125,327,220,598
314585,202309,940,2519,573,1666,47,156,276,716,323,872
314587,202309,2851,6792,2003,5309,739,2037,820,1992,1559,4029
314590,202309,5436,12949,3605,9258,515,1378,1684,3863,2199,5241
314600,202309,2348,5938,1305,3886,274,900,160,402,434,1302
314610,202309,12461,28311,8104,20061,995,2751,3822,8774,4817,11525
314620,202309,3105,6107,2317,5015,163,307,1804,3905,1967,4212
314625,202309,2004,4363,1446,3507,65,259,1128,2506,1193,2765
314630,202309,6093,13807,4432,11246,210,651,3315,7997,3525,8648
314640,202309,1084,2078,756,1540,27,88,591,1088,618,1176
314650,202309,1028,2307,581,1486,70,209,290,617,360,826
314655,202309,1810,4438,1118,3148,224,550,533,1501,757,2051
314660,202309,458,878,315,639,13,37,238,429,251,466
314670,202309,1893,3920,1175,2807,56,164,818,1817,874,1981
314675,202309,2035,4689,1574,3893,103,243,1162,2776,1265,3019
314690,202309,2641,6666,1820,5189,472,1356,509,1355,981,2711
314700,202309,15492,37417,9328,25223,1432,4254,4331,10499,5763,14753
314710,202309,10302,26006,6439,17202,1102,3125,2511,5636,3613,8761
314720,202309,3011,8160,1732,5252,387,1265,294,642,681,1907
314730,202309,3346,7947,1780,4678,337,973,653,1370,990,2343
314740,202309,4187,10426,2951,8075,569,1673,1367,3322,1936,4995
314750,202309,371,891,242,617,20,58,139,311,159,369
314760,202309,2426,6415,1362,3983,258,798,342,707,600,1505
314770,202309,1294,3513,633,1913,78,228,112,271,190,499
314780,202309,460,1034,287,731,20,54,185,427,205,481
314790,202309,15987,38413,9829,26275,1933,5563,3963,9365,5896,14928
314795,202309,1849,4155,1386,3368,79,202,988,2229,1067,2431
314800,202309,15483,36197,9235,24011,1471,4210,3902,8601,5373,12811
314810,202309,14020,33249,8989,23628,2204,5825,3345,8159,5549,13984
314820,202309,1558,3426,1028,2546,67,194,643,1433,710,1627
314830,202309,2289,5545,1631,4273,145,411,1003,2368,1148,2779
314840,202309,1100,2981,820,2433,87,327,536,1464,623,1791
314850,202309,3500,5834,2692,4831,52,129,2431,4275,2483,4404
314860,202309,4197,10167,3174,8292,135,444,2327,5719,2462,6163
314870,202309,8752,16663,5947,12901,313,737,4413,9392,4726,10129
314875,202309,2176,6000,1746,5243,289,783,1061,3185,1350,3968
314880,202309,958,2148,593,1500,48,135,338,788,386,923
314890,202309,596,1703,372,1157,81,297,105,227,186,524
314900,202309,1156,2519,740,1761,84,213,453,967,537,1180
314910,202309,2037,5377,1291,3907,265,937,519,1367,784,2304
314915,202309,2606,6843,1895,5518,234,653,1035,2943,1269,3596
314920,202309,742,1612,446,1125,36,87,272,662,308,749
314930,202309,8525,21081,5572,14689,1009,2852,2460,5531,3469,8383
314940,202309,532,1123,362,826,43,110,212,452,255,562
314950,202309,866,1958,489,1296,55,182,256,585,311,767
314960,202309,1217,2625,843,1976,80,191,543,1216,623,1407
314970,202309,1574,4194,1058,3111,204,651,401,953,605,1604
314980,202309,2839,6497,1996,5005,199,520,1305,3047,1504,3567
314990,202309,3549,9343,2052,5823,362,1018,513,1203,875,2221
314995,202309,2161,5236,1466,3873,97,322,908,2135,1005,2457
315000,202309,1313,3010,850,2254,99,295,537,1328,636,1623
315010,202309,522,1251,382,1025,37,113,236,584,273,697
315015,202309,3091,7432,2442,6259,233,717,1667,3948,1900,4665
315020,202309,988,2564,566,1604,52,160,300,725,352,885
315030,202309,894,2078,530,1400,162,410,139,318,301,728
315040,202309,1251,2891,958,2357,148,417,606,1391,754,1808
315050,202309,1407,3297,856,2271,91,272,393,956,484,1228
315053,202309,1542,3447,1005,2480,137,316,554,1297,691,1613
315057,202309,2303,5671,1625,4498,145,361,985,2825,1130,3186
315060,202309,930,2482,609,1785,116,375,173,441,289,816
315070,202309,1169,2239,801,1693,113,263,533,1061,646,1324
315080,202309,4323,10051,2846,7229,146,393,2004,4719,2150,5112
315090,202309,1022,2705,696,2031,113,335,327,844,440,1179
315100,202309,1812,4811,1022,2969,182,555,409,1002,591,1557
315110,202309,2911,6120,1829,4344,153,381,1058,2369,1211,2750
315120,202309,16127,34104,10266,24395,1435,3288,5554,12581,6989,15869
315130,202309,2319,5544,1650,4191,189,529,872,1927,1061,2456
315140,202309,4257,10422,3090,8099,506,1413,1761,4240,2267,5653
315150,202309,5896,13881,3598,9605,627,1760,1487,3553,2114,5313
315160,202309,2602,5561,1530,3684,210,550,888,1950,1098,2500
315170,202309,1822,5263,1159,3655,210,705,343,966,553,1671
315180,202309,22492,51685,11019,28865,1855,5024,3860,8491,5715,13515
315190,202309,2689,5473,1874,4304,344,725,1197,2761,1541,3486
315200,202309,6060,14730,4086,11130,1342,3785,1200,2808,2542,6593
315210,202309,10635,25702,6177,16080,748,2090,2800,6130,3548,8220
315213,202309,1263,3028,984,2540,26,81,784,1946,810,2027
315217,202309,3268,8263,2187,6296,880,2562,681,1793,1561,4355
315220,202309,10811,26580,7401,20264,705,1789,3886,10606,4591,12395
315230,202309,3694,7140,2699,5674,159,298,2002,4104,2161,4402
315240,202309,3144,7859,2252,6198,561,1659,893,2288,1454,3947
315250,202309,20038,48332,12386,32581,1970,5567,5600,12595,7570,18162
315260,202309,1167,2904,617,1769,104,284,160,377,264,661
315270,202309,1300,3298,898,2465,115,337,423,926,538,1263
315280,202309,4366,9929,2541,6506,677,1784,840,1944,1517,3728
315290,202309,1516,3429,824,2200,142,414,347,796,489,1210
315300,202309,810,1836,545,1424,40,118,356,888,396,1006
315310,202309,1607,3592,1052,2538,71,194,743,1613,814,1807
315320,202309,755,2027,471,1418,79,239,173,448,252,687
315330,202309,873,2575,463,1486,64,223,190,517,254,740
315340,202309,3398,7862,1913,5122,546,1417,574,1514,1120,2931
315350,202309,2422,5360,1869,4447,176,454,1346,3047,1522,3501
315360,202309,2057,5314,1416,3961,200,591,626,1535,826,2126
315370,202309,781,1873,508,1351,77,211,222,498,299,709
315380,202309,273,707,163,475,36,110,18,35,54,145
315390,202309,1615,4063,1140,3071,128,433,624,1423,752,1856
315400,202309,5081,12197,3491,9196,449,1258,1956,4757,2405,6015
315410,202309,2306,5033,1465,3589,366,1014,375,771,741,1785
315415,202309,1891,4812,1289,3621,382,1262,220,500,602,1762
315420,202309,1931,4974,1189,3442,327,971,282,688,609,1659
315430,202309,4330,9920,2633,7085,463,1359,1154,2831,1617,4190
315440,202309,1270,2947,827,2121,102,291,500,1157,602,1448
315445,202309,2850,5528,1930,4203,159,327,1448,3087,1607,3414
315450,202309,2680,6627,1851,5035,195,533,1184,2999,1379,3532
315460,202309,63080,146943,46752,115764,4814,13839,29141,64679,33955,78518
315470,202309,855,2175,506,1336,70,204,224,511,294,715
315480,202309,2018,4899,1230,3168,168,458,622,1381,790,1839
315490,202309,3555,8186,2015,5322,351,910,702,1701,1053,2611
315500,202309,653,1587,349,925,18,43,227,546,245,589
315510,202309,1721,3753,1285,3090,26,103,1035,2304,1061,2407
315520,202309,1402,3076,1081,2553,46,101,865,1927,911,2028
315530,202309,1067,2323,814,1859,63,179,601,1242,664,1421
315540,202309,2091,4979,1174,3169,146,411,485,1171,631,1582
315550,202309,2254,5613,1299,3684,199,633,429,1129,628,1762
315560,202309,8264,21254,6345,17436,544,1416,4335,11454,4879,12870
315570,202309,3216,7299,1853,4638,341,980,914,1911,1255,2891
315580,202309,4190,8715,2771,6267,367,962,1302,2578,1669,3540
315590,202309,1645,3005,1302,2481,35,111,1067,1819,1102,1930
315600,202309,3067,8267,1929,5943,556,1638,647,2115,1203,3753
315610,202309,1269,2871,795,1963,91,268,405,815,496,1083
315620,202309,664,1584,427,1176,35,116,234,615,269,731
315630,202309,1579,3777,1063,2726,179,479,495,1100,674,1579
315640,202309,515,1134,361,889,35,97,222,494,257,591
315645,202309,1215,2895,768,2077,165,488,295,699,460,1187
315650,202309,2286,4528,1690,3620,89,217,1329,2731,1418,2948
315660,202309,2566,6030,1776,4603,268,715,894,2214,1162,2929
315670,202309,21625,50899,14709,37195,2815,7193,6686,15268,9501,22461
315680,202309,3932,9707,2582,7108,372,1120,1263,3248,1635,4368
315690,202309,4890,11242,2412,6547,500,1318,687,1950,1187,3268
315700,202309,11030,26242,7525,19236,790,2155,4255,9813,5045,11968
315710,202309,2151,4650,1375,3432,100,262,894,2100,994,2362
315720,202309,5690,13536,3877,9841,191,631,2627,6019,2818,6650
315725,202309,2940,6617,2094,5245,294,687,1315,3360,1609,4047
315727,202309,820,1872,567,1437,61,190,312,703,373,893
315730,202309,790,2125,543,1574,110,333,203,484,313,817
315733,202309,1896,4343,1267,3161,245,613,543,1213,788,1826
315737,202309,1436,3470,918,2445,44,136,644,1598,688,1734
315740,202309,1081,2745,778,2087,56,168,512,1237,568,1405
315750,202309,1598,3636,1127,2918,110,265,686,1797,796,2062
315760,202309,1482,3036,1016,2331,31,93,816,1758,847,1851
315765,202309,2527,5287,2004,4615,33,132,1780,4001,1813,4133
315770,202309,1664,4186,1142,3220,318,921,335,902,653,1823
315780,202309,41255,99128,29794,75839,2549,7365,18287,42129,20836,49494
315790,202309,4310,12082,3417,10333,465,1394,1812,5712,2277,7106
315800,202309,1691,4788,1130,3412,128,457,518,1287,646,1744
315810,202309,1777,3678,1324,2943,73,201,1026,2124,1099,2325
315820,202309,3700,7942,2755,6508,345,685,1806,4231,2151,4916
315830,202309,1630,4274,837,2413,103,293,249,556,352,849
315840,202309,1119,2430,677,1611,64,158,381,772,445,930
315850,202309,1468,3709,1041,2934,199,584,525,1395,724,1979
315860,202309,657,1752,435,1320,75,225,127,315,202,540
315870,202309,579,1431,426,1156,36,104,298,762,334,866
315880,202309,1447,3178,888,2122,125,344,490,986,615,1330
315890,202309,2235,5613,1730,4845,587,1843,537,1378,1124,3221
315895,202309,8184,20155,4844,13011,621,1855,2237,5261,2858,7116
315900,202309,1135,2700,852,2198,127,340,485,1177,612,1517
315910,202309,820,1824,660,1573,36,100,505,1141,541,1241
315920,202309,1629,3789,814,2185,159,530,337,734,496,1264
315930,202309,1415,2831,839,1943,66,151,537,1163,603,1314
315935,202309,1508,3886,1047,2939,175,523,503,1318,678,1841
315940,202309,735,1784,502,1365,64,197,262,646,326,843
315950,202309,1593,3800,1269,3252,155,417,874,2188,1029,2605
315960,202309,6654,17313,3571,10315,817,2475,736,1543,1553,4018
315970,202309,682,1721,504,1436,64,195,291,770,355,965
315980,202309,5309,10813,2658,6128,402,990,1386,2826,1788,3816
315990,202309,4352,10155,2847,7211,497,1286,1380,3164,1877,4450
316000,202309,978,2105,670,1615,63,191,410,885,473,1076
316010,202309,830,2182,555,1570,88,258,224,509,312,767
316020,202309,1173,2829,859,2217,84,235,563,1342,647,1577
316030,202309,3337,8186,2247,6145,410,1101,1150,3208,1560,4309
316040,202309,3290,8753,1917,5856,351,1201,522,1250,873,2451
316045,202309,2789,5730,2320,5066,150,293,1943,4178,2093,4471
316050,202309,547,1281,369,961,34,82,234,556,268,638
316060,202309,877,1853,558,1374,31,100,378,844,409,944
316070,202309,7729,18426,5439,13695,999,2425,2488,5802,3487,8227
316080,202309,1064,2831,726,2075,122,369,343,866,465,1235
316090,202309,683,1657,449,1112,40,140,261,556,301,696
316095,202309,1552,4375,1034,3125,265,858,292,776,557,1634
316100,202309,3067,7796,1919,5312,331,1036,801,1893,1132,2929
316105,202309,884,2101,615,1633,49,142,368,960,417,1102
316110,202309,18313,42860,13896,35121,913,2833,10147,23875,11060,26708
316120,202309,1517,3778,783,2124,144,443,254,516,398,959
316130,202309,1573,3275,875,2037,101,272,498,1028,599,1300
316140,202309,1290,3166,698,2007,170,505,196,509,366,1014
316150,202309,2756,5761,1672,3796,192,426,970,2007,1162,2433
316160,202309,1205,2823,850,2156,25,76,593,1396,618,1472
316165,202309,1091,2362,735,1782,68,180,482,1074,550,1254
316170,202309,1835,3697,1248,2739,60,165,924,1838,984,2003
316180,202309,2027,5145,1128,3166,197,579,386,907,583,1486
316190,202309,3353,8761,1518,4280,175,534,688,1594,863,2128
316200,202309,4915,11810,3346,8787,470,1358,1751,4050,2221,5408
316210,202309,7446,19512,4278,11958,1371,4064,474,1056,1845,5120
316220,202309,940,2641,501,1632,100,352,115,350,215,702
316225,202309,1992,4078,1371,3107,64,236,1023,2029,1087,2265
316230,202309,625,1459,428,1105,101,278,220,535,321,813
316240,202309,7025,17672,5486,14707,416,1211,3968,10029,4384,11240
316245,202309,3926,10820,3222,9548,255,989,2201,6012,2456,7001
316250,202309,15043,32575,9635,22639,1900,4661,3935,8419,5835,13080
316255,202309,3566,9421,2759,7902,325,929,1803,5121,2128,6050
316257,202309,2022,4112,1330,3010,124,272,889,1933,1013,2205
316260,202309,3350,6676,2377,5125,255,494,1524,3199,1779,3693
316265,202309,1333,3213,920,2447,30,68,686,1746,716,1814
316270,202309,4764,12705,3637,10239,493,1467,1942,4919,2435,6386
316280,202309,3861,9117,2837,7193,426,1135,1525,3591,1951,4726
316290,202309,5238,12452,3267,8404,384,1006,1373,3150,1757,4156
316292,202309,7990,19012,5590,14502,631,1844,3503,8288,4134,10132
316294,202309,1226,3361,768,2417,184,638,250,670,434,1308
316295,202309,4760,11771,3189,8548,312,945,1831,4358,2143,5303
316300,202309,1388,3202,1027,2635,56,168,749,1800,805,1968
316310,202309,914,2398,560,1587,99,308,180,444,279,752
316320,202309,839,2158,520,1472,81,265,157,413,238,678
316330,202309,1296,2958,890,2251,43,120,677,1608,720,1728
316340,202309,1291,3125,907,2360,130,359,500,1145,630,1504
316350,202309,1812,4135,1427,3462,161,376,1004,2320,1165,2696
316360,202309,783,1866,565,1497,88,229,365,960,453,1189
316370,202309,7941,18066,5214,12935,629,1853,2780,5735,3409,7588
316380,202309,2176,4533,1490,3419,90,208,1073,2354,1163,2562
316390,202309,934,2309,613,1707,233,724,142,330,375,1054
316400,202309,1542,3982,782,2340,108,333,267,671,375,1004
316410,202309,1546,3474,1181,2839,24,64,935,2131,959,2195
316420,202309,2270,5521,1748,4681,73,238,1286,3236,1359,3474
316430,202309,1174,2801,715,1948,129,415,299,705,428,1120
316440,202309,1083,3123,663,2154,123,412,162,471,285,883
316443,202309,719,1787,427,1202,94,302,154,373,248,675
316447,202309,2774,5996,2183,5065,184,318,1723,3947,1907,4265
316450,202309,2580,6728,1731,4982,226,672,982,2706,1208,3378
316460,202309,1746,4152,1190,3074,93,283,736,1703,829,1986
316470,202309,9579,24443,6070,16780,984,2874,2537,5939,3521,8813
316480,202309,282,638,214,511,31,77,124,261,155,338
316490,202309,422,1083,244,704,50,155,84,202,134,357
316500,202309,1742,4729,1076,3169,240,740,356,877,596,1617
316510,202309,1003,2872,716,2233,119,370,328,977,447,1347
316520,202309,1698,3718,1109,2601,196,493,375,734,571,1227
316530,202309,1550,3435,1057,2535,117,313,625,1319,742,1632
316540,202309,1432,3186,982,2405,183,477,393,863,576,1340
316550,202309,1885,4472,1489,3777,48,177,1207,2915,1255,3092
316553,202309,6398,16548,3849,10402,547,1632,1898,4377,2445,6009
316555,202309,3296,8414,2611,7410,118,498,2096,5653,2214,6151
316556,202309,700,1480,458,1014,33,73,294,557,327,630
316557,202309,1583,4238,1238,3593,428,1297,434,1180,862,2477
316560,202309,502,1402,292,937,55,195,72,192,127,387
316570,202309,1889,4670,1282,3466,304,727,411,1157,715,1884
316580,202309,446,947,233,571,33,85,92,180,125,265
316590,202309,1602,3589,956,2299,103,207,620,1407,723,1614
316600,202309,1286,3230,1017,2672,143,447,662,1561,805,2008
316610,202309,777,1997,551,1578,64,191,321,834,385,1025
316620,202309,2901,6414,2179,5134,179,400,1626,3669,1805,4069
316630,202309,1918,5152,1498,4290,454,1271,541,1722,995,2993
316640,202309,227,557,161,423,40,118,55,117,95,235
316650,202309,1436,3504,1047,2819,93,264,682,1728,775,1992
316660,202309,205,484,95,251,8,20,33,69,41,89
316670,202309,2038,4557,1364,3455,440,1143,371,859,811,2002
316680,202309,2927,6956,1888,4858,198,539,1114,2719,1312,3258
316690,202309,1660,4436,937,2828,173,527,153,337,326,864
316695,202309,1186,3145,833,2436,27,115,555,1511,582,1626
316700,202309,672,1146,520,957,8,17,444,759,452,776
316710,202309,4554,12054,3266,9267,441,1356,1831,4629,2272,5985
316720,202309,30485,73008,20586,52953,3039,8385,10657,24512,13696,32897
316730,202309,699,1503,487,1125,49,106,281,587,330,693
316740,202309,1119,2684,801,2106,115,333,520,1289,635,1622
316750,202309,528,1317,345,974,85,253,141,369,226,622
316760,202309,4999,13692,3856,11417,1320,4415,1412,3887,2732,8302
316770,202309,1928,3891,1339,3044,49,131,1063,2386,1112,2517
316780,202309,762,2035,544,1608,193,589,72,148,265,737
316790,202309,932,2282,589,1607,112,316,171,433,283,749
316800,202309,8516,21002,5989,16230,970,2840,2864,7085,3834,9925
316805,202309,1513,2780,1138,2317,32,88,959,1877,991,1965
316810,202309,992,2408,641,1715,57,170,432,1084,489,1254
316820,202309,499,938,272,585,13,30,191,370,204,400
316830,202309,1169,2633,814,2030,110,270,464,1092,574,1362
316840,202309,3802,8242,2727,6482,119,356,2102,4609,2221,4965
316850,202309,3010,6462,1957,4579,171,491,1280,2647,1451,3138
316860,202309,30534,66663,20864,50544,3031,8288,11148,24618,14179,32906
316870,202309,11572,27272,7232,18340,897,2530,3769,8115,4666,10645
316880,202309,1484,3429,1094,2733,165,427,597,1327,762,1754
316890,202309,1422,3038,811,2140,120,374,465,1101,585,1475
316900,202309,3960,8946,2613,6414,463,1216,1230,2657,1693,3873
316905,202309,612,1649,412,1235,229,688,85,263,314,951
316910,202309,1309,3141,777,2118,166,488,203,477,369,965
316920,202309,2569,5198,1759,3919,352,645,1021,2186,1373,2831
316930,202309,12476,30980,8329,22632,1763,5074,3134,7313,4897,12387
316935,202309,5725,13485,3694,9526,649,1773,1734,3973,2383,5746
316940,202309,7810,20485,5493,15446,1026,2993,2279,5518,3305,8511
316950,202309,2532,5010,1802,3973,135,314,1401,2939,1536,3253
316960,202309,7080,13698,4356,9656,332,804,3048,6391,3380,7195
316970,202309,5487,12985,3793,9655,724,1943,1685,3686,2409,5629
316980,202309,1157,2901,812,2291,223,690,337,831,560,1521
316990,202309,17096,40763,10693,27401,2764,7352,2711,5907,5475,13259
317000,202309,3462,8131,2738,7014,118,294,2230,5559,2348,5853
317005,202309,3267,8250,2227,6104,431,1251,1042,2590,1473,3841
317010,202309,39622,86245,24740,61131,3667,9888,13434,30292,17101,40180
317020,202309,100205,220218,55562,137686,11181,29296,20373,44042,31554,73338
317030,202309,829,2004,614,1648,16,52,441,1135,457,1187
317040,202309,14985,34570,8266,22217,2196,6242,1754,4573,3950,10815
317043,202309,1180,2228,709,1531,30,71,562,1158,592,1229
317047,202309,1359,2905,843,2023,50,142,573,1266,623,1408
317050,202309,1489,4356,863,2728,122,380,276,685,398,1065
317052,202309,3038,7079,2099,5460,271,708,1277,3112,1548,3820
317057,202309,2864,5258,1948,3882,42,116,1603,2978,1645,3094
317060,202309,620,1514,305,868,60,186,111,263,171,449
317065,202309,1375,3575,975,2688,67,228,627,1511,694,1739
317070,202309,11062,27992,7807,21386,1226,3678,3630,8618,4856,12296
317075,202309,1399,3152,945,2292,156,392,536,1194,692,1586
317080,202309,8569,18232,5713,13240,1122,2792,2719,5910,3841,8702
317090,202309,5878,14803,4652,12669,484,1208,3217,8624,3701,9832
317100,202309,3241,7174,1879,4683,460,1140,744,1696,1204,2836
317103,202309,3117,6534,2274,5168,164,389,1690,3617,1854,4006
317107,202309,1858,4256,1254,3083,62,182,819,1713,881,1895
317110,202309,849,1828,439,1141,83,230,207,481,290,711
317115,202309,1436,3629,1062,2908,157,471,595,1552,752,2023
317120,202309,26252,60253,18603,45925,1701,4780,11593,25708,13294,30488
317130,202309,14645,31382,8803,20845,1363,3341,3482,7570,4845,10911
317140,202309,1217,2616,761,1837,120,275,476,1121,596,1396
317150,202309,1322,2628,926,2068,29,102,752,1549,781,1651
317160,202309,4136,9304,2330,6131,327,790,1071,2996,1398,3786
317170,202309,2662,5919,1895,4474,119,362,1315,2684,1434,3046
317180,202309,2257,6349,1333,4136,291,903,209,602,500,1505
317190,202309,1351,3346,900,2531,179,535,432,1101,611,1636
317200,202309,8427,20341,4970,12967,1066,2902,1304,2890,2370,5792
317210,202309,1542,3265,1025,2438,37,109,714,1584,751,1693
317220,202309,441,1068,328,863,58,193,190,421,248,614
320010,202309,6120,16591,4021,12065,935,2996,1308,3750,2243,6746
320013,202309,2624,6457,1598,4409,347,1031,690,1858,1037,2889
320016,202309,3549,8379,2392,6379,328,897,1485,3798,1813,4695
320020,202309,6490,14533,4394,10712,657,1822,2431,5368,3088,7190
320030,202309,2344,5738,1384,3772,221,669,624,1443,845,2112
320035,202309,2490,5942,1804,4679,281,787,1057,2602,1338,3389
320040,202309,5916,14741,4188,11164,620,1711,2159,5148,2779,6859
320050,202309,2524,5092,1799,3953,196,557,1226,2383,1422,2940
320060,202309,20171,49333,12443,33215,2510,7064,5276,12557,7786,19621
320070,202309,2571,6117,1655,4261,204,593,883,1972,1087,2565
320080,202309,7300,16904,4541,11393,751,2018,2142,4783,2893,6801
320090,202309,10611,26045,6057,16557,1301,3825,2074,4858,3375,8683
320100,202309,4552,10281,3339,8094,444,1198,2072,4634,2516,5832
320110,202309,3305,6623,2092,4710,397,871,1157,2367,1554,3238
320115,202309,2803,8047,2193,6868,768,2491,591,1823,1359,4314
320120,202309,35770,80532,21725,53801,3021,7835,11159,24729,14180,32564
320130,202309,81164,186889,57292,141858,7651,20309,33526,76356,41177,96665
320140,202309,5450,13213,3353,8787,686,1943,1493,3495,2179,5438
320150,202309,18845,43968,11101,28838,2985,8406,1660,3223,4645,11629
320160,202309,8799,21102,5892,15601,895,2568,3146,7717,4041,10285
320170,202309,2364,6027,1503,4294,414,1215,458,1386,872,2601
320180,202309,956,2721,675,2136,222,791,119,309,341,1100
320190,202309,4127,11650,2713,8494,577,2003,483,1233,1060,3236
320200,202309,1730,4336,1061,3034,239,749,283,750,522,1499
320210,202309,5803,13369,3976,10056,677,1830,1944,4464,2621,6294
320220,202309,4936,11080,3116,7731,680,1741,1356,3085,2036,4826
320225,202309,2060,5686,1295,4003,378,1282,282,794,660,2076
320230,202309,7409,17560,4840,12778,1309,3589,1251,3327,2560,6916
320240,202309,23113,53451,15101,39333,4225,11738,3747,8891,7972,20629
320245,202309,4195,11415,2698,8088,681,2180,291,767,972,2947
320250,202309,3891,9057,2097,5162,352,954,1049,2227,1401,3181
320255,202309,2826,7455,2212,6263,397,1208,1383,3804,1780,5012
320260,202309,1859,4778,1012,2944,274,794,257,621,531,1415
320265,202309,2988,8414,1968,6210,622,2130,178,467,800,2597
320270,202309,2908,7291,1876,5233,507,1576,601,1525,1108,3101
320280,202309,11868,26366,8597,20626,917,2504,5891,12915,6808,15419
320290,202309,1673,4605,976,2942,247,847,257,707,504,1554
320300,202309,5836,15376,4190,12073,1270,4075,1144,3014,2414,7089
320305,202309,7190,17792,4935,13441,881,2620,2351,5914,3232,8534
320310,202309,2779,6740,1703,4478,307,839,795,1871,1102,2710
320313,202309,3341,7453,1796,4363,365,982,648,1263,1013,2245
320316,202309,2017,5234,1353,3967,255,761,652,1900,907,2661
320320,202309,27822,68177,17771,49096,4917,13906,4506,11756,9423,25662
320330,202309,3731,8869,2634,6971,441,1169,1439,3754,1880,4923
320332,202309,11346,26327,8063,20256,1919,4821,4054,9590,5973,14411
320334,202309,2658,6675,1508,4336,244,821,349,729,593,1550
320335,202309,2433,6407,1385,4048,304,1007,423,1048,727,2055
320340,202309,7593,15579,5428,12081,476,1089,3776,8000,4252,9089
320350,202309,6756,14663,4181,9948,520,1388,2351,5081,2871,6469
320360,202309,1766,4145,1076,2807,138,384,546,1290,684,1674
320370,202309,3879,10350,2723,7859,733,2355,966,2487,1699,4842
320380,202309,4086,8781,3070,6913,242,682,2245,4589,2487,5271
320390,202309,10729,25317,6788,17306,1513,4056,2697,6256,4210,10312
320400,202309,4163,10746,2663,7613,893,2674,851,2250,1744,4924
320405,202309,6902,15878,4433,11272,679,1774,2345,5560,3024,7334
320410,202309,5958,14327,3977,10749,815,2175,1728,4574,2543,6749
320420,202309,5815,12748,3936,9531,962,2483,1593,3618,2555,6101
320425,202309,2746,5811,1860,4287,148,366,1266,2676,1414,3042
320430,202309,4013,9321,2674,6792,379,973,1522,3615,1901,4588
320435,202309,3199,8904,2395,7174,874,2852,599,1729,1473,4581
320440,202309,1953,4847,1241,3412,231,716,529,1231,760,1947
320450,202309,2851,6782,2071,5296,312,1020,1209,2661,1521,3681
320455,202309,6005,16679,3619,11182,896,3048,898,2312,1794,5360
320460,202309,2707,7361,1696,5107,497,1617,450,1157,947,2774
320465,202309,2127,5424,1290,3694,332,1021,508,1389,840,2410
320470,202309,5802,14033,3744,9939,744,2129,1216,2795,1960,4924
320480,202309,3577,7506,2430,5528,338,761,1512,3160,1850,3921
320490,202309,35236,78915,21911,54181,4237,10279,9710,23246,13947,33525
320495,202309,1862,4629,1203,3278,298,921,161,275,459,1196
320500,202309,95634,219754,67112,166341,8709,23348,38761,87040,47470,110388
320501,202309,6481,16797,3871,11366,1015,3076,926,2469,1941,5545
320503,202309,3424,8899,1996,5898,593,1930,516,1284,1109,3214
320506,202309,3868,10251,2397,6798,740,2225,657,1564,1397,3789
320510,202309,16541,39029,11015,28485,2222,5550,4884,12080,7106,17630
320515,202309,2356,5917,1477,4032,457,1333,427,1050,884,2383
320517,202309,3041,8017,2228,6330,650,2014,863,2338,1513,4352
320520,202309,67087,150463,45358,110815,7003,18343,22625,50049,29628,68392
320530,202309,49090,109485,33722,80885,2747,7871,21754,45953,24501,53824
330010,202309,38772,83926,28791,66249,2280,5888,20652,44106,22932,49994
330015,202309,2442,5069,1701,3819,265,630,982,2011,1247,2641
330020,202309,32942,69315,25446,57542,2414,6244,18596,39467,21010,45711
330022,202309,2637,6484,1656,4636,333,991,608,1566,941,2557
330023,202309,10256,21436,7315,16653,1045,2628,4403,9074,5448,11702
330025,202309,10695,21360,6786,14950,998,2486,3661,7264,4659,9750
330030,202309,16462,36153,11586,27786,1061,2846,7605,16449,8666,19295
330040,202309,26745,58850,19660,46006,984,2892,14657,31367,15641,34259
330045,202309,149747,281404,117908,237915,6798,13895,96273,188580,103071,202475
330050,202309,5189,11274,3759,8877,547,1580,2361,4879,2908,6459
330060,202309,8873,19276,5619,13586,1097,2912,2160,4638,3257,7550
330070,202309,47744,98789,36870,82352,4361,10211,24581,52675,28942,62886
330080,202309,15338,30911,11891,25593,1498,3177,8322,17238,9820,20415
330090,202309,4682,8667,3098,6387,302,482,2056,4260,2358,4742
330093,202309,4266,8699,2810,6402,162,469,2163,4575,2325,5044
330095,202309,2128,5019,1360,3522,118,340,820,1913,938,2253
330100,202309,109088,236594,88447,203092,5989,14226,67422,147041,73411,161267
330110,202309,3382,7778,2602,6402,228,667,1783,3996,2011,4663
330115,202309,4062,8473,2493,5844,427,1076,1368,2810,1795,3886
330120,202309,4868,9258,3330,7108,163,401,2564,5094,2727,5495
330130,202309,8392,19079,6331,15680,826,2074,3938,9181,4764,11255
330140,202309,6325,12337,4893,10296,233,651,4015,7915,4248,8566
330150,202309,3822,8504,2641,6448,424,1080,1409,3200,1833,4280
330160,202309,2368,5425,1764,4357,266,764,1002,2151,1268,2915
330170,202309,241015,458923,189849,385165,21682,45404,139045,271415,160727,316819
330180,202309,3253,6277,2377,4959,76,216,1837,3488,1913,3704
330185,202309,17698,34196,13659,28346,485,1324,11200,21639,11685,22963
330187,202309,8938,18393,6386,14224,884,2142,4112,8451,4996,10593
330190,202309,69834,134213,54836,111783,2734,6431,44077,84862,46811,91293
330200,202309,29661,61153,22756,51106,2732,6373,16144,34859,18876,41232
330205,202309,3059,6742,2025,4933,202,537,1313,2889,1515,3426
330210,202309,4723,10150,3171,7477,502,1192,1568,3299,2070,4491
330220,202309,21063,44564,13721,31558,2476,5964,6901,14196,9377,20160
330225,202309,6625,14314,4649,11074,324,897,3110,6766,3434,7663
330227,202309,29536,58306,23641,49987,594,1683,20335,40552,20929,42235
330230,202309,2506,5298,1445,3589,174,423,669,1595,843,2018
330240,202309,43448,92869,33400,75511,3749,9007,22805,48635,26554,57642
330245,202309,2317,5219,1298,3390,285,817,555,1234,840,2051
330250,202309,74219,146497,59695,124533,6155,13361,44373,88827,50528,102188
330260,202309,10299,20305,7825,16851,414,1105,6218,12679,6632,13784
330270,202309,50137,105541,28956,69084,3828,9762,15425,33633,19253,43395
330280,202309,4256,8777,2987,6650,303,702,2009,4121,2312,4823
330285,202309,47005,88677,36183,72633,1893,4461,29404,55291,31297,59752
330290,202309,7047,13397,5217,10842,360,1020,4013,7642,4373,8662
330300,202309,8307,16699,5599,12649,419,1022,4103,8837,4522,9859
330310,202309,3860,7892,2678,5928,118,292,2041,4216,2159,4508
330320,202309,27999,54911,20087,43727,2706,5793,13825,28594,16531,34387
330330,202309,80655,151559,60262,121901,4942,10529,45880,88073,50822,98602
330340,202309,29714,61172,20190,45544,2743,7289,11853,23608,14596,30897
330350,202309,260071,481912,205570,408508,9562,20683,173957,331898,183519,352581
330360,202309,11345,22297,8893,18548,396,861,7294,14338,7690,15199
330370,202309,8393,19717,5893,15092,958,2666,3032,7139,3990,9805
330380,202309,10997,23248,7990,18018,456,1291,5904,12242,6360,13533
330385,202309,6531,15085,4863,12340,883,2429,2443,5741,3326,8170
330390,202309,54679,116929,38287,87975,3409,9424,26111,53522,29520,62946
330395,202309,5356,10907,3978,8850,159,509,3099,6383,3258,6892
330400,202309,5248,11607,4032,9547,241,740,2889,6122,3130,6862
330410,202309,4931,10451,3421,7904,363,1035,2396,5013,2759,6048
330411,202309,4125,9772,2819,7248,172,536,1849,4302,2021,4838
330412,202309,2546,5788,1906,4649,156,447,1316,2900,1472,3347
330414,202309,37817,80555,29093,67066,2364,5771,21583,47450,23947,53221
330415,202309,6464,15247,4176,10961,451,1289,2440,5876,2891,7165
330420,202309,19188,42022,12757,30530,1464,3824,7545,16290,9009,20114
330430,202309,16312,30787,12701,25460,565,1267,10361,19633,10926,20900
330440,202309,4523,9970,2928,7019,318,872,1948,4188,2266,5060
330450,202309,2164,5112,1515,3882,118,341,953,2235,1071,2576
330452,202309,31475,66899,23871,54290,1959,5330,17349,36506,19308,41836
330455,202309,1131367,2150084,875099,1769895,91132,193944,629065,1208447,720197,1402391
330460,202309,1754,4066,1253,3241,185,465,654,1645,839,2110
330470,202309,8967,18746,5753,13498,1406,3559,2336,4929,3742,8488
330475,202309,13828,29751,10601,25114,1526,3974,6850,15420,8376,19394
330480,202309,8115,18031,6251,14816,569,1450,4200,9173,4769,10623
330490,202309,180414,353287,135208,285078,11427,25219,99753,199720,111180,224939
330500,202309,12541,26045,9426,21257,595,1514,7058,15066,7653,16580
330510,202309,78188,160344,58941,131791,5180,12586,43662,91767,48842,104353
330513,202309,1908,4154,1327,3238,202,539,715,1615,917,2154
330515,202309,3992,9248,2885,7413,582,1600,1203,2794,1785,4394
330520,202309,22230,47418,17282,39468,1711,4405,11774,25104,13485,29509
330530,202309,2292,4957,1484,3613,276,713,710,1660,986,2373
330540,202309,4511,10202,3147,7757,612,1572,1624,3728,2236,5300
330550,202309,31617,61219,20955,44960,2856,6505,12790,25831,15646,32336
330555,202309,32550,55737,25531,46700,924,2017,21769,38530,22693,40547
330560,202309,5995,13010,4475,10529,715,1706,2817,6310,3532,8016
330570,202309,4487,9948,3638,8650,592,1563,2366,5401,2958,6964
330575,202309,9437,19409,7548,16132,337,886,6155,12171,6492,13057
330580,202309,36193,77633,26938,61099,3953,9253,16251,33836,20204,43089
330590,202309,2234,4958,1776,4298,269,629,1020,2481,1289,3110
330600,202309,19637,42562,14038,32568,889,2524,10076,21295,10965,23819
330610,202309,14724,31605,11060,25405,1182,2940,7467,15960,8649,18900
330615,202309,3087,6989,2354,5931,395,854,1492,3886,1887,4740
330620,202309,6735,15608,4882,12345,749,1975,2753,6381,3502,8356
330630,202309,47805,98800,32099,71821,1576,4579,23727,48112,25303,52691
350010,202309,3180,7558,1614,4236,285,796,394,848,679,1644
350020,202309,854,2103,442,1233,72,211,175,414,247,625
350030,202309,5231,12619,3619,9513,776,2184,1808,4266,2584,6450
350040,202309,998,2624,534,1604,83,272,173,388,256,660
350050,202309,2043,4583,1167,2998,197,583,362,685,559,1268
350055,202309,1249,2764,852,2044,110,269,508,1076,618,1345
350060,202309,440,953,188,457,44,109,72,151,116,260
350070,202309,4604,10978,2869,7629,469,1355,1215,2751,1684,4106
350075,202309,888,2268,530,1522,150,416,85,233,235,649
350080,202309,878,2130,485,1311,54,173,251,576,305,749
350090,202309,816,1637,469,1054,57,151,302,598,359,749
350100,202309,3490,7970,2162,5427,134,386,1466,3274,1600,3660
350110,202309,682,1474,442,1025,15,48,322,675,337,723
350115,202309,1424,3874,967,2790,166,481,401,1037,567,1518
350120,202309,723,1613,364,960,42,108,193,471,235,579
350130,202309,4615,10970,3100,7861,403,1118,1802,4058,2205,5176
350140,202309,919,2276,503,1400,41,139,289,716,330,855
350150,202309,587,1649,328,1012,84,268,91,219,175,487
350160,202309,17364,40308,10939,27269,1510,4134,6310,14087,7820,18221
350170,202309,4042,9756,2842,6998,516,1334,1536,3303,2052,4637
350180,202309,1276,2800,703,1707,86,225,405,872,491,1097
350190,202309,5401,13655,3434,8854,442,1314,1953,4221,2395,5535
350200,202309,735,1691,489,1204,48,121,293,668,341,789
350210,202309,9052,18830,5672,13005,409,1164,3922,8016,4331,9180
350220,202309,4296,10634,2611,6998,493,1400,1194,2731,1687,4131
350230,202309,1563,3452,1048,2640,135,403,638,1450,773,1853
350240,202309,809,2123,388,1146,91,269,74,187,165,456
350250,202309,4942,12045,3199,8770,839,2344,866,2228,1705,4572
350260,202309,1082,2376,554,1416,87,216,266,626,353,842
350270,202309,5817,13647,4018,10136,582,1527,2231,5104,2813,6631
350275,202309,4251,9694,3088,7569,168,516,2259,5051,2427,5567
350280,202309,25799,54658,15175,35881,2184,5437,7880,16626,10064,22063
350290,202309,4711,11710,3001,8065,591,1698,1263,2894,1854,4592
350300,202309,1067,2289,634,1497,93,262,431,921,524,1183
350310,202309,1294,3271,809,2215,109,332,391,923,500,1255
350315,202309,909,1963,492,1240,26,94,298,655,324,749
350320,202309,24130,56215,15885,39866,2837,7765,7927,17133,10764,24898
350330,202309,18894,41884,12027,28423,1154,3137,7969,16968,9123,20105
350335,202309,473,1236,283,828,35,104,126,355,161,459
350340,202309,1777,4282,968,2574,139,417,475,1070,614,1487
350350,202309,926,2115,668,1714,99,221,380,949,479,1170
350360,202309,1586,4028,1026,2739,171,454,454,1109,625,1563
350370,202309,943,2132,588,1400,164,380,225,474,389,854
350380,202309,6696,16957,3932,10695,902,2518,1386,3337,2288,5855
350390,202309,16163,37175,10815,26865,1528,4237,6502,14587,8030,18824
350395,202309,504,1203,203,591,25,77,75,204,100,281
350400,202309,11950,27316,7411,18783,1985,5308,2388,5435,4373,10743
350410,202309,15049,38118,9585,26916,1965,5864,3451,8811,5416,14675
350420,202309,1651,3879,966,2475,204,523,299,631,503,1154
350430,202309,865,2083,616,1644,108,325,298,707,406,1032
350440,202309,2824,6325,1908,4607,234,615,1237,2749,1471,3364
350450,202309,10184,25369,7030,19196,1532,4550,3166,7601,4698,12151
350460,202309,3372,7942,1937,5136,307,887,918,2132,1225,3019
350470,202309,345,771,233,574,10,32,182,415,192,447
350480,202309,1176,2768,697,1887,185,567,139,290,324,857
350490,202309,2755,6146,1754,4397,256,740,908,1894,1164,2634
350500,202309,815,2033,523,1470,96,292,190,472,286,764
350510,202309,1607,3587,1067,2557,122,301,658,1430,780,1731
350520,202309,3314,8743,2272,6545,347,1068,1093,2823,1440,3891
350530,202309,4198,9600,2728,6566,206,608,1767,3757,1973,4365
350535,202309,1985,4704,1466,3782,215,608,935,2283,1150,2891
350540,202309,2577,5239,1809,4027,233,680,1250,2447,1483,3127
350550,202309,13785,30784,8723,21523,1001,2786,4807,10398,5808,13184
350560,202309,6461,14268,4793,11221,187,580,3757,8193,3944,8773
350570,202309,44812,108601,31141,80968,5572,15095,15244,35666,20816,50761
350580,202309,2920,6995,1538,4138,410,1123,354,704,764,1827
350590,202309,7191,17230,4769,11909,716,2072,2830,6215,3546,8287
350600,202309,46160,101895,26100,65128,4602,12352,11546,25171,16148,37523
350610,202309,9653,23580,6185,16313,696,2039,3571,8280,4267,10319
350620,202309,516,1236,276,748,31,80,149,369,180,449
350630,202309,2396,5067,1487,3449,92,251,1034,2195,1126,2446
350635,202309,16212,34121,11344,25934,1115,2780,7977,16977,9092,19757
350640,202309,1149,2881,519,1508,86,266,150,360,236,626
350650,202309,11840,28787,7462,19649,1458,4032,3111,7135,4569,11167
350660,202309,6622,15097,4651,11629,764,1813,2676,6437,3440,8250
350670,202309,2473,6052,1588,4350,272,764,792,1986,1064,2750
350680,202309,1611,3865,994,2646,148,419,521,1232,669,1651
350690,202309,1964,4655,1233,3292,217,610,576,1382,793,1992
350700,202309,7372,16591,5046,12466,1217,3248,2502,5452,3719,8700
350710,202309,4355,10039,3056,7555,579,1579,1615,3575,2194,5154
350715,202309,923,2446,686,1943,130,419,340,792,470,1211
350720,202309,214,494,115,301,15,45,39,80,54,125
350730,202309,834,2242,500,1490,52,163,263,689,315,852
350740,202309,2090,5047,1258,3311,229,630,438,979,667,1609
350745,202309,802,1944,386,1057,27,87,216,515,243,602
350750,202309,16421,38611,11521,29103,2045,5641,5295,11841,7340,17482
350760,202309,25320,54891,16164,37918,2142,5812,8989,18303,11131,24115
350770,202309,1366,3013,799,1993,85,227,527,1198,612,1425
350775,202309,950,1992,515,1231,72,194,276,600,348,794
350780,202309,3086,6902,2028,5236,577,1437,709,1905,1286,3342
350790,202309,2572,6324,1421,4036,344,1014,319,713,663,1727
350800,202309,4780,11885,3641,9700,559,1498,2149,5341,2708,6839
350810,202309,3772,8249,2470,6008,586,1495,1113,2478,1699,3973
350820,202309,1246,2662,674,1590,59,170,421,879,480,1049
350830,202309,1116,2728,570,1550,109,311,204,447,313,758
350840,202309,4439,12030,2997,8890,639,2049,1184,3021,1823,5070
350850,202309,11690,28575,8198,21663,1397,3900,4265,10293,5662,14193
350860,202309,5454,12287,4189,10180,497,1304,2704,6140,3201,7444
350870,202309,3516,8728,2249,6440,479,1385,924,2465,1403,3850
350880,202309,2258,5437,1585,4046,421,1123,712,1533,1133,2656
350890,202309,648,1592,303,810,70,198,110,249,180,447
350900,202309,13491,31810,8482,21084,1327,3515,4623,10304,5950,13819
350910,202309,1262,2666,918,2074,99,202,625,1350,724,1552
350920,202309,17637,40394,12336,30277,936,2564,8479,19149,9415,21713
350925,202309,5975,14058,4014,10464,630,1850,2194,4887,2824,6737
350930,202309,1898,4520,997,2602,76,194,579,1391,655,1585
350940,202309,3787,8437,2771,6676,295,817,1891,4127,2186,4944
350945,202309,1280,3218,825,2262,160,452,344,825,504,1277
350950,202309,141361,320864,94360,227651,12750,33099,55017,120124,67767,153223
350960,202309,10510,24680,7060,17708,1114,3121,3690,8043,4804,11164
350970,202309,5296,13350,3102,8481,772,2376,1038,2168,1810,4544
350980,202309,1036,2360,786,1893,115,304,482,1065,597,1369
350990,202309,2958,6849,2135,5436,507,1469,1064,2452,1571,3921
350995,202309,1162,3123,897,2485,55,194,605,1527,660,1721
351000,202309,3939,10176,2180,6269,452,1409,524,1291,976,2700
351010,202309,549,1302,291,789,56,165,128,322,184,487
351015,202309,1334,3549,848,2375,154,482,379,910,533,1392
351020,202309,11049,26428,7158,18708,1535,4009,3125,7256,4660,11265
351030,202309,4208,11111,2898,8231,666,2037,1195,3015,1861,5052
351040,202309,7949,16682,5607,12638,438,1124,4079,8372,4517,9496
351050,202309,24873,55844,16815,41789,3159,8194,8548,19460,11707,27654
351060,202309,70524,157393,47289,114689,4751,12905,30883,69238,35634,82143
351070,202309,2008,4623,1013,2820,273,785,169,413,442,1198
351080,202309,3826,8282,2599,6400,343,909,1501,3338,1844,4247
351090,202309,451,1098,304,826,54,138,134,331,188,469
351100,202309,3868,9343,2077,5509,339,967,856,2031,1195,2998
351110,202309,7877,18790,5139,13521,991,2765,2362,5550,3353,8315
351120,202309,1038,2451,582,1496,108,318,218,453,326,771
351130,202309,1549,4007,615,1821,117,371,127,318,244,689
351140,202309,3033,7566,1969,5392,460,1393,730,1639,1190,3032
351150,202309,3638,9533,2131,6155,384,1205,568,1395,952,2600
351160,202309,1953,5431,1176,3604,203,638,189,445,392,1083
351170,202309,2243,5200,1699,4142,136,408,1186,2614,1322,3022
351190,202309,1283,3300,742,2113,189,550,191,500,380,1050
351200,202309,1991,4617,1265,3291,163,459,599,1318,762,1777
351210,202309,1933,4305,1122,2762,78,226,748,1672,826,1898
351220,202309,5259,12098,3842,9468,507,1207,2411,5599,2918,6806
351230,202309,3121,7168,2060,5158,345,948,1013,2182,1358,3130
351240,202309,3044,7604,1422,3949,255,716,173,314,428,1030
351250,202309,1301,3275,603,1713,92,271,230,584,322,855
351260,202309,1036,2351,647,1631,125,328,252,565,377,893
351270,202309,699,1741,412,1119,54,161,201,438,255,599
351280,202309,5219,12704,3351,8787,831,2251,1125,2677,1956,4928
351290,202309,1991,4262,1165,2752,84,242,847,1854,931,2096
351300,202309,32740,78640,21543,56653,3965,11063,10252,24402,14217,35465
351310,202309,5385,11696,3575,8370,317,777,2382,5069,2699,5846
351320,202309,1043,2791,627,1900,97,294,155,407,252,701
351330,202309,376,915,188,521,23,60,82,193,105,253
351340,202309,11395,25325,8816,20405,1809,4452,5093,10476,6902,14928
351350,202309,18912,41864,13263,30900,1261,3239,9376,19950,10637,23189
351360,202309,5265,12065,3950,9846,827,2217,1868,4140,2695,6357
351370,202309,2668,6882,1485,4278,348,1091,312,672,660,1763
351380,202309,64067,138916,39473,93649,4267,10906,24794,54236,29061,65142
351385,202309,484,1201,164,475,33,98,61,147,94,245
351390,202309,1899,4274,1203,3224,83,247,877,2206,960,2453
351400,202309,1597,3918,1058,2736,256,592,467,1173,723,1765
351410,202309,3577,8860,2294,6170,479,1344,926,2239,1405,3583
351420,202309,635,1440,335,867,70,163,175,428,245,591
351430,202309,1344,3078,899,2196,102,262,583,1284,685,1546
351440,202309,5005,11810,2897,7345,509,1358,1111,2325,1620,3683
351450,202309,2338,5549,1266,3369,238,762,463,979,701,1741
351460,202309,1407,3251,944,2391,176,446,550,1285,726,1731
351470,202309,1582,3660,1007,2546,79,217,649,1500,728,1717
351480,202309,3166,8089,2197,6256,391,1145,1012,2601,1403,3746
351490,202309,3061,7535,2213,5812,95,316,1626,3971,1721,4287
351492,202309,495,1151,352,848,16,48,268,591,284,639
351495,202309,297,729,185,492,20,43,105,251,125,294
351500,202309,62066,131661,42223,96645,6314,15097,26759,56381,33073,71478
351510,202309,18942,40770,12467,28940,1462,3816,7981,17129,9443,20945
351512,202309,601,1498,343,922,58,158,106,237,164,395
351515,202309,4182,9350,2198,5561,461,1259,538,1259,999,2518
351518,202309,2555,6291,1531,4243,278,830,586,1340,864,2170
351519,202309,827,2126,384,1165,79,252,81,200,160,452
351520,202309,1314,3026,566,1569,72,215,282,682,354,897
351530,202309,447,1055,234,599,38,108,104,206,142,314
351535,202309,2088,4862,1280,3339,225,644,573,1373,798,2017
351540,202309,3567,7891,2152,5309,262,770,1141,2410,1403,3180
351550,202309,10053,22779,5948,14835,963,2474,3022,6720,3985,9194
351560,202309,720,1885,448,1286,76,218,193,495,269,713
351565,202309,370,878,234,615,32,104,126,280,158,384
351570,202309,32868,75999,22744,55518,1948,5463,15241,34223,17189,39686
351580,202309,294,727,142,414,24,75,63,186,87,261
351590,202309,531,1151,236,617,26,81,114,259,140,340
351600,202309,1689,4155,1071,2819,198,507,459,1046,657,1553
351610,202309,858,1867,446,1081,57,108,254,585,311,693
351620,202309,34045,82036,21907,59088,3270,9869,10085,23711,13355,33580
351630,202309,40361,91500,27963,68220,2445,6727,19137,42637,21582,49364
351640,202309,28527,63627,20019,47602,1573,4370,13969,30285,15542,34655
351650,202309,493,1296,188,594,35,115,40,118,75,233
351660,202309,777,2026,476,1360,87,265,130,304,217,569
351670,202309,8201,20395,4423,11681,932,2473,1950,4458,2882,6931
351680,202309,542,1387,328,956,57,164,122,320,179,484
351685,202309,679,1701,415,1143,80,209,157,366,237,575
351690,202309,1535,3633,788,2170,135,438,289,659,424,1097
351700,202309,1839,4022,1158,2766,177,452,681,1433,858,1885
351710,202309,1042,2462,628,1612,53,167,365,820,418,987
351720,202309,1997,4796,1191,3181,206,566,557,1352,763,1918
351730,202309,1356,3039,901,2230,76,185,562,1257,638,1442
351740,202309,4300,9842,3069,7479,401,1054,1806,3966,2207,5020
351750,202309,2614,6361,1392,3802,192,548,709,1712,901,2260
351760,202309,4313,10611,2901,7769,607,1830,1251,2888,1858,4718
351770,202309,2786,6618,2069,5169,518,1284,1061,2440,1579,3724
351780,202309,1382,3198,704,1837,85,234,324,757,409,991
351790,202309,2050,4410,1377,3293,254,592,741,1682,995,2274
351800,202309,537,1187,240,623,34,103,89,173,123,276
351810,202309,1494,3514,998,2562,263,755,449,1002,712,1757
351820,202309,4248,10136,2714,6940,626,1673,1080,2422,1706,4095
351830,202309,6984,15533,4584,11065,375,1094,3073,6599,3448,7693
351840,202309,13339,32395,9412,24701,845,2523,6055,14383,6900,16906
351850,202309,1856,4899,1029,3109,205,685,298,687,503,1372
351860,202309,3736,9500,2538,7034,915,2547,831,2065,1746,4612
351870,202309,41904,94889,30200,73842,5671,14259,15817,36711,21488,50970
351880,202309,241385,524560,166824,388448,23359,64022,104597,217468,127956,281490
351885,202309,1396,3077,1007,2414,47,123,759,1710,806,1833
351890,202309,1024,2483,533,1541,109,347,138,340,247,687
351900,202309,1686,4080,1118,3053,126,341,694,1839,820,2180
351905,202309,821,2150,517,1440,62,176,223,533,285,709
351907,202309,32211,75876,21338,54250,2678,7654,12551,28672,15229,36326
351910,202309,2371,5386,1444,3465,154,448,910,1895,1064,2343
351920,202309,1176,2798,786,2008,167,405,291,666,458,1071
351925,202309,1334,3189,896,2301,100,299,521,1185,621,1484
351930,202309,6188,13517,4937,11206,688,1574,3304,7021,3992,8595
351940,202309,1453,3428,933,2433,190,517,377,931,567,1448
351950,202309,2120,4088,1430,3031,68,184,1083,2129,1151,2313
351960,202309,7566,17202,4883,12124,1176,3031,1946,4270,3122,7301
351970,202309,15310,35269,11567,28735,1530,4372,7536,16978,9066,21350
351980,202309,1423,3154,762,1935,148,403,330,727,478,1130
351990,202309,1843,4026,1081,2619,49,154,660,1380,709,1534
352000,202309,3759,9048,2744,6848,268,811,1874,4206,2142,5017
352010,202309,3187,7545,2193,5712,612,1645,592,1442,1204,3087
352020,202309,2311,5378,1597,4037,277,742,839,1936,1116,2678
352030,202309,8443,18715,6105,14554,783,2168,3960,8562,4743,10730
352040,202309,6336,14500,4050,10026,784,2067,1719,3763,2503,5830
352042,202309,5298,11175,3201,7687,371,985,2001,4458,2372,5443
352044,202309,2727,6698,1400,3959,234,735,324,694,558,1429
352050,202309,18937,46234,10699,28814,3076,8805,2351,4826,5427,13631
352060,202309,1028,2433,668,1731,126,360,330,756,456,1116
352070,202309,1216,2408,666,1524,112,263,349,719,461,982
352080,202309,575,1371,258,676,37,101,105,224,142,325
352090,202309,2100,5385,1460,3975,201,637,759,1745,960,2382
352100,202309,5284,13410,3479,9663,750,2176,1423,3592,2173,5768
352110,202309,1006,2524,610,1650,121,329,272,643,393,972
352115,202309,622,1599,478,1370,139,446,191,455,330,901
352120,202309,1090,2803,787,2176,68,188,482,1209,550,1397
352130,202309,2473,6477,1361,3698,227,628,622,1481,849,2109
352140,202309,1913,4634,1185,3075,235,627,481,1134,716,1761
352150,202309,1116,2711,752,2020,121,331,441,1128,562,1459
352160,202309,1236,2821,724,1860,72,200,358,837,430,1037
352170,202309,3843,9556,2551,6782,514,1506,1057,2382,1571,3888
352180,202309,3719,9316,2539,6977,498,1482,1047,2557,1545,4039
352190,202309,2245,5101,1636,4059,266,686,878,2044,1144,2730
352200,202309,439,1291,264,864,42,141,94,259,136,400
352210,202309,32842,65123,24134,52270,1410,3526,18897,38430,20307,41956
352215,202309,809,2001,571,1555,122,333,270,686,392,1019
352220,202309,40469,84928,27468,61334,3688,9326,17609,35044,21297,44370
352230,202309,21172,54151,14300,39718,3981,11433,4848,11496,8829,22929
352240,202309,14368,33921,10175,26403,2289,6398,5017,11465,7306,17863
352250,202309,35594,89674,26409,72531,3798,11270,15663,39899,19461,51169
352260,202309,6728,15498,4060,9928,770,2057,1881,3833,2651,5890
352265,202309,1126,3018,934,2682,249,770,413,1106,662,1876
352270,202309,2924,7404,2114,5664,434,1207,910,2206,1344,3413
352280,202309,3204,6995,2290,5510,496,1273,1148,2476,1644,3749
352290,202309,2061,5139,1273,3399,205,560,590,1348,795,1908
352300,202309,1228,2872,635,1622,74,215,322,704,396,919
352310,202309,65432,152663,46422,118015,7903,20024,28336,68529,36239,88553
352320,202309,9262,20833,6650,15916,939,2435,3978,8354,4917,10789
352330,202309,3540,7743,2559,6204,234,766,1718,3694,1952,4460
352340,202309,11310,26806,7290,18497,1128,3174,3870,8579,4998,11753
352350,202309,3405,8230,2305,5881,158,479,1530,3536,1688,4015
352360,202309,2098,4844,1475,3650,180,492,897,1938,1077,2430
352370,202309,1359,3374,1005,2694,91,287,682,1694,773,1981
352380,202309,1282,2965,789,1999,166,427,288,659,454,1086
352390,202309,20380,46501,12746,31804,1882,5218,7249,16048,9131,21266
352400,202309,5349,13756,3470,9723,824,2410,1086,2593,1910,5003
352410,202309,5190,11508,3527,8467,578,1414,1857,4109,2435,5523
352420,202309,1086,2570,653,1719,114,294,307,712,421,1006
352430,202309,12100,25561,7860,17793,999,2507,4652,9619,5651,12126
352440,202309,26869,65589,17561,46282,4173,11017,5970,14633,10143,25650
352450,202309,1034,2440,483,1379,71,232,214,520,285,752
352460,202309,3243,8103,2302,6354,434,1324,1044,2562,1478,3886
352470,202309,3851,9469,2587,6935,296,929,1481,3542,1777,4471
352480,202309,6123,13252,3467,8325,530,1379,1669,3468,2199,4847
352490,202309,1124,2793,713,1928,135,360,295,731,430,1091
352500,202309,15933,37564,8915,23602,3038,8618,1495,2536,4533,11154
352510,202309,6396,15050,4506,11397,542,1465,2915,6853,3457,8318
352520,202309,3829,9463,2530,6965,472,1364,1226,2929,1698,4293
352530,202309,16119,37182,9688,24354,2317,6324,3281,6680,5598,13004
352540,202309,739,1866,486,1322,66,190,255,618,321,808
352550,202309,1478,3586,933,2606,190,618,328,742,518,1360
352560,202309,899,2116,606,1490,40,121,409,889,449,1010
352570,202309,2862,7284,1767,5150,479,1505,252,492,731,1997
352580,202309,1019,2294,749,1776,107,289,461,984,568,1273
352585,202309,504,1273,277,778,43,128,97,206,140,334
352590,202309,17121,42032,10746,29155,1978,5862,5087,11816,7065,17678
352600,202309,2590,6270,1829,4732,326,924,1016,2308,1342,3232
352610,202309,3948,9293,2739,7162,448,1255,1369,3250,1817,4505
352620,202309,8101,17766,5471,13437,1485,3522,2398,5739,3883,9261
352630,202309,1078,2395,712,1794,118,342,329,746,447,1088
352640,202309,4544,10483,2947,7291,269,716,1783,3891,2052,4607
352650,202309,713,1863,406,1181,68,215,162,414,230,629
352660,202309,1472,3787,1037,2821,74,242,702,1745,776,1987
352670,202309,14266,33774,9210,23240,1743,4659,4397,9722,6140,14381
352680,202309,4463,11784,2942,8252,592,1917,1334,2932,1926,4849
352690,202309,36011,82569,24256,59884,1378,4125,17258,39040,18636,43165
352700,202309,1087,2523,703,1812,96,274,376,869,472,1143
352710,202309,7415,17384,4715,12179,1493,4012,1573,3444,3066,7456
352720,202309,13993,31253,10050,23673,1313,3388,6207,13374,7520,16762
352725,202309,666,1443,317,817,27,87,179,384,206,471
352730,202309,4519,12219,3415,9560,563,1680,1573,3581,2136,5261
352740,202309,3052,6896,1898,4768,267,747,896,1935,1163,2682
352750,202309,538,1240,266,723,35,93,113,256,148,349
352760,202309,1812,4517,1320,3512,194,539,697,1706,891,2245
352770,202309,1214,2871,760,1968,100,274,429,1023,529,1297
352780,202309,826,2182,458,1364,117,299,128,361,245,660
352790,202309,525,1266,313,800,56,143,135,292,191,435
352800,202309,1779,4828,987,2946,183,552,231,519,414,1071
352810,202309,2146,4671,1523,3486,151,380,1087,2356,1238,2736
352820,202309,550,1449,330,984,68,214,81,197,149,411
352830,202309,681,1625,279,773,40,110,92,217,132,327
352840,202309,5182,13284,3596,9959,832,2425,1417,3581,2249,6006
352850,202309,18113,38402,11802,27730,1887,4892,6711,13988,8598,18880
352860,202309,1539,3859,933,2568,181,487,343,881,524,1368
352870,202309,1046,2530,617,1600,77,188,348,833,425,1021
352880,202309,2248,4977,1284,3067,230,576,539,1123,769,1699
352885,202309,461,1149,301,820,34,98,170,412,204,510
352890,202309,899,1903,505,1102,53,123,364,716,417,839
352900,202309,26343,62072,15707,40549,2693,7154,6290,14646,8983,21800
352910,202309,462,1138,219,629,13,36,95,233,108,269
352920,202309,3673,8510,2491,6241,152,457,1802,4148,1954,4605
352930,202309,7814,18378,5566,13704,946,2684,2858,6022,3804,8706
352940,202309,39001,93019,28183,70341,4326,11482,16308,37084,20634,48566
352950,202309,703,1796,393,1185,82,263,126,313,208,576
352960,202309,929,2271,454,1223,70,202,154,328,224,530
352965,202309,298,762,161,476,29,72,46,134,75,206
352970,202309,5229,9670,3949,7699,116,301,3338,6121,3454,6422
352980,202309,2049,4455,1426,3480,391,1005,660,1449,1051,2454
352990,202309,5900,13577,4025,10218,733,1923,2143,5092,2876,7015
353000,202309,551,1365,273,763,36,108,93,220,129,328
353010,202309,3635,8131,2121,5210,362,977,1018,2160,1380,3137
353020,202309,3787,8985,2142,5693,372,1097,915,2166,1287,3263
353030,202309,6344,14903,3686,9940,956,2728,976,2348,1932,5076
353040,202309,966,2112,629,1525,59,158,423,944,482,1102
353050,202309,6863,17542,4391,12273,756,2326,2156,5344,2912,7670
353060,202309,69640,156032,51550,123803,3756,10740,37243,82056,40999,92796
353070,202309,15573,38803,9842,25809,1747,4981,4636,10522,6383,15503
353080,202309,6975,16625,4415,11418,862,2457,1865,3991,2727,6448
353090,202309,749,2050,485,1466,54,179,252,668,306,847
353100,202309,403,972,156,453,30,90,52,120,82,210
353110,202309,11411,25810,8389,21058,1893,4776,4133,10340,6026,15116
353120,202309,679,1584,462,1176,77,238,237,496,314,734
353130,202309,4134,9033,2402,5721,558,1422,1042,2049,1600,3471
353140,202309,4192,9110,2757,6527,466,1301,1564,3255,2030,4556
353150,202309,2273,5210,1453,3677,290,769,681,1531,971,2300
353160,202309,807,1927,450,1202,53,165,204,441,257,606
353170,202309,925,2105,625,1600,59,186,394,909,453,1095
353180,202309,13179,30447,8586,21578,2035,5442,3649,8151,5684,13593
353190,202309,4747,11295,3042,7648,388,1020,1753,4011,2141,5031
353200,202309,2299,5672,1236,3396,169,529,539,1283,708,1812
353205,202309,629,1627,408,1076,44,127,245,561,289,688
353210,202309,1162,2270,649,1420,27,66,495,1001,522,1067
353215,202309,500,1231,318,831,48,144,143,318,191,462
353220,202309,985,2491,531,1482,106,302,185,440,291,742
353230,202309,1103,2803,785,2251,204,656,173,436,377,1092
353240,202309,3423,7994,2542,6450,379,1109,1493,3431,1872,4540
353250,202309,1777,3573,1055,2335,128,326,674,1351,802,1677
353260,202309,1524,3281,783,2041,178,518,311,700,489,1218
353270,202309,1121,2542,783,1865,101,280,471,986,572,1266
353280,202309,973,2359,605,1661,129,354,213,529,342,883
353282,202309,2089,5472,1515,4258,171,547,827,2060,998,2607
353284,202309,466,1059,221,581,20,65,96,207,116,272
353286,202309,203,507,105,317,24,65,15,43,39,108
353290,202309,1678,4084,763,2091,176,439,219,560,395,999
353300,202309,2926,7136,1764,4624,378,1091,794,1762,1172,2853
353310,202309,505,1112,319,734,22,58,227,470,249,528
353320,202309,839,2077,527,1424,71,210,271,638,342,848
353325,202309,1042,2657,577,1583,92,279,267,632,359,911
353330,202309,832,1889,434,1100,57,145,217,479,274,624
353340,202309,4306,10601,3048,7957,528,1572,1557,3466,2085,5038
353350,202309,6026,13361,3732,8999,1065,2751,1033,2109,2098,4860
353360,202309,904,2299,610,1640,51,152,376,903,427,1055
353370,202309,804,2094,565,1655,81,251,317,864,398,1115
353380,202309,388,972,275,743,40,124,159,369,199,493
353390,202309,8479,19513,5190,13203,515,1522,3033,6834,3548,8356
353400,202309,763,1859,485,1280,84,226,211,437,295,663
353410,202309,685,1635,438,1138,152,400,150,308,302,708
353420,202309,660,1536,403,1026,87,256,124,257,211,513
353430,202309,3012,7591,2033,5588,476,1341,806,2008,1282,3349
353440,202309,110785,261945,73608,185740,10200,27982,43052,96915,53252,124897
353450,202309,477,1151,270,763,39,101,95,250,134,351
353460,202309,4292,10665,2405,6636,502,1538,600,1269,1102,2807
353470,202309,12698,29778,8073,20678,1479,4025,3620,8033,5099,12058
353475,202309,2053,4728,1084,2771,159,457,452,981,611,1438
353480,202309,2094,4746,1458,3557,96,264,1023,2298,1119,2562
353490,202309,1418,3308,903,2277,125,354,519,1157,644,1511
353500,202309,1634,3650,1089,2657,241,614,515,1145,756,1759
353510,202309,1361,3449,791,2083,148,411,335,732,483,1143
353520,202309,1361,3257,770,2128,145,396,275,619,420,1015
353530,202309,3324,7659,2376,5765,273,765,1534,3333,1807,4098
353540,202309,2964,6964,2078,5341,310,842,1258,2966,1568,3808
353550,202309,8322,18447,5601,13230,815,2073,3406,7261,4221,9334
353560,202309,3122,7547,2148,5818,602,1748,681,1487,1283,3235
353570,202309,826,2075,432,1238,70,211,157,379,227,590
353580,202309,3261,7770,2219,5658,420,1040,1179,2834,1599,3874
353590,202309,946,2212,604,1562,102,254,320,776,422,1030
353600,202309,1997,4745,1203,3188,194,519,559,1381,753,1900
353610,202309,1106,2935,679,2017,102,312,285,748,387,1060
353620,202309,3888,9081,2436,6433,600,1659,728,1639,1328,3298
353625,202309,827,1862,405,1053,50,160,224,509,274,669
353630,202309,2126,5547,1555,4269,221,655,842,2041,1063,2696
353640,202309,1830,4319,1212,3120,156,377,747,1820,903,2197
353650,202309,9298,23174,6040,16278,945,2757,3191,7670,4136,10427
353657,202309,471,1164,264,734,26,81,120,282,146,363
353660,202309,1753,3383,1139,2491,150,372,768,1564,918,1936
353670,202309,5930,14573,3710,9738,767,2269,1549,3392,2316,5661
353680,202309,945,2182,611,1638,105,301,305,732,410,1033
353690,202309,532,1370,195,583,30,91,43,101,73,192
353700,202309,2978,6738,2066,5134,222,566,1287,2965,1509,3531
353710,202309,5330,11516,3383,7782,609,1473,1871,3697,2480,5170
353715,202309,534,1335,256,719,28,81,119,289,147,370
353720,202309,2517,6004,1708,4524,385,1085,706,1695,1091,2780
353730,202309,7096,16322,5082,12560,748,2071,3001,6662,3749,8733
353740,202309,2924,6953,1932,5015,369,1067,932,2053,1301,3120
353750,202309,1170,3173,703,2185,172,545,107,288,279,833
353760,202309,20184,39940,14116,31086,2966,6860,7446,15440,10412,22300
353770,202309,827,2227,408,1291,66,226,38,98,104,324
353780,202309,9484,22093,6912,16995,1353,3680,3725,8234,5078,11914
353790,202309,3591,9695,2306,6790,580,1811,460,1043,1040,2854
353800,202309,25692,59860,18293,46171,2582,6938,11112,25847,13694,32785
353810,202309,1691,4091,1005,2595,204,516,406,976,610,1492
353820,202309,2505,5951,1502,3987,447,1194,407,932,854,2126
353830,202309,784,1811,483,1283,66,199,250,574,316,773
353850,202309,2099,5112,1419,3750,259,725,659,1579,918,2304
353860,202309,3729,8926,2658,7023,649,1965,1095,2347,1744,4312
353870,202309,40091,96564,25342,66184,4601,12548,10758,24892,15359,37440
353880,202309,3969,9668,2933,7616,235,721,1931,4551,2166,5272
353890,202309,4377,8262,2796,5819,201,503,1981,3678,2182,4181
353900,202309,974,2480,584,1602,97,296,224,526,321,822
353910,202309,4275,9867,3167,7846,273,773,2171,4966,2444,5739
353920,202309,2625,6517,1633,4471,485,1473,340,632,825,2105
353930,202309,7563,17820,4950,12648,933,2553,2161,4780,3094,7333
353940,202309,1790,4642,1018,2891,210,583,364,886,574,1469
353950,202309,4644,11160,3123,8105,1029,2722,788,1877,1817,4599
353960,202309,963,2345,572,1565,130,364,88,209,218,573
353970,202309,899,1864,592,1359,55,146,440,942,495,1088
353980,202309,24239,52949,16744,39188,795,2403,12658,27139,13453,29542
353990,202309,1299,2775,808,1889,111,291,495,1062,606,1353
354000,202309,3346,7590,1549,3911,257,711,693,1503,950,2214
354010,202309,428,1030,281,751,49,140,165,412,214,552
354020,202309,5450,12742,3675,8933,883,2276,1502,3261,2385,5537
354025,202309,909,2334,508,1441,95,278,157,386,252,664
354030,202309,667,1410,291,708,45,120,151,334,196,454
354040,202309,968,2070,538,1346,62,178,320,710,382,888
354050,202309,1384,3560,862,2573,195,619,304,829,499,1448
354060,202309,5682,13987,3635,9388,558,1600,1926,4253,2484,5853
354070,202309,5502,12713,3373,8379,604,1552,1373,2933,1977,4485
354075,202309,3836,9456,2825,7559,615,1717,1484,3566,2099,5283
354080,202309,2034,5106,1270,3504,192,571,627,1497,819,2068
354085,202309,533,978,353,702,5,13,273,495,278,508
354090,202309,2283,5585,1733,4396,116,337,1259,2957,1375,3294
354100,202309,35415,86288,24472,66173,4711,13839,11892,28926,16603,42765
354105,202309,1463,3518,881,2392,133,383,437,1049,570,1432
354110,202309,636,1573,390,1089,54,152,182,452,236,604
354120,202309,1874,4581,1064,2802,234,636,391,883,625,1519
354130,202309,7999,18876,4582,11800,1303,3432,1186,2560,2489,5992
354140,202309,25690,59232,16257,40384,2542,6743,8405,18308,10947,25051
354150,202309,3625,8025,2507,6085,673,1613,712,1708,1385,3321
354160,202309,3633,9339,2680,7344,667,1879,1144,2837,1811,4716
354165,202309,950,2418,661,1799,71,229,417,995,488,1224
354170,202309,2647,6599,1642,4417,341,1032,726,1584,1067,2616
354180,202309,591,1530,358,995,42,126,176,429,218,555
354190,202309,2000,5082,1227,3397,86,292,738,1824,824,2116
354200,202309,1187,2716,767,1921,103,287,433,950,536,1237
354210,202309,1449,3398,923,2289,91,247,592,1325,683,1572
354220,202309,4172,9935,2737,7035,596,1608,1061,2383,1657,3991
354230,202309,1053,2378,784,1966,52,156,538,1243,590,1399
354240,202309,2425,6106,1417,3876,286,798,562,1306,848,2104
354250,202309,896,2091,493,1320,120,330,163,407,283,737
354260,202309,12201,27539,8376,20470,1416,3577,3962,9028,5378,12605
354270,202309,1283,3378,881,2454,137,384,438,1056,575,1440
354280,202309,1032,2343,728,1782,59,172,499,1092,558,1264
354290,202309,1296,3585,935,2766,139,433,511,1382,650,1815
354300,202309,4278,11298,3332,9389,928,2651,1293,3319,2221,5970
354310,202309,1067,2683,758,2050,105,325,466,1124,571,1449
354320,202309,1196,2658,664,1687,125,332,305,655,430,987
354323,202309,563,1250,298,750,40,115,162,366,202,481
354325,202309,1674,4763,837,2645,180,588,128,311,308,899
354330,202309,13706,30860,8431,20037,1209,3115,4883,10423,6092,13538
354340,202309,59036,133957,38768,96928,6822,17725,19992,45810,26814,63535
354350,202309,1524,3435,1143,2740,162,448,701,1490,863,1938
354360,202309,839,1831,462,1179,119,299,165,367,284,666
354370,202309,1197,2963,870,2375,158,470,500,1263,658,1733
354380,202309,679,1719,440,1283,61,218,156,369,217,587
354390,202309,21171,46037,12904,30491,1863,4734,7113,14940,8976,19674
354400,202309,2119,6090,1372,4252,247,799,427,1189,674,1988
354410,202309,9678,21605,6417,15032,1069,2702,3651,7730,4720,10432
354420,202309,1843,4402,1137,3019,197,563,527,1230,724,1793
354425,202309,3822,8338,2408,5735,392,960,1370,3036,1762,3996
354430,202309,2334,5356,1558,3900,145,424,989,2235,1134,2659
354440,202309,743,1787,369,949,44,128,196,439,240,567
354450,202309,649,1608,318,907,43,129,119,273,162,402
354460,202309,998,2408,590,1636,171,528,142,308,313,836
354470,202309,496,1256,222,621,17,52,86,184,103,236
354480,202309,1812,3796,1052,2474,80,228,706,1482,786,1710
354490,202309,1061,2853,659,1897,141,388,285,746,426,1134
354500,202309,3179,7727,2205,5908,560,1590,764,1832,1324,3422
354510,202309,958,2451,606,1676,84,246,293,671,377,917
354515,202309,567,1515,324,965,62,192,95,234,157,426
354520,202309,11487,27863,7260,18768,1015,2932,4046,9092,5061,12024
354530,202309,7173,17329,4793,12322,1243,3194,1929,4501,3172,7695
354540,202309,1627,3918,1015,2701,179,512,458,1100,637,1612
354550,202309,745,1867,487,1340,77,235,242,566,319,801
354560,202309,2818,6278,1351,3427,184,441,740,1724,924,2165
354570,202309,1100,2565,403,1145,68,209,59,152,127,361
354580,202309,11210,27903,6955,19104,1059,3178,3516,8602,4575,11780
354600,202309,2772,6755,1794,4774,329,867,898,2210,1227,3077
354610,202309,597,1485,276,785,34,96,124,305,158,401
354620,202309,635,1653,344,1033,34,121,180,482,214,603
354625,202309,391,1028,191,580,19,67,59,130,78,197
354630,202309,3400,8523,2526,6684,870,2297,693,1699,1563,3996
354640,202309,5045,12525,3472,9256,498,1493,1826,4292,2324,5785
354650,202309,1117,2647,687,1712,201,463,307,739,508,1202
354660,202309,4507,9903,2220,5841,309,905,939,2138,1248,3043
354670,202309,1613,4020,1053,2823,222,638,362,811,584,1449
354680,202309,8828,19649,6158,14871,984,2574,3620,8029,4604,10603
354690,202309,692,1935,404,1239,68,204,158,418,226,622
354700,202309,1215,2856,750,1907,108,317,412,935,520,1252
354710,202309,606,1491,332,907,35,86,158,364,193,450
354720,202309,390,874,169,457,65,160,36,84,101,244
354730,202309,15665,40510,10651,29899,1597,4577,5609,14224,7206,18801
354740,202309,384,993,140,432,32,95,18,45,50,140
354750,202309,3157,7479,1852,4779,301,827,839,1848,1140,2675
354760,202309,3015,7117,1877,4899,360,988,770,1699,1130,2687
354765,202309,438,1096,156,465,15,60,47,111,62,171
354770,202309,3251,7378,2078,5028,447,1227,1013,2149,1460,3376
354780,202309,88734,193136,60059,136138,4222,11636,42963,87301,47185,98937
354790,202309,1176,3009,874,2485,90,269,501,1332,591,1601
354800,202309,3618,8569,2211,5849,510,1368,762,1712,1272,3080
354805,202309,1850,3953,1157,2734,79,216,809,1717,888,1933
354810,202309,651,1848,370,1233,81,305,96,258,177,563
354820,202309,1231,3286,799,2403,158,495,228,557,386,1052
354830,202309,689,1528,342,863,68,188,132,270,200,458
354840,202309,1078,2596,534,1401,46,120,301,691,347,811
354850,202309,32504,71855,21706,52187,1883,5351,14825,31911,16708,37262
354860,202309,2123,5175,1225,3376,157,476,534,1270,691,1746
354870,202309,97864,216574,64706,151011,5665,15042,42663,88430,48328,103472
354880,202309,8550,19778,4203,10465,586,1653,2022,3984,2608,5637
354890,202309,26220,57896,18180,42829,2483,6383,10365,22061,12848,28444
354900,202309,490,1140,276,743,86,236,81,187,167,423
354910,202309,8348,20111,4547,12601,973,2858,1433,3340,2406,6198
354920,202309,597,1531,217,643,30,94,58,133,88,227
354925,202309,331,892,147,477,17,64,26,55,43,119
354930,202309,443,1015,226,549,21,52,136,301,157,353
354940,202309,3806,9969,2575,7186,739,2146,1033,2450,1772,4596
354950,202309,2035,4533,1397,3387,72,222,1017,2250,1089,2472
354960,202309,1074,2598,690,1923,79,277,334,798,413,1075
354970,202309,5931,14339,4119,10990,299,962,2718,6593,3017,7555
354980,202309,49571,107799,31359,74700,4079,10999,19329,40866,23408,51865
354990,202309,110542,243827,70107,167667,5123,14686,46944,99947,52067,114633
354995,202309,4615,8598,3240,6604,171,400,2571,4888,2742,5288
355000,202309,1973,4527,1273,3313,226,650,566,1287,792,1937
355010,202309,5502,13426,3116,8295,981,2534,864,2100,1845,4634
355020,202309,3972,10690,2960,8796,784,2529,928,2314,1712,4843
355030,202309,1861122,4161011,1171318,2777997,178429,456066,642095,1368773,820524,1824839
355040,202309,4907,10445,3436,8222,492,1274,2246,4940,2738,6214
355050,202309,1504,3255,957,2332,224,558,351,774,575,1332
355060,202309,9491,23065,6269,16605,1058,3015,3146,7374,4204,10389
355070,202309,15565,34730,11207,26708,1356,3600,7140,15332,8496,18932
355080,202309,1281,3357,683,2107,169,513,116,308,285,821
355090,202309,1824,4423,1258,3313,200,531,687,1595,887,2126
355100,202309,46453,103552,35916,85327,3406,9101,25870,56946,29276,66047
355110,202309,1333,3322,809,2363,152,458,54,136,206,594
355120,202309,920,2192,534,1496,82,243,259,635,341,878
355130,202309,1131,2239,534,1124,17,46,417,808,434,854
355140,202309,3043,5580,2352,4590,97,238,1964,3584,2061,3822
355150,202309,6903,15786,4943,12048,635,1657,3076,6937,3711,8594
355160,202309,3282,8026,1953,5420,442,1257,567,1343,1009,2600
355170,202309,17152,38515,11690,28291,1919,5073,6711,14778,8630,19851
355180,202309,3795,8620,2570,6598,668,1813,1143,2667,1811,4480
355190,202309,2446,5990,1563,4256,619,1680,323,923,942,2603
355200,202309,1196,3216,899,2659,245,808,315,813,560,1621
355210,202309,4338,10561,2791,7297,790,2004,981,2355,1771,4359
355220,202309,76187,176130,53649,130026,6610,18419,32668,70186,39278,88605
355230,202309,1517,3668,647,1765,145,441,259,579,404,1020
355240,202309,34485,82325,21818,56097,2590,7375,13403,31200,15993,38575
355250,202309,57212,135593,38494,96923,9670,24043,17853,41943,27523,65986
355255,202309,847,1950,382,1019,46,134,177,392,223,526
355260,202309,2040,4333,1277,2980,115,335,882,1850,997,2185
355270,202309,1676,4383,1157,3259,296,807,432,1120,728,1927
355280,202309,45791,103110,28865,70107,3752,9888,16529,36316,20281,46204
355290,202309,1239,2998,815,2150,185,484,380,902,565,1386
355300,202309,1911,4923,1386,3813,246,713,624,1473,870,2186
355310,202309,1170,2910,752,2069,110,341,399,1013,509,1354
355320,202309,726,1794,439,1176,94,281,167,351,261,632
355330,202309,4175,9421,2779,6732,140,414,2084,4625,2224,5039
355340,202309,5345,11236,3369,7939,708,1679,1376,3312,2084,4991
355350,202309,1854,4726,1258,3500,247,773,578,1417,825,2190
355360,202309,1641,3789,1078,2791,170,481,562,1240,732,1721
355365,202309,435,990,188,523,39,95,61,151,100,246
355370,202309,7677,17477,5193,13016,1111,2463,2545,6355,3656,8818
355380,202309,3916,9486,2599,6881,470,1348,969,2139,1439,3487
355385,202309,1794,4256,1210,3095,130,366,711,1623,841,1989
355390,202309,935,2341,611,1646,112,322,291,649,403,971
355395,202309,2269,6091,1249,3716,224,719,498,1254,722,1973
355400,202309,13278,33413,9493,25322,1856,5482,4434,10049,6290,15531
355410,202309,33322,83151,20831,56701,4069,11804,8852,21388,12921,33192
355420,202309,757,2195,541,1710,124,418,150,420,274,838
355430,202309,4760,11065,3109,7749,575,1539,1670,3887,2245,5426
355440,202309,885,2186,470,1299,98,291,140,327,238,618
355450,202309,4964,11541,2791,7034,369,1017,1439,3015,1808,4032
355460,202309,606,1393,361,943,45,135,165,375,210,510
355465,202309,574,1329,402,1035,61,158,230,543,291,701
355470,202309,1524,3577,746,1997,210,606,269,655,479,1261
355475,202309,445,962,291,694,15,35,195,423,210,458
355480,202309,5585,14129,3971,11197,624,1909,2237,5831,2861,7740
355490,202309,1134,2872,533,1580,73,244,222,563,295,807
355495,202309,1301,3102,801,2206,101,326,386,870,487,1196
355500,202309,9447,21764,5326,13406,705,2004,2542,5512,3247,7516
355510,202309,1846,4237,1060,2714,180,492,499,1105,679,1597
355520,202309,395,886,180,509,27,75,28,71,55,146
355530,202309,372,806,152,387,12,34,91,206,103,240
355535,202309,705,1751,490,1330,101,326,216,457,317,783
355540,202309,18563,40021,14148,32976,1449,3663,9860,21446,11309,25109
355550,202309,821,2202,609,1777,77,259,341,870,418,1129
355560,202309,1455,3559,696,2006,184,563,27,82,211,645
355570,202309,392,942,185,507,35,78,77,190,112,268
355580,202309,1510,3445,715,1905,135,366,131,318,266,684
355590,202309,201,498,136,378,16,45,72,175,88,220
355600,202309,1726,4098,1008,2732,141,422,302,689,443,1111
355610,202309,2695,6122,1543,3915,334,850,697,1572,1031,2422
355620,202309,7063,16804,4536,11492,600,1759,2606,5731,3206,7490
355630,202309,3475,8450,2205,5839,284,787,1310,3164,1594,3951
355635,202309,1380,3564,818,2303,115,342,341,835,456,1177
355640,202309,4710,11985,2787,7997,812,2319,484,1423,1296,3742
355645,202309,4724,12142,2918,8434,419,1313,1384,3549,1803,4862
355650,202309,11290,26759,7611,19282,1365,3584,3780,8608,5145,12192
355660,202309,1663,4267,817,2524,162,488,131,336,293,824
355670,202309,6316,15091,3777,9440,502,1455,1959,4143,2461,5598
355680,202309,3201,8355,1305,3906,356,1158,126,330,482,1488
355690,202309,931,2538,557,1730,206,645,15,30,221,675
355695,202309,325,826,169,496,18,53,34,71,52,124
355700,202309,12364,30329,9029,22948,1106,3193,5340,12064,6446,15257
355710,202309,13547,29795,7986,18686,1258,3273,4168,8318,5426,11591
355715,202309,612,1549,292,819,76,206,87,204,163,410
355720,202309,1942,4755,1331,3536,254,691,683,1624,937,2315
355730,202309,1432,3499,945,2517,91,269,558,1351,649,1620
410010,202309,1506,3921,959,2692,217,603,224,554,441,1157
410020,202309,1463,3770,939,2626,277,766,234,570,511,1336
410030,202309,2230,5369,1604,4231,258,733,862,2187,1120,2920
410040,202309,19931,49594,12388,34210,2653,7621,3828,9448,6481,17069
410045,202309,868,2176,546,1482,131,361,142,329,273,690
410050,202309,2662,6561,1573,4392,267,827,459,1086,726,1913
410060,202309,2592,6668,1789,5042,460,1442,576,1397,1036,2839
410070,202309,2460,5784,1338,3511,245,648,500,1128,745,1776
410080,202309,1756,4304,1115,3078,293,841,258,609,551,1450
410090,202309,1438,3136,972,2302,257,593,308,794,565,1387
410100,202309,2630,6872,1297,3729,221,701,89,231,310,932
410105,202309,733,1661,385,984,46,102,193,428,239,530
410110,202309,4049,8948,2593,6263,397,1037,1485,3217,1882,4254
410115,202309,669,1623,397,1067,51,159,144,289,195,448
410120,202309,4313,9859,3366,8185,775,1574,1853,4473,2628,6047
410130,202309,1703,4019,1323,3243,194,527,802,1828,996,2355
410140,202309,22805,51475,12423,31576,2623,6955,4180,9324,6803,16279
410150,202309,20046,44786,9245,23344,1594,4437,3413,7209,5007,11646
410160,202309,3793,9857,2538,7136,599,1850,909,2287,1508,4137
410165,202309,765,1933,542,1424,89,265,249,578,338,843
410170,202309,3737,8937,1728,4518,347,931,420,946,767,1877
410180,202309,23298,58597,14706,39562,2699,7755,6767,15768,9466,23523
410185,202309,586,1559,365,1046,62,190,145,355,207,545
410190,202309,2763,6494,1563,4078,342,873,294,662,636,1535
410200,202309,7310,15597,3377,8517,831,2197,631,1308,1462,3505
410210,202309,3875,9225,2038,5670,351,1076,646,1450,997,2526
410220,202309,802,1928,384,973,84,219,134,291,218,510
410230,202309,2682,6500,1580,4116,253,720,697,1538,950,2258
410240,202309,6326,15677,3519,9756,797,2639,627,1420,1424,4059
410250,202309,2855,6434,1718,4333,238,627,780,1808,1018,2435
410260,202309,2575,5803,1411,3592,309,824,664,1485,973,2309
410270,202309,629,1532,339,921,52,161,158,346,210,507
410275,202309,744,1916,407,1181,86,278,162,413,248,691
410280,202309,2901,7098,1607,4405,230,690,711,1651,941,2341
410290,202309,4111,10478,2432,6899,1035,2858,475,1319,1510,4177
410300,202309,860,1979,576,1436,71,222,301,620,372,842
410302,202309,411,976,215,607,38,110,93,238,131,348
410304,202309,1870,4076,1374,3195,182,453,765,1729,947,2182
410305,202309,2185,4812,1345,3432,189,548,829,1938,1018,2486
410310,202309,4152,9446,2862,6961,206,653,1990,4358,2196,5011
410315,202309,870,1883,501,1235,135,338,156,350,291,688
410320,202309,1131,3006,574,1721,73,238,102,255,175,493
410322,202309,762,1957,295,853,38,104,92,206,130,310
410330,202309,1752,4092,991,2588,195,500,300,684,495,1184
410335,202309,1046,2624,628,1733,127,371,186,431,313,802
410337,202309,1000,2344,532,1356,74,196,202,446,276,642
410340,202309,584,1505,303,794,25,81,155,310,180,391
410345,202309,3581,8760,1777,4728,469,1220,654,1550,1123,2770
410347,202309,976,2348,565,1513,110,289,127,326,237,615
410350,202309,2059,4690,1189,3076,122,362,671,1513,793,1875
410360,202309,4873,11731,2910,7802,583,1634,808,1938,1391,3572
410370,202309,18618,46223,9644,24807,1358,3903,4299,9095,5657,12998
410380,202309,2225,5111,1176,3015,182,518,368,822,550,1340
410390,202309,3599,7892,2113,5246,437,1258,881,1796,1318,3054
410395,202309,1112,2941,762,2212,166,467,256,747,422,1214
410400,202309,10518,23682,6686,16160,685,1928,4233,9078,4918,11006
410405,202309,1160,2506,677,1710,80,250,347,788,427,1038
410410,202309,2039,4812,1523,3856,136,378,984,2387,1120,2765
410420,202309,16666,40305,10462,27242,1850,5141,4714,10554,6564,15695
410425,202309,4983,12449,2977,8203,547,1589,1041,2503,1588,4092
410430,202309,17256,39511,9788,24640,1557,4257,4032,8944,5589,13201
410440,202309,3071,7802,2363,6357,441,1167,1202,3014,1643,4181
410442,202309,3229,8640,2101,6065,532,1558,441,1116,973,2674
410445,202309,2826,7383,1627,4915,393,1317,160,476,553,1793
410450,202309,2065,4737,1215,3223,230,613,333,773,563,1386
410460,202309,3329,7365,2007,4888,326,845,994,2112,1320,2957
410465,202309,3778,9938,2226,6423,590,1712,497,1162,1087,2874
410470,202309,3087,7806,1898,5523,687,2274,121,317,808,2591
410480,202309,53904,120627,25421,67312,4199,11978,8260,18434,12459,30412
410490,202309,15261,37924,9314,24850,1693,4840,4507,10527,6200,15367
410500,202309,2281,5514,1180,3257,239,652,204,441,443,1093
410510,202309,2249,5163,1254,3205,299,717,400,1001,699,1718
410520,202309,3901,10760,3158,9190,1013,3146,1172,3193,2185,6339
410530,202309,1852,4360,658,1752,87,261,186,394,273,655
410540,202309,3583,8708,2094,5610,413,1200,931,2171,1344,3371
410550,202309,9717,24221,5489,14775,938,2742,1753,3753,2691,6495
410560,202309,1868,4529,1070,2828,204,613,273,581,477,1194
410570,202309,3479,8488,2047,5763,731,2348,190,444,921,2792
410580,202309,37836,88902,24570,63200,4212,11502,11573,26689,15785,38191
410590,202309,2117,5458,1235,3417,198,583,336,732,534,1315
410600,202309,2309,5471,1589,4081,362,916,661,1574,1023,2490
410610,202309,868,2043,539,1387,44,122,286,653,330,775
410620,202309,3788,9206,2410,6273,609,1646,777,1841,1386,3487
410630,202309,2951,7152,1601,4327,328,1011,263,505,591,1516
410640,202309,6653,14456,3694,8965,917,2348,686,1564,1603,3912
410645,202309,1788,4055,1293,3313,133,390,878,2135,1011,2525
410650,202309,3370,8330,1809,4953,428,1145,677,1661,1105,2806
410655,202309,1081,2470,567,1448,136,351,195,440,331,791
410657,202309,737,1856,402,1090,66,207,202,443,268,650
410660,202309,4753,10924,2358,5882,394,1036,893,1925,1287,2961
410670,202309,1211,2866,579,1541,85,249,206,463,291,712
410680,202309,3026,8349,1929,5723,579,1701,513,1477,1092,3178
410685,202309,652,1567,406,1100,104,303,153,355,257,658
410690,202309,187944,423924,109506,268499,18399,49286,46988,97791,65387,147077
410700,202309,3073,7271,2082,5369,523,1397,719,1646,1242,3043
410710,202309,1131,2678,585,1585,163,473,212,474,375,947
410712,202309,1000,2530,544,1528,101,297,244,634,345,931
410715,202309,1080,2853,570,1688,74,251,246,655,320,906
410720,202309,5023,11522,3322,8215,546,1657,1258,2771,1804,4428
410725,202309,1460,3361,722,1938,173,488,178,402,351,890
410730,202309,1139,2684,603,1583,111,344,126,291,237,635
410740,202309,1047,2723,591,1725,58,196,327,901,385,1097
410750,202309,2476,5565,1571,3804,257,669,691,1522,948,2191
410752,202309,484,1127,201,559,82,204,26,71,108,275
410753,202309,426,1145,223,687,43,131,69,181,112,312
410754,202309,1459,3247,1012,2492,93,261,710,1671,803,1932
410755,202309,668,1625,401,1075,50,157,187,430,237,587
410760,202309,4452,10846,2714,7447,816,2657,594,1354,1410,4011
410765,202309,25221,61598,16556,43457,3440,9894,5900,13008,9340,22902
410770,202309,1237,2802,708,1841,80,194,347,859,427,1053
410773,202309,1663,3976,1197,3100,294,775,575,1323,869,2098
410775,202309,2101,4224,1589,3347,52,138,1244,2409,1296,2547
410780,202309,727,1718,405,1059,66,175,142,341,208,516
410785,202309,1047,2327,649,1645,99,294,332,762,431,1056
410790,202309,1488,4008,966,2819,209,680,215,527,424,1207
410800,202309,4337,8544,2647,5595,84,233,1920,3735,2004,3968
410810,202309,571,1428,351,983,38,97,166,415,204,512
410820,202309,1262,3260,554,1518,122,350,132,293,254,643
410830,202309,60842,131391,37726,89468,6178,16184,19452,40941,25630,57125
410832,202309,1376,3352,900,2372,102,316,491,1114,593,1430
410840,202309,11645,27398,5521,14891,1504,4047,1054,2290,2558,6337
410845,202309,1529,3213,1067,2450,113,318,722,1521,835,1839
410850,202309,2650,6808,1953,5371,416,1213,875,2249,1291,3462
410855,202309,878,2079,477,1272,74,228,221,484,295,712
410860,202309,6266,13331,4252,9629,185,551,3089,6274,3274,6825
410865,202309,1783,4563,1327,3681,256,725,657,1854,913,2579
410870,202309,1464,3660,970,2704,139,434,502,1265,641,1699
410880,202309,6069,14822,3399,9593,580,1711,538,1583,1118,3294
410890,202309,1488,3702,1006,2670,199,500,480,1169,679,1669
410895,202309,1233,3555,933,2862,269,897,278,759,547,1656
410900,202309,1088,2732,613,1763,117,366,113,243,230,609
410910,202309,547,1200,271,655,17,48,163,350,180,398
410920,202309,1180,2551,662,1565,51,131,424,928,475,1059
410930,202309,2231,5295,1266,3520,273,842,190,418,463,1260
410940,202309,33051,81068,20449,55798,4359,13100,8352,20189,12711,33289
410950,202309,2494,6203,2046,5385,208,497,1486,3763,1694,4260
410960,202309,11416,25179,7308,18166,2270,6044,2330,5081,4600,11125
410965,202309,1378,3330,680,1901,137,405,258,639,395,1044
410970,202309,5470,13632,3157,8687,816,2631,604,1241,1420,3872
410975,202309,1880,4196,1070,2705,238,616,402,928,640,1544
410980,202309,9833,22335,5626,14315,652,1905,2930,6455,3582,8360
410990,202309,1959,4206,1226,2994,251,656,591,1368,842,2024
411000,202309,846,2159,494,1416,92,274,155,382,247,656
411005,202309,584,1368,277,715,42,110,113,237,155,347
411007,202309,3178,7658,1926,5169,399,1213,707,1605,1106,2818
411010,202309,6117,15888,3675,10491,983,2925,826,1908,1809,4833
411020,202309,2949,7522,2055,5770,578,1647,612,1645,1190,3292
411030,202309,844,1987,471,1201,55,153,200,416,255,569
411040,202309,1280,3029,537,1435,96,238,166,376,262,614
411050,202309,2544,7272,1690,5296,367,1234,266,659,633,1893
411060,202309,2957,7134,1567,4184,296,844,591,1260,887,2104
411065,202309,476,1143,233,635,23,65,94,226,117,291
411070,202309,10061,22937,6650,16526,1200,3096,3196,7093,4396,10189
411080,202309,2623,6253,1662,4345,399,1160,584,1279,983,2439
411090,202309,974,2519,459,1359,65,234,141,340,206,574
411095,202309,2959,6721,1257,3334,242,628,194,408,436,1036
411100,202309,1493,3578,829,2249,153,492,297,688,450,1180
411110,202309,774,1939,292,867,32,94,24,40,56,134
411120,202309,2165,5171,1351,3553,219,682,586,1324,805,2006
411125,202309,6977,18153,4944,13799,1532,4356,1594,4049,3126,8405
411130,202309,936,2292,520,1404,152,389,152,399,304,788
411140,202309,2686,7683,1814,5650,475,1517,467,1414,942,2931
411150,202309,5143,12077,2809,7256,614,1672,243,493,857,2165
411155,202309,1392,3160,792,1943,134,372,436,913,570,1285
411160,202309,507,1079,259,670,41,119,74,191,115,310
411170,202309,970,2513,664,1894,138,440,314,814,452,1254
411180,202309,6965,16116,5030,12290,767,2084,2776,5974,3543,8058
411190,202309,2776,6606,1617,4187,231,644,750,1692,981,2336
411200,202309,6409,15725,4167,11069,885,2643,1435,3095,2320,5738
411210,202309,4505,9604,2464,5754,298,826,1243,2472,1541,3298
411220,202309,1226,2816,679,1746,131,364,265,572,396,936
411230,202309,1050,2618,649,1792,137,380,165,399,302,779
411240,202309,1903,4229,1086,2696,243,630,364,784,607,1414
411250,202309,2854,6932,1690,4619,462,1332,417,976,879,2308
411260,202309,406,974,218,588,32,104,103,220,135,324
411270,202309,2557,6288,1543,4187,232,666,739,1765,971,2431
411275,202309,2066,4253,1259,2844,122,350,730,1397,852,1747
411280,202309,1940,4773,1149,3094,265,747,408,938,673,1685
411290,202309,1017,2452,564,1525,67,211,273,663,340,874
411295,202309,1616,3845,994,2619,204,516,369,848,573,1364
411300,202309,1227,2938,585,1560,68,211,223,451,291,662
411310,202309,1222,2497,749,1718,129,316,399,795,528,1111
411320,202309,7467,17004,4851,11914,767,2108,2321,4770,3088,6878
411325,202309,1934,4732,1415,3746,221,608,825,2134,1046,2742
411330,202309,3985,9846,2636,7323,721,2176,680,1719,1401,3895
411340,202309,1005,2542,473,1321,80,229,170,409,250,638
411342,202309,1270,2925,589,1543,154,410,194,418,348,828
411345,202309,1517,3512,942,2439,70,200,622,1512,692,1712
411350,202309,3782,9437,2013,5688,468,1406,259,602,727,2008
411360,202309,858,1978,533,1326,91,267,227,486,318,753
411370,202309,77104,175990,46767,117457,4534,12808,27290,60972,31824,73780
411373,202309,1755,4007,1183,2987,213,540,501,1197,714,1737
411375,202309,1340,3148,718,1906,129,341,236,537,365,878
411380,202309,1435,3081,740,1685,36,88,511,1063,547,1151
411390,202309,1937,4784,1213,3114,216,635,527,1092,743,1727
411400,202309,2974,6705,1887,4630,232,645,1034,2227,1266,2872
411410,202309,3926,10248,2285,6513,596,1735,526,1251,1122,2986
411420,202309,5286,12246,2153,5871,348,1042,407,763,755,1805
411430,202309,5342,12591,3515,9025,706,2031,1298,2728,2004,4759
411435,202309,544,1362,230,658,41,126,37,71,78,197
411440,202309,3455,8502,2137,5836,621,1661,524,1297,1145,2958
411450,202309,3126,7652,2080,5606,355,903,1125,2971,1480,3874
411460,202309,5760,13859,2845,7854,431,1327,806,1783,1237,3110
411470,202309,1167,2598,794,1942,66,223,510,1095,576,1318
411480,202309,7099,17341,4021,10997,806,2453,1223,2933,2029,5386
411490,202309,2147,4924,1417,3588,184,566,784,1758,968,2324
411500,202309,1735,4241,973,2534,211,597,280,547,491,1144
411510,202309,2810,6366,1773,4437,354,1044,490,1125,844,2169
411520,202309,47610,108414,23113,58126,3035,8810,10916,23179,13951,31989
411530,202309,1156,2771,552,1557,110,328,141,343,251,671
411535,202309,639,1786,330,1038,36,133,82,217,118,350
411540,202309,3520,7799,1928,4736,211,587,1107,2488,1318,3075
411545,202309,1088,2871,810,2288,76,232,501,1361,577,1593
411550,202309,860,1988,568,1404,107,274,215,464,322,738
411560,202309,2379,6289,971,2933,141,456,73,168,214,624
411570,202309,9921,21289,6045,14782,1384,3611,2156,4787,3540,8398
411573,202309,966,2373,699,1840,100,337,406,936,506,1273
411575,202309,2568,6222,1592,4254,322,924,573,1393,895,2317
411580,202309,5492,12786,2676,7429,398,1250,503,1036,901,2286
411585,202309,724,2036,274,868,36,120,32,73,68,193
411590,202309,609,1494,361,958,50,165,179,393,229,558
411600,202309,436,999,212,571,39,98,81,187,120,285
411605,202309,2013,4321,1029,2587,119,371,502,1226,621,1597
411610,202309,3642,7353,2217,4761,73,213,1658,3177,1731,3390
411620,202309,3817,8865,2788,7039,607,1555,1175,2870,1782,4425
411630,202309,1096,2603,597,1599,81,272,278,619,359,891
411640,202309,572,1446,302,801,47,128,100,227,147,355
411650,202309,243,648,133,398,20,59,43,98,63,157
411660,202309,1055,2535,590,1565,106,299,226,496,332,795
411670,202309,1946,4279,1103,2703,133,348,589,1291,722,1639
411680,202309,1751,4225,1074,2872,228,642,404,971,632,1613
411690,202309,5101,11871,3004,7753,633,1642,1088,2542,1721,4184
411695,202309,818,2242,469,1348,38,108,215,570,253,678
411700,202309,2026,4854,1124,2980,266,712,298,664,564,1376
411705,202309,3146,7719,2334,6197,369,1022,1405,3639,1774,4661
411710,202309,2708,6303,1503,3848,316,847,546,1172,862,2019
411720,202309,1271,2968,687,1806,105,270,219,512,324,782
411721,202309,1233,2893,768,1984,160,408,218,522,378,930
411722,202309,1239,3259,583,1691,94,249,199,491,293,740
411725,202309,1588,4199,864,2632,229,777,169,420,398,1197
411727,202309,1812,4633,1031,2969,214,635,131,223,345,858
411729,202309,714,1736,341,968,90,304,87,172,177,476
411730,202309,7170,17163,4579,11895,1178,3327,1621,3847,2799,7174
411740,202309,584,1427,268,756,76,187,49,123,125,310
411745,202309,989,2603,530,1537,73,226,129,297,202,523
411750,202309,8687,20584,5192,13481,749,2053,2453,5853,3202,7906
411760,202309,9692,22684,6180,16382,2082,5630,1281,3393,3363,9023
411770,202309,3974,10553,2431,6922,550,1654,577,1415,1127,3069
411780,202309,3187,8380,2332,6739,652,1936,552,1646,1204,3582
411790,202309,4108,9162,2142,5397,324,891,837,1701,1161,2592
411800,202309,1476,3932,883,2420,174,533,274,629,448,1162
411810,202309,1952,4673,1147,2950,224,567,435,998,659,1565
411820,202309,23045,53850,17619,43741,4152,10242,9105,21616,13257,31858
411830,202309,557,1375,329,893,67,179,69,150,136,329
411840,202309,16638,39879,9332,24449,1575,4363,3750,8388,5325,12751
411845,202309,807,2129,393,1176,76,249,90,209,166,458
411850,202309,10317,24643,5617,15246,1597,4641,877,1715,2474,6356
411860,202309,959,2497,588,1666,163,439,106,270,269,709
411870,202309,746,1947,465,1316,134,428,98,193,232,621
411880,202309,3061,6692,1865,4546,363,901,808,1762,1171,2663
411885,202309,1281,3184,677,1883,105,316,182,429,287,745
411890,202309,1870,4608,1138,3131,238,676,151,379,389,1055
411900,202309,1082,2759,514,1528,181,547,25,75,206,622
411910,202309,1463,3951,914,2749,178,591,329,836,507,1427
411915,202309,21348,48491,12367,30634,1908,5120,5506,11572,7414,16692
411920,202309,1520,3891,1071,2979,276,829,402,969,678,1798
411925,202309,619,1492,379,1018,108,280,144,355,252,635
411930,202309,6566,17538,4827,13964,2476,7347,507,1585,2983,8932
411940,202309,4186,10948,2814,7880,695,1949,975,2364,1670,4313
411950,202309,20685,49548,14773,38061,1922,5536,8608,19978,10530,25514
411960,202309,7496,18056,4907,12716,1108,3105,1927,4288,3035,7393
411965,202309,653,1646,363,1010,59,171,156,358,215,529
411970,202309,1457,2961,888,2022,169,306,394,998,563,1304
411980,202309,2131,4565,1252,3062,337,776,395,941,732,1717
411990,202309,52348,125034,30143,81369,5953,17046,12030,28558,17983,45604
411995,202309,6639,14666,4465,10988,1359,3663,1259,2801,2618,6464
412000,202309,2528,5214,1537,3374,67,193,1158,2261,1225,2454
412010,202309,780,2125,387,1129,42,141,133,305,175,446
412015,202309,628,1632,456,1286,122,351,179,500,301,851
412020,202309,568,1524,295,942,47,164,83,215,130,379
412030,202309,790,2038,545,1548,111,292,232,606,343,898
412033,202309,1134,2763,577,1538,68,182,261,607,329,789
412035,202309,864,2204,446,1343,98,275,161,445,259,720
412040,202309,886,2186,428,1157,68,184,165,375,233,559
412050,202309,1794,4226,1039,2763,297,862,188,465,485,1327
412060,202309,9138,23582,6207,17320,1851,5733,1587,3706,3438,9439
412065,202309,757,1892,416,1159,76,228,119,276,195,504
412070,202309,1724,3970,1112,2739,121,332,571,1144,692,1476
412080,202309,3557,8380,2226,5559,285,751,1200,2540,1485,3291
412085,202309,421,1004,126,384,20,72,33,83,53,155
412090,202309,8288,18840,5190,13217,1180,3295,2200,5303,3380,8598
412100,202309,2399,5845,1480,4150,433,1285,274,778,707,2063
412110,202309,1188,2935,598,1664,87,259,173,393,260,652
412120,202309,2974,7530,1992,5595,451,1371,581,1394,1032,2765
412125,202309,1007,2629,466,1378,81,243,110,280,191,523
412130,202309,977,2283,504,1344,121,331,130,325,251,656
412135,202309,669,1680,283,811,38,130,134,316,172,446
412140,202309,2580,5826,1448,3650,279,727,334,793,613,1520
412150,202309,3446,8086,2459,6156,671,1706,1050,2301,1721,4007
412160,202309,1199,3481,425,1421,33,124,32,66,65,190
412170,202309,5890,14263,4376,11416,929,2552,2076,4811,3005,7363
412175,202309,1609,4280,1138,3262,258,746,345,954,603,1700
412180,202309,2121,5440,1261,3619,266,837,409,994,675,1831
412190,202309,3871,9277,2254,6073,337,1012,937,2240,1274,3252
412200,202309,2440,6384,1450,4110,420,1261,219,534,639,1795
412210,202309,796,1811,415,1100,60,161,180,423,240,584
412215,202309,4144,10122,2602,7123,530,1543,1111,2956,1641,4499
412217,202309,1272,2897,917,2226,25,74,703,1563,728,1637
412220,202309,7701,20600,4877,14298,1149,3322,1060,2879,2209,6201
412230,202309,3562,9356,2133,6130,377,1201,566,1367,943,2568
412240,202309,10452,25434,5444,14869,1043,3104,1741,3783,2784,6887
412250,202309,2360,5764,1407,3832,386,1086,209,456,595,1542
412260,202309,1703,4010,953,2355,192,471,348,750,540,1221
412265,202309,1317,3111,894,2321,116,332,532,1248,648,1580
412270,202309,1420,3621,792,2195,85,254,353,823,438,1077
412280,202309,528,1371,328,939,71,189,75,193,146,382
412290,202309,1338,3087,851,2173,154,410,358,834,512,1244
412300,202309,2383,5483,1441,3685,309,835,497,1102,806,1937
412310,202309,781,2121,447,1382,73,242,134,346,207,588
412320,202309,837,2040,469,1285,66,225,157,366,223,591
412330,202309,2002,4858,1130,3128,257,749,303,749,560,1498
412340,202309,1573,3893,889,2466,135,404,76,194,211,598
412350,202309,3867,9749,1980,5690,326,1034,606,1400,932,2434
412360,202309,376,870,238,607,15,48,157,359,172,407
412370,202309,1528,3704,817,2229,171,498,195,472,366,970
412380,202309,1759,4544,1060,3019,255,786,78,204,333,990
412382,202309,625,1441,362,938,41,130,185,395,226,525
412385,202309,2952,6989,2027,5198,649,1651,622,1620,1271,3271
412390,202309,3093,7043,1841,4703,416,1047,550,1306,966,2353
412395,202309,931,2305,553,1465,66,175,280,676,346,851
412400,202309,1178,2799,709,1868,122,348,259,556,381,904
412402,202309,3114,7108,1727,4498,391,992,589,1487,980,2479
412405,202309,3857,9734,2064,6034,630,1811,358,938,988,2749
412410,202309,8384,20264,5084,14033,1003,3052,1741,4282,2744,7334
412420,202309,650,1539,326,856,43,135,123,278,166,413
412430,202309,636,1540,263,713,50,128,94,243,144,371
412440,202309,3751,8988,2202,5916,502,1364,723,1815,1225,3179
412450,202309,680,1835,351,1020,39,121,45,87,84,208
412460,202309,1468,3338,901,2249,198,529,379,861,577,1390
412470,202309,2012,5661,1521,4560,389,1255,444,1172,833,2427
412480,202309,1809,4126,974,2369,184,482,370,753,554,1235
412490,202309,1617,3688,1027,2549,83,237,593,1281,676,1518
412500,202309,2560,5974,1480,3808,273,742,478,1043,751,1785
412510,202309,2342,6527,1486,4481,367,1207,210,445,577,1652
412520,202309,1733,4141,845,2299,153,413,92,227,245,640
412530,202309,855,2153,464,1304,107,281,107,274,214,555
412535,202309,986,2468,478,1363,91,276,65,126,156,402
412540,202309,1250,3134,766,2188,168,602,137,308,305,910
412545,202309,918,2215,480,1322,84,251,164,419,248,670
412550,202309,49617,119284,29690,76680,4301,12215,14256,31847,18557,44062
412555,202309,360,862,173,440,17,46,65,122,82,168
412560,202309,6973,17785,4254,11643,1212,3656,660,1441,1872,5097
412570,202309,5405,12425,2839,7468,595,1803,755,1630,1350,3433
412575,202309,1445,3238,967,2340,287,680,404,837,691,1517
412580,202309,1991,4557,1127,2830,136,324,627,1415,763,1739
412590,202309,560,1388,251,711,57,156,32,61,89,217
412600,202309,2164,4976,1512,3673,99,309,1006,2159,1105,2468
412610,202309,1028,2581,575,1547,105,270,225,508,330,778
412620,202309,1669,3915,1146,2958,231,626,528,1209,759,1835
412625,202309,13390,32969,7566,20799,1570,4582,1828,4197,3398,8779
412627,202309,1366,3566,770,2276,175,538,188,491,363,1029
412630,202309,3341,9115,1853,5594,347,1144,424,1080,771,2224
412635,202309,618,1489,314,847,96,261,41,81,137,342
412640,202309,1190,3025,568,1617,79,236,120,263,199,499
412650,202309,2127,5333,1354,3653,253,739,503,1174,756,1913
412660,202309,3684,8496,2199,5527,290,806,870,1846,1160,2652
412665,202309,535,1227,343,872,77,198,122,274,199,472
412667,202309,2065,5139,1280,3526,242,737,493,1239,735,1976
412670,202309,1157,2460,662,1573,119,319,301,610,420,929
412680,202309,2728,6637,1426,3898,215,688,452,968,667,1656
412690,202309,1426,3381,812,2114,167,470,283,597,450,1067
412700,202309,2187,5369,1536,4034,359,1015,676,1625,1035,2640
412710,202309,6760,17866,4074,11694,780,2406,1161,2619,1941,5025
412720,202309,1687,4514,1124,3170,195,571,301,646,496,1217
412730,202309,3452,8201,2124,5432,327,966,1103,2449,1430,3415
412740,202309,2587,6687,1415,4162,263,877,271,734,534,1611
412750,202309,4954,12146,3394,9132,517,1537,1766,4271,2283,5808
412760,202309,4032,9698,2856,7458,576,1651,1423,3340,1999,4991
412770,202309,16078,39151,7362,21069,1044,3214,1966,4535,3010,7749
412780,202309,1572,3790,974,2614,256,783,276,580,532,1363
412785,202309,2788,5979,1719,4157,307,851,980,2133,1287,2984
412788,202309,1742,4501,1223,3475,352,997,428,1092,780,2089
412790,202309,1738,4193,925,2514,160,471,365,783,525,1254
412795,202309,1482,3552,690,1941,140,347,165,433,305,780
412796,202309,2764,7354,1919,5520,487,1388,526,1367,1013,2755
412800,202309,5384,11560,3247,7500,321,939,1883,3696,2204,4635
412810,202309,17582,41085,9645,24674,1156,3295,4615,10053,5771,13348
412820,202309,7955,20236,4727,13350,1284,3720,1087,2859,2371,6579
412830,202309,465,1187,263,720,48,136,95,215,143,351
412840,202309,2536,5300,1636,3594,142,377,1091,2085,1233,2462
412850,202309,3459,8248,2336,6204,275,854,1278,3008,1553,3862
412853,202309,2043,4506,1469,3354,191,504,854,1708,1045,2212
412855,202309,1679,4072,711,1954,107,316,174,379,281,695
412860,202309,984,2294,553,1485,112,348,217,493,329,841
412862,202309,804,1952,474,1320,85,248,217,534,302,782
412863,202309,1648,4343,1291,3596,280,875,626,1503,906,2378
412865,202309,796,2067,517,1465,129,389,102,258,231,647
412870,202309,1240,2979,751,2088,249,738,173,439,422,1177
412880,202309,1218,3093,741,2148,156,451,249,661,405,1112
420005,202309,587,1598,288,872,35,107,128,365,163,472
420010,202309,3777,8654,2232,5867,174,516,1514,3791,1688,4307
420020,202309,526,1541,347,1087,63,212,98,245,161,457
420030,202309,178,585,112,404,33,121,26,78,59,199
420040,202309,728,2094,338,1132,54,198,30,74,84,272
420050,202309,999,2363,551,1398,100,268,290,631,390,899
420055,202309,249,684,108,328,18,56,44,116,62,172
420060,202309,312,818,221,603,30,92,111,271,141,363
420070,202309,1137,3078,799,2360,153,497,416,1111,569,1608
420075,202309,96,251,51,147,8,26,16,28,24,54
420080,202309,533,1456,302,866,67,199,75,179,142,378
420090,202309,584,1671,321,1037,75,261,73,179,148,440
420100,202309,1875,4247,1307,3213,158,379,762,1786,920,2165
420110,202309,384,1128,280,878,47,146,124,361,171,507
420120,202309,843,2199,459,1327,74,234,182,424,256,658
420125,202309,495,1421,293,940,61,187,86,225,147,412
420127,202309,398,1025,138,424,12,40,53,135,65,175
420130,202309,6897,17818,4474,12797,890,2823,1744,4091,2634,6914
420140,202309,6475,15967,4226,11556,1117,3367,1127,2573,2244,5940
420150,202309,881,2182,528,1459,62,201,269,668,331,869
420160,202309,261,633,89,257,12,39,30,87,42,126
420165,202309,223,656,99,328,12,49,26,67,38,116
420170,202309,457,1249,329,973,36,130,191,496,227,626
420180,202309,179,548,82,291,12,52,21,67,33,119
420190,202309,266,735,132,403,25,76,36,87,61,163
420195,202309,2786,6725,1881,5007,294,898,1032,2438,1326,3336
420200,202309,11311,24941,6144,14956,841,2273,2733,5446,3574,7719
420205,202309,2862,6970,1667,4550,255,751,812,1978,1067,2729
420207,202309,3096,7326,1821,4893,383,1129,717,1669,1100,2798
420208,202309,458,1239,219,692,77,256,50,114,127,370
420209,202309,230,673,114,355,20,75,58,155,78,230
420210,202309,6321,15102,3966,10575,650,1897,1972,4679,2622,6576
420213,202309,993,2733,697,2060,130,413,262,695,392,1108
420215,202309,313,850,182,541,48,155,47,125,95,280
420220,202309,456,1282,250,799,48,184,94,233,142,417
420230,202309,8646,20882,5673,14802,840,2389,3031,6950,3871,9339
420240,202309,21805,56415,11966,33008,1711,5219,5228,11646,6939,16865
420243,202309,673,1556,487,1213,108,271,274,665,382,936
420245,202309,2897,6767,1971,5009,190,532,1197,2726,1387,3258
420250,202309,914,1980,690,1599,59,175,486,1010,545,1185
420253,202309,571,1343,341,916,51,126,197,501,248,627
420257,202309,216,527,126,361,17,63,63,162,80,225
420260,202309,1610,3770,1053,2867,83,263,696,1769,779,2032
420270,202309,799,2020,309,830,43,115,143,347,186,462
420280,202309,2190,5736,1448,4046,226,735,646,1556,872,2291
420285,202309,151,412,90,282,14,51,16,28,30,79
420287,202309,588,1295,333,858,57,171,147,337,204,508
420290,202309,7633,19839,4906,13528,778,2411,2510,5913,3288,8324
420300,202309,10848,28520,5149,14845,1056,3121,1684,4091,2740,7212
420310,202309,948,2108,475,1232,48,132,191,437,239,569
420315,202309,1213,3127,650,1942,94,291,318,853,412,1144
420320,202309,8878,22306,5807,16553,1587,4650,1582,4136,3169,8786
420325,202309,419,1141,248,746,38,131,82,192,120,323
420330,202309,1471,4035,768,2345,177,545,197,520,374,1065
420340,202309,1793,4105,1154,2878,268,709,518,1116,786,1825
420350,202309,1822,3971,1247,2941,187,437,810,1801,997,2238
420360,202309,3870,10155,1708,5202,276,924,158,420,434,1344
420370,202309,1955,4559,1474,3694,102,331,1098,2537,1200,2868
420380,202309,5970,14651,3632,9847,681,2006,1626,3858,2307,5864
420390,202309,1501,3659,864,2274,149,428,290,538,439,966
420395,202309,1796,4674,1041,3018,167,507,224,505,391,1012
420400,202309,1605,3972,937,2569,124,379,524,1280,648,1659
420410,202309,752,1863,435,1189,73,219,212,536,285,755
420415,202309,458,1210,281,790,49,162,127,322,176,484
420417,202309,815,2261,519,1569,117,335,213,645,330,980
420419,202309,154,492,94,326,26,98,6,25,32,123
420420,202309,20984,51555,12197,33573,3179,9472,3461,7982,6640,17454
420425,202309,836,2190,493,1407,64,207,224,550,288,757
420430,202309,4569,11459,2448,6824,385,1210,1020,2343,1405,3553
420435,202309,461,1157,228,684,55,165,111,321,166,486
420440,202309,1099,2757,615,1688,219,556,162,439,381,995
420445,202309,292,700,162,439,36,104,40,75,76,179
420450,202309,1168,3155,706,2058,146,444,287,700,433,1144
420455,202309,2771,6178,1758,4410,538,1324,573,1440,1111,2764
420460,202309,13969,33945,9175,24271,1441,4257,4689,10725,6130,14982
420470,202309,924,2322,431,1174,68,198,147,302,215,500
420475,202309,92,236,34,106,6,23,9,20,15,43
420480,202309,7472,17534,4158,11188,848,2361,1636,4073,2484,6434
420490,202309,522,1406,299,870,53,162,132,342,185,504
420500,202309,1798,4651,1054,3160,209,731,456,1198,665,1929
420510,202309,160,464,90,273,16,55,30,64,46,119
420515,202309,185,531,102,311,14,55,37,83,51,138
420517,202309,948,2215,674,1645,104,270,388,887,492,1157
420519,202309,381,966,223,647,26,83,109,303,135,386
420520,202309,355,930,155,508,18,72,3,7,21,79
420530,202309,973,2835,498,1589,107,379,158,393,265,772
420535,202309,282,792,84,278,12,40,23,61,35,101
420540,202309,57591,128159,34007,83225,4646,12811,14842,29704,19488,42515
420543,202309,329,912,192,579,34,112,76,203,110,315
420545,202309,2206,6144,1418,4204,261,812,599,1504,860,2316
420550,202309,5793,13919,3017,8308,527,1515,1245,3005,1772,4520
420555,202309,435,1171,252,758,33,112,131,352,164,464
420560,202309,559,1211,335,836,44,96,168,416,212,512
420570,202309,4405,10390,2906,7473,537,1442,1419,3329,1956,4771
420580,202309,2339,6273,1332,4168,293,953,351,947,644,1900
420590,202309,4473,11403,2533,7035,463,1393,748,1621,1211,3014
420600,202309,1936,4833,1334,3563,114,388,892,2180,1006,2568
420610,202309,808,2073,455,1307,82,222,224,592,306,814
420620,202309,1110,2734,615,1749,108,323,229,581,337,904
420630,202309,1477,4183,960,2895,186,602,365,966,551,1568
420640,202309,629,1650,250,796,46,155,24,59,70,214
420650,202309,4895,11894,2823,7404,469,1372,1228,2690,1697,4062
420660,202309,591,1428,275,742,52,147,47,84,99,231
420665,202309,943,2303,494,1357,98,282,174,367,272,649
420670,202309,1588,4370,776,2459,96,364,160,383,256,747
420675,202309,284,716,162,494,16,60,97,262,113,322
420680,202309,353,805,167,484,26,95,84,206,110,301
420690,202309,1265,3418,693,2019,113,346,245,559,358,905
420700,202309,4468,10963,3026,8086,278,856,1977,4889,2255,5745
420710,202309,1468,4008,1121,3209,158,507,582,1389,740,1896
420720,202309,1791,4432,1214,3271,192,587,709,1715,901,2302
420730,202309,5123,12402,3510,9265,669,1955,1590,3655,2259,5610
420740,202309,551,1503,284,860,60,191,99,274,159,465
420750,202309,3060,8338,1733,5107,309,1012,565,1348,874,2360
420757,202309,161,411,73,232,8,25,29,85,37,110
420760,202309,478,1320,186,555,43,125,61,159,104,284
420765,202309,817,2136,342,1000,57,193,159,415,216,608
420768,202309,1845,4607,1320,3552,174,439,821,2125,995,2564
420770,202309,278,807,105,373,13,53,14,30,27,83
420775,202309,393,996,202,610,37,103,69,189,106,292
420780,202309,1310,3462,623,1811,131,381,115,298,246,679
420785,202309,295,731,164,432,8,28,81,166,89,194
420790,202309,1460,3884,1032,2930,248,873,537,1250,785,2123
420800,202309,1018,2349,529,1414,124,335,251,619,375,954
420810,202309,1818,5043,1350,4010,330,1054,490,1214,820,2268
420820,202309,19711,46998,12481,33186,1760,5091,6257,14538,8017,19629
420830,202309,7089,17112,4363,11796,910,2723,1693,4059,2603,6782
420840,202309,796,2406,346,1218,58,232,43,130,101,362
420845,202309,4184,10061,2567,7041,510,1606,1076,2663,1586,4269
420850,202309,1344,3837,874,2658,168,548,283,683,451,1231
420860,202309,471,1211,254,776,86,270,58,135,144,405
420870,202309,1033,2743,608,1800,122,396,209,535,331,931
420880,202309,1618,4479,1110,3347,260,870,426,1066,686,1936
420890,202309,10626,27357,5755,16588,1011,3118,2030,4813,3041,7931
420895,202309,254,705,128,389,18,54,62,169,80,223
420900,202309,2294,5384,1098,3065,142,463,455,1020,597,1483
420910,202309,48252,119322,28764,78982,4914,14692,12479,28909,17393,43601
420915,202309,590,2054,456,1710,72,277,210,750,282,1027
420917,202309,613,1497,231,595,42,88,110,266,152,354
420920,202309,119,308,33,102,5,18,6,13,11,31
420930,202309,25269,58320,15984,40549,2270,6376,8582,19211,10852,25587
420940,202309,5174,11877,2986,7768,656,1974,991,1942,1647,3916
420945,202309,270,806,113,358,15,54,38,104,53,158
420950,202309,556,1471,306,906,57,187,95,237,152,424
420960,202309,1421,3329,825,2130,137,395,348,757,485,1152
420970,202309,2921,7396,1728,5019,375,1085,478,1362,853,2447
420980,202309,315,1034,229,817,64,246,29,87,93,333
420985,202309,488,1265,204,638,38,113,50,130,88,243
420990,202309,487,1413,263,848,50,169,45,109,95,278
421000,202309,760,2219,439,1406,114,361,66,144,180,505
421003,202309,541,1300,121,344,15,41,12,25,27,66
421005,202309,137,388,81,250,13,43,25,70,38,113
421010,202309,5260,12830,3316,8958,530,1665,1414,3054,1944,4719
421020,202309,524,1540,348,1107,58,216,181,493,239,709
421030,202309,1372,3614,925,2647,195,590,332,847,527,1437
421040,202309,880,2094,438,1249,47,143,242,625,289,768
421050,202309,1625,4247,856,2398,182,525,247,545,429,1070
421055,202309,182,517,96,293,16,54,43,115,59,169
421060,202309,966,2613,607,1784,106,346,257,629,363,975
421070,202309,875,2383,453,1352,90,274,194,508,284,782
421080,202309,660,1774,434,1274,73,256,177,433,250,689
421085,202309,395,1090,121,407,13,40,18,48,31,88
421090,202309,380,964,177,470,22,77,82,179,104,256
421100,202309,1118,2366,432,1173,50,141,87,178,137,319
421105,202309,2027,5069,1147,3231,262,720,350,884,612,1604
421110,202309,1715,4044,1202,3101,136,425,762,1802,898,2227
421120,202309,1488,4171,887,2734,133,452,294,739,427,1191
421125,202309,523,1270,327,841,63,173,129,286,192,459
421130,202309,9248,24029,6773,18727,1282,3821,3199,7877,4481,11698
421140,202309,446,1166,249,728,53,142,96,256,149,398
421145,202309,446,1187,285,816,101,294,52,127,153,421
421150,202309,1062,2773,627,1771,124,390,254,545,378,935
421160,202309,894,2288,591,1605,69,229,335,764,404,993
421165,202309,303,848,142,421,26,75,42,89,68,164
421170,202309,1602,3958,1131,3007,107,306,713,1760,820,2066
421175,202309,1467,3607,752,2199,182,568,285,757,467,1325
421180,202309,521,1250,250,675,31,98,124,261,155,359
421185,202309,403,983,251,663,39,117,110,233,149,350
421187,202309,311,929,130,420,26,77,54,166,80,243
421189,202309,553,1433,330,966,58,186,113,295,171,481
421190,202309,21028,52059,13840,36916,2453,7136,6364,14782,8817,21918
421200,202309,1099,2728,696,1877,86,270,388,947,474,1217
421205,202309,325,833,204,582,43,117,80,227,123,344
421210,202309,1408,3392,673,1960,212,595,147,389,359,984
421220,202309,1801,4844,1234,3609,298,896,368,940,666,1836
421223,202309,554,1318,317,843,55,171,149,348,204,519
421225,202309,1490,3887,1129,3191,113,384,723,1895,836,2279
421227,202309,915,2428,477,1437,100,312,187,537,287,849
421230,202309,876,2222,559,1579,104,325,247,637,351,962
421240,202309,359,1019,143,484,23,99,33,80,56,179
421250,202309,3613,8668,2338,6288,397,1103,1299,3239,1696,4342
421260,202309,341,1055,68,198,14,40,10,26,24,66
421265,202309,1328,2953,958,2331,115,265,603,1380,718,1645
421270,202309,460,1219,224,732,55,191,75,227,130,418
421280,202309,3783,9122,2514,6729,402,1283,1301,3031,1703,4314
421290,202309,1456,3792,569,1631,93,283,92,218,185,501
421300,202309,428,1116,132,408,16,49,25,59,41,108
421310,202309,311,835,197,576,66,198,52,132,118,330
421315,202309,433,1124,220,645,43,133,67,169,110,302
421320,202309,819,2477,337,1065,29,85,53,84,82,169
421330,202309,802,2221,444,1378,88,279,110,287,198,566
421335,202309,543,1538,372,1170,52,178,164,467,216,645
421340,202309,1848,4894,1006,3151,177,564,402,1109,579,1673
421350,202309,2347,5559,1303,3569,277,752,417,1021,694,1773
421360,202309,2758,7019,1485,4344,394,1312,380,748,774,2060
421370,202309,970,2984,536,1809,94,330,117,335,211,665
421380,202309,1127,2608,828,2069,85,285,529,1179,614,1464
421390,202309,199,511,68,216,16,49,18,52,34,101
421400,202309,874,2217,469,1348,90,283,182,436,272,719
421410,202309,246,631,117,356,29,77,18,55,47,132
421415,202309,259,693,159,441,32,91,52,133,84,224
421420,202309,797,2056,458,1281,83,240,212,504,295,744
421430,202309,165,449,78,234,14,40,11,25,25,65
421440,202309,980,2494,494,1463,112,342,179,483,291,825
421450,202309,509,1540,297,999,45,172,18,72,63,244
421460,202309,377,1151,175,637,7,19,9,18,16,37
421470,202309,498,1357,271,841,52,155,70,214,122,369
421480,202309,4533,11443,2809,7656,403,1287,1287,2968,1690,4255
421490,202309,162,491,84,265,11,51,30,77,41,128
421500,202309,3398,9011,2047,5988,414,1300,771,1819,1185,3119
421505,202309,423,1051,307,854,29,83,149,385,178,468
421507,202309,557,1384,278,748,49,124,88,195,137,319
421510,202309,641,1689,355,1033,48,166,181,414,229,580
421520,202309,591,1527,289,795,52,140,92,203,144,343
421530,202309,433,1252,210,721,36,141,42,97,78,238
421535,202309,573,1430,301,835,48,139,156,366,204,505
421540,202309,478,1086,223,611,33,85,74,194,107,279
421545,202309,901,2504,582,1776,115,370,221,564,336,934
421550,202309,2934,7374,1887,5251,355,1066,823,2046,1178,3112
421555,202309,284,787,61,198,11,43,8,17,19,60
421560,202309,130,406,76,255,12,42,20,50,32,92
421565,202309,1377,3391,853,2382,229,700,366,908,595,1608
421567,202309,588,1689,398,1186,103,313,111,322,214,635
421568,202309,399,1102,163,512,33,123,47,111,80,234
421569,202309,190,518,72,208,13,39,35,83,48,122
421570,202309,2215,5834,1363,3849,228,722,578,1341,806,2063
421575,202309,422,1225,226,673,26,75,69,177,95,252
421580,202309,7031,17773,3634,10076,570,1721,1498,3377,2068,5098
421590,202309,274,696,189,520,43,126,78,187,121,313
421600,202309,807,1988,426,1132,52,146,204,443,256,589
421605,202309,895,2220,550,1551,126,355,200,516,326,871
421610,202309,1306,3242,728,2032,154,459,275,710,429,1169
421620,202309,5231,12852,3395,9325,724,2242,1379,3248,2103,5490
421625,202309,163,449,82,234,10,28,25,52,35,80
421630,202309,3932,9838,2065,5804,348,1060,579,1296,927,2356
421635,202309,592,1491,356,976,32,101,210,497,242,598
421640,202309,988,2377,688,1878,180,504,326,823,506,1327
421650,202309,3732,9243,2232,6304,433,1335,745,1853,1178,3188
421660,202309,18033,45412,11824,32468,1717,5269,6038,14467,7755,19736
421670,202309,1197,3161,683,1895,152,458,270,639,422,1097
421680,202309,2327,4968,1700,3861,155,400,1183,2479,1338,2879
421690,202309,1955,5472,1129,3532,236,779,237,614,473,1393
421700,202309,806,2313,406,1288,59,194,93,222,152,416
421710,202309,271,814,122,393,19,71,50,139,69,210
421715,202309,222,526,143,341,24,71,81,151,105,222
421720,202309,2783,7242,1421,4119,328,996,435,1001,763,1997
421725,202309,372,887,170,459,20,58,80,173,100,231
421730,202309,751,2096,354,1007,50,148,160,384,210,532
421740,202309,1130,2986,598,1748,136,394,196,471,332,865
421750,202309,1297,3009,630,1713,151,454,213,484,364,938
421755,202309,208,551,82,239,17,54,28,65,45,119
421760,202309,1490,3573,755,2064,127,379,284,642,411,1021
421770,202309,3284,8024,1984,5493,350,1026,737,1749,1087,2775
421775,202309,261,686,119,358,15,45,33,71,48,116
421780,202309,1274,3302,782,2214,137,410,333,795,470,1205
421790,202309,1204,3074,483,1447,92,265,152,386,244,651
421795,202309,324,939,150,466,19,71,50,138,69,209
421800,202309,4073,10594,2549,7417,480,1460,915,2330,1395,3790
421810,202309,738,1951,395,1181,52,188,176,480,228,668
421820,202309,1531,4153,789,2280,138,438,270,633,408,1071
421825,202309,2129,4704,1573,3774,124,325,1084,2463,1208,2788
421830,202309,2581,7069,1650,5009,356,1143,389,1120,745,2263
421835,202309,330,765,207,515,29,86,132,305,161,391
421840,202309,514,1536,337,1064,61,217,104,270,165,487
421850,202309,518,1482,247,856,53,193,34,89,87,282
421860,202309,290,740,128,391,20,67,41,94,61,161
421870,202309,7861,18267,5016,12354,729,2124,2752,5636,3481,7760
421875,202309,392,1136,129,410,19,51,20,53,39,104
421880,202309,939,2484,499,1454,102,269,133,344,235,613
421885,202309,381,1043,166,519,24,88,42,107,66,195
421890,202309,1431,3583,963,2670,122,400,580,1412,702,1812
421895,202309,553,1333,393,1048,48,133,250,662,298,795
421900,202309,1491,3699,829,2154,141,403,367,781,508,1184
421910,202309,450,1301,184,637,35,116,24,65,59,181
421915,202309,472,1267,228,690,61,184,49,112,110,296
421917,202309,812,1770,374,1012,92,252,81,202,173,454
421920,202309,550,1551,329,1023,92,270,84,246,176,516
421930,202309,4498,10687,2183,5993,413,1206,673,1500,1086,2706
421935,202309,512,1466,364,1148,77,248,135,399,212,647
421940,202309,438,1227,164,488,31,98,59,153,90,251
421950,202309,4178,10408,2158,6164,405,1218,615,1451,1020,2669
421960,202309,189,466,90,262,13,33,35,101,48,134
421970,202309,2825,7026,1405,3858,273,796,547,1257,820,2053
421985,202309,414,1099,237,679,26,84,115,307,141,391
422000,202309,2674,6313,1756,4674,145,452,1137,2840,1282,3292
430003,202309,888,2120,523,1447,68,194,275,727,343,921
430005,202309,506,1177,343,874,18,59,231,524,249,583
430010,202309,2345,4945,1542,3623,332,746,706,1614,1038,2360
430020,202309,697,1501,459,1106,61,159,256,542,317,701
430030,202309,1310,2826,687,1615,107,275,412,843,519,1118
430040,202309,12536,27277,6976,17522,2008,5231,1977,4430,3985,9661
430045,202309,690,1500,430,1054,29,74,295,661,324,735
430047,202309,297,659,88,223,18,40,30,71,48,111
430050,202309,1076,2535,514,1388,124,297,142,361,266,658
430055,202309,309,698,126,323,18,43,58,130,76,173
430057,202309,118,262,46,120,11,22,14,32,25,54
430060,202309,29678,69256,21109,54062,3728,10040,11220,26593,14948,36633
430063,202309,831,2160,650,1803,144,402,349,926,493,1328
430064,202309,1430,3527,935,2577,227,666,408,1042,635,1708
430066,202309,125,307,80,224,8,21,41,100,49,121
430070,202309,671,1690,141,412,25,81,23,54,48,135
430080,202309,1189,2879,536,1462,101,316,215,463,316,779
430085,202309,1138,2270,614,1439,111,259,256,594,367,853
430087,202309,1175,2771,699,1872,83,240,359,894,442,1134
430090,202309,562,1406,198,610,54,176,37,103,91,279
430100,202309,1549,3462,655,1621,80,215,313,679,393,894
430105,202309,2029,4615,1281,3300,181,536,706,1635,887,2171
430107,202309,220,595,97,281,14,44,30,73,44,117
430110,202309,2755,6265,1822,4595,364,963,924,2166,1288,3129
430120,202309,1491,3857,930,2496,157,414,422,1062,579,1476
430130,202309,4409,9023,2886,6703,1093,2487,583,1555,1676,4042
430140,202309,1310,3089,817,2132,141,390,389,948,530,1338
430150,202309,721,1783,349,1040,76,234,85,227,161,461
430155,202309,265,618,90,241,14,38,24,41,38,79
430160,202309,28469,57306,19947,43979,1554,3912,14304,29397,15858,33309
430163,202309,4527,8907,2857,6403,72,253,2272,4697,2344,4950
430165,202309,420,1050,111,333,17,40,11,28,28,68
430170,202309,1163,2845,314,988,90,337,53,108,143,445
430175,202309,1056,2398,832,1963,116,273,516,1184,632,1457
430180,202309,834,1953,496,1293,116,272,190,497,306,769
430185,202309,795,1925,309,895,79,219,56,140,135,359
430187,202309,1103,2150,703,1605,76,171,470,1024,546,1195
430190,202309,1881,4269,1254,3175,274,697,551,1280,825,1977
430192,202309,137,342,41,114,9,25,13,31,22,56
430195,202309,533,1448,68,202,7,17,14,29,21,46
430200,202309,1393,3600,970,2745,269,813,145,390,414,1203
430205,202309,722,1380,591,1174,21,57,510,971,531,1028
430210,202309,9543,22881,4533,11814,640,1788,1373,2822,2013,4610
430215,202309,469,1050,244,617,27,85,114,244,141,329
430220,202309,712,1696,245,720,50,151,80,190,130,341
430222,202309,317,794,169,476,37,104,58,144,95,248
430223,202309,362,864,241,635,27,70,142,337,169,407
430225,202309,46,101,32,76,4,8,19,40,23,48
430230,202309,2825,6449,2023,5071,147,428,1454,3381,1601,3809
430235,202309,590,1477,304,855,52,163,72,158,124,321
430237,202309,685,1378,418,936,24,69,293,592,317,661
430240,202309,1737,3851,722,1871,109,294,299,645,408,939
430245,202309,910,2202,681,1782,140,347,354,950,494,1297
430250,202309,1355,3030,816,2061,251,666,228,516,479,1182
430258,202309,159,395,88,241,15,38,44,114,59,152
430260,202309,894,2057,508,1316,69,198,278,679,347,877
430265,202309,298,811,186,594,32,104,69,205,101,309
430270,202309,4273,8832,2975,6662,554,1202,1804,3852,2358,5054
430280,202309,6530,13447,4085,9202,699,1662,2166,4525,2865,6187
430290,202309,2806,5637,2052,4581,193,436,1515,3219,1708,3655
430300,202309,14049,30278,9379,21791,1466,3480,5496,11823,6962,15303
430310,202309,18987,42784,11648,28547,1499,3873,6877,15418,8376,19291
430320,202309,1115,2674,556,1559,50,152,308,806,358,958
430330,202309,797,1822,385,993,94,238,129,289,223,527
430340,202309,885,1782,529,1200,65,141,365,784,430,925
430350,202309,11308,24962,7590,18227,1154,2917,4436,9895,5590,12812
430355,202309,435,1145,117,349,32,93,9,20,41,113
430360,202309,1127,2582,576,1560,154,452,153,350,307,802
430367,202309,447,909,249,576,41,104,155,320,196,424
430370,202309,581,1519,179,529,47,128,49,118,96,246
430380,202309,772,1806,314,898,58,171,103,259,161,430
430390,202309,4571,10445,2417,6185,478,1286,293,518,771,1804
430400,202309,1293,2511,810,1765,108,288,493,959,601,1247
430410,202309,723,1517,488,1132,42,114,343,735,385,849
430420,202309,3750,8565,2587,6261,393,1134,1471,3027,1864,4161
430430,202309,596,1415,207,595,38,106,31,83,69,189
430435,202309,2451,5438,1514,3735,260,653,737,1739,997,2392
430440,202309,6459,14678,4340,10558,458,1210,2736,6027,3194,7237
430450,202309,10342,21526,7582,16731,1247,3159,4437,8809,5684,11968
430460,202309,54467,120181,33874,83520,5392,14046,17889,40940,23281,54986
430461,202309,231,584,76,225,14,47,35,89,49,136
430462,202309,393,955,181,518,43,136,60,150,103,286
430463,202309,9852,23335,6523,16928,1208,3488,3220,7586,4428,11074
430465,202309,710,1581,422,1034,66,187,240,544,306,731
430466,202309,6425,14170,4507,10909,697,1799,2688,5876,3385,7675
430467,202309,640,1444,391,976,42,118,231,539,273,657
430468,202309,1975,4247,1352,3202,69,206,974,2118,1043,2324
430469,202309,728,1921,108,310,11,30,37,82,48,112
430470,202309,7468,17646,4199,11366,1097,3278,971,2091,2068,5369
430471,202309,1065,2447,821,1986,84,224,562,1241,646,1465
430480,202309,814,2088,426,1193,70,230,140,283,210,513
430485,202309,210,512,86,228,21,52,25,52,46,104
430490,202309,635,1488,263,720,42,136,110,230,152,366
430495,202309,495,1258,276,820,51,155,128,347,179,502
430500,202309,1193,2797,725,1941,228,653,218,502,446,1155
430510,202309,36176,86948,22364,57715,4502,12566,9310,20510,13812,33076
430511,202309,392,1026,122,366,26,75,22,45,48,120
430512,202309,1304,2671,915,2063,226,533,353,743,579,1276
430513,202309,971,2127,445,1074,60,155,257,535,317,690
430515,202309,486,1180,281,759,48,133,139,362,187,495
430517,202309,1786,4424,1229,3240,276,680,629,1634,905,2314
430520,202309,1618,3831,793,2063,146,392,207,480,353,872
430530,202309,1115,2606,395,1109,77,236,129,321,206,557
430535,202309,4631,10594,2787,7046,406,1064,1394,3250,1800,4314
430537,202309,686,1492,546,1235,75,159,379,817,454,976
430540,202309,712,1628,361,993,77,197,149,415,226,612
430543,202309,1368,2339,729,1544,206,440,157,354,363,794
430544,202309,831,2188,485,1420,118,372,135,363,253,735
430545,202309,3140,7240,2108,5540,425,1138,1043,2558,1468,3696
430550,202309,492,1221,274,749,84,211,78,204,162,415
430558,202309,191,418,66,161,1,1,42,96,43,97
430560,202309,354,803,142,414,17,65,46,107,63,172
430570,202309,1029,2310,567,1358,159,421,234,448,393,869
430580,202309,961,2296,674,1800,171,429,219,634,390,1063
430583,202309,214,517,37,100,8,33,11,16,19,49
430585,202309,256,608,109,289,23,70,38,81,61,151
430587,202309,250,638,133,378,22,70,57,145,79,215
430590,202309,1667,3737,1082,2709,124,322,639,1510,763,1832
430593,202309,38,100,23,61,2,7,13,27,15,34
430595,202309,516,1271,95,286,13,25,18,43,31,68
430597,202309,570,1343,190,501,19,48,68,140,87,188
430600,202309,2325,5778,847,2388,158,460,143,373,301,833
430605,202309,1731,4004,1069,2769,155,417,536,1286,691,1703
430607,202309,860,1799,474,1097,66,131,285,634,351,765
430610,202309,7569,16441,4869,12104,1463,3873,1809,3984,3272,7857
430613,202309,306,685,65,174,15,43,17,38,32,81
430620,202309,1051,2288,655,1542,111,291,318,598,429,889
430630,202309,490,1296,157,448,29,85,40,95,69,180
430632,202309,511,1261,157,450,23,66,59,147,82,213
430635,202309,699,1446,435,965,71,137,278,609,349,746
430637,202309,655,1435,419,1031,51,139,262,584,313,723
430640,202309,1369,3549,667,1958,90,265,213,505,303,770
430642,202309,468,1215,218,623,35,98,87,223,122,321
430645,202309,195,447,82,221,17,41,21,45,38,86
430650,202309,2258,5525,1571,4360,472,1244,582,1734,1054,2978
430655,202309,403,919,192,481,23,65,113,238,136,303
430660,202309,6753,15167,4436,11060,743,2041,2326,5317,3069,7358
430670,202309,717,1611,405,1015,78,195,187,438,265,633
430673,202309,599,1286,234,624,56,141,78,179,134,320
430675,202309,285,803,55,186,11,38,12,40,23,78
430676,202309,7746,17299,5496,13476,915,2377,3198,7420,4113,9797
430680,202309,1582,3774,822,2227,237,701,262,500,499,1201
430690,202309,4309,9783,3069,7499,1022,2611,1134,2593,2156,5204
430692,202309,239,644,172,528,10,34,116,342,126,376
430693,202309,1129,2817,567,1653,138,426,134,349,272,775
430695,202309,522,1214,277,685,52,143,157,336,209,479
430697,202309,671,1500,441,1114,55,151,289,693,344,844
430700,202309,10620,24271,5552,14293,1260,3461,1491,3120,2751,6581
430705,202309,425,968,174,493,27,83,65,151,92,234
430710,202309,2614,4425,1592,3087,64,188,1315,2371,1379,2559
430720,202309,970,2179,444,1221,64,186,217,538,281,724
430730,202309,1146,2895,647,1846,130,369,240,636,370,1005
430740,202309,854,2147,372,1065,58,166,131,333,189,499
430745,202309,633,1384,413,957,58,180,271,526,329,706
430750,202309,2164,4882,1298,3255,272,714,668,1521,940,2235
430755,202309,577,1307,334,810,34,105,206,433,240,538
430760,202309,3385,7617,2218,5474,477,1203,1036,2315,1513,3518
430770,202309,10085,22084,7068,16836,925,2331,4341,9584,5266,11915
430780,202309,3007,6841,1705,4435,201,583,958,2219,1159,2802
430781,202309,850,1985,489,1203,161,411,185,399,346,810
430783,202309,439,943,255,636,65,162,116,265,181,427
430786,202309,45,135,23,85,4,13,3,5,7,18
430790,202309,6297,14068,3823,9333,426,1192,2285,4837,2711,6029
430800,202309,1101,2115,730,1551,48,125,565,1117,613,1242
430805,202309,481,1049,307,703,14,34,236,497,250,531
430807,202309,756,1733,372,989,61,165,144,308,205,473
430810,202309,886,2041,373,996,66,195,135,298,201,493
430820,202309,1785,4603,818,2366,140,408,254,622,394,1030
430825,202309,322,735,111,255,15,37,49,97,64,134
430830,202309,2610,5725,1871,4324,116,282,1402,3018,1518,3300
430840,202309,1593,3342,935,2233,173,402,560,1298,733,1700
430843,202309,241,568,90,255,6,13,27,66,33,79
430845,202309,638,1343,359,856,61,157,188,388,249,545
430850,202309,3061,7382,1778,4864,547,1611,392,920,939,2531
430860,202309,1541,3584,688,1837,96,308,291,610,387,918
430865,202309,777,1746,416,1074,124,334,164,378,288,712
430870,202309,626,1593,222,653,47,146,43,108,90,254
430880,202309,1889,3861,1196,2706,155,386,744,1537,899,1923
430885,202309,223,553,119,329,18,56,57,146,75,202
430890,202309,1401,3279,713,1951,192,608,71,122,263,730
430900,202309,4424,8114,2529,5291,123,356,1864,3488,1987,3844
430905,202309,1166,2723,665,1724,124,340,257,614,381,954
430910,202309,2983,7414,1730,4552,259,762,774,1696,1033,2458
430912,202309,671,1739,368,1070,69,191,174,508,243,699
430915,202309,646,1682,366,1078,104,312,81,231,185,543
430920,202309,37075,82729,25659,62009,3291,8384,15887,35867,19178,44251
430925,202309,114,241,52,132,7,20,26,57,33,77
430930,202309,16181,33810,10239,23818,1129,2962,6697,14109,7826,17071
430940,202309,1673,3895,1010,2617,197,505,403,925,600,1430
430950,202309,1027,2083,597,1338,76,201,388,758,464,959
430955,202309,551,1383,133,361,21,57,40,75,61,132
430957,202309,254,710,212,614,45,116,106,313,151,429
430960,202309,1747,3889,827,2133,219,583,236,532,455,1115
430965,202309,1968,4120,1378,3195,61,153,1043,2366,1104,2519
430970,202309,493,1141,233,629,27,71,95,240,122,311
430975,202309,609,1561,430,1181,88,271,145,345,233,616
430980,202309,564,1235,286,730,42,108,127,296,169,404
430990,202309,725,1797,481,1284,83,237,213,524,296,761
430995,202309,681,1518,390,983,78,194,197,454,275,648
431000,202309,1821,4045,622,1672,87,246,88,178,175,424
431010,202309,3618,8595,2179,5781,395,1209,945,2094,1340,3303
431020,202309,11754,24077,6000,14437,1060,2767,2755,5739,3815,8506
431030,202309,401,1061,179,574,44,168,22,69,66,237
431033,202309,5473,11959,3202,8003,767,1856,1218,2896,1985,4752
431036,202309,351,773,74,221,9,30,20,54,29,84
431040,202309,1107,2520,641,1635,71,233,405,909,476,1142
431041,202309,494,1092,274,691,50,128,113,232,163,360
431043,202309,404,972,267,669,26,70,167,368,193,438
431046,202309,114,285,37,95,6,15,9,19,15,34
431050,202309,1543,3343,1014,2442,189,470,535,1216,724,1686
431053,202309,881,2066,424,1163,85,235,144,329,229,564
431055,202309,797,1735,513,1242,69,165,327,775,396,940
431057,202309,242,699,121,370,31,97,37,112,68,209
431060,202309,7236,15951,4471,11127,1163,3088,1820,3985,2983,7073
431065,202309,579,1307,312,832,39,108,174,416,213,524
431070,202309,517,1288,244,683,53,145,68,212,121,357
431075,202309,328,799,161,429,24,77,84,184,108,261
431080,202309,864,2200,438,1232,66,217,153,341,219,558
431085,202309,984,2367,424,1138,74,192,174,444,248,636
431087,202309,491,1251,339,919,54,156,193,492,247,648
431090,202309,479,1083,139,419,27,86,34,91,61,177
431100,202309,5731,10955,3858,8367,449,1053,2510,4985,2959,6038
431110,202309,1815,3863,1160,2653,180,463,673,1381,853,1844
431112,202309,784,1810,583,1441,74,230,368,822,442,1052
431113,202309,700,1591,490,1197,112,270,266,614,378,884
431115,202309,1409,3345,956,2516,101,340,642,1531,743,1871
431120,202309,3452,7842,2065,5195,506,1450,849,1801,1355,3251
431123,202309,443,1065,254,675,41,92,122,310,163,402
431125,202309,1578,3644,1002,2581,241,643,542,1350,783,1993
431127,202309,303,740,54,160,12,36,8,18,20,54
431130,202309,4260,9536,2865,7080,515,1346,1486,3329,2001,4675
431140,202309,8215,18326,4075,10078,585,1539,1891,3799,2476,5338
431142,202309,828,1804,518,1261,62,146,327,748,389,894
431150,202309,1289,3080,876,2313,103,311,526,1287,629,1598
431160,202309,868,2110,491,1342,141,399,152,357,293,756
431162,202309,775,1770,418,1073,45,141,246,567,291,708
431164,202309,199,452,37,108,8,29,9,16,17,45
431170,202309,576,1411,375,1006,105,278,83,188,188,466
431171,202309,1212,2396,904,1951,125,277,672,1395,797,1672
431173,202309,574,1356,371,1041,117,360,96,222,213,582
431175,202309,1671,3587,885,2178,133,316,438,1006,571,1322
431177,202309,1240,2856,821,2121,185,533,412,987,597,1520
431179,202309,376,810,98,279,25,81,34,83,59,164
431180,202309,3249,7882,1691,4578,424,1091,509,1230,933,2321
431190,202309,745,1753,244,683,29,84,61,121,90,205
431198,202309,518,1378,402,1130,94,265,162,444,256,709
431200,202309,352,841,93,244,21,52,15,33,36,85
431205,202309,288,720,145,399,37,106,44,110,81,216
431210,202309,820,1771,567,1342,131,295,263,619,394,914
431213,202309,414,1027,247,684,23,71,134,339,157,410
431215,202309,766,1721,290,792,37,112,130,323,167,435
431217,202309,212,496,127,338,24,65,41,97,65,162
431220,202309,815,1833,424,1082,114,284,192,447,306,731
431225,202309,2006,4113,1327,2967,146,348,901,1908,1047,2256
431230,202309,1010,2441,599,1536,104,295,307,640,411,935
431235,202309,201,538,30,93,2,4,7,15,9,19
431237,202309,474,1315,297,909,38,123,142,411,180,534
431238,202309,45,130,29,92,6,24,9,20,15,44
431240,202309,7035,15383,4868,11411,518,1400,3037,6376,3555,7776
431242,202309,399,894,278,647,31,87,158,329,189,416
431244,202309,494,1163,196,512,51,116,59,135,110,251
431245,202309,1626,3530,872,2168,109,273,383,841,492,1114
431247,202309,352,794,169,427,19,52,70,142,89,194
431250,202309,2546,5439,1795,4268,358,904,1009,2266,1367,3170
431260,202309,414,1015,203,576,22,71,79,180,101,251
431261,202309,359,957,241,703,27,94,143,370,170,464
431262,202309,339,898,163,510,27,96,73,211,100,307
431265,202309,1976,4416,634,1689,160,467,162,317,322,784
431267,202309,290,673,161,419,26,71,82,196,108,267
431270,202309,3743,7546,1767,4230,534,1283,546,1230,1080,2513
431275,202309,198,495,98,256,14,44,58,136,72,180
431280,202309,330,873,126,386,28,90,29,77,57,167
431290,202309,470,1349,220,696,41,136,45,120,86,256
431295,202309,94,237,32,100,7,18,9,28,16,46
431300,202309,387,1001,85,249,20,65,27,66,47,131
431301,202309,324,881,71,231,9,27,9,16,18,43
431303,202309,860,1951,436,1106,33,92,243,519,276,611
431306,202309,2972,6678,1375,3573,208,570,598,1304,806,1874
431308,202309,47,125,36,99,15,43,9,22,24,65
431310,202309,692,1614,375,947,62,135,190,455,252,590
431320,202309,850,2193,424,1230,81,255,133,298,214,553
431330,202309,2632,5772,1239,3104,182,522,621,1326,803,1848
431333,202309,248,617,113,323,21,58,36,97,57,155
431335,202309,40,119,25,87,7,21,3,12,10,33
431337,202309,5549,11500,4144,9213,199,543,3263,6788,3462,7331
431339,202309,591,1392,340,903,70,189,147,362,217,551
431340,202309,25797,57811,15810,39312,2402,6471,8333,18537,10735,25008
431342,202309,483,1064,304,752,52,135,187,442,239,577
431344,202309,461,1116,228,649,49,129,108,294,157,423
431346,202309,256,600,83,241,19,59,25,64,44,123
431349,202309,1297,2717,694,1561,122,306,414,839,536,1145
431350,202309,6407,14435,4375,10873,688,1803,2543,5768,3231,7571
431360,202309,735,1684,298,796,90,265,84,175,174,440
431365,202309,3046,5990,2086,4575,155,425,1628,3307,1783,3732
431370,202309,6805,14391,4316,10189,761,1958,2335,5055,3096,7013
431380,202309,1196,2907,841,2240,194,501,416,1085,610,1586
431390,202309,3297,7499,1732,4417,206,603,926,1986,1132,2589
431395,202309,2295,4683,1566,3546,160,376,1105,2344,1265,2720
431400,202309,386,1030,162,490,27,72,34,93,61,165
431402,202309,1102,2294,714,1677,94,219,428,948,522,1167
431403,202309,247,651,162,456,29,86,54,123,83,209
431405,202309,7601,17775,4881,12592,887,2447,2368,5441,3255,7888
431406,202309,723,1833,419,1181,116,307,106,319,222,626
431407,202309,661,1647,364,1018,80,215,132,349,212,564
431410,202309,25808,57553,15930,39414,2016,5812,9449,20502,11465,26314
431413,202309,310,835,62,183,10,27,18,37,28,64
431415,202309,939,2198,528,1423,118,346,198,447,316,793
431417,202309,687,1385,382,877,77,191,196,426,273,617
431420,202309,2163,4314,1423,3214,104,273,984,2037,1088,2310
431430,202309,694,1644,285,797,49,146,102,245,151,391
431440,202309,52785,107214,36793,81241,6208,14795,21011,41243,27219,56038
431442,202309,211,563,71,225,11,35,6,13,17,48
431445,202309,433,1185,121,385,17,52,23,53,40,105
431446,202309,344,885,254,703,31,91,143,374,174,465
431447,202309,938,2248,442,1219,78,221,163,403,241,624
431449,202309,979,2248,528,1374,97,255,269,632,366,887
431450,202309,3308,5839,2266,4316,223,360,1685,3087,1908,3447
431454,202309,60,197,39,138,5,20,18,57,23,77
431455,202309,638,1422,285,721,44,91,132,326,176,417
431460,202309,4174,8603,2406,5506,457,1158,1226,2561,1683,3719
431470,202309,1711,4259,1036,2855,256,706,319,845,575,1551
431475,202309,297,780,46,143,2,7,6,10,8,17
431477,202309,612,1419,301,806,92,216,99,252,191,468
431478,202309,290,787,52,155,14,43,9,18,23,61
431480,202309,4157,9921,2633,6978,572,1506,920,2217,1492,3723
431490,202309,186429,379695,127808,283282,7581,21539,93064,187116,100645,208655
431500,202309,599,1384,345,894,61,152,159,386,220,538
431505,202309,306,678,181,456,25,70,112,267,137,337
431507,202309,350,798,120,348,38,117,25,67,63,184
431510,202309,2118,5010,1181,3111,458,1178,220,550,678,1728
431513,202309,255,532,114,277,29,88,34,55,63,143
431514,202309,152,368,91,240,11,23,45,106,56,129
431515,202309,702,1500,464,1067,101,235,232,498,333,733
431517,202309,89,243,57,167,10,35,27,75,37,110
431520,202309,436,1007,159,429,29,87,63,128,92,215
431530,202309,6775,13864,3550,8581,765,1954,1532,3370,2297,5324
431531,202309,262,602,117,316,28,76,28,79,56,155
431532,202309,795,1664,404,972,75,185,189,426,264,611
431535,202309,408,1006,185,482,33,93,77,171,110,264
431540,202309,2474,6452,1898,5432,142,505,1279,3448,1421,3953
431545,202309,440,1020,96,229,11,24,44,99,55,123
431550,202309,2948,6687,1777,4429,268,690,872,1983,1140,2673
431555,202309,884,1844,450,1073,48,123,261,602,309,725
431560,202309,34245,75994,19836,50710,3492,9184,8599,20733,12091,29917
431570,202309,7047,13850,5171,10911,524,1215,3571,6876,4095,8091
431575,202309,503,1103,329,768,56,142,183,354,239,496
431580,202309,926,2189,486,1235,48,135,260,545,308,680
431590,202309,1110,2816,589,1662,157,482,211,502,368,984
431595,202309,457,1122,231,645,53,162,86,198,139,360
431600,202309,2373,5463,1413,3728,240,713,543,1191,783,1904
431610,202309,1924,4210,997,2490,202,529,356,937,558,1466
431620,202309,589,1355,289,729,64,184,155,318,219,502
431630,202309,1593,3685,650,1789,160,449,175,429,335,878
431640,202309,8993,18044,6414,14195,1062,2372,3947,8289,5009,10661
431642,202309,831,1765,413,984,89,210,170,360,259,570
431643,202309,488,1135,164,429,19,42,66,150,85,192
431645,202309,3136,5416,2255,4212,45,111,1906,3381,1951,3492
431647,202309,381,884,93,254,14,44,12,20,26,64
431650,202309,168,450,103,308,17,50,44,117,61,167
431660,202309,1029,2545,458,1339,80,253,106,245,186,498
431670,202309,1595,3490,808,2000,128,340,436,959,564,1299
431673,202309,263,671,94,302,12,46,28,76,40,122
431675,202309,431,1062,87,282,8,30,8,16,16,46
431680,202309,13327,29061,8152,19274,1750,4482,3474,7116,5224,11598
431690,202309,36784,79975,23465,55547,4607,11539,12024,25485,16631,37024
431695,202309,282,667,140,379,17,51,71,148,88,199
431697,202309,562,1196,363,858,66,141,193,450,259,591
431700,202309,1928,4146,1333,3075,231,483,683,1591,914,2074
431710,202309,19955,40198,13189,30042,1498,3834,8744,18610,10242,22444
431720,202309,9118,20204,4342,11000,1263,3324,749,1562,2012,4886
431725,202309,41,103,23,69,6,22,5,8,11,30
431730,202309,5997,12670,3619,8834,676,1824,1857,3999,2533,5823
431740,202309,6586,14746,3679,9487,811,2273,1181,2623,1992,4896
431750,202309,11150,25749,6544,17234,1845,5114,1879,4479,3724,9593
431755,202309,404,1042,66,209,7,19,8,25,15,44
431760,202309,6959,14557,4262,9803,494,1369,2637,5269,3131,6638
431770,202309,2865,5754,1863,4230,392,815,1048,2350,1440,3165
431775,202309,301,695,116,314,23,64,38,85,61,149
431780,202309,2723,6068,1459,3678,307,837,450,984,757,1821
431790,202309,958,2407,531,1513,153,443,155,404,308,847
431795,202309,315,768,140,404,20,58,34,94,54,152
431800,202309,10500,23010,5675,14722,1818,5106,644,1470,2462,6576
431805,202309,306,780,44,156,3,9,0,0,3,9
431810,202309,4047,8452,2440,5572,456,1115,1338,2794,1794,3909
431820,202309,2840,6642,1904,5021,465,1288,814,1978,1279,3266
431830,202309,10971,22975,6753,16366,2145,5602,1208,2809,3353,8411
431840,202309,3706,8129,2623,6286,413,1043,1575,3547,1988,4590
431842,202309,621,1455,184,512,36,104,29,60,65,164
431843,202309,373,967,200,567,53,160,77,194,130,354
431844,202309,220,580,59,196,13,42,21,69,34,111
431845,202309,585,1379,317,822,34,84,172,446,206,530
431846,202309,379,820,284,666,19,55,222,481,241,536
431848,202309,174,438,64,188,8,22,14,29,22,51
431849,202309,421,1028,54,159,9,27,7,18,16,45
431850,202309,5437,13344,3364,9055,998,2729,809,2067,1807,4796
431860,202309,865,1926,423,1040,74,191,245,553,319,744
431861,202309,122,303,64,179,8,25,26,60,34,85
431862,202309,636,1858,448,1470,90,326,203,600,293,926
431870,202309,32551,71662,22122,53126,2856,7179,13591,30172,16447,37351
431880,202309,5218,12042,3397,8728,541,1534,1754,4058,2295,5592
431890,202309,6262,14451,3338,8682,1054,2702,802,1960,1856,4662
431900,202309,1322,3063,749,1930,148,431,331,696,479,1127
431910,202309,954,2124,322,830,75,175,88,182,163,357
431912,202309,735,1617,528,1257,84,191,329,757,413,948
431915,202309,1477,3080,1035,2339,75,183,767,1644,842,1827
431920,202309,1711,3258,1235,2581,46,111,1032,2071,1078,2182
431930,202309,985,2318,568,1539,190,529,176,445,366,974
431935,202309,99,238,48,135,8,22,8,14,16,36
431936,202309,372,950,172,480,40,112,81,208,121,320
431937,202309,246,563,105,275,26,59,26,62,52,121
431940,202309,3856,8176,2111,5008,255,583,1173,2663,1428,3246
431950,202309,2979,6751,1859,4701,439,1126,676,1571,1115,2697
431960,202309,3796,8515,2473,6033,779,1998,510,1183,1289,3181
431970,202309,530,1278,192,505,40,115,58,107,98,222
431971,202309,103,249,47,134,11,26,15,38,26,64
431973,202309,728,1983,474,1454,36,96,330,1005,366,1101
431975,202309,135,287,36,92,8,25,11,20,19,45
431980,202309,1605,3399,1141,2622,116,331,775,1549,891,1880
431990,202309,9260,19819,5806,14285,381,1158,3872,8694,4253,9852
432000,202309,21355,43955,14249,32093,1786,4556,9341,19229,11127,23785
432010,202309,3673,7890,1936,4791,482,1214,714,1605,1196,2819
432020,202309,1926,4819,1018,2832,375,1038,146,384,521,1422
432023,202309,695,1553,273,730,29,80,119,252,148,332
432026,202309,1262,3046,896,2326,277,731,324,856,601,1587
432030,202309,560,1266,251,676,20,64,143,348,163,412
432032,202309,378,911,222,590,22,72,108,240,130,312
432035,202309,875,2184,650,1758,175,467,268,699,443,1166
432040,202309,1242,2914,444,1241,51,169,199,464,250,633
432045,202309,225,536,110,302,15,46,45,110,60,156
432050,202309,704,1591,429,1083,62,176,225,517,287,693
432055,202309,912,2085,546,1397,178,428,166,456,344,884
432057,202309,181,445,135,338,30,64,74,170,104,234
432060,202309,547,1255,125,386,17,51,22,57,39,108
432065,202309,291,707,196,517,39,110,110,259,149,369
432067,202309,1044,2576,772,1999,159,400,379,942,538,1342
432070,202309,2002,4579,1296,3227,192,559,642,1363,834,1922
432080,202309,6691,13853,4021,9291,822,2230,1810,3506,2632,5736
432085,202309,499,1268,359,988,64,181,164,413,228,594
432090,202309,3604,8272,1678,4358,318,810,758,1717,1076,2527
432100,202309,1078,2532,453,1314,74,253,64,133,138,386
432110,202309,2704,6261,1738,4440,407,1136,595,1283,1002,2419
432120,202309,4851,11731,3281,8770,518,1551,1691,4010,2209,5561
432130,202309,3576,7889,2385,5800,533,1334,1094,2603,1627,3937
432132,202309,356,870,166,434,30,89,83,194,113,283
432135,202309,1230,2591,717,1717,112,244,390,963,502,1207
432140,202309,2536,6011,1853,4699,248,630,1184,2826,1432,3456
432143,202309,2075,4875,1361,3614,141,396,791,1989,932,2385
432145,202309,2388,5784,1149,3117,191,552,390,849,581,1401
432146,202309,168,424,104,294,30,76,23,59,53,135
432147,202309,713,1776,329,941,99,278,48,140,147,418
432149,202309,640,1395,234,592,32,73,111,248,143,321
432150,202309,5601,12394,3777,9174,901,2358,1740,3641,2641,5999
432160,202309,9045,20167,6105,15361,1488,3882,2472,5839,3960,9721
432162,202309,245,530,39,106,5,15,8,8,13,23
432163,202309,208,479,32,91,1,2,8,17,9,19
432166,202309,823,2074,520,1428,115,320,166,389,281,709
432170,202309,1953,4881,1029,2977,211,632,349,875,560,1507
432180,202309,3729,8204,1681,4290,277,777,772,1685,1049,2462
432183,202309,535,1347,355,953,61,199,205,487,266,686
432185,202309,1103,2554,568,1504,131,364,257,612,388,976
432190,202309,2990,6438,1785,4335,143,421,1177,2520,1320,2941
432195,202309,1249,2969,580,1600,106,302,169,434,275,736
432200,202309,4853,10805,3158,7812,331,818,2016,4694,2347,5512
432210,202309,517,1191,306,792,52,157,128,279,180,436
432215,202309,814,2061,569,1575,129,357,207,611,336,968
432218,202309,279,643,95,249,10,31,44,88,54,119
432220,202309,4897,10265,3030,7017,545,1310,1705,3618,2250,4928
432225,202309,197,484,124,341,30,68,32,85,62,153
432230,202309,901,2052,382,1058,94,275,86,187,180,462
432232,202309,600,1371,345,888,57,158,167,371,224,529
432234,202309,327,783,157,427,35,87,44,101,79,188
432235,202309,63,141,32,76,4,10,20,41,24,51
432237,202309,360,829,289,708,27,53,213,514,240,567
432240,202309,22474,47846,14950,36648,1495,4086,9764,22533,11259,26619
432250,202309,9660,23329,6111,15987,989,2838,3251,7620,4240,10458
432252,202309,589,1343,337,829,41,115,170,361,211,476
432253,202309,1199,3132,739,2050,240,691,156,394,396,1085
432254,202309,702,1620,153,419,23,72,40,92,63,164
432255,202309,122,313,58,163,4,10,28,66,32,76
432260,202309,7727,17355,4663,11435,853,2258,2172,4644,3025,6902
432270,202309,3096,7211,1992,5092,602,1538,591,1451,1193,2989
432280,202309,1484,3563,579,1661,90,268,147,326,237,594
432285,202309,164,486,21,55,3,5,5,14,8,19
432290,202309,442,1071,239,619,46,140,95,204,141,344
432300,202309,42725,92168,29493,69670,2481,7008,20234,43364,22715,50372
432310,202309,1366,2942,958,2287,147,306,654,1580,801,1886
432320,202309,200,459,94,257,21,57,34,85,55,142
432330,202309,202,448,62,178,22,61,11,31,33,92
432335,202309,210,593,65,217,2,4,15,40,17,44
432340,202309,404,940,145,396,21,50,58,156,79,206
432345,202309,1164,2078,923,1764,28,66,780,1439,808,1505
432350,202309,369,880,161,469,31,102,54,134,85,236
432360,202309,272,789,48,153,9,25,10,30,19,55
432370,202309,501,1123,225,617,18,46,116,295,134,341
432375,202309,619,1410,352,877,125,325,70,174,195,499
432377,202309,211,613,45,153,3,11,11,29,14,40
432380,202309,2457,6383,1432,4264,243,779,589,1598,832,2377
500020,202309,4451,9929,2519,6556,321,940,1428,3449,1749,4389
500025,202309,1476,3335,781,2018,103,270,426,1027,529,1297
500060,202309,10998,26870,7357,19425,978,2824,4225,10424,5203,13248
500070,202309,6684,14995,4162,10523,822,2219,1873,4537,2695,6756
500080,202309,1971,4491,1065,2813,191,524,461,1106,652,1630
500085,202309,2753,6202,1561,3981,363,967,606,1351,969,2318
500090,202309,2530,6075,1585,4488,298,885,422,1235,720,2120
500100,202309,5291,12138,3382,8740,562,1585,1495,3482,2057,5067
500110,202309,14144,31537,8680,22215,2052,5361,3889,9494,5941,14855
500124,202309,2912,7168,2155,5922,392,1035,1221,3312,1613,4347
500150,202309,2023,4232,1267,3059,193,492,720,1588,913,2080
500190,202309,6575,15549,3569,9391,911,2352,1057,2502,1968,4854
500200,202309,3438,7317,1864,4519,260,693,1000,2192,1260,2885
500210,202309,6675,13918,4223,10526,1060,2862,2181,5071,3241,7933
500215,202309,1862,4617,1144,3269,141,409,608,1693,749,2102
500220,202309,4608,11150,3024,8207,418,1236,1653,4053,2071,5289
500230,202309,2694,5965,1728,4324,278,744,942,2198,1220,2942
500240,202309,5349,14184,3468,10190,533,1699,1337,3715,1870,5414
500260,202309,4046,8090,2359,5493,253,691,1441,3070,1694,3761
500270,202309,195890,425165,110669,276355,15589,43504,52028,114041,67617,157545
500280,202309,1770,4016,1041,2845,174,439,548,1486,722,1925
500290,202309,4686,10577,2411,6432,398,1225,880,1997,1278,3222
500295,202309,5562,12292,3163,7880,520,1430,1342,2869,1862,4299
500310,202309,1310,2436,704,1605,128,229,336,747,464,976
500315,202309,6220,13303,4841,11368,304,818,3934,8877,4238,9695
500320,202309,26511,64256,16331,46013,3968,10507,6865,20073,10833,30580
500325,202309,8283,16695,5107,11774,698,1796,3126,6653,3824,8449
500330,202309,8752,18405,5087,12548,698,1834,2645,6278,3343,8112
500345,202309,2861,6565,1563,4165,322,863,503,1201,825,2064
500348,202309,3088,6978,2184,5446,390,1046,1383,3246,1773,4292
500350,202309,1505,3791,787,2273,139,418,257,633,396,1051
500370,202309,36661,88243,23431,64288,3663,10966,10660,26879,14323,37845
500375,202309,3169,7900,1652,4672,212,633,603,1445,815,2078
500380,202309,4636,10768,2571,6845,723,1865,361,999,1084,2864
500390,202309,938,1819,526,1270,78,211,341,778,419,989
500400,202309,2166,5149,1204,3221,203,603,423,990,626,1593
500410,202309,3045,6659,1855,4774,221,541,962,2490,1183,3031
500430,202309,3616,8295,2068,5642,350,943,766,2187,1116,3130
500440,202309,2026,4547,888,2444,156,449,330,884,486,1333
500450,202309,2568,6045,1406,3913,311,879,322,900,633,1779
500460,202309,4911,11985,2602,7322,483,1521,456,1093,939,2614
500470,202309,3852,9539,2229,6195,522,1599,660,1524,1182,3123
500480,202309,2409,6895,1802,5844,195,688,1182,3781,1377,4469
500490,202309,1492,3388,740,2094,159,509,174,450,333,959
500500,202309,5093,12647,2907,8771,917,3226,278,818,1195,4044
500510,202309,893,2136,516,1395,53,142,321,785,374,927
500515,202309,2045,4819,1297,3472,223,602,626,1668,849,2270
500520,202309,4363,11330,2981,8774,549,1624,1564,4523,2113,6147
500525,202309,1291,3436,901,2706,139,406,451,1299,590,1705
500540,202309,6833,16834,3531,10537,1070,3529,549,1268,1619,4797
500560,202309,7470,17654,5648,14992,424,1123,4260,11128,4684,12251
500568,202309,5946,12158,3313,8000,909,2171,1220,2706,2129,4877
500570,202309,11683,25006,7129,17120,1000,2758,4040,8637,5040,11395
500580,202309,4060,9643,2520,6779,693,1870,916,2388,1609,4258
500600,202309,4827,11231,2885,7688,719,1919,824,2111,1543,4030
500620,202309,10865,25547,6257,16393,947,2544,3092,7344,4039,9888
500625,202309,725,1801,434,1220,69,190,184,462,253,652
500627,202309,977,2507,491,1476,96,318,111,281,207,599
500630,202309,10185,21439,5117,12689,1150,3112,1610,3534,2760,6646
500635,202309,3300,9789,2323,8311,363,1190,1364,5325,1727,6515
500640,202309,2180,4401,1319,3119,83,196,901,2027,984,2223
500660,202309,28637,64636,16856,45922,4553,12965,5531,14696,10084,27661
500690,202309,3541,8315,2217,6093,754,2285,723,1841,1477,4126
500710,202309,4377,10773,2520,7098,549,1634,602,1502,1151,3136
500720,202309,6567,15629,3731,10407,764,2286,1076,2691,1840,4977
500730,202309,1417,3187,674,1824,169,445,187,492,356,937
500740,202309,5738,12889,3207,8653,819,2244,991,2631,1810,4875
500750,202309,1543,3482,875,2280,127,359,403,921,530,1280
500755,202309,1459,3498,758,2100,133,401,224,501,357,902
500769,202309,6709,15568,3022,8300,780,2219,450,994,1230,3213
500770,202309,1739,4396,1142,3345,211,666,343,973,554,1639
500780,202309,1697,4100,858,2406,145,431,206,465,351,896
500790,202309,10342,25284,6210,17230,1138,3433,2302,5796,3440,9229
500793,202309,2821,6573,1680,4311,373,996,631,1444,1004,2440
500795,202309,3824,8058,2808,6632,719,1804,1617,3627,2336,5431
500797,202309,1051,2416,582,1512,177,478,189,442,366,920
500800,202309,4607,9939,2423,6329,582,1650,714,1795,1296,3445
500830,202309,27613,63213,15200,38868,3616,9573,5206,11989,8822,21562
500840,202309,1875,4172,1010,2489,116,291,504,1104,620,1395
510010,202309,2202,4459,1420,3355,170,369,930,2150,1100,2519
510020,202309,5697,13743,2284,6606,383,1100,664,1763,1047,2863
510025,202309,9948,22594,5692,15169,727,2066,3115,7618,3842,9684
510030,202309,4000,8304,2134,5134,178,471,1069,2494,1247,2965
510035,202309,1328,3425,793,2486,212,677,280,940,492,1617
510040,202309,3077,6244,1950,4557,273,612,1127,2650,1400,3262
510050,202309,2951,5536,1851,4058,213,581,1279,2596,1492,3177
510060,202309,1967,4768,1116,2999,310,891,282,622,592,1513
510080,202309,1981,4749,1177,3358,208,679,415,984,623,1663
510100,202309,864,1819,563,1332,69,183,349,759,418,942
510120,202309,350,602,186,402,8,23,141,275,149,298
510125,202309,2634,6351,1656,4504,259,787,633,1474,892,2261
510130,202309,2141,4836,1321,3436,253,748,634,1440,887,2188
510140,202309,3786,9611,2373,7336,1044,3403,552,1740,1596,5143
510160,202309,2630,5613,1879,4570,49,145,1659,3972,1708,4117
510170,202309,6481,15120,4253,11066,728,2039,2241,5380,2969,7419
510180,202309,19100,38979,11434,27363,1564,3985,6191,14469,7755,18454
510185,202309,2125,5235,1277,3842,406,1296,448,1429,854,2725
510190,202309,3225,8346,1758,5629,385,1294,507,1600,892,2894
510250,202309,22980,52262,14796,38678,2192,6199,8187,20317,10379,26516
510260,202309,2377,9416,1908,8564,255,1154,1199,5868,1454,7022
510263,202309,5188,13413,2853,8239,524,1631,697,1599,1221,3230
510267,202309,7396,19817,3589,10743,699,2207,719,1791,1418,3998
510268,202309,1580,3968,895,2601,236,707,154,412,390,1119
510269,202309,1206,3023,712,2057,144,466,318,825,462,1291
510270,202309,3657,9869,2255,7158,405,1343,812,2476,1217,3819
510279,202309,2354,5686,1139,3318,200,618,320,777,520,1395
510285,202309,1380,3353,801,2269,212,663,270,687,482,1350
510300,202309,5361,11645,3651,9091,273,720,2599,6167,2872,6887
510305,202309,1929,4934,1152,3399,272,833,400,1161,672,1994
510310,202309,1391,3171,911,2347,234,587,361,919,595,1506
510320,202309,5377,12255,2958,7807,747,2127,812,1880,1559,4007
510325,202309,5573,15041,3503,10858,895,3019,562,1617,1457,4636
510330,202309,3494,8886,2205,6591,622,1875,942,2766,1564,4641
510335,202309,6410,16554,4382,12997,1121,3508,1777,4992,2898,8500
510336,202309,683,1800,444,1400,52,151,246,829,298,980
510337,202309,1857,4912,1099,3498,405,1339,229,648,634,1987
510340,202309,130156,273150,77268,188421,14983,41163,35313,76269,50296,117432
510343,202309,1564,3485,916,2368,134,377,473,1133,607,1510
510345,202309,1878,4355,1142,2911,215,589,637,1471,852,2060
510350,202309,4061,9790,2143,6171,555,1583,519,1444,1074,3027
510360,202309,2309,4353,1220,2953,48,113,905,2211,953,2324
510370,202309,2290,5946,1611,4801,309,859,887,2733,1196,3592
510380,202309,676,1529,358,980,55,185,167,421,222,606
510385,202309,1650,4877,1143,3868,76,324,812,2705,888,3029
510390,202309,1868,4112,1216,3296,239,677,724,1909,963,2586
510395,202309,858,1750,510,1232,40,85,334,805,374,890
510410,202309,7040,16927,4688,12811,561,1599,3007,7923,3568,9522
510420,202309,3407,6191,2101,4341,64,163,1671,3302,1735,3465
510450,202309,635,1454,328,895,61,159,154,399,215,558
510452,202309,1273,3209,895,2435,159,408,525,1417,684,1825
510454,202309,1501,3631,895,2534,163,419,455,1360,618,1779
510455,202309,1193,3003,668,1934,140,444,227,567,367,1011
510460,202309,2462,5776,1493,4000,544,1634,442,875,986,2509
510480,202309,6326,14254,3539,8854,653,1773,1652,3599,2305,5372
510490,202309,2198,5029,1506,4020,200,513,926,2465,1126,2978
510500,202309,1809,4122,958,2664,231,677,260,693,491,1370
510510,202309,5130,13222,3139,9540,922,3023,918,2630,1840,5653
510515,202309,6802,16824,4127,11730,784,2316,1662,4356,2446,6672
510517,202309,2136,5088,1319,3730,458,1407,419,1090,877,2497
510520,202309,2973,5850,1308,3291,217,591,569,1436,786,2027
510523,202309,1436,3176,899,2255,156,415,494,1147,650,1562
510525,202309,11071,28592,6421,18504,1309,3848,2020,5170,3329,9018
510530,202309,756,1747,525,1400,32,90,382,982,414,1072
510550,202309,3291,8644,2234,6635,421,1281,1135,3197,1556,4478
510558,202309,2822,7165,1872,5541,285,800,944,2855,1229,3655
510560,202309,2565,6855,1389,4349,304,991,220,670,524,1661
510562,202309,7977,17081,5066,11925,808,2097,2755,5731,3563,7828
510590,202309,4253,9538,2782,7346,385,1028,1815,4653,2200,5681
510600,202309,1665,3343,1034,2356,254,718,507,956,761,1674
510610,202309,3659,7999,2267,5891,310,878,1329,3258,1639,4136
510615,202309,3619,8664,2238,6293,454,1339,1049,2806,1503,4145
510617,202309,1394,3768,1041,3200,121,384,729,2303,850,2687
510618,202309,1670,3959,1070,2915,213,666,548,1363,761,2029
510619,202309,904,2209,442,1328,94,281,92,236,186,517
510620,202309,1767,3731,721,1961,265,814,84,195,349,1009
510621,202309,2013,5074,1037,3112,267,859,259,625,526,1484
510622,202309,7341,18863,3596,10501,948,2806,427,989,1375,3795
510623,202309,3713,8279,2136,5435,411,1132,876,2041,1287,3173
510624,202309,1910,4811,877,2682,107,381,159,401,266,782
510625,202309,4767,10714,2599,6747,618,1713,853,2120,1471,3833
510626,202309,1682,3983,1031,2862,330,1057,231,568,561,1625
510627,202309,831,1983,396,1127,125,384,102,296,227,680
510628,202309,1781,3778,1031,2681,349,1021,313,694,662,1715
510629,202309,2297,5908,1288,3886,315,1057,244,661,559,1718
510630,202309,4458,11324,2463,7437,567,1698,746,2374,1313,4072
510631,202309,748,1625,503,1223,39,97,377,898,416,995
510637,202309,4599,10103,2595,6628,776,2147,807,1840,1583,3987
510642,202309,7422,18594,5097,14755,1055,3273,2547,6992,3602,10265
510645,202309,1259,2460,685,1660,178,421,267,671,445,1092
510650,202309,9884,21230,6737,17167,819,1480,4655,12667,5474,14147
510665,202309,2116,4371,1140,2745,271,590,419,1065,690,1655
510670,202309,511,1076,293,754,38,91,161,427,199,518
510675,202309,8523,21839,4974,14606,1226,3866,998,2499,2224,6365
510677,202309,2648,6475,1766,4976,319,946,1018,2777,1337,3723
510680,202309,878,2125,414,1210,65,209,108,272,173,481
510682,202309,2301,5901,1581,4620,403,1254,731,2031,1134,3285
510685,202309,693,1716,426,1204,45,127,240,644,285,771
510700,202309,5446,11988,3392,8797,383,1143,2141,5276,2524,6419
510704,202309,14853,32793,8223,20704,1882,5000,2784,6090,4666,11090
510706,202309,3400,9088,2230,6884,452,1416,1016,3153,1468,4569
510710,202309,3792,8686,2027,5219,659,1658,463,1074,1122,2732
510715,202309,755,1618,412,1065,35,87,265,648,300,735
510718,202309,2766,6218,1545,4372,298,880,736,2234,1034,3114
510719,202309,594,1176,318,759,48,130,151,289,199,419
510720,202309,1116,2384,660,1688,130,375,289,638,419,1013
510724,202309,1094,2934,624,1936,90,314,233,613,323,927
510726,202309,1127,2053,557,1242,53,132,362,754,415,886
510729,202309,817,1766,328,888,50,136,94,246,144,382
510730,202309,3660,8279,2271,5883,567,1596,1029,2359,1596,3955
510735,202309,1713,4399,1261,3633,126,362,961,2746,1087,3108
510740,202309,1226,2729,686,1674,43,120,471,1044,514,1164
510757,202309,660,1977,460,1583,121,455,165,504,286,959
510760,202309,57241,120426,29300,73612,7017,19077,8282,17885,15299,36962
510770,202309,5504,10947,3613,8321,201,498,2630,5907,2831,6405
510774,202309,558,1354,374,1033,65,190,215,587,280,777
510775,202309,852,2045,459,1329,103,309,116,303,219,612
510776,202309,999,2417,573,1525,111,302,267,702,378,1004
510777,202309,1738,4369,1145,3487,225,790,605,1692,830,2482
510779,202309,1051,2708,648,1952,74,210,389,1205,463,1415
510780,202309,5513,12476,3464,9216,569,1546,1812,4923,2381,6469
510785,202309,2533,6145,1316,3823,302,916,437,1210,739,2126
510787,202309,4614,12074,2562,7546,940,2830,293,790,1233,3620
510788,202309,599,1348,369,976,57,137,171,484,228,621
510790,202309,26087,63875,13762,40097,3053,9542,1562,4004,4615,13546
510792,202309,14851,38470,8285,24689,2055,6417,2034,5330,4089,11747
510794,202309,1561,4062,989,2953,288,924,140,316,428,1240
510795,202309,15011,34934,9309,24522,2070,5907,3362,7694,5432,13601
510800,202309,1909,4851,1104,3226,342,1006,162,390,504,1396
510805,202309,1890,4884,1025,3157,206,666,363,1008,569,1674
510810,202309,846,1634,511,1163,154,312,260,640,414,952
510820,202309,933,1718,500,1136,32,95,343,703,375,798
510830,202309,974,2318,683,1887,127,380,373,1031,500,1411
510835,202309,761,1672,445,1190,67,207,247,602,314,809
510840,202309,83365,162635,52131,118721,8264,18386,30608,67623,38872,86009
510850,202309,2216,5558,1119,3456,263,876,72,138,335,1014
510860,202309,3497,8498,2143,6255,819,2569,427,1199,1246,3768
510880,202309,924,2486,573,1786,210,653,79,250,289,903
510885,202309,797,1853,437,1195,100,267,128,340,228,607
510890,202309,1041,2719,621,1873,188,606,131,350,319,956
510895,202309,1878,4436,1150,3111,263,793,522,1228,785,2021
520005,202309,5071,12294,3602,9997,1195,3076,1179,3760,2374,6836
520010,202309,3953,9537,2561,6739,588,1659,1019,2328,1607,3987
520013,202309,4704,10978,2636,7004,770,1978,663,1849,1433,3827
520015,202309,618,1469,370,1037,90,237,133,391,223,628
520017,202309,1604,3684,969,2538,173,536,411,973,584,1509
520020,202309,708,1265,472,946,51,95,349,672,400,767
520025,202309,51869,124542,39975,104530,6637,17657,22835,56927,29472,74584
520030,202309,9293,19406,6850,15570,555,1201,5053,11096,5608,12297
520050,202309,528,1200,254,682,54,148,98,254,152,402
520055,202309,2228,5148,1056,2633,188,476,471,1059,659,1535
520060,202309,2508,5827,1534,4078,304,881,421,1076,725,1957
520080,202309,2393,5477,1621,4283,377,966,676,1773,1053,2739
520082,202309,1032,2452,635,1700,165,478,212,554,377,1032
520085,202309,1279,2914,882,2242,192,462,427,1036,619,1498
520090,202309,1098,1996,737,1557,107,148,542,1200,649,1348
520110,202309,58954,143691,32804,93422,8814,26567,1897,4593,10711,31160
520120,202309,324,716,160,420,31,88,65,144,96,232
520130,202309,5163,11243,3147,7581,706,1715,1269,2818,1975,4533
520140,202309,68770,166082,42117,117317,13306,38977,4360,11757,17666,50734
520145,202309,791,1698,401,1051,87,230,109,256,196,486
520150,202309,918,2097,598,1563,76,179,336,828,412,1007
520160,202309,1121,2540,654,1676,122,301,290,741,412,1042
520170,202309,5885,11933,3444,8404,536,1359,1998,4584,2534,5943
520180,202309,3661,8229,2668,6673,336,947,1732,4100,2068,5047
520215,202309,2284,4967,1506,3698,142,416,1005,2298,1147,2714
520235,202309,966,1876,547,1258,97,227,318,675,415,902
520250,202309,2290,5289,1438,3868,544,1593,116,344,660,1937
520260,202309,914,2037,480,1254,108,271,151,379,259,650
520280,202309,1050,2171,681,1562,164,368,309,694,473,1062
520310,202309,1167,2377,703,1669,169,446,322,752,491,1198
520320,202309,2770,6509,1666,4388,232,606,812,2108,1044,2714
520330,202309,6606,15349,4562,11616,761,2087,2552,6015,3313,8102
520340,202309,2843,5746,1544,3777,233,493,719,1850,952,2343
520350,202309,4477,10181,2558,6785,803,2130,713,1874,1516,4004
520355,202309,2325,5915,1492,4200,473,1431,225,567,698,1998
520357,202309,1124,2457,756,1903,118,284,486,1221,604,1505
520360,202309,1034,2359,690,1721,96,261,333,725,429,986
520380,202309,1725,4083,865,2373,172,467,231,560,403,1027
520390,202309,1466,3273,841,2255,244,752,132,342,376,1094
520393,202309,913,1901,536,1283,68,183,269,571,337,754
520396,202309,1099,2476,782,1896,78,159,513,1182,591,1341
520400,202309,2025,4370,1401,3438,130,322,957,2342,1087,2664
520410,202309,2769,5683,1648,3834,281,697,885,1928,1166,2625
520420,202309,461,953,336,750,19,56,247,511,266,567
520425,202309,1955,4436,922,2333,279,749,190,381,469,1130
520430,202309,3117,6846,1559,4005,331,861,318,685,649,1546
520440,202309,3858,8801,1940,5155,407,1153,403,1001,810,2154
520450,202309,18930,42275,11078,28512,2740,7144,2935,7045,5675,14189
520455,202309,1018,2416,588,1682,166,492,160,447,326,939
520460,202309,1306,2814,865,2143,248,525,345,893,593,1418
520465,202309,1125,2379,836,1946,42,116,620,1367,662,1483
520470,202309,3136,6908,2142,5370,725,1989,779,1812,1504,3801
520480,202309,1339,3259,837,2310,182,515,347,876,529,1391
520485,202309,2012,5456,1503,4493,247,777,843,2409,1090,3186
520490,202309,5636,13099,3808,10029,621,1716,2177,5484,2798,7200
520495,202309,2015,3860,1408,3011,139,304,1023,2141,1162,2445
520500,202309,2296,5131,1475,3566,264,747,788,1685,1052,2432
520505,202309,1204,2248,868,1796,97,169,628,1280,725,1449
520510,202309,13486,30318,9027,22581,1460,4267,4682,10477,6142,14744
520520,202309,1439,3370,1003,2611,279,773,391,944,670,1717
520530,202309,3349,8007,2221,6003,456,1219,966,2765,1422,3984
520540,202309,3926,9375,2120,5702,340,958,758,1750,1098,2708
520545,202309,1911,4317,1245,3173,315,790,471,1185,786,1975
520547,202309,1941,4552,1323,3409,274,695,663,1677,937,2372
520549,202309,22661,51927,16969,42548,2236,5978,10697,25172,12933,31150
520551,202309,6732,15006,5076,12284,446,1335,3722,8353,4168,9688
520552,202309,1280,2948,866,2307,245,639,329,906,574,1545
520570,202309,688,1452,389,960,67,137,185,444,252,581
520580,202309,3056,5938,1894,4414,408,970,986,2246,1394,3216
520590,202309,1727,3999,1034,2760,218,614,403,994,621,1608
520620,202309,12842,29911,9121,23647,1591,4290,4907,12042,6498,16332
520630,202309,1102,2561,722,1906,103,299,352,894,455,1193
520640,202309,2782,6345,1833,4528,503,1247,476,1177,979,2424
520650,202309,1338,2636,862,1924,176,397,478,1055,654,1452
520660,202309,644,1552,312,884,86,257,89,249,175,506
520670,202309,1247,2878,883,2238,88,187,577,1399,665,1586
520680,202309,1066,2283,728,1709,108,215,461,1078,569,1293
520690,202309,450,1059,280,739,73,194,94,217,167,411
520710,202309,562,1282,309,802,19,59,198,475,217,534
520725,202309,1708,3833,1039,2646,254,643,390,971,644,1614
520735,202309,1187,2523,732,1762,217,511,222,516,439,1027
520740,202309,3290,7037,1975,4892,386,1005,832,2011,1218,3016
520750,202309,947,1955,623,1439,137,278,318,730,455,1008
520753,202309,1641,3880,1138,2980,206,590,534,1241,740,1831
520760,202309,1883,3616,1387,2980,51,144,1148,2345,1199,2489
520780,202309,2058,4496,1332,3310,241,599,656,1534,897,2133
520790,202309,3975,8720,2316,5865,385,907,1270,3284,1655,4191
520800,202309,25033,56345,17365,43637,3699,8941,8656,21537,12355,30478
520810,202309,1432,2948,945,2311,275,671,362,909,637,1580
520815,202309,730,2050,439,1370,85,260,127,391,212,651
520830,202309,2155,4366,1426,3363,89,208,1062,2407,1151,2615
520840,202309,3726,9106,2642,7348,687,2067,801,2155,1488,4222
520850,202309,1235,2511,726,1709,135,350,359,763,494,1113
520860,202309,12561,30425,7779,21099,2040,5770,2402,5828,4442,11598
520870,202309,206474,437960,129222,308753,24670,61701,58843,128596,83513,190297
520880,202309,12984,33733,9013,25638,1831,5174,3614,9752,5445,14926
520890,202309,6273,12698,3861,8743,639,1649,2102,4254,2741,5903
520910,202309,5922,13754,3472,9132,850,2329,804,1902,1654,4231
520915,202309,1075,2543,606,1561,107,310,291,661,398,971
520920,202309,5642,11615,3708,8799,757,1664,1991,4767,2748,6431
520929,202309,792,1747,521,1274,104,201,215,570,319,771
520940,202309,1221,2970,851,2336,98,262,536,1396,634,1658
520945,202309,586,1225,370,877,62,130,192,458,254,588
520960,202309,1450,2936,997,2281,372,790,361,885,733,1675
520970,202309,4979,11611,3254,8623,1111,2931,711,1934,1822,4865
520980,202309,958,2025,628,1522,95,219,302,686,397,905
520990,202309,3990,8598,2922,7071,447,958,1997,4851,2444,5809
520993,202309,1527,3497,815,2047,291,714,204,488,495,1202
520995,202309,3252,7539,1968,5174,598,1665,350,1003,948,2668
521000,202309,12348,29164,6973,18286,1254,3364,2361,5581,3615,8945
521010,202309,5212,12076,3413,8698,575,1615,1725,3962,2300,5577
521015,202309,975,2212,570,1426,25,69,405,929,430,998
521020,202309,6286,14176,3447,8878,858,2217,946,2295,1804,4512
521030,202309,1038,1771,683,1281,36,72,558,1000,594,1072
521040,202309,11193,25430,6934,17844,1784,4556,2011,5185,3795,9741
521056,202309,1323,3227,819,2305,247,684,126,365,373,1049
521060,202309,1241,2972,768,2072,262,712,151,406,413,1118
521080,202309,1293,2659,611,1563,119,306,172,392,291,698
521090,202309,3904,9788,2157,5994,493,1483,226,535,719,2018
521100,202309,2450,4968,1625,3756,213,524,966,2151,1179,2675
521120,202309,6325,14226,4234,10901,1400,3697,888,2432,2288,6129
521130,202309,1310,2960,624,1681,113,320,272,706,385,1026
521140,202309,2142,4847,1356,3378,174,465,806,1813,980,2278
521150,202309,18732,39508,10695,26685,2905,7750,3771,8492,6676,16242
521160,202309,1055,1986,592,1239,59,123,396,758,455,881
521170,202309,1351,2923,829,2041,162,427,328,718,490,1145
521180,202309,11154,26180,7716,19945,1677,4676,3405,8350,5082,13026
521190,202309,15406,35559,8806,23674,2096,6047,2875,6882,4971,12929
521200,202309,882,2003,518,1361,103,286,202,464,305,750
521205,202309,783,1691,558,1321,32,82,425,948,457,1030
521210,202309,1120,2747,562,1562,155,437,124,269,279,706
521220,202309,4852,10692,2888,7288,777,2186,1147,2426,1924,4612
521225,202309,558,1076,368,836,25,62,284,627,309,689
521230,202309,1882,4322,1354,3458,551,1468,387,920,938,2388
521250,202309,48816,111061,35103,89336,7625,20550,17814,42140,25439,62690
521260,202309,676,1388,469,1068,70,169,260,543,330,712
521270,202309,2743,5988,2084,5026,245,551,1431,3464,1676,4015
521280,202309,2331,5657,1508,4160,321,925,552,1436,873,2361
521290,202309,717,1494,395,980,39,110,227,514,266,624
521295,202309,1482,3030,955,2226,160,374,511,1099,671,1473
521300,202309,2331,5247,1551,3918,337,882,751,1837,1088,2719
521305,202309,850,1794,527,1278,49,121,337,773,386,894
521308,202309,6105,14663,3626,9765,366,1074,2139,5316,2505,6390
521310,202309,14460,33735,8204,21393,1768,4785,2819,6693,4587,11478
521340,202309,536,1128,309,762,26,73,176,394,202,467
521350,202309,2406,5708,1672,4513,124,384,1178,3027,1302,3411
521370,202309,1634,3970,880,2515,303,896,140,437,443,1333
521375,202309,2250,5405,1300,3550,301,783,355,971,656,1754
521377,202309,1580,3245,1028,2458,128,273,696,1691,824,1964
521380,202309,8471,20835,4342,12423,767,2345,795,2194,1562,4539
521385,202309,876,1922,548,1421,73,179,310,821,383,1000
521390,202309,898,2127,518,1445,111,356,101,221,212,577
521400,202309,3891,8411,2524,6205,406,1013,1420,3356,1826,4369
521405,202309,1676,4101,927,2573,106,312,461,1173,567,1485
521410,202309,1183,2562,846,2012,210,442,432,1077,642,1519
521440,202309,1797,4086,1170,2996,320,754,476,1215,796,1969
521450,202309,5592,14917,3525,10399,956,2780,772,2194,1728,4974
521460,202309,8676,19934,4929,12923,1342,3573,1313,3321,2655,6894
521470,202309,1101,2496,638,1582,107,231,328,767,435,998
521480,202309,735,1434,409,895,52,115,232,436,284,551
521483,202309,2916,6558,1874,4849,638,1645,571,1501,1209,3146
521486,202309,2162,4831,1434,3618,137,271,898,2197,1035,2468
521487,202309,617,1335,417,1014,89,188,235,568,324,756
521490,202309,1036,2489,693,1869,36,124,482,1178,518,1302
521500,202309,2512,6144,1582,4346,236,708,766,1906,1002,2614
521520,202309,1072,2260,756,1748,102,217,465,1053,567,1270
521523,202309,19560,51006,13456,38763,4364,12332,4858,13343,9222,25675
521525,202309,1329,2957,894,2251,167,435,483,1144,650,1579
521530,202309,2828,6920,1633,4478,325,890,471,1150,796,2040
521540,202309,902,2174,613,1668,158,469,233,566,391,1035
521550,202309,2231,5225,940,2543,192,563,213,594,405,1157
521560,202309,7572,17445,4925,13367,1420,3941,1728,4719,3148,8660
521565,202309,854,1962,527,1386,103,286,229,564,332,850
521570,202309,5838,14363,3445,9589,853,2528,545,1519,1398,4047
521580,202309,717,1560,383,958,78,196,157,347,235,543
521590,202309,1135,2328,738,1729,116,291,416,902,532,1193
521600,202309,559,1339,302,826,59,164,137,336,196,500
521630,202309,2164,4355,1133,2708,392,944,235,521,627,1465
521640,202309,2456,5454,1368,3596,306,900,353,830,659,1730
521645,202309,667,1619,323,944,148,413,22,51,170,464
521680,202309,1821,4419,1278,3438,327,921,537,1334,864,2255
521690,202309,642,1485,453,1168,67,194,242,571,309,765
521710,202309,4470,9988,2665,6765,575,1555,895,2053,1470,3608
521720,202309,3114,6611,1684,4234,213,559,841,2020,1054,2579
521730,202309,5686,13835,3446,9594,972,2954,667,1474,1639,4428
521740,202309,6160,14099,3966,10111,1239,3374,1213,2515,2452,5889
521760,202309,24700,56037,18196,45631,3967,10540,9867,22942,13834,33482
521770,202309,4103,8988,2236,5757,446,1207,483,1217,929,2424
521800,202309,9236,21683,5656,15316,1858,5056,1279,3713,3137,8769
521805,202309,1440,2858,773,1834,153,344,348,845,501,1189
521810,202309,955,2036,612,1504,102,256,363,890,465,1146
521830,202309,7791,18845,5693,15124,792,2054,3517,8874,4309,10928
521839,202309,1099,2338,721,1675,58,149,489,1026,547,1175
521850,202309,9393,20106,5153,12973,1758,4532,646,1516,2404,6048
521860,202309,2168,5502,1244,3568,272,812,325,821,597,1633
521870,202309,948,2355,589,1629,121,367,239,553,360,920
521878,202309,1138,2728,621,1655,62,173,328,792,390,965
521880,202309,33667,76107,21256,54424,4209,11522,9158,21136,13367,32658
521890,202309,4276,10006,2385,6333,660,1737,603,1457,1263,3194
521900,202309,1784,3962,892,2373,316,794,68,186,384,980
521910,202309,1723,3626,1130,2731,291,697,412,939,703,1636
521920,202309,717,1661,484,1241,55,175,282,649,337,824
521925,202309,1098,2494,659,1715,151,372,304,758,455,1130
521930,202309,7081,15927,4061,10892,1301,3028,1432,4149,2733,7177
521935,202309,1260,2829,765,1933,103,264,438,1040,541,1304
521940,202309,1646,3455,960,2373,153,404,533,1241,686,1645
521945,202309,887,2027,491,1291,97,231,238,620,335,851
521950,202309,954,2059,576,1414,132,280,248,617,380,897
521960,202309,830,1982,532,1407,64,194,293,674,357,868
521970,202309,3453,7267,2368,5711,315,700,1472,3495,1787,4195
521971,202309,1001,2292,487,1318,118,305,118,287,236,592
521973,202309,2160,5153,1313,3533,235,629,568,1437,803,2066
521975,202309,18369,41773,13380,33521,2224,5891,8010,18682,10234,24573
521980,202309,2779,6074,1892,4762,162,455,1348,3269,1510,3724
521990,202309,1812,4043,1321,3227,256,670,732,1715,988,2385
522000,202309,3320,7901,2278,6290,888,2550,641,1795,1529,4345
522005,202309,527,1071,277,687,46,136,103,236,149,372
522010,202309,5932,13773,3651,9537,884,2375,1175,2809,2059,5184
522015,202309,1359,3216,905,2416,264,680,336,886,600,1566
522020,202309,6969,14996,4076,10135,942,2456,1753,4196,2695,6652
522026,202309,1006,2423,606,1670,98,302,204,492,302,794
522028,202309,678,1515,396,972,51,149,220,486,271,635
522040,202309,4913,9841,2888,6688,646,1410,1348,2883,1994,4293
522045,202309,27826,69827,17759,50207,4093,11976,4476,11729,8569,23705
522050,202309,1569,3663,972,2521,197,579,447,996,644,1575
522060,202309,4208,10105,2567,7096,554,1476,1006,2743,1560,4219
522068,202309,2283,4877,1612,3921,216,428,1060,2536,1276,2964
522070,202309,1091,2119,828,1737,34,77,688,1379,722,1456
522100,202309,1119,2590,654,1764,115,303,257,659,372,962
522108,202309,1511,2997,1056,2344,60,157,817,1687,877,1844
522119,202309,2534,5338,1854,4372,270,585,1146,2676,1416,3261
522130,202309,698,1524,472,1162,37,96,348,832,385,928
522140,202309,33008,77403,19825,51996,4445,12150,6005,14070,10450,26220
522145,202309,932,2100,602,1560,149,415,289,705,438,1120
522150,202309,1403,3050,794,1984,172,415,237,587,409,1002
522155,202309,1223,2894,760,2015,143,375,424,1095,567,1470
522157,202309,945,1854,690,1505,48,108,517,1129,565,1237
522160,202309,8083,18832,4511,12024,1204,3422,473,1293,1677,4715
522170,202309,3482,8214,2444,6461,405,1024,1372,3568,1777,4592
522180,202309,971,2033,522,1181,105,224,149,333,254,557
522185,202309,33290,74674,21265,56061,8973,25354,2921,7736,11894,33090
522190,202309,1035,2201,621,1534,95,266,303,631,398,897
522200,202309,2786,6934,1783,4977,440,1208,624,1677,1064,2885
522205,202309,2044,4653,1263,3244,540,1508,248,525,788,2033
522220,202309,1528,3267,969,2453,145,353,515,1318,660,1671
522230,202309,1748,3821,1114,2742,120,329,680,1572,800,1901
530010,202309,383608,879198,292375,721338,45440,116790,166623,383032,212063,499822
110001,202308,4863,12536,2916,8712,753,2403,794,2176,1547,4579
110002,202308,18435,43034,11545,30454,2826,7904,3326,8153,6152,16057
110003,202308,933,2529,596,1807,159,493,112,310,271,803
110004,202308,18058,42056,10222,27382,2302,6428,3467,8541,5769,14969
110005,202308,3136,7653,1876,5311,531,1524,554,1557,1085,3081
110006,202308,1829,4776,1008,3025,205,672,199,521,404,1193
110007,202308,1481,3528,755,2179,207,613,132,386,339,999
110008,202308,4386,10182,2990,8093,636,1533,1564,4678,2200,6211
110009,202308,5625,14591,3169,9811,690,2281,891,2522,1581,4803
110010,202308,10287,28073,7272,22609,1940,5331,3134,11077,5074,16408
110011,202308,9783,23628,5939,16350,1665,4795,1250,3141,2915,7936
110012,202308,22882,52503,13016,34643,3299,8756,3562,8846,6861,17602
110013,202308,7599,19707,4758,14076,1783,5519,751,2176,2534,7695
110014,202308,4712,11395,2744,7586,533,1570,1082,2828,1615,4398
110015,202308,7734,18008,4346,11583,1063,3162,1304,2771,2367,5933
110018,202308,5871,13727,3064,8242,728,2042,739,1729,1467,3771
110020,202308,122321,254579,83292,195404,17337,42346,43270,98300,60607,140646
110025,202308,5907,13381,3547,9058,589,1660,1755,4049,2344,5709
110026,202308,721,1787,429,1238,102,304,117,346,219,650
110028,202308,9406,22125,4913,13616,1283,3919,481,1207,1764,5126
110029,202308,1945,4516,1003,2804,201,570,405,1089,606,1659
110030,202308,18479,40583,9717,25753,2940,8265,1392,3529,4332,11794
110032,202308,4698,11906,2459,7272,788,2372,387,1148,1175,3520
110033,202308,5904,15936,4153,12606,1229,3786,1410,4384,2639,8170
110034,202308,3914,8752,2312,6238,867,2496,501,1393,1368,3889
110037,202308,1834,5132,1135,3713,312,1067,266,815,578,1882
110040,202308,3667,9351,2304,6729,651,2066,488,1244,1139,3310
110045,202308,5655,14943,3626,10987,1053,3374,1036,2969,2089,6343
110050,202308,2098,5262,1121,3383,377,1257,107,229,484,1486
110060,202308,1166,3190,634,1941,179,532,121,345,300,877
110070,202308,1797,5102,1159,3686,342,1158,253,663,595,1821
110080,202308,8112,18012,5458,14008,1323,3466,2533,6468,3856,9934
110090,202308,750,1919,450,1333,122,402,136,381,258,783
110092,202308,1760,4660,1095,3324,265,840,520,1513,785,2353
110094,202308,3589,9560,2407,7268,772,2403,432,1363,1204,3766
110100,202308,2132,5626,1517,4465,552,1687,428,1230,980,2917
110110,202308,2310,5720,1428,4137,422,1312,222,688,644,2000
110120,202308,1679,4342,1008,2979,285,862,261,726,546,1588
110130,202308,3275,7545,1702,4637,440,1256,189,495,629,1751
110140,202308,3126,8004,2115,6010,471,1468,944,2494,1415,3962
110143,202308,1753,4423,1134,3228,318,987,368,969,686,1956
110145,202308,1127,2731,589,1675,183,499,193,567,376,1066
110146,202308,653,1612,386,1104,134,371,102,323,236,694
110147,202308,969,2280,506,1349,63,175,247,576,310,751
110148,202308,1200,3010,497,1483,125,408,56,102,181,510
110149,202308,4356,10371,2662,7378,894,2561,589,1644,1483,4205
110150,202308,2959,7304,1667,5011,604,1995,145,392,749,2387
110155,202308,1067,2856,654,1862,132,423,247,624,379,1047
110160,202308,1852,5037,1141,3489,409,1291,156,456,565,1747
110170,202308,2492,5892,1474,3985,269,799,789,1897,1058,2696
110175,202308,2753,6998,1658,4762,304,959,721,1912,1025,2871
110180,202308,1622,4022,1010,2840,263,796,287,756,550,1552
120001,202308,4505,11196,3323,9304,485,1552,2112,5627,2597,7179
120005,202308,2564,8538,2225,7961,267,984,1563,5674,1830,6658
120010,202308,7816,18434,6504,16416,631,1515,4914,12266,5545,13781
120013,202308,3221,8977,2612,8025,983,3017,910,3031,1893,6048
120017,202308,3825,9149,2950,7807,448,1152,1854,5052,2302,6204
120020,202308,19840,60169,17382,55422,1319,4477,13019,40885,14338,45362
120025,202308,4757,10670,3685,9291,595,1498,2280,5963,2875,7461
120030,202308,7678,27452,6769,25693,564,2402,4766,18206,5330,20608
120032,202308,2161,8470,1986,8096,109,659,1632,6467,1741,7126
120033,202308,5561,16113,5051,15215,139,584,4315,12660,4454,13244
120034,202308,3694,11017,3097,10016,162,679,2507,7868,2669,8547
120035,202308,5234,16200,4719,15303,248,932,4021,12755,4269,13687
120038,202308,4176,10629,3351,9264,605,1729,1922,5332,2527,7061
120039,202308,2538,9500,2288,8978,174,904,1728,6599,1902,7503
120040,202308,80167,191046,63183,162721,8358,22164,39014,96409,47372,118573
120042,202308,4351,13105,3827,12108,161,651,3143,9708,3304,10359
120043,202308,1829,6421,1500,5895,72,468,1177,4431,1249,4899
120045,202308,7313,16507,5652,14235,716,1877,3784,9384,4500,11261
120050,202308,12366,36306,10906,33930,513,1996,8792,26972,9305,28968
120060,202308,12412,40770,10930,38321,560,2693,8921,30521,9481,33214
120070,202308,4494,12153,3633,10792,736,2074,2038,6373,2774,8447
120080,202308,7041,16111,6038,14570,702,1642,4527,10833,5229,12475
130002,202308,4369,13664,3738,12774,416,1140,2962,10571,3378,11711
130006,202308,3234,9957,2549,8821,454,1435,1568,5803,2022,7238
130008,202308,3339,9929,2789,9104,200,669,2204,7299,2404,7968
130010,202308,5467,12831,4564,11705,172,468,3999,10098,4171,10566
130014,202308,5002,12473,3426,9927,763,2248,1727,5180,2490,7428
130020,202308,3411,12082,2816,11058,216,1185,2057,7759,2273,8944
130030,202308,20115,41071,17913,38475,240,634,16866,35750,17106,36384
130040,202308,5039,13588,3951,12137,621,1761,2689,8569,3310,10330
130050,202308,8775,29051,7162,26586,625,2423,5374,19904,5999,22327
130060,202308,8960,32273,7484,30131,318,1826,6109,24041,6427,25867
130063,202308,8098,22963,6971,21561,228,946,6236,18972,6464,19918
130068,202308,4840,13411,3941,12160,257,940,3186,9736,3443,10676
130070,202308,9058,23427,7113,21007,828,2099,5117,15604,5945,17703
130080,202308,9579,27872,7937,25812,329,1119,6735,21924,7064,23043
130083,202308,3742,10265,3106,9432,240,733,2484,7764,2724,8497
130090,202308,5106,12499,4367,11576,104,310,3793,10216,3897,10526
130100,202308,9046,25435,7367,23540,198,738,6408,20470,6606,21208
130110,202308,11039,26343,8547,23035,1795,4262,5066,15029,6861,19291
130115,202308,6331,17119,5133,15502,156,494,4342,13158,4498,13652
130120,202308,21201,57733,17918,53108,1858,5802,13839,40787,15697,46589
130130,202308,7259,19382,5461,16909,752,2212,3694,12053,4446,14265
130140,202308,9115,27571,7723,25790,369,1574,6525,21580,6894,23154
130150,202308,4971,14636,4488,13973,258,1063,3762,11594,4020,12657
130160,202308,8132,21704,6847,20018,346,970,5937,17388,6283,18358
130165,202308,4269,13593,3862,13002,132,573,3328,11091,3460,11664
130170,202308,18152,40698,14501,36186,476,1395,12714,30969,13190,32364
130180,202308,5419,15330,5053,14883,53,321,4793,13961,4846,14282
130185,202308,25758,53552,20198,47070,1590,2538,16574,39814,18164,42352
130190,202308,26791,74398,21045,65598,2485,7338,14999,47100,17484,54438
130195,202308,3056,10032,2527,9321,132,584,2058,7652,2190,8236
130200,202308,3774,8928,2915,7723,226,717,2182,5598,2408,6315
130210,202308,1997,6585,1768,6296,180,733,1381,4880,1561,5613
130220,202308,3327,8921,2679,8125,122,358,2315,7093,2437,7451
130230,202308,6441,22236,5553,20971,198,1080,4866,18271,5064,19351
130240,202308,18238,40447,14815,36118,210,945,13591,32242,13801,33187
130250,202308,32551,85775,26460,77818,1656,4324,21006,62565,22662,66889
130255,202308,6190,16343,4956,14193,266,743,3925,11075,4191,11818
130260,202308,499277,1089290,390687,929241,68836,174356,249465,567505,318301,741861
130270,202308,12610,37784,10013,33665,2054,6182,6186,21739,8240,27921
130280,202308,4680,15207,4157,14559,165,709,3657,12698,3822,13407
130290,202308,22042,52515,19008,48749,575,1787,17245,43485,17820,45272
130300,202308,6246,17626,5265,16215,219,833,4298,12997,4517,13830
130310,202308,10724,25049,9066,22891,567,1482,7461,18576,8028,20058
130320,202308,4316,12763,3378,11292,537,1772,2087,7059,2624,8831
130330,202308,5666,15627,4384,13960,252,825,3530,11359,3782,12184
130340,202308,31578,80019,26082,73247,1787,4354,21232,61053,23019,65407
130350,202308,4628,15101,4060,14312,156,787,3471,12052,3627,12839
130353,202308,9667,23338,7319,19998,1359,3480,4376,12352,5735,15832
130356,202308,6909,18720,5447,16365,1322,3710,2850,8943,4172,12653
130360,202308,3630,10855,2750,9634,206,880,2208,7540,2414,8420
130370,202308,6361,25027,5159,23036,671,3636,3050,13520,3721,17156
130380,202308,10191,39051,9204,37251,784,3547,6946,27780,7730,31327
130390,202308,9234,31045,7727,28629,545,2565,6340,22943,6885,25508
130395,202308,3140,8562,2486,7486,163,580,1989,5819,2152,6399
130400,202308,3677,9681,2954,8657,101,328,2567,7423,2668,7751
130406,202308,14837,45608,12192,42029,3245,9750,6877,25330,10122,35080
130410,202308,5616,16989,4664,15472,1281,4243,2525,8702,3806,12945
130420,202308,19806,56909,16332,52311,2443,7289,11088,36620,13531,43909
130423,202308,5418,15586,4572,14496,230,914,3957,12308,4187,13222
130426,202308,3943,12138,3468,11560,82,284,3020,10486,3102,10770
130430,202308,6306,13807,5194,12351,219,566,4470,10344,4689,10910
130440,202308,7298,17223,6040,15645,152,481,5505,14074,5657,14555
140002,202308,3118,8232,2531,7463,370,923,1759,5462,2129,6385
140005,202308,4250,11187,3431,10105,2000,6086,823,2412,2823,8498
140010,202308,72823,187293,54077,155773,14216,42596,18340,52600,32556,95196
140015,202308,7839,15654,6464,14124,280,599,5731,12398,6011,12997
140017,202308,7276,16694,5765,14666,405,1011,4490,11415,4895,12426
140020,202308,7118,17351,5739,15502,775,1984,3804,10587,4579,12571
140023,202308,3602,9077,2721,7765,359,1086,1948,5519,2307,6605
140028,202308,2541,6010,2006,5287,143,372,1522,4030,1665,4402
140030,202308,7853,16262,6437,14513,367,705,5471,12270,5838,12975
140040,202308,3684,12909,3320,12410,149,817,2824,10334,2973,11151
140045,202308,5693,17681,4791,16322,1624,4630,2308,9048,3932,13678
140047,202308,7889,20115,6234,17458,967,2686,3728,10610,4695,13296
140050,202308,2280,5740,1772,4912,346,803,1020,2945,1366,3748
140060,202308,2886,6174,2393,5490,227,448,1883,4297,2110,4745
140070,202308,2556,11890,2408,11568,169,1135,1889,8833,2058,9968
150010,202308,66011,135260,54670,119484,1373,2846,47993,102265,49366,105111
150013,202308,2758,5617,2176,4926,85,172,1858,4157,1943,4329
150020,202308,19387,48614,16913,45009,1713,3699,13237,35940,14950,39639
150030,202308,11680,36336,10153,34272,835,2229,7913,28344,8748,30573
150034,202308,5314,11411,3824,9283,252,605,2953,7015,3205,7620
150040,202308,20319,47515,16638,42909,1047,1787,14294,37892,15341,39679
150050,202308,10000,26503,8685,24637,273,885,7706,21853,7979,22738
150060,202308,30868,74015,22838,61063,3629,9591,13551,36253,17180,45844
150070,202308,10994,30863,9243,28544,295,1186,8189,24898,8484,26084
150080,202308,116201,245617,83527,195464,22898,52203,29059,73785,51957,125988
150085,202308,12404,28453,10555,26082,182,512,9806,23903,9988,24415
150090,202308,16051,40361,14366,37551,576,1486,12507,32100,13083,33586
150095,202308,9318,19768,7584,17488,848,1438,5922,13969,6770,15407
150100,202308,3797,11371,3166,10319,189,651,2610,8418,2799,9069
150110,202308,5786,19255,5223,18551,167,685,4677,16597,4844,17282
150120,202308,10119,26663,8790,24661,378,874,7579,21272,7957,22146
150125,202308,1136,2657,774,2111,95,301,489,1286,584,1587
150130,202308,32170,80072,25134,68191,4972,12058,14691,41298,19663,53356
150140,202308,389664,736373,297602,603389,24314,50395,220302,425346,244616,475741
150145,202308,5200,14765,3867,12460,1523,4936,928,3571,2451,8507
150150,202308,23379,50334,18092,42964,1827,4124,12558,29316,14385,33440
150157,202308,4488,11018,3274,9177,482,1414,1914,5362,2396,6776
150160,202308,5216,10773,4422,9561,317,745,3523,7196,3840,7941
150170,202308,36363,90828,30812,81131,5740,13185,19196,53383,24936,66568
150172,202308,7333,16138,5541,13490,391,971,4247,10196,4638,11167
150175,202308,2577,6203,2059,5330,165,569,1623,3931,1788,4500
150178,202308,16093,33497,11620,28045,1067,1507,9001,23131,10068,24638
150180,202308,36572,92001,31624,85928,2718,4860,25205,73236,27923,78096
150190,202308,9877,23880,8626,22287,153,482,7766,19696,7919,20178
150195,202308,6568,17449,5798,16285,180,568,5177,14346,5357,14914
150200,202308,7386,18515,6366,17218,79,259,5712,15334,5791,15593
150210,202308,42102,106945,37879,100939,1283,3347,33294,88358,34577,91705
150215,202308,14666,37199,11092,30153,1853,5289,6366,16572,8219,21861
150220,202308,18106,42484,14394,36525,764,1835,10901,26920,11665,28755
150230,202308,18279,42369,15391,38061,1329,2907,11671,28807,13000,31714
150240,202308,46131,111553,34974,91129,7514,19604,15622,38390,23136,57994
150250,202308,5497,17855,4991,17239,351,1245,4312,14944,4663,16189
150260,202308,3788,9787,3119,8734,109,346,2592,7029,2701,7375
150270,202308,11093,28354,6897,20270,1933,5869,1825,5389,3758,11258
150275,202308,9789,24377,8586,22631,210,814,7510,19070,7720,19884
150276,202308,2967,7289,2356,6420,266,701,1593,4503,1859,5204
150277,202308,7037,15353,4875,12331,679,1663,3133,7775,3812,9438
150280,202308,9511,30154,8794,28978,784,2157,6986,23814,7770,25971
150285,202308,4454,12889,3720,11623,235,694,2867,8828,3102,9522
150290,202308,14089,32364,11798,29445,430,952,10316,25779,10746,26731
150293,202308,11929,26358,8583,21464,974,2504,5663,13558,6637,16062
150295,202308,9193,22072,5624,16502,1867,5299,1868,6010,3735,11309
150300,202308,4258,8669,3693,7966,54,142,3439,7332,3493,7474
150304,202308,5453,14115,4255,12159,842,2293,2555,7431,3397,9724
150307,202308,7202,19912,6129,18065,275,802,4797,13962,5072,14764
150309,202308,8005,20421,5870,16613,996,2767,3303,9418,4299,12185
150310,202308,9210,30998,8443,29908,459,1944,7088,25217,7547,27161
150320,202308,11940,27532,9899,24225,1249,2722,6838,16777,8087,19499
150330,202308,19556,50874,17110,47282,2677,5951,11312,34051,13989,40002
150340,202308,3031,7973,2453,7020,265,661,1736,4958,2001,5619
150345,202308,11621,27415,9731,24830,454,1293,8198,20447,8652,21740
150350,202308,12916,26162,10834,23343,1032,1712,8764,19031,9796,20743
150360,202308,32355,79293,23794,66903,2175,4814,17376,49699,19551,54513
150370,202308,14477,36849,11011,31709,1509,3741,7586,22814,9095,26555
150375,202308,5005,18061,4379,17007,292,1226,3506,13391,3798,14617
150380,202308,12810,28439,9522,23744,457,1264,7556,18266,8013,19530
150390,202308,10004,35267,8406,32367,2022,6541,4685,19972,6707,26513
150400,202308,8239,25397,7499,24083,178,570,6295,20615,6473,21185
150405,202308,11197,25390,8822,22041,831,1444,6707,17367,7538,18811
150410,202308,2400,6423,1915,5599,170,468,1313,3795,1483,4263
150420,202308,60828,145036,43380,117089,9576,27136,21243,56378,30819,83514
150430,202308,10237,25656,8496,23015,715,1571,6474,17357,7189,18928
150440,202308,8677,20030,7317,18047,497,1201,6043,14636,6540,15837
150442,202308,39604,79059,29833,65598,1653,3815,22949,48009,24602,51824
150445,202308,10163,23804,8513,21411,182,534,7547,18644,7729,19178
150450,202308,8199,24324,7516,23368,248,1222,6846,20609,7094,21831
150460,202308,11048,29521,9645,27596,527,1217,7944,23260,8471,24477
150470,202308,25699,61507,21326,55517,581,2219,18328,45798,18909,48017
150475,202308,7008,18799,5472,16176,973,2603,3333,10208,4306,12811
150480,202308,18140,48012,15532,43998,4251,10663,8816,26995,13067,37658
150490,202308,10211,31314,8806,29076,809,2323,6648,22609,7457,24932
150495,202308,6833,18454,6056,17268,220,863,5214,14417,5434,15280
150497,202308,3367,9391,2374,7560,444,1437,1234,3962,1678,5399
150500,202308,3824,9048,3097,7850,196,517,2385,5783,2581,6300
150503,202308,7526,17627,5015,14153,1638,4095,1856,5825,3494,9920
150506,202308,17356,42418,14208,37951,2296,5771,9620,26707,11916,32478
150510,202308,16493,42418,13366,36975,1181,2946,10351,28556,11532,31502
150520,202308,10696,31270,9956,30224,131,713,9322,27829,9453,28542
150530,202308,16220,47910,13395,43543,1273,3585,10074,33128,11347,36713
150540,202308,6571,14734,5388,12935,351,804,4362,10287,4713,11091
150543,202308,9165,23316,6849,19748,661,2021,4740,13561,5401,15582
150548,202308,13269,35043,11201,31861,593,1594,9354,26597,9947,28191
150549,202308,2362,5829,1854,5034,121,393,1413,3752,1534,4145
150550,202308,25715,67234,18268,53154,5375,15738,6201,17935,11576,33673
150553,202308,52463,128456,35159,96414,10182,27867,13498,36595,23680,64462
150555,202308,2580,6090,1821,4896,153,398,1239,3359,1392,3757
150560,202308,2510,6073,1988,5129,204,530,1318,3286,1522,3816
150563,202308,3419,8884,2535,7285,600,1811,1272,3559,1872,5370
150565,202308,5719,16209,4621,14201,186,585,3593,11027,3779,11612
150570,202308,9979,23451,8669,21577,223,723,7687,18599,7910,19322
150580,202308,14952,50039,12370,46932,1744,5432,9040,36332,10784,41764
150590,202308,10666,30505,8849,28247,406,1318,7600,24368,8006,25686
150600,202308,13339,34687,11796,32531,491,1378,10267,28194,10758,29572
150610,202308,4089,9085,3410,8043,136,381,2854,6490,2990,6871
150611,202308,4089,9612,3302,8412,105,377,2764,6697,2869,7074
150613,202308,18534,46262,12530,35465,2709,8198,5530,14699,8239,22897
150616,202308,4757,11950,3072,8746,615,1823,1453,3985,2068,5808
150618,202308,9338,23041,7017,19161,1116,3226,4226,11272,5342,14498
150619,202308,8150,20671,6253,17816,1148,2954,3869,11386,5017,14340
150620,202308,9692,27901,7899,24454,1886,5361,3918,12503,5804,17864
150630,202308,9319,18984,8131,17396,149,370,7373,15331,7522,15701
150635,202308,6917,16196,5237,13271,622,1454,3351,8398,3973,9852
150640,202308,2567,6766,2222,6304,70,227,1935,5456,2005,5683
150650,202308,15517,36945,12327,31557,3755,9382,4745,12753,8500,22135
150655,202308,6995,17224,5916,15554,187,739,4926,12459,5113,13198
150658,202308,5456,14500,3572,11099,1052,3430,1364,4157,2416,7587
150660,202308,7073,17892,5703,15629,1412,3722,2902,7845,4314,11567
150670,202308,12875,25029,9327,20567,1218,2899,6448,13899,7666,16798
150680,202308,100359,247692,73718,204171,16767,42581,37619,109771,54386,152352
150690,202308,3290,7084,2558,6069,152,339,2086,4895,2238,5234
150700,202308,8881,21938,7256,19486,1025,2125,4984,13925,6009,16050
150710,202308,4770,13431,3979,12091,799,2447,2329,7103,3128,9550
150715,202308,6673,15553,5044,13119,403,1111,3893,9863,4296,10974
150720,202308,10669,25954,9193,23715,360,1177,7829,19402,8189,20579
150730,202308,17264,45225,13507,39198,2288,6901,8578,25031,10866,31932
150740,202308,5095,12371,4038,10636,458,961,2837,7578,3295,8539
150745,202308,7067,17179,5238,14372,717,2121,3450,9280,4167,11401
150746,202308,2184,5456,1818,4891,72,207,1462,3825,1534,4032
150747,202308,6858,16486,5757,14776,405,935,4593,11698,4998,12633
150750,202308,4816,12583,3594,10693,380,1135,2463,7446,2843,8581
150760,202308,14737,37636,12299,33692,2453,6215,7221,20408,9674,26623
150770,202308,9037,26334,8030,25042,264,622,7111,22690,7375,23312
150775,202308,1506,3493,1098,2930,109,340,748,1930,857,2270
150780,202308,6407,16794,5409,15490,247,752,4651,13362,4898,14114
150790,202308,7940,18357,6273,16336,550,1137,4213,12596,4763,13733
150795,202308,21711,54904,17661,48508,3375,9066,10491,28906,13866,37972
150796,202308,5134,10444,4046,9056,276,661,3266,7124,3542,7785
150797,202308,5749,14587,4577,12735,469,1255,3540,9751,4009,11006
150800,202308,18819,50603,15738,46007,3115,8616,9403,28407,12518,37023
150803,202308,11169,25161,9495,22701,304,863,8260,18999,8564,19862
150805,202308,4574,12336,3511,10602,487,1416,2340,7115,2827,8531
150808,202308,8271,22173,5564,17307,1902,6585,770,2402,2672,8987
150810,202308,27428,60596,19445,49736,4646,11525,9798,26816,14444,38341
150812,202308,8528,19163,6943,16503,466,1340,5292,11705,5758,13045
150815,202308,11804,31341,9364,28037,1644,4842,6285,19063,7929,23905
150820,202308,19169,38776,15581,33980,1527,2405,12174,27476,13701,29881
150830,202308,16578,45609,14740,42913,616,1625,12775,37198,13391,38823
150835,202308,4633,12173,3789,10826,436,1276,2625,7412,3061,8688
150840,202308,10994,27164,7957,21840,1101,3271,4696,12107,5797,15378
160005,202308,1857,3845,1517,3429,51,132,1312,2879,1363,3011
160010,202308,2789,6764,2421,6311,45,187,2200,5574,2245,5761
160015,202308,5139,10592,4406,9727,433,777,3741,8375,4174,9152
160020,202308,3244,8300,2686,7517,340,853,1932,5612,2272,6465
160021,202308,1638,5148,1335,4760,72,363,903,3275,975,3638
160023,202308,1774,5343,1475,4812,292,917,847,2862,1139,3779
160025,202308,2359,6153,2121,5865,230,416,1788,5150,2018,5566
160027,202308,14695,29842,12454,26831,1008,2109,10110,21651,11118,23760
160030,202308,117415,271576,90650,233247,16435,40028,52768,139092,69203,179120
160040,202308,7939,22532,6770,20844,556,1524,5429,16865,5985,18389
160050,202308,8590,20524,6956,18397,2417,5718,3452,10102,5869,15820
160053,202308,5688,14356,4703,12853,258,632,3825,10599,4083,11231
160055,202308,2224,4250,2024,4011,26,64,1900,3697,1926,3761
160060,202308,39857,83864,31342,73254,3846,7480,23028,55019,26874,62499
160070,202308,4115,12014,3405,10910,440,1214,2464,8293,2904,9507
160080,202308,4090,10487,3422,9702,80,253,3041,8644,3121,8897
170025,202308,798,1992,415,1248,101,298,89,262,190,560
170030,202308,1374,3758,892,2767,190,573,317,994,507,1567
170035,202308,1700,4015,1081,2875,112,324,616,1524,728,1848
170040,202308,2200,5383,1494,4222,247,689,738,2137,985,2826
170070,202308,2359,4979,1461,3637,119,332,872,2090,991,2422
170100,202308,3015,7388,2148,5827,299,724,1355,3663,1654,4387
170105,202308,771,2052,449,1386,109,331,128,349,237,680
170110,202308,1338,3425,862,2541,74,264,484,1322,558,1586
170130,202308,1789,4387,1191,3324,108,351,761,2018,869,2369
170190,202308,1862,4348,1290,3369,161,506,797,1903,958,2409
170200,202308,2357,5234,1284,3318,318,767,429,1067,747,1834
170210,202308,34113,84563,21745,61276,5873,17221,4224,11821,10097,29042
170215,202308,1523,3655,1040,2868,103,340,683,1773,786,2113
170220,202308,6865,19418,5145,16166,2416,7605,944,3418,3360,11023
170230,202308,1507,3901,1001,2872,191,582,461,1229,652,1811
170240,202308,3591,8153,2572,6461,245,687,1761,4176,2006,4863
170255,202308,4439,11751,2963,8951,530,1652,1414,4146,1944,5798
170270,202308,988,2289,619,1650,71,188,364,919,435,1107
170290,202308,3731,9193,3002,8063,323,639,2206,6138,2529,6777
170300,202308,2583,5838,1835,4641,130,364,1324,3133,1454,3497
170305,202308,806,1997,548,1473,92,250,254,668,346,918
170307,202308,1356,3682,1012,2994,116,385,640,1737,756,2122
170310,202308,1945,4314,1214,3117,196,519,602,1465,798,1984
170320,202308,1253,3027,800,2228,103,311,450,1204,553,1515
170330,202308,1198,3208,995,2838,46,188,753,1997,799,2185
170360,202308,710,1635,465,1237,45,120,269,630,314,750
170370,202308,1609,3641,973,2538,140,411,526,1219,666,1630
170380,202308,2186,5672,1508,4518,128,401,859,2565,987,2966
170382,202308,580,1546,425,1264,18,73,266,704,284,777
170384,202308,2084,6291,1543,5154,305,994,745,2360,1050,3354
170386,202308,1150,2964,552,1704,74,259,196,526,270,785
170388,202308,842,2045,547,1520,96,278,297,766,393,1044
170389,202308,989,2867,694,2312,110,399,365,1217,475,1616
170390,202308,2155,4289,1446,3362,71,203,1125,2569,1196,2772
170410,202308,723,1641,471,1195,32,90,315,737,347,827
170460,202308,501,1240,330,925,43,128,182,476,225,604
170510,202308,1068,2697,647,1886,42,161,414,1096,456,1257
170550,202308,8247,19642,5499,14865,1409,4074,1945,4913,3354,8987
170555,202308,1628,3907,1090,2930,144,359,531,1407,675,1766
170560,202308,1137,2904,762,2271,104,299,393,1196,497,1495
170600,202308,1641,4000,1102,3091,162,416,619,1718,781,2134
170610,202308,1986,4552,1286,3333,97,305,847,2011,944,2316
170625,202308,519,1256,309,841,46,111,129,313,175,424
170650,202308,1827,4448,1363,3657,146,460,890,2224,1036,2684
170700,202308,4333,11486,2868,8389,577,1740,1175,3146,1752,4886
170710,202308,2076,4476,1374,3378,142,365,918,2162,1060,2527
170720,202308,2261,4946,1509,3741,156,372,1019,2424,1175,2796
170730,202308,1327,3161,852,2345,124,304,496,1348,620,1652
170740,202308,2441,7060,1877,5970,165,619,1339,4067,1504,4686
170755,202308,992,2402,618,1738,118,359,277,691,395,1050
170765,202308,1334,3154,829,2236,145,381,413,1057,558,1438
170770,202308,2241,5679,1645,4658,124,395,1209,3276,1333,3671
170820,202308,4717,12228,3138,9253,648,1916,1425,4013,2073,5929
170825,202308,1307,2691,902,2083,87,190,661,1476,748,1666
170830,202308,1611,3771,1081,2866,351,977,376,848,727,1825
170900,202308,3829,10213,3109,9123,460,1188,2120,6330,2580,7518
170930,202308,4917,11987,3290,8832,759,2148,1181,2907,1940,5055
170950,202308,14208,36424,8287,24611,2487,7764,1080,3039,3567,10803
170980,202308,627,1436,343,922,46,131,157,397,203,528
171050,202308,2000,5558,1567,4767,141,438,1113,3372,1254,3810
171070,202308,1614,3986,1252,3403,259,613,643,1947,902,2560
171090,202308,1172,2878,838,2329,144,422,428,1135,572,1557
171110,202308,667,1696,386,1120,68,198,169,449,237,647
171150,202308,1139,2594,624,1710,120,388,296,685,416,1073
171180,202308,806,2126,422,1331,83,264,148,463,231,727
171190,202308,2487,6982,1954,5990,311,989,1107,3355,1418,4344
171195,202308,1018,2794,694,2130,91,303,404,1134,495,1437
171200,202308,728,1900,445,1362,113,374,112,298,225,672
171215,202308,500,1181,366,927,55,169,166,375,221,544
171240,202308,914,2647,627,2091,15,83,432,1353,447,1436
171245,202308,902,2404,596,1761,63,227,288,733,351,960
171250,202308,1101,2846,644,1958,95,301,244,721,339,1022
171270,202308,580,1838,399,1424,75,306,188,624,263,930
171280,202308,1039,2781,741,2241,61,184,447,1323,508,1507
171320,202308,4738,12111,3056,8817,640,1848,1122,3147,1762,4995
171330,202308,3657,8981,2360,6570,622,1745,954,2521,1576,4266
171360,202308,1921,4668,1223,3555,135,355,714,2208,849,2563
171370,202308,817,1937,548,1524,78,247,315,817,393,1064
171380,202308,1643,4059,1182,3309,170,434,714,2002,884,2436
171395,202308,1190,2815,753,2087,117,331,405,1077,522,1408
171420,202308,2402,5868,1571,4265,266,710,824,2099,1090,2809
171430,202308,1305,3401,907,2600,92,288,537,1406,629,1694
171488,202308,3004,7494,2050,5765,371,1095,1001,2660,1372,3755
171500,202308,1040,2431,610,1624,87,260,328,826,415,1086
171510,202308,1012,2833,765,2338,65,270,500,1403,565,1673
171515,202308,573,1280,372,951,35,106,238,545,273,651
171525,202308,851,2058,525,1457,61,184,311,782,372,966
171550,202308,408,1056,264,815,36,154,121,313,157,467
171570,202308,1316,3427,970,2750,143,418,566,1516,709,1934
171575,202308,1859,4494,1134,3171,159,437,584,1548,743,1985
171610,202308,7284,18906,4556,13705,1202,3875,784,2337,1986,6212
171620,202308,3624,8042,2874,6886,183,420,2254,5274,2437,5694
171630,202308,1328,3180,900,2504,137,387,519,1453,656,1840
171650,202308,2753,7287,1801,5395,480,1548,369,1029,849,2577
171660,202308,2755,6325,1700,4489,123,353,1169,2946,1292,3299
171665,202308,1512,3870,1034,2987,251,804,369,1010,620,1814
171670,202308,2185,5254,1464,3936,272,787,655,1616,927,2403
171700,202308,1381,3492,907,2548,140,377,518,1404,658,1781
171720,202308,878,2024,551,1452,65,172,336,857,401,1029
171750,202308,1625,4513,1009,3252,212,679,298,1083,510,1762
171780,202308,1512,3446,963,2511,94,292,595,1436,689,1728
171790,202308,1620,4783,1201,3903,180,604,618,1911,798,2515
171800,202308,860,2071,564,1543,68,186,313,785,381,971
171820,202308,14555,37005,9034,26561,2101,6493,2299,6625,4400,13118
171830,202308,1896,5296,1489,4507,382,1070,644,2166,1026,3236
171840,202308,850,2005,538,1444,28,85,332,823,360,908
171845,202308,854,1882,543,1382,51,138,350,826,401,964
171850,202308,1249,3205,960,2621,49,200,754,1909,803,2109
171855,202308,1195,3324,819,2535,108,348,452,1318,560,1666
171865,202308,592,1513,423,1179,71,221,229,561,300,782
171870,202308,950,2389,567,1676,125,405,236,650,361,1055
171875,202308,1763,4205,1321,3484,59,250,1027,2531,1086,2781
171880,202308,1827,4211,1429,3618,66,210,1125,2751,1191,2961
171884,202308,1374,3155,919,2348,149,372,546,1362,695,1734
171886,202308,1745,4334,1105,3254,321,999,275,823,596,1822
171888,202308,668,1784,421,1263,35,127,245,666,280,793
171889,202308,508,1444,297,988,83,279,89,276,172,555
171890,202308,1575,4067,983,2948,112,360,564,1587,676,1947
171900,202308,691,2053,468,1573,63,195,228,764,291,959
172000,202308,665,1853,441,1361,81,255,153,448,234,703
172010,202308,1594,4280,1173,3477,111,291,755,2216,866,2507
172015,202308,433,1358,288,1032,57,221,123,398,180,619
172020,202308,3483,8784,2698,7506,323,897,1759,4894,2082,5791
172025,202308,867,2112,534,1498,47,140,356,931,403,1071
172030,202308,1481,3965,1089,3256,103,354,730,2076,833,2430
172049,202308,1385,3282,824,2403,110,304,433,1279,543,1583
172065,202308,1794,4083,1237,3264,163,386,645,1848,808,2234
172080,202308,2742,7281,2003,5849,124,397,1330,3763,1454,4160
172085,202308,493,1263,273,806,45,131,88,233,133,364
172090,202308,4946,10605,3606,8623,154,490,2807,6278,2961,6768
172093,202308,535,1473,349,1086,23,116,201,556,224,672
172097,202308,746,1805,408,1163,63,197,155,406,218,603
172100,202308,65233,147379,40561,103900,7570,20911,17448,41833,25018,62744
172110,202308,2098,6440,1630,5620,117,523,1214,4035,1331,4558
172120,202308,6314,16305,4307,12656,591,1700,2421,6983,3012,8683
172125,202308,486,1191,300,834,23,77,160,377,183,454
172130,202308,648,1545,417,1124,20,65,245,572,265,637
172208,202308,3004,6542,2104,5222,163,384,1488,3577,1651,3961
172210,202308,3203,7060,2207,5577,230,549,1486,3781,1716,4330
210005,202308,24337,61711,16173,47133,4580,13764,6053,17206,10633,30970
210010,202308,2674,6679,2352,6240,54,216,2107,5473,2161,5689
210015,202308,3840,10116,3115,9014,140,431,2561,7350,2701,7781
210020,202308,9575,18638,7753,16388,433,764,6590,13837,7023,14601
210030,202308,5517,16298,4727,14989,522,1681,3503,10898,4025,12579
210040,202308,2558,5068,2118,4512,72,193,1843,3803,1915,3996
210043,202308,6802,17467,5328,15194,365,1132,3990,11187,4355,12319
210047,202308,8453,21895,6320,18889,179,730,5223,15387,5402,16117
210050,202308,2994,8088,2242,6644,190,747,1626,4523,1816,5270
210055,202308,2577,6567,2125,5860,58,164,1809,5040,1867,5204
210060,202308,8737,28766,7342,26073,1004,3590,4727,17013,5731,20603
210070,202308,8027,18604,6986,17164,140,379,6290,15252,6430,15631
210080,202308,5388,14574,4875,13908,84,382,4329,12148,4413,12530
210083,202308,7221,16462,5891,14895,123,468,5387,13361,5510,13829
210087,202308,3140,8065,2524,7182,139,422,2052,5775,2191,6197
210090,202308,10908,29760,9528,27376,627,1415,7799,22420,8426,23835
210095,202308,7320,22692,6274,21022,727,2388,4489,15488,5216,17876
210100,202308,7699,20936,6154,18009,946,2575,3850,11266,4796,13841
210110,202308,3759,9240,3290,8610,61,264,2907,7405,2968,7669
210120,202308,35490,75466,27426,64159,1254,2586,21898,49838,23152,52424
210125,202308,5515,12964,4503,11649,920,1885,2982,8275,3902,10160
210130,202308,4931,11317,3776,9770,59,181,3331,8491,3390,8672
210135,202308,2160,4700,1684,3980,63,155,1451,3353,1514,3508
210140,202308,25692,61461,17804,48998,2575,6860,10246,27443,12821,34303
210150,202308,5583,11912,4508,10343,103,290,3828,8474,3931,8764
210160,202308,26747,59948,21371,52545,2380,4932,15572,38496,17952,43428
210170,202308,21324,53917,18263,49436,2218,5286,13098,36068,15316,41354
210173,202308,2588,8341,2357,7935,85,364,2055,6781,2140,7145
210177,202308,3831,9537,3118,8539,447,1113,2217,6206,2664,7319
210180,202308,1848,4091,1503,3609,46,126,1291,3083,1337,3209
210190,202308,6888,15032,5369,12774,109,240,4692,10910,4801,11150
210193,202308,1589,4005,1276,3493,76,233,965,2614,1041,2847
210197,202308,2366,6552,1987,5958,166,446,1523,4615,1689,5061
210200,202308,9687,26373,8029,23711,788,2376,5884,17071,6672,19447
210203,202308,8243,21855,6471,19331,685,1969,4699,14274,5384,16243
210207,202308,4566,10133,3425,8631,205,571,2629,6555,2834,7126
210210,202308,8884,24663,7665,22867,209,975,6318,18368,6527,19343
210215,202308,2900,8132,2423,7383,156,626,1927,5739,2083,6365
210220,202308,8586,23408,7732,22051,267,1304,6750,18386,7017,19690
210230,202308,6867,17223,5905,15626,192,531,5225,13621,5417,14152
210232,202308,14734,39073,11474,33937,1544,4368,7698,23010,9242,27378
210235,202308,4002,10702,3246,9453,147,510,2645,7566,2792,8076
210237,202308,5055,10777,4144,9684,64,181,3834,8800,3898,8981
210240,202308,3036,8122,2559,7319,117,305,2039,5812,2156,6117
210250,202308,7241,17581,6300,16334,138,489,5597,14209,5735,14698
210255,202308,3157,8608,2364,7003,285,879,1430,4045,1715,4924
210260,202308,6358,16569,5245,14834,538,1606,4015,11092,4553,12698
210270,202308,5698,13638,4745,12349,174,631,3991,10111,4165,10742
210275,202308,3948,9018,3146,7974,195,457,2511,6364,2706,6821
210280,202308,7640,17170,5944,14526,151,639,4757,10821,4908,11460
210290,202308,9933,21597,8455,19745,144,403,7768,17806,7912,18209
210300,202308,37928,96443,28500,81231,8106,23245,10426,32660,18532,55905
210310,202308,3601,7982,2962,7063,39,116,2680,6285,2719,6401
210312,202308,3464,7196,2918,6556,37,136,2617,5677,2654,5813
210315,202308,4383,9578,3774,8869,129,323,3456,8052,3585,8375
210317,202308,5171,14227,4537,13359,134,534,4001,11639,4135,12173
210320,202308,33356,69899,29460,64786,384,1439,26911,57520,27295,58959
210325,202308,4163,10746,3148,9234,541,1743,2077,5927,2618,7670
210330,202308,33315,76758,24524,65156,3351,7197,16142,46359,19493,53556
210340,202308,15191,33278,12597,29624,646,1330,10346,24402,10992,25732
210350,202308,11725,27998,9777,25244,183,567,8546,21606,8729,22173
210355,202308,4382,13293,3676,12062,97,510,2987,9598,3084,10108
210360,202308,14754,42351,12154,37613,655,2657,8670,25643,9325,28300
210370,202308,14614,27275,10471,22803,305,511,9535,20841,9840,21352
210375,202308,3804,9698,2467,7421,1016,3064,461,1428,1477,4492
210380,202308,6660,15288,5290,13402,239,669,4350,10726,4589,11395
210390,202308,3896,9711,3466,9029,109,399,3078,7848,3187,8247
210400,202308,5478,13722,4446,12287,277,611,3725,10389,4002,11000
210405,202308,8939,20569,6586,16961,982,2314,3990,10205,4972,12519
210407,202308,2460,6925,1934,5912,174,493,1407,4260,1581,4753
210408,202308,3271,10482,2916,9926,184,773,2303,7788,2487,8561
210409,202308,4566,13725,3826,12459,282,1130,2805,9090,3087,10220
210410,202308,4355,11277,3344,9325,83,312,2659,7090,2742,7402
210420,202308,4564,13030,3727,11474,224,696,2977,9018,3201,9714
210430,202308,2723,7018,2246,6283,189,531,1818,5042,2007,5573
210440,202308,5000,12240,3989,10762,205,447,3388,9077,3593,9524
210450,202308,2687,7043,2146,6164,288,639,1477,4368,1765,5007
210455,202308,5891,13540,4138,11018,1039,2891,1793,4588,2832,7479
210460,202308,3922,10325,3044,9009,133,458,2399,6938,2532,7396
210462,202308,1996,5393,1533,4615,61,189,1179,3525,1240,3714
210465,202308,3139,8045,2578,7206,126,441,2138,5819,2264,6260
210467,202308,7330,19020,5983,17051,899,2431,4191,12075,5090,14506
210470,202308,2014,5292,1446,4367,188,524,971,2935,1159,3459
210480,202308,20071,53684,15700,47527,2220,5033,10363,34011,12583,39044
210490,202308,3843,8724,2827,7299,107,307,2337,5947,2444,6254
210500,202308,7634,24964,6732,23261,422,1596,5408,18379,5830,19975
210510,202308,8225,20785,6917,19098,172,676,6265,16977,6437,17653
210515,202308,4365,11605,3529,10439,232,738,2817,8335,3049,9073
210520,202308,3091,8060,2526,7172,166,485,2001,5535,2167,6020
210530,202308,68287,153250,46597,117905,9446,24817,21498,54331,30944,79148
210535,202308,4518,12260,3874,11254,165,525,3315,9506,3480,10031
210540,202308,18200,46771,14079,40227,2419,6279,8306,24804,10725,31083
210542,202308,7580,16427,5279,13507,590,1533,3801,9580,4391,11113
210545,202308,2469,7013,2102,6324,63,262,1707,4986,1770,5248
210547,202308,4373,13911,3707,12680,311,976,2768,9710,3079,10686
210550,202308,6852,19130,4845,15588,709,2305,2673,8637,3382,10942
210560,202308,4360,12269,3604,10939,131,398,2972,8862,3103,9260
210565,202308,1779,4602,1381,4004,109,341,987,2850,1096,3191
210570,202308,12804,32009,10665,28958,322,872,9037,24303,9359,25175
210580,202308,3404,7913,2463,6560,218,549,1750,4832,1968,5381
210590,202308,4780,12896,3794,11466,94,425,3194,9429,3288,9854
210592,202308,3357,8211,2925,7443,43,166,2504,6157,2547,6323
210594,202308,2869,7513,2023,6035,233,677,1338,4007,1571,4684
210596,202308,3494,10358,2930,9360,359,1157,2122,6869,2481,8026
210598,202308,2398,5821,2048,5326,121,330,1711,4392,1832,4722
210600,202308,3553,8963,2660,7543,365,983,1677,4738,2042,5721
210610,202308,3729,8543,2865,7290,72,272,2388,5843,2460,6115
210620,202308,3559,7802,2760,6752,140,303,2323,5605,2463,5908
210630,202308,3753,10579,3120,9376,272,876,2290,6701,2562,7577
210632,202308,7298,16579,6243,15119,183,574,5463,12851,5646,13425
210635,202308,1830,6027,1640,5640,207,617,1178,4166,1385,4783
210637,202308,3230,8904,2571,7870,181,614,1951,5973,2132,6587
210640,202308,5899,16661,5320,15936,83,411,4755,14001,4838,14412
210650,202308,8146,20485,6839,18598,140,459,5906,15842,6046,16301
210660,202308,9379,24361,7828,21724,173,758,6686,17818,6859,18576
210663,202308,3657,8194,3065,7404,325,600,2254,5793,2579,6393
210667,202308,2244,6407,1897,5841,91,349,1547,4709,1638,5058
210670,202308,6945,17300,5974,15759,161,612,5203,13310,5364,13922
210675,202308,6547,14403,5228,12641,673,1436,3901,9504,4574,10940
210680,202308,5863,11774,4732,10389,90,205,4380,9495,4470,9700
210690,202308,11324,25397,8943,22307,252,684,7923,19146,8175,19830
210700,202308,3222,7861,2435,6656,173,396,1822,4955,1995,5351
210710,202308,6393,16407,5370,14949,110,411,4704,12864,4814,13275
210720,202308,3629,10066,3001,9207,115,458,2545,7715,2660,8173
210725,202308,1535,4362,1151,3617,46,123,841,2691,887,2814
210730,202308,1741,3577,1357,3042,47,92,1190,2653,1237,2745
210735,202308,5293,13243,4177,11673,423,1032,3181,9160,3604,10192
210740,202308,6312,14064,4979,12368,121,266,4190,10207,4311,10473
210745,202308,4945,11958,4119,10744,124,441,3504,8895,3628,9336
210750,202308,32105,76083,25378,65440,4328,9648,15074,40110,19402,49758
210760,202308,7720,15778,6257,14112,140,310,5721,12916,5861,13226
210770,202308,7355,16213,5862,14302,88,339,5250,12488,5338,12827
210780,202308,8676,23900,6887,20708,533,1636,5082,14905,5615,16541
210790,202308,5217,14181,4344,12864,336,971,3316,9969,3652,10940
210800,202308,5825,13780,4734,12223,86,346,4130,10328,4216,10674
210805,202308,5028,15406,4372,14277,253,926,3413,10976,3666,11902
210810,202308,5941,15329,4995,13932,529,1279,3827,10907,4356,12186
210820,202308,8452,21834,6510,18472,1147,3044,3520,10118,4667,13162
210825,202308,10590,23663,9242,21818,240,706,8378,19236,8618,19942
210830,202308,10650,24569,9132,22488,934,1668,7206,18374,8140,20042
210840,202308,6051,10375,5260,9368,38,138,4987,8633,5025,8771
210845,202308,7323,17357,5882,15522,145,386,5236,13687,5381,14073
210850,202308,8560,21926,6787,19183,501,1470,5265,14604,5766,16074
210860,202308,25803,56272,19854,48448,1594,3251,15395,38330,16989,41581
210870,202308,8823,19181,6653,16484,202,450,5761,14094,5963,14544
210880,202308,4941,13070,4003,11573,302,1012,2962,8390,3264,9402
210890,202308,6032,13091,5196,11885,168,449,4631,10277,4799,10726
210900,202308,5799,15130,4029,11759,1470,4251,834,2703,2304,6954
210905,202308,2743,5610,2245,4961,53,117,2098,4608,2151,4725
210910,202308,8724,24477,6514,20359,1246,3743,3446,10605,4692,14348
210920,202308,3715,10256,3141,9414,86,354,2744,8037,2830,8391
210923,202308,2325,5203,1885,4517,91,205,1507,3480,1598,3685
210927,202308,5431,16303,4452,14798,805,2483,2631,9085,3436,11568
210930,202308,3497,8994,2904,7971,97,310,2457,6482,2554,6792
210940,202308,4034,10860,3427,10038,279,1210,2690,7245,2969,8455
210945,202308,10163,22975,8638,21021,689,1249,6810,16945,7499,18194
210950,202308,6414,15801,4652,13173,624,1440,2981,8874,3605,10314
210955,202308,1785,4857,1368,4132,185,537,857,2547,1042,3084
210960,202308,11053,29451,8608,25137,3593,10308,2298,7573,5891,17881
210970,202308,2090,4800,1605,3956,89,236,1287,3002,1376,3238
210975,202308,1993,5531,1672,4965,228,692,1152,3345,1380,4037
210980,202308,12714,24623,10862,22499,280,473,9935,20403,10215,20876
210990,202308,21626,52520,15730,43895,1820,4583,10500,29764,12320,34347
211000,202308,17213,43849,13288,38322,3163,8023,7874,24143,11037,32166
211003,202308,7569,17428,6049,15492,149,601,5121,12801,5270,13402
211010,202308,8378,23550,7329,22121,165,742,6418,19207,6583,19949
211020,202308,11325,26089,9497,23833,233,665,8297,20727,8530,21392
211023,202308,2467,7024,2110,6428,133,373,1651,4932,1784,5305
211027,202308,4749,11534,4259,10769,99,349,3852,9497,3951,9846
211030,202308,4539,11297,3794,10157,431,1127,2792,7552,3223,8679
211040,202308,5272,16519,4623,15380,148,714,3983,12987,4131,13701
211050,202308,10867,24447,9150,22136,175,552,7999,18968,8174,19520
211060,202308,9231,22386,7987,20550,264,900,6934,17313,7198,18213
211065,202308,2946,6750,2282,5836,124,279,1924,4914,2048,5193
211070,202308,10204,27071,8181,23807,389,1236,6699,19118,7088,20354
211080,202308,1559,3738,1149,3057,26,110,881,2147,907,2257
211085,202308,2633,6461,2018,5606,231,549,1478,4272,1709,4821
211090,202308,3708,9073,3176,8351,51,181,2846,7349,2897,7530
211100,202308,9115,18464,8030,17127,83,197,7398,15535,7481,15732
211102,202308,3899,10980,3346,10088,583,1785,2281,6797,2864,8582
211105,202308,2741,7625,2212,6675,123,365,1717,5056,1840,5421
211107,202308,5461,15426,4295,13476,176,591,3380,10714,3556,11305
211110,202308,7692,17703,5787,14676,355,1007,4609,11309,4964,12316
211120,202308,62408,135649,46933,114221,7918,17447,28574,70707,36492,88154
211125,202308,2155,5854,1670,5061,35,141,1364,4046,1399,4187
211130,202308,227030,486418,180521,415271,24464,50762,117793,270800,142257,321562
211140,202308,5556,14648,4438,12918,176,507,3594,10326,3770,10833
211150,202308,11549,27044,9026,23491,572,1165,6910,18453,7482,19618
211153,202308,3616,8723,2308,6912,455,1200,1290,4101,1745,5301
211157,202308,1513,4140,1212,3577,108,347,805,2310,913,2657
211160,202308,6554,14154,4899,11651,188,659,3851,8508,4039,9167
211163,202308,1726,4949,1472,4530,79,257,1176,3645,1255,3902
211167,202308,2041,5186,1782,4791,40,120,1558,4122,1598,4242
211170,202308,8826,17067,7659,15572,108,289,7101,14074,7209,14363
211172,202308,3014,7577,2338,6467,100,317,1877,4970,1977,5287
211174,202308,3439,8620,2965,8044,48,200,2712,7250,2760,7450
211176,202308,4941,12503,3621,10445,243,765,2802,7885,3045,8650
211178,202308,6512,12225,5415,11017,47,188,5142,10239,5189,10427
211180,202308,4946,14314,4249,13151,175,683,3409,10305,3584,10988
211190,202308,3822,9393,3095,8269,50,214,2698,7005,2748,7219
211195,202308,1904,4373,1530,3778,70,166,1298,3164,1368,3330
211200,202308,2467,6757,1713,5323,174,572,1158,3453,1332,4025
211210,202308,7168,19965,5969,18028,606,1827,4379,13110,4985,14937
211220,202308,53353,113521,40851,96140,3935,8651,29672,68323,33607,76974
211223,202308,6264,15248,4597,12696,648,1821,2672,7227,3320,9048
211227,202308,1996,5553,1645,5016,62,244,1319,4004,1381,4248
211230,202308,10439,25091,8386,21982,327,756,7068,18318,7395,19074
211240,202308,12729,28244,11634,26856,160,574,10932,24722,11092,25296
211245,202308,8981,18747,7432,17002,190,447,6857,15426,7047,15873
211250,202308,18393,46869,15779,42584,1384,3754,12121,32083,13505,35837
211260,202308,9961,26976,8172,24712,293,1003,7014,21133,7307,22136
211270,202308,11957,33044,9788,29995,444,1546,7701,23526,8145,25072
211280,202308,19461,40734,16374,36556,339,872,14765,32085,15104,32957
211285,202308,2429,6752,2022,6109,204,676,1410,4173,1614,4849
211290,202308,8525,22577,7043,20123,426,1315,5376,15011,5802,16326
211300,202308,8348,22348,6709,19419,474,1461,4826,13524,5300,14985
211400,202308,13886,33957,10543,28905,1570,3991,6695,18901,8265,22892
220005,202308,2369,5308,1962,4651,82,198,1629,3705,1711,3903
220010,202308,1774,4403,1307,3542,86,183,977,2616,1063,2799
220020,202308,5653,11775,4515,10105,273,537,3810,8324,4083,8861
220025,202308,2731,5315,2140,4408,55,100,1813,3598,1868,3698
220027,202308,1662,3494,1305,2953,33,88,1105,2404,1138,2492
220030,202308,4697,9727,3947,8588,118,250,3482,7374,3600,7624
220040,202308,10197,26775,8131,22759,1689,4341,4377,12523,6066,16864
220045,202308,1956,4833,1488,4039,51,222,1190,3024,1241,3246
220050,202308,6842,14308,5516,12493,84,287,4913,10615,4997,10902
220060,202308,3465,5864,2730,4984,91,176,2490,4458,2581,4634
220070,202308,2807,6440,2137,5446,97,275,1678,4121,1775,4396
220080,202308,884,2253,680,1905,23,90,539,1435,562,1525
220090,202308,2021,4248,1484,3403,54,136,1203,2691,1257,2827
220095,202308,1258,2216,1061,1950,27,62,954,1682,981,1744
220100,202308,1676,3952,1193,3150,37,124,935,2299,972,2423
220105,202308,2371,6420,1869,5536,185,582,1305,3793,1490,4375
220110,202308,4251,9884,3358,8422,79,304,2809,6811,2888,7115
220115,202308,3503,8805,2898,7814,183,542,2241,5836,2424,6378
220117,202308,1594,3395,1159,2733,30,87,932,2100,962,2187
220120,202308,20881,39498,18075,35889,200,543,16623,32163,16823,32706
220130,202308,1324,3079,1038,2671,34,131,892,2189,926,2320
220140,202308,2850,5104,2163,4263,80,145,1815,3559,1895,3704
220150,202308,7935,19605,6624,17237,190,613,5399,13458,5589,14071
220155,202308,1417,3678,1042,2971,32,99,737,2016,769,2115
220157,202308,1303,2764,1010,2326,48,116,784,1736,832,1852
220160,202308,3486,8235,2643,6693,77,245,2110,5110,2187,5355
220170,202308,1809,4379,1366,3684,40,147,1095,2861,1135,3008
220173,202308,2497,6301,1782,4977,60,193,1399,3766,1459,3959
220177,202308,2867,6123,2555,5732,38,137,2375,5163,2413,5300
220180,202308,1394,2831,1052,2241,6,23,906,1805,912,1828
220190,202308,10264,20253,7946,17071,647,1205,5783,12459,6430,13664
220191,202308,2011,5185,1691,4617,147,434,1230,3228,1377,3662
220192,202308,2405,5672,1625,4300,58,194,1285,3330,1343,3524
220194,202308,2275,5291,1801,4430,40,155,1513,3529,1553,3684
220196,202308,2557,5767,2153,5091,26,108,1807,4085,1833,4193
220198,202308,1552,3405,1254,3012,19,59,1125,2694,1144,2753
220200,202308,6031,15622,5003,14063,206,694,4028,11043,4234,11737
220202,202308,2560,6178,2014,5263,34,137,1684,4217,1718,4354
220205,202308,3293,7525,2717,6482,71,218,2267,5204,2338,5422
220207,202308,943,2470,741,2112,82,206,444,1259,526,1465
220208,202308,2151,5936,1628,4903,533,1680,551,1589,1084,3269
220209,202308,1867,4936,1408,4005,23,96,1110,3058,1133,3154
220210,202308,2277,4591,1787,3841,40,91,1525,3139,1565,3230
220211,202308,1992,4152,1672,3702,41,139,1413,3019,1454,3158
220213,202308,2140,4939,1636,4008,46,133,1274,2909,1320,3042
220217,202308,2949,6979,2565,6511,174,363,2217,5757,2391,6120
220220,202308,16809,33086,13380,27927,384,921,11420,22908,11804,23829
220225,202308,1217,2644,943,2272,18,71,837,1945,855,2016
220230,202308,6937,15030,5391,12699,394,793,4324,10020,4718,10813
220240,202308,3972,9660,3042,8010,102,354,2434,6121,2536,6475
220245,202308,2501,4333,1770,3443,26,77,1600,3025,1626,3102
220250,202308,3671,8718,3016,7851,51,166,2685,6863,2736,7029
220253,202308,2009,4823,1549,4077,45,132,1265,3229,1310,3361
220255,202308,2428,4984,1944,4290,59,183,1659,3479,1718,3662
220260,202308,6303,15080,5009,12804,275,736,3934,9823,4209,10559
220265,202308,1910,4838,1606,4354,81,264,1293,3338,1374,3602
220270,202308,7401,21130,6481,19298,198,763,5337,15073,5535,15836
220271,202308,1799,3946,1455,3397,59,140,1218,2773,1277,2913
220272,202308,2073,5347,1650,4528,71,220,1240,3233,1311,3453
220273,202308,1499,3915,1126,3220,74,234,805,2263,879,2497
220275,202308,3125,5917,2299,4784,80,137,1994,4070,2074,4207
220277,202308,2822,5832,2140,4779,102,204,1784,3838,1886,4042
220280,202308,2405,4350,1912,3723,21,42,1721,3279,1742,3321
220285,202308,2032,4019,1637,3525,25,77,1476,3086,1501,3163
220290,202308,8433,20522,6126,16933,589,1458,4091,11408,4680,12866
220300,202308,2280,5904,1641,4958,69,286,1223,3549,1292,3835
220310,202308,3896,8968,2847,7556,108,336,2334,6075,2442,6411
220320,202308,3724,9331,2687,7499,64,286,2117,5620,2181,5906
220323,202308,2048,5033,1459,4036,58,218,1171,3053,1229,3271
220325,202308,1464,3954,1102,3270,33,124,831,2378,864,2502
220327,202308,2026,4882,1609,4170,69,254,1278,3107,1347,3361
220330,202308,6612,13004,5293,11349,133,375,4608,9489,4741,9864
220335,202308,2239,5494,1922,5007,132,291,1550,4031,1682,4322
220340,202308,2081,5195,1414,3981,163,463,778,2113,941,2576
220342,202308,1495,3649,1228,3203,118,229,914,2445,1032,2674
220345,202308,3585,7206,2499,5657,33,86,2156,4710,2189,4796
220350,202308,3884,8941,2768,7073,231,589,1875,4636,2106,5225
220360,202308,1610,3566,1151,2802,29,90,912,2097,941,2187
220370,202308,11044,27191,9277,24200,512,1368,7500,19076,8012,20444
220375,202308,2082,4806,1747,4370,36,126,1625,4004,1661,4130
220380,202308,1875,3724,1371,3005,26,55,1187,2572,1213,2627
220385,202308,1130,2215,819,1689,8,25,730,1452,738,1477
220390,202308,16286,33919,11796,26938,2091,4767,6540,14391,8631,19158
220400,202308,1821,3885,1231,2911,30,97,963,2112,993,2209
220410,202308,1420,3458,1035,2769,32,113,826,2101,858,2214
220415,202308,988,2332,734,1874,23,50,547,1352,570,1402
220420,202308,2213,5738,1575,4465,154,457,1000,2684,1154,3141
220430,202308,3563,7538,2903,6612,61,130,2526,5613,2587,5743
220435,202308,2499,5311,1978,4451,49,130,1641,3539,1690,3669
220440,202308,3952,8949,3189,7805,70,302,2753,6328,2823,6630
220450,202308,3348,7318,2610,6273,58,206,2220,5140,2278,5346
220455,202308,1748,4177,1542,3887,30,91,1344,3332,1374,3423
220460,202308,1393,2793,1177,2467,28,54,1012,2045,1040,2099
220465,202308,2968,7850,2446,6972,184,476,1847,5175,2031,5651
220470,202308,4699,11134,3699,9344,201,440,2779,6825,2980,7265
220480,202308,3157,7470,2210,5829,260,540,1414,3722,1674,4262
220490,202308,2886,6338,2238,5387,39,125,1934,4521,1973,4646
220500,202308,4035,8612,3020,6957,159,328,2335,5158,2494,5486
220510,202308,3257,7551,2421,6060,144,357,1858,4619,2002,4976
220515,202308,2210,4481,1872,3958,75,116,1596,3339,1671,3455
220520,202308,6326,13879,5234,12135,125,332,4435,9982,4560,10314
220525,202308,1673,3540,1302,3051,45,110,1130,2636,1175,2746
220527,202308,2024,4255,1572,3531,83,175,1373,3049,1456,3224
220530,202308,2023,4041,1540,3415,166,342,1103,2471,1269,2813
220535,202308,951,2352,823,2126,16,52,635,1525,651,1577
220540,202308,3843,10626,3257,9466,238,691,2470,7062,2708,7753
220545,202308,1830,4683,1505,4142,83,276,1255,3356,1338,3632
220550,202308,10485,29596,8477,25533,646,2027,5694,16343,6340,18370
220551,202308,1748,4131,1408,3529,21,60,1181,2858,1202,2918
220552,202308,1900,4955,1414,4033,29,117,1121,3012,1150,3129
220553,202308,2594,5067,2002,4240,25,54,1827,3806,1852,3860
220554,202308,1167,2514,841,2002,65,125,620,1440,685,1565
220555,202308,4775,8578,3939,7523,58,166,3473,6537,3531,6703
220556,202308,1563,3857,1133,2999,45,186,770,1813,815,1999
220557,202308,2302,5971,1559,4434,103,352,1136,3061,1239,3413
220558,202308,1769,4048,1323,3381,35,124,1095,2679,1130,2803
220559,202308,2224,4731,1714,3874,66,106,1413,3156,1479,3262
220560,202308,2369,4448,1874,3832,36,102,1687,3359,1723,3461
220570,202308,9918,25335,8387,22782,790,1981,6061,16169,6851,18150
220580,202308,8132,19342,6867,17349,159,480,5927,14683,6086,15163
220585,202308,2511,6857,1873,5541,75,218,1454,4200,1529,4418
220590,202308,2029,4215,1564,3492,107,231,1257,2723,1364,2954
220595,202308,3373,7986,2764,7044,83,298,2264,5496,2347,5794
220600,202308,2233,3751,1776,3209,22,32,1658,2940,1680,2972
220605,202308,1701,4562,1335,3823,28,119,1030,2834,1058,2953
220610,202308,3545,8347,3076,7642,36,101,2841,6944,2877,7045
220620,202308,10910,25952,9278,23469,159,655,8239,20141,8398,20796
220630,202308,419,1111,295,890,31,103,175,477,206,580
220635,202308,2147,5577,1715,4702,58,178,1393,3700,1451,3878
220640,202308,2875,7065,2303,6126,81,276,1802,4612,1883,4888
220650,202308,3021,6646,2399,5670,67,155,2029,4735,2096,4890
220660,202308,3153,8467,2408,7104,77,312,1964,5610,2041,5922
220665,202308,1704,4175,1344,3561,31,141,1171,2956,1202,3097
220667,202308,1903,4982,1610,4450,76,221,1273,3437,1349,3658
220669,202308,1973,5171,1709,4702,39,136,1484,3957,1523,4093
220670,202308,2846,5942,2109,4868,44,131,1821,4075,1865,4206
220672,202308,4119,8982,3187,7748,114,362,2665,6211,2779,6573
220675,202308,1559,3807,1277,3275,111,309,938,2316,1049,2625
220680,202308,3780,7855,3397,7364,169,274,3006,6511,3175,6785
220690,202308,1869,4364,1392,3549,109,310,1004,2429,1113,2739
220695,202308,1100,2734,919,2413,30,82,761,1959,791,2041
220700,202308,15440,29447,11707,24125,432,975,9591,18787,10023,19762
220710,202308,1064,2555,710,1947,31,106,547,1430,578,1536
220720,202308,2700,5364,2206,4671,34,86,1920,3923,1954,4009
220730,202308,1708,3879,1324,3230,19,71,1115,2575,1134,2646
220735,202308,1210,2435,840,1829,55,120,637,1325,692,1445
220740,202308,1623,3741,1174,3079,80,203,912,2354,992,2557
220750,202308,5332,10933,4330,9524,244,394,3765,8316,4009,8710
220755,202308,1833,3678,1352,2945,48,99,1112,2355,1160,2454
220760,202308,4214,8938,3465,7956,63,209,3145,7025,3208,7234
220770,202308,35340,87340,27630,73306,8313,22331,10218,26681,18531,49012
220775,202308,1774,3658,1491,3307,19,53,1403,3071,1422,3124
220777,202308,1826,4112,1340,3330,35,74,946,2427,981,2501
220779,202308,1455,3503,1154,3024,96,182,909,2407,1005,2589
220780,202308,7319,15623,6137,13861,448,970,4665,10417,5113,11387
220785,202308,1758,3486,1451,3080,24,51,1359,2840,1383,2891
220790,202308,12754,30512,10694,27287,316,1023,8825,21965,9141,22988
220793,202308,1193,2639,899,2145,25,76,772,1800,797,1876
220795,202308,1642,3752,1314,3255,54,149,1120,2696,1174,2845
220800,202308,26677,50015,20826,41588,2073,4306,15554,29504,17627,33810
220810,202308,3765,8993,2912,7568,82,208,2247,5833,2329,6041
220820,202308,7444,15351,6086,13284,321,563,5083,10993,5404,11556
220830,202308,9383,20854,7710,18185,444,987,5975,13558,6419,14545
220840,202308,16760,41068,13080,33942,1572,3958,8722,21632,10294,25590
220850,202308,3559,9602,2994,8768,71,284,2576,7425,2647,7709
220855,202308,1051,1950,861,1704,22,50,787,1543,809,1593
220860,202308,1514,2904,1202,2465,22,62,1095,2170,1117,2232
220865,202308,2677,6631,1859,5100,54,224,1333,3418,1387,3642
220870,202308,3988,8784,3001,7396,65,219,2564,6095,2629,6314
220880,202308,8244,14514,6705,12625,191,403,5983,11008,6174,11411
220885,202308,1827,4343,1447,3756,124,323,1119,2858,1243,3181
220887,202308,1977,3582,1520,2962,49,68,1399,2697,1448,2765
220890,202308,1673,4456,1284,3764,53,188,985,2792,1038,2980
220900,202308,2614,5202,2044,4405,41,118,1768,3642,1809,3760
220910,202308,2181,4666,1699,3913,328,567,1137,2760,1465,3327
220915,202308,1082,2690,742,2051,41,122,515,1329,556,1451
220920,202308,1980,4964,1596,4382,124,348,1225,3318,1349,3666
220930,202308,2418,5041,1875,4300,43,132,1614,3704,1657,3836
220935,202308,1259,3304,917,2580,24,104,607,1590,631,1694
220937,202308,1764,4054,1320,3269,39,133,1061,2475,1100,2608
220940,202308,2293,4740,1746,3849,54,143,1433,3012,1487,3155
220945,202308,591,1800,420,1438,40,166,256,836,296,1002
220950,202308,1634,3335,1050,2438,14,39,859,1866,873,1905
220955,202308,2031,4314,1505,3437,43,129,1263,2762,1306,2891
220960,202308,879,2068,580,1545,60,191,348,836,408,1027
220965,202308,2265,5083,1814,4362,31,140,1590,3658,1621,3798
220970,202308,2603,4990,1826,3872,27,93,1584,3208,1611,3301
220975,202308,920,2113,686,1759,23,73,581,1416,604,1489
220980,202308,1617,3631,1355,3233,33,95,1158,2653,1191,2748
220985,202308,1786,3742,1394,3074,100,177,1076,2325,1176,2502
220987,202308,1827,4559,1514,4014,49,179,1257,3233,1306,3412
220990,202308,1981,4845,1602,4213,35,131,1296,3315,1331,3446
220995,202308,1721,3805,1331,3163,21,61,1145,2647,1166,2708
220997,202308,2904,7378,2505,6691,63,236,2121,5420,2184,5656
221000,202308,5896,13509,4653,11538,232,643,3628,8614,3860,9257
221005,202308,1998,4359,1712,3871,33,106,1439,3073,1472,3179
221010,202308,1552,2945,1132,2410,32,83,957,1947,989,2030
221020,202308,1810,4939,1451,4235,35,128,1114,3162,1149,3290
221030,202308,2078,4106,1633,3500,24,69,1458,3078,1482,3147
221035,202308,1901,4124,1427,3420,59,127,1184,2788,1243,2915
221037,202308,845,2007,617,1571,19,58,462,1085,481,1143
221038,202308,617,1525,440,1208,35,87,294,780,329,867
221039,202308,989,2411,762,2032,32,101,588,1498,620,1599
221040,202308,5457,13573,4086,11107,293,820,3008,7912,3301,8732
221050,202308,5667,11044,4684,9639,93,232,4278,8639,4371,8871
221060,202308,12049,28307,9033,23066,497,1177,6905,17074,7402,18251
221062,202308,1654,4100,1302,3525,122,280,937,2539,1059,2819
221063,202308,1526,3528,1155,2863,43,117,935,2215,978,2332
221065,202308,3593,7541,2882,6400,36,78,2559,5530,2595,5608
221070,202308,3986,10961,2975,8894,524,1476,1689,5139,2213,6615
221080,202308,4414,9370,3399,7859,68,216,2770,6013,2838,6229
221090,202308,1685,3613,1311,3011,20,45,1135,2532,1155,2577
221093,202308,2085,4605,1710,3937,176,361,1226,2711,1402,3072
221095,202308,1076,2458,829,2092,32,77,671,1660,703,1737
221097,202308,991,2240,687,1723,24,76,511,1197,535,1273
221100,202308,189273,413154,146257,339548,10906,27501,104026,225344,114932,252845
221110,202308,14163,33132,11977,29961,426,1136,10112,24680,10538,25816
221120,202308,6113,15423,4939,13466,205,638,3928,10409,4133,11047
221130,202308,7326,15602,5239,11848,1406,2734,2701,6078,4107,8812
221135,202308,2437,5083,1981,4462,94,154,1675,3797,1769,3951
221140,202308,1922,3502,1478,2929,71,127,1242,2389,1313,2516
221150,202308,1357,2999,908,2239,32,98,707,1626,739,1724
221160,202308,886,1936,710,1661,40,65,535,1244,575,1309
221170,202308,1351,2996,1184,2703,20,52,1088,2434,1108,2486
230010,202308,3607,8444,2695,6851,200,456,2024,4987,2224,5443
230015,202308,4497,11683,3712,10075,249,718,2525,6644,2774,7362
230020,202308,18843,47615,16523,43719,1324,3224,12669,33116,13993,36340
230030,202308,15585,34238,12073,29031,647,1359,9260,22326,9907,23685
230040,202308,5691,12042,4509,10238,92,283,3556,8162,3648,8445
230050,202308,3015,8656,2037,6303,368,1092,919,2599,1287,3691
230060,202308,2998,6948,2111,5352,54,193,1687,4099,1741,4292
230070,202308,5490,11981,3888,9155,673,1478,2398,5559,3071,7037
230075,202308,12299,32298,10494,29038,935,2407,7789,21023,8724,23430
230080,202308,3669,6762,2672,5508,18,47,2446,4927,2464,4974
230090,202308,5643,11621,4267,9406,134,334,3601,7561,3735,7895
230100,202308,28244,59764,22405,50916,2334,5219,15174,33570,17508,38789
230110,202308,17605,45587,13487,37411,3047,8020,6060,16302,9107,24322
230120,202308,9870,22909,7561,18964,1030,2435,4774,11737,5804,14172
230125,202308,3782,8814,2975,7460,125,367,2272,5379,2397,5746
230130,202308,6881,18423,5036,14555,447,1141,3392,9597,3839,10738
230140,202308,4334,11225,3289,9106,104,373,2467,6428,2571,6801
230150,202308,1918,5033,1459,4082,244,639,795,2222,1039,2861
230160,202308,8889,17888,7156,15332,283,566,5954,12399,6237,12965
230170,202308,7470,19122,5529,15257,513,1332,3699,9918,4212,11250
230180,202308,2002,4755,1481,3775,27,97,1215,2943,1242,3040
230185,202308,5765,13306,4368,10996,564,1332,2879,7229,3443,8561
230190,202308,18226,49382,13110,38640,2249,6321,6351,18037,8600,24358
230195,202308,7151,18039,5958,15911,316,827,4531,11855,4847,12682
230200,202308,5921,14666,4574,12084,365,869,3254,8287,3619,9156
230205,202308,5622,13131,4674,11718,534,1070,3358,8479,3892,9549
230210,202308,13264,26771,10608,22968,424,922,8636,17958,9060,18880
230220,202308,19068,40950,15675,35940,1158,2625,12055,26725,13213,29350
230230,202308,8776,21800,7455,19242,810,1681,5284,13687,6094,15368
230240,202308,16989,37750,13216,31547,940,1941,9678,22410,10618,24351
230250,202308,11704,28049,9887,24825,1773,4109,5532,13253,7305,17362
230260,202308,18622,46690,14869,39810,2125,5387,9023,23540,11148,28927
230270,202308,8666,20819,5992,15826,858,2109,3422,9112,4280,11221
230280,202308,24649,55666,19048,46039,556,1876,15183,34066,15739,35942
230290,202308,6233,14067,5016,11912,237,566,3989,9116,4226,9682
230300,202308,6189,13769,5175,12327,100,323,4391,10187,4491,10510
230310,202308,5863,14671,4346,11731,195,601,3099,7905,3294,8506
230320,202308,9294,23589,7221,19947,274,989,5368,14087,5642,15076
230330,202308,5883,13840,4092,10461,217,525,3045,7454,3262,7979
230340,202308,4620,12865,3692,10954,348,987,2396,6900,2744,7887
230350,202308,23620,54140,18995,46651,1212,3364,13634,31942,14846,35306
230360,202308,3765,8495,2749,6806,149,353,2026,4977,2175,5330
230365,202308,3723,7783,2961,6656,87,235,2586,5711,2673,5946
230370,202308,104703,219079,85813,189904,5723,13468,66260,139039,71983,152507
230380,202308,7472,18288,5430,14450,148,466,4103,10341,4251,10807
230390,202308,4092,10290,3276,8920,85,357,2572,6695,2657,7052
230393,202308,4221,10237,3121,8123,72,300,2491,6080,2563,6380
230395,202308,6878,16868,5169,13634,521,1380,3329,8298,3850,9678
230400,202308,7030,16461,5669,14158,145,485,4590,10764,4735,11249
230410,202308,16455,43170,12606,36114,1441,3874,8140,22915,9581,26789
230420,202308,38818,90636,28638,72188,3425,8475,17270,41009,20695,49484
230423,202308,5411,14334,4383,12223,337,956,3072,8273,3409,9229
230425,202308,7687,20118,6598,17905,764,1907,4451,11881,5215,13788
230426,202308,3282,7521,2144,5369,75,224,1599,3802,1674,4026
230427,202308,2161,5420,1334,3693,104,304,856,2158,960,2462
230428,202308,12591,30292,9829,25545,1599,3994,5255,12960,6854,16954
230430,202308,5966,15209,4263,12069,196,507,3163,8684,3359,9191
230435,202308,7881,17571,5540,13423,822,1916,3146,7356,3968,9272
230440,202308,628847,1264638,491041,1051753,36738,84427,353816,711650,390554,796077
230445,202308,4926,12156,3687,9882,345,867,2363,5974,2708,6841
230450,202308,4620,11257,3638,9600,188,555,2623,6426,2811,6981
230460,202308,2729,6282,2239,5522,81,252,1816,4340,1897,4592
230465,202308,5048,12243,3908,10110,286,631,2874,7219,3160,7850
230470,202308,14417,40109,12180,35885,1100,2862,8614,24626,9714,27488
230480,202308,1898,4568,1393,3636,83,252,996,2447,1079,2699
230490,202308,3381,8280,2537,6636,232,668,1606,3813,1838,4481
230495,202308,7622,18251,6004,15305,891,2235,3668,8889,4559,11124
230500,202308,11439,32391,9255,28214,725,2040,6673,20272,7398,22312
230510,202308,2179,5191,1581,4015,177,482,997,2349,1174,2831
230520,202308,5907,13823,4735,11765,383,899,3495,8371,3878,9270
230523,202308,21081,55046,13753,38976,3180,8624,3444,10034,6624,18658
230526,202308,4819,11423,3714,9543,273,535,2677,6959,2950,7494
230530,202308,6713,18814,5204,15843,1333,3902,2599,8014,3932,11916
230533,202308,6068,11387,4310,8780,98,272,3613,6911,3711,7183
230535,202308,5836,15077,4445,12536,382,1098,2794,7620,3176,8718
230540,202308,18515,45212,14525,38423,379,1254,11580,29395,11959,30649
230550,202308,28415,63604,20950,50574,2800,5715,13346,31461,16146,37176
230560,202308,9217,19272,6795,15602,657,909,5066,12205,5723,13114
230565,202308,3726,8950,2927,7519,134,361,2254,5540,2388,5901
230570,202308,4041,9244,3143,7840,84,271,2564,6136,2648,6407
230580,202308,15183,32460,12029,27623,677,1379,9887,22176,10564,23555
230590,202308,11818,28590,9031,23608,830,2051,6337,16139,7167,18190
230600,202308,4645,10251,3394,8136,233,478,2294,5492,2527,5970
230610,202308,8341,19991,6835,17434,564,1381,5161,12860,5725,14241
230620,202308,2773,6115,2026,4743,71,213,1518,3214,1589,3427
230625,202308,13200,30874,10325,25577,2085,5279,5091,11886,7176,17165
230630,202308,14288,35237,11456,29956,1624,3800,6908,17969,8532,21769
230640,202308,32699,89307,27116,78944,1816,5545,19635,54644,21451,60189
230650,202308,6326,14946,4946,12578,372,882,3780,9306,4152,10188
230655,202308,12124,33526,10923,31371,830,2118,8641,24705,9471,26823
230660,202308,7229,18721,5476,15560,182,731,4258,11623,4440,12354
230670,202308,7173,15158,4763,11312,237,516,3764,8618,4001,9134
230680,202308,3497,8302,2562,6635,168,372,1754,4480,1922,4852
230690,202308,8528,22371,6373,17981,555,1535,3857,10646,4412,12181
230700,202308,12978,28137,9359,21607,361,989,7291,15929,7652,16918
230710,202308,8120,22786,6364,18856,684,2037,4026,11310,4710,13347
230720,202308,2298,6049,1667,4804,123,367,1045,2844,1168,3211
230725,202308,5886,14994,4985,13388,636,1716,3107,8004,3743,9720
230730,202308,76108,175657,54176,140211,12071,30340,22574,58610,34645,88950
230740,202308,7271,18012,5572,15094,190,603,4253,11230,4443,11833
230750,202308,10256,23959,7334,18692,152,518,5943,14244,6095,14762
230760,202308,14608,33574,11408,28120,588,1674,8306,19148,8894,20822
230763,202308,5825,13765,4394,11256,108,431,3484,8351,3592,8782
230765,202308,59284,137063,46149,113883,4693,12137,30065,69642,34758,81779
230770,202308,36009,70952,27948,59547,1851,4096,21081,42656,22932,46752
230780,202308,8209,24447,6831,21200,986,2773,4109,12750,5095,15523
230790,202308,3921,9351,3340,8407,153,441,2559,6102,2712,6543
230800,202308,11027,29525,8770,24766,1093,2959,5310,14178,6403,17137
230810,202308,13057,35169,10644,30617,889,2183,7443,20913,8332,23096
230820,202308,4361,12453,3175,9766,442,1341,1825,5353,2267,6694
230830,202308,9154,21556,7083,17862,396,923,5234,12649,5630,13572
230835,202308,4924,10413,3517,8194,129,307,2933,6573,3062,6880
230837,202308,4980,10965,4152,9662,83,266,3656,8091,3739,8357
230840,202308,11543,30294,9217,26023,871,2373,6479,17993,7350,20366
230850,202308,12417,29813,9731,25012,597,1418,7214,18161,7811,19579
230860,202308,7953,14683,6213,12177,182,356,5500,10416,5682,10772
230870,202308,22640,44550,17436,36090,873,1643,14018,27801,14891,29444
230880,202308,2361,6376,2021,5700,73,264,1545,4111,1618,4375
230890,202308,5616,15587,4717,13880,265,951,3347,9501,3612,10452
230900,202308,4108,10145,3160,8256,219,640,2189,5380,2408,6020
230910,202308,4238,9245,3116,7519,71,291,2610,6048,2681,6339
230920,202308,5781,14216,4294,11623,162,519,3223,8342,3385,8861
230930,202308,8395,20776,6237,16899,924,2018,3738,10195,4662,12213
230940,202308,10205,22185,8049,18806,207,496,6855,15612,7062,16108
230945,202308,7869,19771,6251,16739,548,1227,4265,11086,4813,12313
230950,202308,7776,16670,6271,14442,203,495,5204,11705,5407,12200
230960,202308,15757,40577,12052,32996,2098,5651,5871,15112,7969,20763
230970,202308,19733,45723,15229,38077,1938,4698,9355,22450,11293,27148
230980,202308,4369,9231,3470,7708,283,582,2594,5574,2877,6156
230990,202308,2048,5049,1556,4110,84,290,1153,2846,1237,3136
231000,202308,3651,7993,2580,6098,75,214,2016,4494,2091,4708
231010,202308,4458,8944,3169,6901,75,207,2679,5564,2754,5771
231020,202308,11371,28391,9433,24732,1762,4093,5553,14672,7315,18765
231025,202308,10615,24041,8876,21218,629,1423,6797,15849,7426,17272
231030,202308,8742,23603,6084,18154,845,2484,3482,10213,4327,12697
231040,202308,3791,8700,3032,7365,112,305,2482,5735,2594,6040
231050,202308,14806,32242,10596,24722,642,1663,8201,18226,8843,19889
231060,202308,3600,8606,2963,7573,139,386,2308,5769,2447,6155
231070,202308,9829,24898,7897,21368,823,2006,5201,13738,6024,15744
231080,202308,4542,11377,3348,9158,260,698,2255,6003,2515,6701
231085,202308,9047,19116,6663,15863,318,801,4989,11298,5307,12099
231090,202308,5203,12161,3599,9120,169,473,2557,6101,2726,6574
231095,202308,2648,7269,1872,5574,173,507,1218,3520,1391,4027
231100,202308,3594,9191,2740,7582,149,447,2031,5388,2180,5835
231110,202308,4511,11837,3748,10355,1171,3130,1644,4272,2815,7402
231120,202308,2966,7248,2333,6169,85,215,1753,4485,1838,4700
231123,202308,2419,5559,1741,4359,107,265,1220,2929,1327,3194
231126,202308,6665,16081,4852,12721,325,743,3620,9325,3945,10068
231130,202308,31230,62606,24035,52550,1286,3380,18578,37585,19864,40965
231135,202308,5013,12520,3802,10168,270,655,2650,6902,2920,7557
231140,202308,21723,51307,16363,41876,1565,4007,11106,27013,12671,31020
231150,202308,7073,17357,4318,11717,818,2185,1660,4233,2478,6418
231160,202308,8671,21950,7067,18797,943,2301,4532,11844,5475,14145
231170,202308,5638,14267,4335,11809,338,929,3067,7932,3405,8861
231180,202308,19536,47176,14100,36179,2157,5294,7561,18454,9718,23748
231190,202308,5100,12267,3614,9546,94,314,2793,6952,2887,7266
231195,202308,5937,16217,4528,13453,298,924,3154,9276,3452,10200
231200,202308,10345,25058,8566,21748,153,604,7193,17232,7346,17836
231210,202308,5905,14962,4571,12629,146,555,3639,9505,3785,10060
231220,202308,16254,34942,11513,26491,689,1393,8576,18704,9265,20097
231230,202308,12157,34057,9987,29866,856,2617,7005,20431,7861,23048
231240,202308,14594,38594,11192,31410,1594,4268,6380,17084,7974,21352
231250,202308,2515,5341,1429,3164,74,161,1068,2192,1142,2353
231260,202308,4066,9624,3152,8066,362,807,2073,5271,2435,6078
231270,202308,7795,17404,5757,13938,160,556,4368,9799,4528,10355
231280,202308,2255,6054,1808,5231,149,423,1211,3462,1360,3885
231290,202308,44758,119095,32558,93184,4694,12474,16537,44868,21231,57342
231300,202308,5096,12302,3518,9166,378,916,2179,5418,2557,6334
231310,202308,10689,22129,7671,16766,498,1281,5717,11611,6215,12892
231320,202308,7836,20251,5763,16314,326,727,4289,12007,4615,12734
231325,202308,2903,6713,2050,5238,130,276,1445,3633,1575,3909
231330,202308,14047,34522,10594,28147,1271,3268,6931,17900,8202,21168
231335,202308,6710,15608,5335,13503,174,520,4438,10925,4612,11445
231340,202308,22763,61532,18483,53504,1729,4986,13012,37377,14741,42363
231350,202308,19795,47025,16527,41905,513,1473,13949,34355,14462,35828
231355,202308,5489,14102,4521,12317,302,830,3456,9040,3758,9870
231360,202308,9798,25896,7729,22073,454,1429,5885,16228,6339,17657
231370,202308,2448,6073,1768,4808,51,170,1352,3537,1403,3707
231375,202308,4918,13295,4140,11897,184,576,3059,8768,3243,9344
231380,202308,7418,16716,6218,15043,202,461,5114,12159,5316,12620
231390,202308,4105,10686,3381,9334,107,407,2568,6702,2675,7109
231395,202308,5370,13320,4159,11171,280,692,2960,7700,3240,8392
231400,202308,12160,29519,9496,24620,353,1144,7237,17656,7590,18800
231410,202308,20155,50023,16926,44608,818,2146,13822,35534,14640,37680
240010,202308,3022,7050,2075,5280,332,857,1003,2390,1335,3247
240020,202308,17801,40745,13487,32810,849,2449,9473,21324,10322,23773
240030,202308,4865,8930,3954,7598,80,223,3483,6282,3563,6505
240040,202308,925,2411,682,1952,25,76,456,1223,481,1299
240050,202308,4192,9918,3027,7789,81,209,2218,5460,2299,5669
240060,202308,1805,4168,1296,3254,44,98,997,2440,1041,2538
240070,202308,3260,8048,2430,6183,197,528,1652,3806,1849,4334
240080,202308,3502,8489,2450,6541,151,462,1632,4053,1783,4515
240090,202308,2798,5760,2092,4598,44,102,1790,3821,1834,3923
240100,202308,13494,27846,9830,21475,279,765,7825,15832,8104,16597
240110,202308,6215,15216,4623,12112,287,836,3255,7880,3542,8716
240120,202308,4115,10369,3141,8738,299,906,2069,5432,2368,6338
240130,202308,4899,8390,3752,6867,43,105,3423,6075,3466,6180
240140,202308,2150,5937,1613,4840,186,628,961,2641,1147,3269
240145,202308,8583,21386,6414,17440,634,1787,4087,10574,4721,12361
240150,202308,1324,3075,997,2455,63,176,707,1624,770,1800
240160,202308,1774,4489,1321,3629,53,215,982,2520,1035,2735
240165,202308,1180,2844,846,2174,21,74,679,1651,700,1725
240170,202308,3457,7935,2618,6433,304,729,1709,3998,2013,4727
240180,202308,3680,9677,2715,7665,538,1461,1289,3644,1827,5105
240185,202308,1762,4673,1476,4132,54,190,1180,3149,1234,3339
240190,202308,1384,3239,1035,2639,38,116,772,1849,810,1965
240200,202308,16367,34291,11832,26460,1631,3520,6980,14710,8611,18230
240210,202308,4242,8518,3227,6849,45,140,2749,5524,2794,5664
240220,202308,8739,23336,7227,20630,564,1917,5228,14245,5792,16162
240230,202308,6949,15532,5084,12384,352,715,3571,8699,3923,9414
240240,202308,2148,5699,1356,3940,231,706,477,1164,708,1870
240250,202308,3718,8196,2841,6725,76,266,2269,5033,2345,5299
240260,202308,20031,50783,16195,44068,4615,11998,6439,18994,11054,30992
240270,202308,3079,7776,2219,6167,141,414,1462,4027,1603,4441
240280,202308,1905,4391,1421,3545,72,169,1066,2576,1138,2745
240290,202308,1335,3452,1002,2722,28,91,667,1665,695,1756
240300,202308,2641,6089,1780,4564,113,309,1135,2764,1248,3073
240310,202308,10377,24839,7319,19077,1187,2923,3530,8825,4717,11748
240320,202308,2274,5683,1476,4116,110,325,930,2421,1040,2746
240325,202308,48357,108413,35765,86290,4282,10934,21570,47985,25852,58919
240330,202308,2177,5291,1504,4012,83,270,1016,2534,1099,2804
240340,202308,2492,4864,1796,3757,53,118,1474,2889,1527,3007
240350,202308,3071,6314,2554,5652,86,248,2224,4775,2310,5023
240360,202308,16484,38414,13337,32968,2009,4786,8175,19560,10184,24346
240370,202308,2679,5684,1834,4147,124,284,1317,2750,1441,3034
240375,202308,1158,2468,863,1973,33,89,646,1354,679,1443
240380,202308,2785,6901,2002,5266,267,694,1158,2874,1425,3568
240390,202308,1139,2564,696,1739,31,70,421,958,452,1028
240400,202308,1686,3801,1173,2918,49,169,808,1834,857,2003
240410,202308,703,1888,504,1493,60,194,266,725,326,919
240420,202308,6384,18362,5190,15690,395,1421,3422,9608,3817,11029
240430,202308,4218,9459,3098,7430,139,371,2341,5249,2480,5620
240440,202308,3396,6759,2625,5579,220,475,1988,4043,2208,4518
240450,202308,5354,12980,3684,9706,266,822,2336,5489,2602,6311
240460,202308,4234,9699,3458,8428,287,688,2581,6075,2868,6763
240470,202308,4070,11174,2701,8163,822,2166,965,3132,1787,5298
240480,202308,670,1669,373,1025,25,62,180,478,205,540
240485,202308,2490,6347,1792,4981,158,493,1042,2782,1200,3275
240490,202308,1995,4353,1392,3285,83,172,1026,2313,1109,2485
240500,202308,2607,6186,2063,5200,120,306,1612,3920,1732,4226
240510,202308,2039,4858,1599,4076,120,373,1211,2879,1331,3252
240520,202308,1966,3957,1346,3055,118,248,1044,2298,1162,2546
240530,202308,2873,6802,2367,5961,166,342,1812,4459,1978,4801
240540,202308,2747,5860,2254,5084,58,188,1942,4222,2000,4410
240550,202308,1074,2327,896,2023,72,151,729,1617,801,1768
240560,202308,4791,9971,4004,8890,158,312,3326,7232,3484,7544
240570,202308,3324,8016,1902,4923,271,736,737,1587,1008,2323
240580,202308,10757,26423,8759,22744,596,1633,6787,16884,7383,18517
240590,202308,1126,2177,871,1786,39,100,671,1277,710,1377
240600,202308,2121,5059,1407,3641,53,135,978,2361,1031,2496
240610,202308,5519,12436,4382,10351,307,791,3102,6867,3409,7658
240615,202308,1562,3479,1142,2767,77,205,819,1825,896,2030
240620,202308,2387,5660,1866,4734,55,187,1536,3703,1591,3890
240630,202308,2887,6281,2412,5505,225,388,1800,4154,2025,4542
240640,202308,1082,2580,773,2032,31,97,583,1450,614,1547
240650,202308,4815,12835,3615,10342,357,979,2270,6433,2627,7412
240660,202308,5452,9496,4527,8346,153,403,3913,6971,4066,7374
240670,202308,3117,7547,2108,5479,200,504,1324,3199,1524,3703
240680,202308,1934,4459,1421,3564,104,270,1044,2497,1148,2767
240690,202308,1482,3100,1096,2459,26,85,911,1912,937,1997
240700,202308,2827,7434,2088,6051,129,373,1477,4151,1606,4524
240710,202308,25328,51849,19875,42989,1984,4338,14045,28936,16029,33274
240720,202308,6302,14368,4755,11753,714,1844,2843,6724,3557,8568
240725,202308,1281,3351,913,2659,56,163,575,1586,631,1749
240730,202308,2685,6639,1957,5243,83,281,1446,3669,1529,3950
240740,202308,2258,5612,1624,4320,101,324,1124,2731,1225,3055
240750,202308,2673,7679,2146,6534,258,817,1295,3763,1553,4580
240760,202308,2059,4107,1349,3053,122,234,937,2183,1059,2417
240770,202308,4031,9443,3151,8087,119,404,2523,6158,2642,6562
240780,202308,6560,15562,5028,12875,705,1698,3124,7652,3829,9350
240790,202308,1064,2629,762,2051,29,119,519,1269,548,1388
240800,202308,74110,148307,52622,112821,5798,12354,33708,66610,39506,78964
240810,202308,140300,295604,113019,250493,11250,24393,78233,164935,89483,189328
240820,202308,8077,20989,6474,17854,1181,3119,3600,9756,4781,12875
240830,202308,10598,25922,8523,22501,474,1416,6555,16753,7029,18169
240840,202308,1296,2931,920,2260,43,92,643,1502,686,1594
240850,202308,1663,4135,1037,2786,84,216,617,1556,701,1772
240860,202308,1848,3920,1324,3028,40,131,1108,2394,1148,2525
240870,202308,1252,2839,872,2165,179,422,432,1076,611,1498
240880,202308,1551,4406,1238,3753,91,338,849,2426,940,2764
240890,202308,6673,14694,4724,11147,467,1205,3027,6389,3494,7594
240895,202308,3609,9598,3032,8601,398,1114,2087,5861,2485,6975
240910,202308,4163,10049,3225,8396,89,320,2472,6077,2561,6397
240920,202308,1305,2822,912,2184,110,219,585,1395,695,1614
240930,202308,4374,8873,3111,7063,308,514,2010,4864,2318,5378
240933,202308,1898,4328,1479,3684,49,204,1191,2806,1240,3010
240940,202308,8982,18656,6413,14213,764,1583,4186,8789,4950,10372
240950,202308,1324,3534,1021,2905,60,204,719,1897,779,2101
240960,202308,839,2073,687,1739,27,97,514,1214,541,1311
240970,202308,2405,5068,1784,4033,73,201,1464,3174,1537,3375
240980,202308,4871,10974,4118,9732,92,355,3516,7879,3608,8234
240990,202308,3638,8225,2876,6790,258,662,2045,4416,2303,5078
241000,202308,1292,2737,913,2045,13,39,763,1610,776,1649
241010,202308,3911,9961,3227,8591,128,424,2517,6296,2645,6720
241020,202308,2545,6013,1778,4516,98,301,1254,2915,1352,3216
241025,202308,1966,5026,1381,3847,50,176,983,2552,1033,2728
241030,202308,3038,8357,2241,6717,222,717,1539,4388,1761,5105
241040,202308,2703,7371,2101,6276,184,574,1507,4394,1691,4968
241050,202308,1739,4268,1283,3387,64,175,910,2324,974,2499
241060,202308,998,2391,766,1922,37,90,539,1242,576,1332
241070,202308,867,2026,651,1653,21,56,507,1220,528,1276
241080,202308,1301,3307,938,2575,39,126,651,1676,690,1802
241090,202308,2499,6173,1840,5030,66,275,1340,3426,1406,3701
241100,202308,1384,3455,966,2615,101,202,589,1576,690,1778
241105,202308,1451,3724,1094,3055,184,534,532,1340,716,1874
241110,202308,1071,2741,710,1985,47,151,444,1128,491,1279
241120,202308,9220,23387,7227,19750,756,2141,4750,12540,5506,14681
241140,202308,3907,9419,2725,7099,236,566,1792,4564,2028,5130
241142,202308,885,2196,558,1520,50,141,294,702,344,843
241150,202308,7162,16485,5664,13948,253,639,4403,10496,4656,11135
241160,202308,1311,3391,818,2389,127,372,391,1046,518,1418
241170,202308,1586,3534,1224,2870,40,131,996,2197,1036,2328
241180,202308,1230,2769,833,2022,50,153,510,1173,560,1326
241190,202308,1424,3199,1033,2459,40,102,739,1659,779,1761
241200,202308,32913,69141,26380,58186,3141,7016,17680,36499,20821,43515
241210,202308,2020,4463,1313,3151,158,324,808,1909,966,2233
241220,202308,12502,30846,9993,26214,2566,6457,4519,11932,7085,18389
241230,202308,3512,8152,2727,6853,143,373,2118,5100,2261,5473
241240,202308,1466,3743,775,2214,110,349,280,710,390,1059
241250,202308,7801,18048,5686,14207,133,464,4437,10296,4570,10760
241255,202308,3353,8769,2638,7354,252,756,1756,4654,2008,5410
241260,202308,5844,13488,4327,10863,165,500,3204,7475,3369,7975
241270,202308,1876,4952,1424,4038,117,366,935,2502,1052,2868
241280,202308,3194,6217,2547,5097,86,155,2235,4343,2321,4498
241290,202308,3778,8314,2620,6462,94,292,2022,4704,2116,4996
241300,202308,1913,4460,1386,3505,47,139,973,2309,1020,2448
241310,202308,2857,5771,2233,4890,60,165,1863,3893,1923,4058
241320,202308,1153,3386,874,2799,125,412,452,1391,577,1803
241330,202308,2071,4652,1543,3889,41,130,1319,3227,1360,3357
241335,202308,4558,11153,3627,9405,141,418,2767,6779,2908,7197
241340,202308,2076,4868,1486,3738,230,645,783,1770,1013,2415
241350,202308,2580,6144,2059,5209,109,291,1555,3784,1664,4075
241355,202308,1675,3934,1214,3065,60,156,887,2125,947,2281
241360,202308,2508,5699,1633,4012,69,171,1216,2804,1285,2975
241370,202308,1613,3838,1163,2975,46,142,836,1974,882,2116
241380,202308,880,2034,633,1594,93,183,363,923,456,1106
241390,202308,3373,8576,2678,7414,176,475,1937,5212,2113,5687
241400,202308,4422,10677,3612,9323,280,767,2660,6580,2940,7347
241410,202308,3036,8090,2279,6551,257,763,1452,4045,1709,4808
241415,202308,2290,5388,1771,4407,76,246,1374,3183,1450,3429
241420,202308,3924,9995,3227,8726,586,1577,1773,4693,2359,6270
241430,202308,866,1908,530,1262,16,38,360,779,376,817
241440,202308,10512,27172,8882,24137,281,923,7160,18659,7441,19582
241445,202308,1650,3351,1301,2846,32,91,1140,2413,1172,2504
241450,202308,3795,7572,2810,6011,174,355,2235,4616,2409,4971
241460,202308,4786,11474,3293,8339,337,836,2103,4923,2440,5759
241470,202308,1760,4036,1285,3327,45,169,1028,2536,1073,2705
241475,202308,1423,3430,994,2639,28,89,723,1782,751,1871
241480,202308,3755,10254,2829,8318,865,2509,972,2952,1837,5461
241490,202308,909,1828,591,1332,28,88,463,982,491,1070
241500,202308,980,2399,803,2148,34,108,627,1613,661,1721
250010,202308,3234,8228,2409,6545,79,255,1797,4613,1876,4868
250020,202308,1920,4480,1317,3353,157,329,912,2319,1069,2648
250030,202308,8590,20457,6856,17528,1224,3018,4342,10852,5566,13870
250040,202308,5479,14364,4333,12230,769,2221,2424,6505,3193,8726
250050,202308,4445,10444,3626,9220,189,526,2787,7031,2976,7557
250053,202308,1560,3924,1309,3460,136,299,888,2293,1024,2592
250057,202308,896,2441,799,2298,24,96,709,2013,733,2109
250060,202308,7516,16732,6129,14609,761,1618,4147,9726,4908,11344
250070,202308,4864,11788,3756,9806,71,267,2971,7385,3042,7652
250073,202308,965,2232,720,1805,12,41,573,1375,585,1416
250077,202308,3253,6814,2355,5360,35,108,2022,4413,2057,4521
250080,202308,7433,14204,5817,12152,84,275,5268,10693,5352,10968
250090,202308,4717,8835,3802,7562,80,163,3340,6426,3420,6589
250100,202308,4170,11196,3438,9765,251,648,2516,6909,2767,7557
250110,202308,6032,14801,5111,13353,376,985,3719,9381,4095,10366
250115,202308,924,1898,605,1375,14,48,505,1104,519,1152
250120,202308,2184,5696,1812,5037,32,149,1423,3764,1455,3913
250130,202308,7429,15631,5967,13503,131,375,5187,11331,5318,11706
250135,202308,1681,3943,1382,3414,209,567,977,2292,1186,2859
250140,202308,2864,7265,2359,6495,217,619,1666,4486,1883,5105
250150,202308,5680,15705,4767,14013,205,750,3662,10278,3867,11028
250153,202308,1634,3934,1267,3331,59,120,975,2516,1034,2636
250157,202308,2683,6110,2184,5246,51,129,1835,4261,1886,4390
250160,202308,4438,9780,3399,8179,69,187,2900,6795,2969,6982
250170,202308,2219,5198,1872,4680,43,133,1507,3622,1550,3755
250180,202308,31460,60888,24975,51752,2223,4606,18323,35728,20546,40334
250190,202308,5168,11885,4065,10131,450,1086,2687,6391,3137,7477
250200,202308,3175,5923,2505,4987,65,150,2218,4222,2283,4372
250205,202308,996,2778,763,2332,23,98,571,1680,594,1778
250210,202308,1702,4537,1382,3930,107,319,987,2705,1094,3024
250215,202308,1894,4672,1351,3646,81,237,766,2041,847,2278
250220,202308,815,2010,596,1624,31,108,407,1026,438,1134
250230,202308,1927,3916,1235,2863,27,76,985,2191,1012,2267
250240,202308,3795,8186,3133,7072,116,251,2647,5812,2763,6063
250250,202308,6023,13840,4883,12138,404,714,3709,9611,4113,10325
250260,202308,1852,4779,1417,3959,74,199,1000,2732,1074,2931
250270,202308,1403,3798,1171,3386,95,280,750,2232,845,2512
250280,202308,4950,10433,4107,9221,326,526,3081,7058,3407,7584
250290,202308,2336,4684,1828,3898,55,138,1490,3016,1545,3154
250300,202308,7393,15732,6024,13777,276,787,4771,10356,5047,11143
250310,202308,1495,3820,1108,3096,82,198,764,2093,846,2291
250320,202308,18628,34247,14945,29685,332,971,12814,24125,13146,25096
250330,202308,3186,7222,2482,6112,72,252,2047,4718,2119,4970
250340,202308,1555,3203,1244,2750,24,61,1090,2340,1114,2401
250350,202308,4554,11822,3573,10071,269,633,2653,7612,2922,8245
250355,202308,2800,6420,2303,5758,34,149,2072,5068,2106,5217
250360,202308,2130,4925,1777,4387,128,377,1360,3165,1488,3542
250370,202308,21032,41621,16997,35569,333,973,14648,29143,14981,30116
250375,202308,1545,3278,1145,2769,30,60,997,2432,1027,2492
250380,202308,2201,4573,1911,4182,72,189,1635,3387,1707,3576
250390,202308,2374,5169,1870,4343,122,308,1471,3324,1593,3632
250400,202308,93751,209143,63306,158063,19433,50955,18322,42316,37755,93271
250403,202308,2967,6014,2388,5283,58,275,2002,4047,2060,4322
250407,202308,1898,3732,1246,2727,140,233,869,2014,1009,2247
250410,202308,863,1990,708,1730,25,72,586,1358,611,1430
250415,202308,2466,5691,2007,4951,39,132,1753,4199,1792,4331
250420,202308,1741,3561,1471,3156,25,83,1300,2666,1325,2749
250430,202308,9472,18496,7337,15374,311,696,5948,11680,6259,12376
250435,202308,1985,4962,1388,3878,70,235,1032,2755,1102,2990
250440,202308,5326,12767,4338,11242,112,307,3674,9285,3786,9592
250450,202308,2184,4952,1688,4213,91,171,1323,3307,1414,3478
250460,202308,9780,23544,7791,20325,557,1626,5589,13871,6146,15497
250470,202308,2196,4569,1696,3770,70,173,1373,2898,1443,3071
250480,202308,4732,11314,3723,9899,223,549,2913,7670,3136,8219
250485,202308,854,1752,564,1275,51,75,399,887,450,962
250490,202308,6937,13478,5814,12094,124,336,5078,10202,5202,10538
250500,202308,2452,6003,1994,5194,64,213,1566,3945,1630,4158
250510,202308,7143,14683,5679,12516,281,447,4529,10008,4810,10455
250520,202308,2218,5344,1751,4614,73,234,1338,3355,1411,3589
250523,202308,2679,5659,2162,4886,173,412,1633,3513,1806,3925
250527,202308,2119,4487,1831,4116,24,72,1660,3677,1684,3749
250530,202308,809,1855,647,1596,21,55,494,1139,515,1194
250535,202308,1657,4225,1374,3688,18,60,1132,2908,1150,2968
250540,202308,4000,7347,3114,6278,345,409,2467,5215,2812,5624
250550,202308,938,2733,762,2361,59,197,513,1525,572,1722
250560,202308,2083,5028,1646,4317,121,325,1217,3056,1338,3381
250570,202308,3327,8633,2693,7474,174,543,1963,5284,2137,5827
250580,202308,1254,2928,1030,2573,67,159,797,1910,864,2069
250590,202308,1265,2626,1086,2371,39,107,934,1928,973,2035
250600,202308,9129,22365,6864,18642,334,922,5035,13153,5369,14075
250610,202308,3416,8744,2787,7664,151,488,2133,5710,2284,6198
250620,202308,1141,2374,879,1933,28,57,714,1499,742,1556
250625,202308,2722,7162,2302,6407,61,253,1931,5198,1992,5451
250630,202308,15618,34027,12318,28535,1100,2744,8745,18982,9845,21726
250640,202308,4556,10427,3672,9058,100,360,2981,6921,3081,7281
250650,202308,1277,2696,931,2213,12,59,793,1826,805,1885
250660,202308,1871,4151,1350,3336,58,139,1091,2549,1149,2688
250670,202308,2999,7674,2576,6872,48,160,2183,5551,2231,5711
250680,202308,7558,14367,5985,12375,136,417,5167,10148,5303,10565
250690,202308,8808,17118,6811,14486,163,342,5805,11899,5968,12241
250700,202308,5708,14133,4560,11996,701,1830,2869,7179,3570,9009
250710,202308,5326,13721,4171,11824,426,1179,2788,7772,3214,8951
250720,202308,3479,8242,2809,7189,79,269,2280,5583,2359,5852
250730,202308,5451,12276,4442,10722,270,645,3501,8051,3771,8696
250740,202308,2494,5431,1891,4517,121,253,1387,3221,1508,3474
250750,202308,167728,347813,131711,291762,8530,21135,97550,200769,106080,221904
250760,202308,3689,6862,3082,5972,61,156,2771,5184,2832,5340
250770,202308,4902,13195,3952,11524,509,1281,2529,7362,3038,8643
250780,202308,2272,5157,1750,4214,52,155,1441,3319,1493,3474
250790,202308,3158,7940,2497,6736,110,434,1815,4492,1925,4926
250800,202308,2936,6852,2335,5830,127,296,1816,4426,1943,4722
250810,202308,1769,3821,1292,3047,143,235,886,2148,1029,2383
250820,202308,2557,5889,2219,5427,50,175,1902,4514,1952,4689
250830,202308,7358,19411,5531,15672,246,825,3831,10046,4077,10871
250840,202308,867,2512,691,2132,43,151,499,1534,542,1685
250850,202308,2181,5548,1773,4806,33,122,1444,3750,1477,3872
250855,202308,1421,3375,1162,2937,43,134,969,2348,1012,2482
250860,202308,4291,11071,3218,9129,435,1300,1857,4957,2292,6257
250870,202308,1273,2941,984,2427,51,121,723,1720,774,1841
250880,202308,1930,4389,1458,3613,132,332,1058,2525,1190,2857
250890,202308,14844,30181,11995,26261,304,1026,10078,20543,10382,21569
250900,202308,3974,9059,3140,7595,103,316,2609,5974,2712,6290
250905,202308,3095,7536,2680,6950,81,280,2323,5884,2404,6164
250910,202308,9082,17256,7286,14979,102,369,6522,12901,6624,13270
250915,202308,2655,5261,1739,4135,52,121,1472,3402,1524,3523
250920,202308,4824,10130,3901,8629,370,684,2884,6207,3254,6891
250930,202308,2821,6821,2237,5938,147,472,1683,4211,1830,4683
250933,202308,1504,3918,1200,3336,44,157,937,2503,981,2660
250937,202308,966,2242,761,1909,35,82,576,1415,611,1497
250939,202308,2519,5507,2006,4698,30,89,1728,3947,1758,4036
250940,202308,4684,10900,3732,9467,83,268,3113,7686,3196,7954
250950,202308,2033,4760,1536,4024,51,170,1205,3010,1256,3180
250960,202308,1373,3469,1126,3006,39,144,894,2267,933,2411
250970,202308,11398,24838,9090,20929,457,989,7216,16089,7673,17078
250980,202308,2847,6649,2343,5815,38,136,1994,4742,2032,4878
250990,202308,2580,6850,2073,5917,102,366,1502,4071,1604,4437
251000,202308,2303,5887,1779,4934,50,163,1394,3766,1444,3929
251010,202308,3003,7350,2484,6522,63,232,2062,5227,2125,5459
251020,202308,1922,4665,1554,4028,44,167,1262,3088,1306,3255
251030,202308,1216,2923,923,2394,46,132,599,1508,645,1640
251040,202308,2190,5302,1718,4509,33,123,1431,3596,1464,3719
251050,202308,1151,3024,873,2425,54,178,602,1549,656,1727
251060,202308,1373,2729,906,2035,46,83,676,1498,722,1581
251065,202308,561,1414,377,1045,15,42,260,684,275,726
251070,202308,904,1961,689,1630,22,81,552,1207,574,1288
251080,202308,26878,57501,20573,47407,3875,8654,11497,26399,15372,35053
251090,202308,3470,8782,2710,7420,60,207,2211,5845,2271,6052
251100,202308,940,2694,729,2246,52,141,499,1442,551,1583
251110,202308,2234,5137,1714,4151,209,420,1199,2862,1408,3282
251120,202308,10018,22572,7858,19365,361,1048,6031,14127,6392,15175
251130,202308,6083,10274,5094,9081,50,121,4720,8158,4770,8279
251140,202308,4807,12345,3991,11002,171,565,2981,8002,3152,8567
251150,202308,3419,8511,2927,7688,81,354,2321,5768,2402,6122
251160,202308,2938,6886,2437,6086,51,200,2112,5059,2163,5259
251170,202308,2302,4899,1895,4328,34,113,1668,3656,1702,3769
251180,202308,3333,7600,2595,6488,330,679,1659,4270,1989,4949
251190,202308,7054,13721,5970,12291,127,302,5265,10400,5392,10702
251200,202308,5666,13641,4675,12179,199,526,3784,9734,3983,10260
251203,202308,1250,3500,986,2893,72,225,629,1731,701,1956
251207,202308,1339,3181,904,2374,23,68,633,1581,656,1649
251210,202308,9857,21840,7309,17805,675,1372,4910,12096,5585,13468
251220,202308,1630,3374,1125,2652,77,167,845,1952,922,2119
251230,202308,5626,14140,4534,12035,144,422,3459,8795,3603,9217
251240,202308,4428,11442,3272,9165,329,918,2048,5567,2377,6485
251250,202308,15064,34177,11855,28343,1200,2748,8334,19140,9534,21888
251260,202308,649,1485,519,1258,9,25,420,957,429,982
251270,202308,5489,14271,4571,12762,305,786,3446,9619,3751,10405
251272,202308,1738,3882,1502,3540,40,151,1316,2952,1356,3103
251274,202308,1007,2555,729,2027,71,216,388,1022,459,1238
251275,202308,1965,4115,1482,3324,92,220,1169,2460,1261,2680
251276,202308,1611,3931,1316,3491,39,150,1018,2553,1057,2703
251278,202308,817,1898,638,1570,44,110,487,1128,531,1238
251280,202308,3390,6932,2879,6170,65,197,2482,4992,2547,5189
251290,202308,10377,18079,8626,15860,257,563,7576,13327,7833,13890
251300,202308,1007,2559,802,2187,19,68,669,1781,688,1849
251310,202308,3445,8506,2769,7383,48,216,2181,5551,2229,5767
251315,202308,2260,6131,1894,5399,107,288,1443,4003,1550,4291
251320,202308,1924,4548,1403,3612,50,168,1070,2608,1120,2776
251330,202308,2565,5175,1923,4341,39,105,1613,3539,1652,3644
251335,202308,1388,3372,1149,2972,15,50,1024,2571,1039,2621
251340,202308,4592,9679,3338,7796,173,385,2543,5681,2716,6066
251350,202308,1323,3312,1078,2875,50,102,844,2214,894,2316
251360,202308,2243,5363,1609,4330,31,100,1257,3259,1288,3359
251365,202308,938,2226,625,1615,19,50,468,1182,487,1232
251370,202308,36246,82035,27978,68758,5518,12833,14123,34542,19641,47375
251380,202308,1881,3969,1477,3299,52,143,1217,2594,1269,2737
251385,202308,931,2153,643,1604,19,46,471,1089,490,1135
251390,202308,9738,22085,8090,19427,653,1588,5946,13778,6599,15366
251392,202308,1248,2998,977,2558,43,110,741,1914,784,2024
251394,202308,831,2113,625,1726,63,178,404,1071,467,1249
251396,202308,855,2108,624,1652,27,86,442,1073,469,1159
251398,202308,1209,2845,760,2037,20,68,548,1381,568,1449
251400,202308,1768,3415,1297,2703,71,116,1039,2087,1110,2203
251410,202308,1903,3830,1413,3084,32,126,1198,2441,1230,2567
251420,202308,2556,5648,1943,4802,50,152,1553,3673,1603,3825
251430,202308,1814,4757,1489,4135,48,134,1225,3312,1273,3446
251440,202308,1315,3175,1015,2650,88,189,719,1885,807,2074
251445,202308,2071,4856,1726,4323,44,161,1385,3298,1429,3459
251450,202308,5699,14036,4650,12114,107,338,3834,9619,3941,9957
251455,202308,1033,2734,846,2367,34,113,660,1770,694,1883
251460,202308,1178,2889,886,2367,87,232,623,1632,710,1864
251465,202308,612,1506,466,1223,13,47,346,855,359,902
251470,202308,1370,3509,949,2628,160,493,482,1196,642,1689
251480,202308,1276,2938,897,2259,26,87,678,1605,704,1692
251490,202308,2392,5428,1846,4595,147,288,1365,3387,1512,3675
251500,202308,2665,5973,2216,5300,136,317,1719,3936,1855,4253
251510,202308,3113,8543,2317,6891,138,397,1471,4141,1609,4538
251520,202308,1193,2822,839,2173,51,115,572,1415,623,1530
251530,202308,19093,38580,14991,33235,245,900,12917,27344,13162,28244
251540,202308,3639,9258,2932,7921,123,488,2337,5966,2460,6454
251550,202308,5387,10009,4047,8184,162,316,3406,6684,3568,7000
251560,202308,659,1834,530,1591,35,125,384,1055,419,1180
251570,202308,1092,2796,793,2166,26,110,605,1560,631,1670
251580,202308,2857,5456,2284,4592,36,108,1965,3690,2001,3798
251590,202308,1975,4173,1514,3494,62,166,1278,2817,1340,2983
251593,202308,1159,3105,948,2712,100,287,597,1639,697,1926
251597,202308,2830,6373,2424,5794,30,109,2149,5010,2179,5119
251600,202308,7631,18795,6211,16437,325,911,4832,12399,5157,13310
251610,202308,4233,10171,3355,8491,457,1042,2257,5560,2714,6602
251615,202308,1669,3529,1197,2724,40,107,1031,2273,1071,2380
251620,202308,24356,47520,18117,39437,380,988,15345,32737,15725,33725
251630,202308,6416,12578,4928,10390,267,637,3909,7723,4176,8360
251640,202308,2650,6261,2176,5517,49,195,1793,4293,1842,4488
251650,202308,5135,11463,4036,9853,109,298,3289,7664,3398,7962
251660,202308,4473,11194,3580,9474,101,382,2872,7225,2973,7607
251670,202308,5805,12456,4908,11200,83,294,4391,9662,4474,9956
251675,202308,1140,2366,952,2068,31,65,825,1739,856,1804
251680,202308,3155,7143,2395,5948,120,264,1856,4555,1976,4819
251690,202308,3933,9743,2964,7844,158,469,2237,5728,2395,6197
251700,202308,2823,6749,2183,5739,56,232,1774,4405,1830,4637
251710,202308,960,2181,599,1447,39,116,410,900,449,1016
251720,202308,1544,3911,1132,3151,39,139,830,2197,869,2336
251740,202308,808,1953,607,1582,24,71,458,1129,482,1200
260005,202308,38712,73025,28979,59086,1781,3719,22492,43536,24273,47255
260010,202308,12708,29479,9496,23728,640,1712,6148,14505,6788,16217
260020,202308,8453,16767,6114,13435,118,427,4977,10233,5095,10660
260030,202308,10237,19841,8132,16827,131,448,7023,13862,7154,14310
260040,202308,8789,19693,6604,16303,351,971,4835,11428,5186,12399
260050,202308,17865,37737,14671,33827,295,844,13240,29988,13535,30832
260060,202308,5235,11060,4056,9141,399,677,2944,6801,3343,7478
260070,202308,14720,29144,11733,24722,235,761,9917,19717,10152,20478
260080,202308,8493,16043,6901,13895,147,328,5881,11345,6028,11673
260090,202308,6816,14469,5568,12595,500,917,4154,9349,4654,10266
260100,202308,4048,8512,3240,7309,57,220,2774,5958,2831,6178
260105,202308,6339,14538,5162,12628,109,392,4268,9897,4377,10289
260110,202308,26216,66545,21356,58559,1198,3641,16270,42916,17468,46557
260120,202308,20127,43554,16055,37186,1904,3943,11211,25680,13115,29623
260130,202308,4050,8816,3261,7638,77,189,2599,5765,2676,5954
260140,202308,16799,31574,13269,26893,415,916,11121,21521,11536,22437
260150,202308,4557,8715,3771,7686,105,246,3317,6592,3422,6838
260160,202308,9192,17652,7536,15539,185,489,6709,13407,6894,13896
260170,202308,27407,55151,21309,46120,1248,2795,16365,33780,17613,36575
260180,202308,4467,9877,3485,8410,97,311,2853,6555,2950,6866
260190,202308,27410,44332,21666,37287,248,512,19713,32804,19961,33316
260200,202308,13505,28812,10967,25302,478,1038,9387,21244,9865,22282
260210,202308,13514,33694,10730,28952,471,1289,8391,22129,8862,23418
260220,202308,15215,28483,12904,25420,319,638,11259,21477,11578,22115
260230,202308,16542,30670,13439,26545,334,649,11512,22018,11846,22667
260240,202308,3429,8748,2726,7401,65,250,2118,5492,2183,5742
260250,202308,2958,6407,2338,5393,100,236,1820,4006,1920,4242
260260,202308,17945,39318,14888,34713,1265,2642,10939,25567,12204,28209
260270,202308,6282,11695,5120,10229,87,257,4523,8675,4610,8932
260280,202308,16658,39439,14054,35255,350,1283,12145,29070,12495,30353
260290,202308,56686,124477,43718,102679,3876,9568,30340,66624,34216,76192
260300,202308,13495,28495,10846,24563,353,1058,8972,19316,9325,20374
260310,202308,8215,16281,6887,14442,397,728,5700,11762,6097,12490
260320,202308,8878,23261,6801,19581,148,535,5450,15299,5598,15834
260330,202308,2855,7845,2266,6664,99,341,1712,4828,1811,5169
260340,202308,2685,6048,2173,5226,54,191,1784,4050,1838,4241
260345,202308,39390,83750,30517,69440,3091,7212,20382,43303,23473,50515
260350,202308,8206,14470,6503,12467,40,157,5953,11054,5993,11211
260360,202308,2930,6721,2198,5355,75,227,1656,3836,1731,4063
260370,202308,6983,16463,5461,13786,191,576,4367,10426,4558,11002
260380,202308,6141,15630,4781,13238,251,667,3535,9518,3786,10185
260390,202308,5703,15120,4054,11652,250,696,2659,7342,2909,8038
260392,202308,5105,12239,4372,11205,67,358,3756,9273,3823,9631
260400,202308,28469,52648,22859,44409,462,1308,19175,34779,19637,36087
260410,202308,106696,224249,79232,182467,15332,35713,39733,89630,55065,125343
260415,202308,6076,12818,4766,10834,83,259,4073,8912,4156,9171
260420,202308,16683,28070,13119,23987,165,497,12012,21291,12177,21788
260430,202308,3262,9225,2542,7735,167,563,1667,4897,1834,5460
260440,202308,5331,10754,4193,9133,88,274,3532,7304,3620,7578
260450,202308,6993,15609,5837,13897,337,663,4756,11245,5093,11908
260460,202308,7064,17009,5446,13945,359,1053,3740,8814,4099,9867
260470,202308,6156,12778,4906,11254,134,344,4202,9713,4336,10057
260480,202308,4547,10411,3478,8670,299,844,2443,5799,2742,6643
260490,202308,7126,13301,5674,11331,85,307,4978,9442,5063,9749
260500,202308,7589,16494,5993,14024,720,1514,4009,9336,4729,10850
260510,202308,14338,27734,11525,23627,206,573,10097,20003,10303,20576
260515,202308,5629,12904,4136,10165,102,310,3037,6811,3139,7121
260520,202308,20285,40965,15934,34527,1006,2236,12286,25181,13292,27417
260530,202308,12751,29381,10378,25661,155,620,8960,21232,9115,21852
260540,202308,9785,17309,8247,15388,129,328,7538,13697,7667,14025
260545,202308,188,469,117,326,24,64,38,79,62,143
260550,202308,3845,9263,2702,7120,189,578,1777,4240,1966,4818
260560,202308,6877,15634,5254,13038,181,583,4160,9801,4341,10384
260570,202308,11510,23131,9411,20275,209,635,8092,16581,8301,17216
260580,202308,6472,11952,5566,10709,75,187,5049,9465,5124,9652
260590,202308,9505,16639,7488,14188,116,333,6609,12004,6725,12337
260600,202308,44650,95161,34591,78926,1506,4076,26893,56955,28399,61031
260610,202308,9742,22392,7493,18838,333,982,5814,13986,6147,14968
260620,202308,28504,56014,22552,46875,1183,2991,17844,34420,19027,37411
260630,202308,2819,6744,2240,5768,60,162,1809,4499,1869,4661
260640,202308,33509,60729,26385,51559,1383,2464,21475,40759,22858,43223
260650,202308,7581,16920,5696,14330,435,876,4512,11198,4947,12074
260660,202308,9621,19954,7729,17340,256,701,6695,14484,6951,15185
260670,202308,2820,6321,2117,5094,88,293,1609,3616,1697,3909
260680,202308,40123,81592,29962,65346,2294,5035,22042,45483,24336,50518
260690,202308,4252,9526,3142,7725,73,247,2528,5941,2601,6188
260700,202308,9516,18958,8522,17820,127,366,8010,16499,8137,16865
260710,202308,1669,3860,1233,3138,45,156,934,2242,979,2398
260720,202308,40150,77651,30966,64748,1624,3877,24392,48151,26016,52028
260730,202308,10236,25114,8452,22370,253,793,7097,18152,7350,18945
260740,202308,1634,3881,1219,3164,33,136,939,2318,972,2454
260750,202308,9744,21072,7364,18017,217,489,6275,15425,6492,15914
260760,202308,8687,16549,7100,14538,118,344,6219,12204,6337,12548
260765,202308,10710,25846,8571,22274,736,2013,5842,14359,6578,16372
260770,202308,4892,10612,3714,8704,114,354,3027,6800,3141,7154
260775,202308,7850,17181,6443,14801,192,572,5185,11122,5377,11694
260780,202308,4736,11813,3534,9392,284,875,2238,5284,2522,6159
260790,202308,200277,369004,155993,305974,18412,37126,109605,203287,128017,240413
260795,202308,4562,8679,3540,7321,156,435,2766,5342,2922,5777
260800,202308,7989,14321,6883,12782,310,472,6001,10847,6311,11319
260805,202308,4735,10759,3649,8802,120,377,2932,6625,3052,7002
260810,202308,8373,19020,6631,15758,306,799,5091,11287,5397,12086
260820,202308,6129,11399,4939,9895,110,313,4265,8280,4375,8593
260825,202308,3523,9264,2835,7978,151,530,2095,5624,2246,6154
260830,202308,5298,13446,4122,11344,431,1012,2799,7683,3230,8695
260840,202308,5843,11936,4812,10458,217,504,4090,8558,4307,9062
260845,202308,5685,12802,4525,10770,205,644,3445,7633,3650,8277
260850,202308,6085,14206,4492,11109,425,1013,2869,6626,3294,7639
260860,202308,4068,10405,3170,8725,210,599,2357,6219,2567,6818
260870,202308,5732,11062,4699,9708,147,281,4058,8210,4205,8491
260875,202308,10876,21231,8043,17158,642,1371,5543,11396,6185,12767
260880,202308,14353,31678,11830,27582,449,1081,9675,21701,10124,22782
260890,202308,16801,36386,13245,30510,1554,3475,8271,18487,9825,21962
260900,202308,6913,17126,5309,14562,566,1556,3067,8017,3633,9573
260910,202308,4300,9516,3596,8454,196,405,2780,6409,2976,6814
260915,202308,7327,15018,6371,13785,97,263,5841,12397,5938,12660
260920,202308,4370,8223,3463,7132,147,347,2928,5804,3075,6151
260930,202308,5187,12949,3989,10804,190,628,3090,7889,3280,8517
260940,202308,19922,39428,15712,32996,1283,2735,11808,23708,13091,26443
260950,202308,9637,21210,7054,16562,371,1032,4962,10561,5333,11593
260960,202308,120960,216245,94326,179193,7242,14330,71576,127788,78818,142118
260970,202308,6991,15868,5371,13341,349,642,3926,9634,4275,10276
260980,202308,5991,14174,4945,12732,121,382,4221,10625,4342,11007
260990,202308,20741,50777,16153,43672,864,2402,12216,31728,13080,34130
261000,202308,21510,41353,16299,34015,719,1663,12976,25522,13695,27185
261010,202308,2684,5933,2157,5174,80,203,1814,4246,1894,4449
261020,202308,8550,18660,6920,15916,298,746,5554,12011,5852,12757
261030,202308,5102,12685,4046,10732,123,439,3113,7736,3236,8175
261040,202308,6703,16274,5122,13418,214,717,3834,9420,4048,10137
261050,202308,10010,21810,8154,18890,201,482,6611,14681,6812,15163
261060,202308,19063,40143,15276,34837,428,1230,12475,27090,12903,28320
261070,202308,97027,184685,72758,148742,7616,15302,51381,100145,58997,115447
261080,202308,9074,17979,7659,16094,91,245,7120,14615,7211,14860
261090,202308,26080,49856,21094,42875,913,1771,17387,34112,18300,35883
261100,202308,11189,25831,9012,22371,544,1341,6848,16391,7392,17732
261110,202308,100595,234130,75814,187632,9043,23804,45320,104447,54363,128251
261120,202308,4952,9899,4016,8510,108,264,3488,7101,3596,7365
261130,202308,9822,19578,7996,16948,228,445,6792,14000,7020,14445
261140,202308,4934,9472,3871,7886,264,456,2983,5971,3247,6427
261150,202308,7025,14749,5647,12696,221,502,4494,9745,4715,10247
261153,202308,2341,6168,1730,4922,87,253,1186,3281,1273,3534
261160,202308,321791,637421,241074,517581,67180,142030,94675,206833,161855,348863
261170,202308,10113,18992,8272,16467,299,554,7104,13596,7403,14150
261180,202308,11817,25197,9281,21261,436,992,7150,15643,7586,16635
261190,202308,6741,14908,5384,12588,180,668,4358,9408,4538,10076
261200,202308,4444,8546,3507,7220,153,347,2856,5677,3009,6024
261210,202308,2278,4915,1825,4212,125,181,1454,3340,1579,3521
261220,202308,19196,43706,14819,35820,1188,3045,10407,23246,11595,26291
261230,202308,4736,11630,3655,9970,78,309,2901,7683,2979,7992
261240,202308,7943,15278,6583,13240,227,447,5715,11134,5942,11581
261245,202308,4856,11302,3714,9378,118,434,2894,6818,3012,7252
261247,202308,3808,9897,2877,8157,308,859,1869,5188,2177,6047
261250,202308,38794,71905,31614,62797,4544,8852,22564,44450,27108,53302
261255,202308,4883,12534,3580,9998,164,559,2583,6776,2747,7335
261260,202308,20491,39979,16813,35227,353,1066,14891,29828,15244,30894
261270,202308,6747,12425,5527,10805,206,374,4870,9253,5076,9627
261280,202308,3282,7720,2682,6717,116,380,2091,4936,2207,5316
261290,202308,3724,7846,2842,6695,78,214,2291,5245,2369,5459
261300,202308,17558,38799,13716,32358,418,1270,10895,24010,11313,25280
261310,202308,12868,26583,10294,22658,890,1966,7681,16194,8571,18160
261320,202308,7503,18092,6072,15664,146,416,4871,12072,5017,12488
261330,202308,8037,15711,6754,13954,177,450,5904,11758,6081,12208
261340,202308,7766,15278,6410,13409,241,562,5488,11019,5729,11581
261350,202308,10339,26979,8170,22872,362,996,6102,16607,6464,17603
261360,202308,11310,21923,9000,18458,485,969,7180,14104,7665,15073
261370,202308,33496,70515,25602,58290,1998,4683,18402,39428,20400,44111
261380,202308,5573,13231,4559,11530,484,1165,2998,7400,3482,8565
261390,202308,22218,54384,16699,44809,1523,4106,10987,28004,12510,32110
261400,202308,6281,15288,5059,12985,213,764,3904,9284,4117,10048
261410,202308,12690,26032,9644,21427,261,757,7937,16498,8198,17255
261420,202308,11054,25975,8913,22655,554,1520,6866,16555,7420,18075
261430,202308,5544,11120,4536,9619,54,162,4073,8266,4127,8428
261440,202308,1669,4470,1279,3695,53,231,900,2445,953,2676
261450,202308,19087,42392,15428,36578,723,1774,11995,27772,12718,29546
261460,202308,9710,22535,7624,19108,293,796,5943,14513,6236,15309
261470,202308,4650,10278,3609,8635,69,237,2978,6788,3047,7025
261480,202308,6902,17489,5501,15042,279,977,4075,10312,4354,11289
261485,202308,7192,17054,5731,14589,375,1118,4209,10116,4584,11234
261500,202308,8798,18870,7125,16337,744,1380,4979,11656,5723,13036
261510,202308,2214,5809,1752,4942,71,271,1330,3639,1401,3910
261520,202308,2954,7498,2375,6302,131,397,1715,4290,1846,4687
261530,202308,15428,37982,11350,30462,744,2398,7042,16980,7786,19378
261540,202308,12238,30164,10564,27501,2847,6601,5035,14407,7882,21008
261550,202308,4650,10669,3670,8955,247,656,2668,6119,2915,6775
261560,202308,12066,27030,9949,23743,349,973,8130,18512,8479,19485
261570,202308,4560,10904,3247,8525,302,866,2144,5298,2446,6164
261580,202308,9165,19383,7411,16836,93,353,6687,14655,6780,15008
261590,202308,3396,7293,2638,6116,62,206,2129,4655,2191,4861
261600,202308,7722,14642,6337,12642,146,339,5434,10346,5580,10685
261610,202308,2744,7029,2056,5711,243,665,1221,3355,1464,4020
261618,202308,3626,6820,2938,5854,65,177,2518,4801,2583,4978
261620,202308,6160,14251,5390,13067,603,1262,3892,9668,4495,10930
261630,202308,7361,18512,5625,15006,422,1218,3495,8489,3917,9707
261640,202308,49503,93684,37922,77807,2057,3586,28973,58360,31030,61946
261650,202308,5528,11055,4196,9234,281,593,3341,7232,3622,7825
270010,202308,5124,15143,3987,12866,181,830,2851,8694,3032,9524
270020,202308,5159,10558,4105,9108,192,629,3295,6716,3487,7345
270030,202308,46487,110691,37241,95325,2465,6599,27630,67880,30095,74479
270040,202308,12089,28574,9392,24723,688,1976,6901,17401,7589,19377
270050,202308,6719,13677,5344,12015,190,487,4592,10061,4782,10548
270060,202308,2751,6342,2137,5464,139,380,1553,3768,1692,4148
270070,202308,6547,14372,5389,12679,148,458,4667,10540,4815,10998
270080,202308,1773,4180,1307,3404,91,234,965,2432,1056,2666
270090,202308,2256,5783,1900,5148,67,212,1628,4314,1695,4526
270100,202308,8903,16414,7248,14180,190,441,6374,12042,6564,12483
270110,202308,3924,8433,2916,7074,176,326,2317,5684,2493,6010
270120,202308,3020,7468,2478,6642,94,282,1878,4854,1972,5136
270130,202308,6107,13801,4806,11929,170,575,3946,9317,4116,9892
270135,202308,2408,5075,1913,4472,43,162,1645,3680,1688,3842
270140,202308,10285,22872,7221,17985,426,1151,5201,12071,5627,13222
270150,202308,3898,8792,3428,8106,48,175,3186,7397,3234,7572
270160,202308,6095,15362,4945,13734,180,614,4230,11430,4410,12044
270170,202308,3790,10022,2904,8490,188,711,1951,5229,2139,5940
270180,202308,2882,7583,2432,6906,88,374,2015,5529,2103,5903
270190,202308,3036,6057,2612,5525,38,137,2357,4803,2395,4940
270200,202308,3325,8628,2605,7325,499,1211,1535,4455,2034,5666
270210,202308,7049,14252,5730,12609,141,488,5016,10628,5157,11116
270220,202308,2089,4480,1530,3580,116,285,1157,2545,1273,2830
270230,202308,12560,29804,9864,25374,954,2647,7207,17633,8161,20280
270235,202308,7587,20338,6108,17696,305,950,4635,12979,4940,13929
270240,202308,14244,33680,10785,28046,962,2734,7657,18940,8619,21674
270250,202308,4217,8276,3394,7089,178,460,2760,5475,2938,5935
270255,202308,5194,13289,3894,10921,168,531,2983,8052,3151,8583
270260,202308,6554,17910,5507,16018,119,492,4531,12723,4650,13215
270270,202308,1208,2868,908,2438,103,265,655,1730,758,1995
270280,202308,4509,9614,3249,7947,244,533,2310,5683,2554,6216
270290,202308,9673,26652,8284,24252,241,941,6950,19848,7191,20789
270300,202308,4841,11428,3487,9558,221,640,2557,6784,2778,7424
270310,202308,7952,20162,6312,17451,180,629,4924,13106,5104,13735
270320,202308,6605,17434,5089,14411,221,766,3611,9370,3832,10136
270330,202308,5255,14336,4344,12883,208,862,3547,10117,3755,10979
270340,202308,1956,4587,1544,3930,98,177,1261,3210,1359,3387
270350,202308,2262,4567,1684,3818,157,294,1120,2584,1277,2878
270360,202308,4310,8190,3669,7414,66,193,3354,6576,3420,6769
270370,202308,1590,4463,1328,3973,39,173,1074,3105,1113,3278
270375,202308,4855,8708,3878,7620,111,306,3349,6380,3460,6686
270380,202308,6949,15742,5369,13552,637,1426,3853,9752,4490,11178
270390,202308,1514,3270,1128,2800,12,64,969,2365,981,2429
270400,202308,7723,18326,5806,15182,347,935,4105,10269,4452,11204
270410,202308,6283,15469,5090,13570,144,506,4185,10708,4329,11214
270420,202308,8388,19456,7289,17723,176,597,6174,14348,6350,14945
270430,202308,218889,440345,161588,357804,18722,42090,103078,216238,121800,258328
270440,202308,5636,13543,4593,12020,299,1012,3545,9039,3844,10051
270450,202308,11305,23468,9368,20882,510,1024,7542,16611,8052,17635
270460,202308,4700,9325,3637,7949,232,420,3064,6614,3296,7034
270470,202308,14756,35334,11771,30506,687,2007,8910,22005,9597,24012
270480,202308,3738,8432,2847,7109,187,496,2181,5172,2368,5668
270490,202308,1063,2653,855,2338,52,165,645,1681,697,1846
270500,202308,5843,15466,4981,13877,294,788,3947,10789,4241,11577
270510,202308,7712,16939,5923,14332,302,891,4605,10552,4907,11443
270520,202308,4913,12057,3453,9449,674,1850,1680,4500,2354,6350
270530,202308,1630,4194,1254,3515,86,229,857,2357,943,2586
270540,202308,2693,6472,2089,5574,86,265,1745,4513,1831,4778
270550,202308,7838,18042,5729,15341,647,1582,3827,10269,4474,11851
270560,202308,3612,8052,2787,6830,161,523,2141,4881,2302,5404
270570,202308,6868,14432,5554,12421,508,1259,4340,9081,4848,10340
270580,202308,2931,7055,2465,6316,105,283,2053,5113,2158,5396
270590,202308,1702,4608,1484,4256,37,149,1274,3573,1311,3722
270600,202308,3343,8844,2886,8070,101,300,2444,6726,2545,7026
270610,202308,4314,10262,3544,9115,215,564,2651,6578,2866,7142
270620,202308,1417,3888,1210,3496,53,155,979,2742,1032,2897
270630,202308,24089,48870,19673,42547,634,1758,16770,34342,17404,36100
270640,202308,6735,16711,5289,14323,156,599,4082,10493,4238,11092
270642,202308,3130,8646,2560,7573,224,704,1773,4984,1997,5688
270644,202308,4771,10562,3749,9130,307,765,2828,6730,3135,7495
270650,202308,4564,10513,3730,9284,220,626,2905,6795,3125,7421
270660,202308,2351,5174,1933,4570,93,208,1482,3396,1575,3604
270670,202308,23520,45415,18252,38277,956,2013,14734,29497,15690,31510
270680,202308,7759,14492,6627,13138,301,462,5919,11757,6220,12219
270690,202308,12749,27241,9760,22875,274,824,7956,17698,8230,18522
270700,202308,693,1788,557,1547,76,212,369,977,445,1189
270710,202308,7100,18597,5741,16228,402,1226,4289,11747,4691,12973
270720,202308,4459,11134,3669,9753,121,387,3008,7683,3129,8070
270730,202308,9433,18919,7172,16238,718,1153,5329,12537,6047,13690
270740,202308,2778,6739,2220,5910,109,367,1692,4244,1801,4611
270750,202308,6833,15277,5667,13530,109,397,5067,11650,5176,12047
270760,202308,4012,9652,3134,8325,66,288,2554,6529,2620,6817
270770,202308,29601,64901,21751,52904,2981,7095,13822,32143,16803,39238
270780,202308,2500,5384,2143,4890,62,163,1889,4180,1951,4343
270790,202308,2191,4982,1689,4187,104,268,1320,3122,1424,3390
270800,202308,14630,32565,12060,28625,603,1589,9404,21325,10007,22914
270810,202308,4180,9907,3106,8203,341,820,2192,5680,2533,6500
270820,202308,1917,5110,1534,4454,59,223,1199,3350,1258,3573
270830,202308,6211,13384,4641,11208,407,819,3435,8155,3842,8974
270840,202308,9827,26399,7939,23168,552,2237,5928,16323,6480,18560
270850,202308,10851,21927,8550,18973,593,1396,6809,14606,7402,16002
270860,202308,17763,35603,12732,28864,800,1936,9945,21739,10745,23675
270870,202308,2825,7297,2019,5817,198,610,1221,3305,1419,3915
270880,202308,9492,25552,7728,22332,252,969,6026,16686,6278,17655
270890,202308,4250,10245,3253,8515,552,1443,1699,4270,2251,5713
270895,202308,4728,11075,4010,10017,178,522,3327,8044,3505,8566
270900,202308,1852,4345,1350,3556,42,143,1028,2545,1070,2688
270910,202308,5562,13631,4438,11820,315,760,3380,8761,3695,9521
270915,202308,11451,28463,8427,22996,872,2687,5311,13358,6183,16045
270920,202308,7365,18382,6053,16305,121,490,5047,13175,5168,13665
270930,202308,22110,44817,16278,37328,2059,4491,11158,25309,13217,29800
270940,202308,7262,17289,5505,14748,184,686,4228,10627,4412,11313
280010,202308,677,1790,496,1420,18,75,329,842,347,917
280020,202308,6550,13887,5128,11607,426,962,3850,8283,4276,9245
280030,202308,128014,248124,96952,200443,16965,33567,55546,111316,72511,144883
280040,202308,3770,8580,2979,7277,175,484,2303,5354,2478,5838
280050,202308,5204,13167,3829,10537,869,2368,1801,4723,2670,7091
280060,202308,9926,21010,7329,16877,1038,2569,4457,9567,5495,12136
280067,202308,8883,18266,6850,14982,623,1044,4969,10663,5592,11707
280070,202308,2198,5863,1874,5308,126,412,1400,3735,1526,4147
280100,202308,5397,12050,4195,10047,641,1328,2460,5978,3101,7306
280110,202308,1992,4161,1602,3601,41,132,1403,3015,1444,3147
280120,202308,10008,23735,8225,20751,1163,2600,5502,13981,6665,16581
280130,202308,10583,22158,8163,18697,710,1709,5959,13239,6669,14948
280140,202308,7642,14768,6326,12796,727,1204,4598,9420,5325,10624
280150,202308,4851,11022,3541,8735,530,1067,2224,5363,2754,6430
280160,202308,1621,3861,1246,3188,123,274,815,1939,938,2213
280170,202308,7220,15073,5864,13028,214,539,4845,10288,5059,10827
280190,202308,2086,3433,1741,2975,30,68,1574,2594,1604,2662
280200,202308,1514,3560,1093,2897,59,222,746,1756,805,1978
280210,202308,22579,46978,17214,38286,2256,4913,11302,24080,13558,28993
280220,202308,2040,4545,1601,3897,87,187,1244,2960,1331,3147
280230,202308,5047,11475,3695,9265,235,530,2508,6091,2743,6621
280240,202308,3897,9195,3211,8098,42,189,2732,6573,2774,6762
280250,202308,1350,2489,909,1784,40,90,738,1356,778,1446
280260,202308,3095,5998,2470,5163,47,121,2208,4461,2255,4582
280270,202308,3093,7112,2546,6274,120,372,2161,5075,2281,5447
280280,202308,4716,12343,3775,10697,508,1177,2570,7381,3078,8558
280290,202308,27861,59523,21582,49443,2452,6063,13059,29351,15511,35414
280300,202308,16610,31957,13693,28503,973,1475,10840,23155,11813,24630
280310,202308,1686,3800,1293,3142,47,134,1019,2343,1066,2477
280320,202308,11624,26084,9191,22053,942,2152,6551,14911,7493,17063
280330,202308,5549,12293,4006,9806,318,810,2782,6406,3100,7216
280340,202308,6421,11907,4720,9807,201,387,3937,7951,4138,8338
280350,202308,40385,74242,32274,62474,2522,4193,25175,47335,27697,51528
280360,202308,7175,17444,5235,13895,594,1604,3224,7998,3818,9602
280370,202308,2881,5953,2167,4759,217,379,1552,3391,1769,3770
280380,202308,1296,2959,988,2443,116,280,680,1643,796,1923
280390,202308,5122,10196,3936,8336,260,461,3132,6459,3392,6920
280400,202308,5163,10626,3953,8818,356,774,2925,6322,3281,7096
280410,202308,3525,8203,2683,6729,364,944,1688,3944,2052,4888
280420,202308,5580,12308,4672,11060,129,327,4099,9568,4228,9895
280430,202308,2984,5879,2414,5084,101,282,1998,3957,2099,4239
280440,202308,5584,12145,4457,10344,321,731,3487,7666,3808,8397
280445,202308,2652,6341,2259,5635,174,286,1659,4092,1833,4378
280450,202308,12068,26821,9533,22812,2438,5668,4686,11354,7124,17022
280460,202308,8684,17800,7185,15644,532,1258,5617,11637,6149,12895
280470,202308,2020,4978,1520,4016,178,435,1051,2673,1229,3108
280480,202308,65457,131672,50991,109132,5829,12589,34429,69859,40258,82448
280490,202308,4121,10778,3178,8992,265,727,2149,5787,2414,6514
280500,202308,1302,2614,939,2099,34,102,747,1625,781,1727
280510,202308,4552,7573,3743,6491,143,248,3331,5583,3474,5831
280520,202308,2335,4763,1880,4089,168,321,1397,2967,1565,3288
280530,202308,2825,6382,2177,5340,105,272,1701,3994,1806,4266
280540,202308,10428,24739,8823,22184,413,1077,7363,18136,7776,19213
280550,202308,8279,16598,6371,13772,182,530,5252,10650,5434,11180
280560,202308,9259,21508,8062,19576,188,576,6960,16397,7148,16973
280570,202308,8680,17646,6606,14680,300,728,5153,10733,5453,11461
280580,202308,7784,16104,6367,13853,476,925,5095,10777,5571,11702
280590,202308,3352,7026,2431,5667,156,417,1772,3838,1928,4255
280600,202308,5282,11239,4247,9448,702,1298,2746,6108,3448,7406
280610,202308,3513,6916,2749,5773,122,288,2276,4549,2398,4837
280620,202308,7778,15872,6012,13310,461,757,4414,9840,4875,10597
280630,202308,5174,11431,4253,9975,378,741,3086,7139,3464,7880
280640,202308,3055,6586,2388,5685,87,245,2062,4766,2149,5011
280650,202308,1405,3334,1024,2665,119,318,618,1468,737,1786
280660,202308,4772,8908,3714,7493,267,524,3016,5902,3283,6426
280670,202308,25873,52978,19744,43803,3541,7431,11560,25239,15101,32670
280680,202308,3548,7460,2747,6198,263,476,1866,4252,2129,4728
280690,202308,1323,2615,1007,2150,46,117,820,1678,866,1795
280700,202308,1470,3017,1149,2514,21,55,966,2042,987,2097
280710,202308,18979,36104,14560,30524,858,1555,12025,24696,12883,26251
280720,202308,3112,6208,2239,4980,41,114,1861,4044,1902,4158
280730,202308,1253,2862,949,2327,103,254,635,1509,738,1763
280740,202308,21384,40060,17024,33521,887,1961,13799,25605,14686,27566
280750,202308,4100,10317,3246,8718,310,791,2241,5876,2551,6667
280760,202308,9193,19342,7215,16376,661,1324,5323,11951,5984,13275
290010,202308,3738,6770,2406,4780,26,61,2065,3869,2091,3930
290020,202308,7417,15114,6282,13573,436,731,5096,10916,5532,11647
290030,202308,5445,11029,4168,9388,351,748,3114,7083,3465,7831
290035,202308,6194,11720,4846,9852,199,344,3915,7758,4114,8102
290040,202308,7185,12175,5813,10466,206,325,5088,9014,5294,9339
290050,202308,2527,7135,1914,5767,145,466,1280,3627,1425,4093
290060,202308,1914,3610,1291,2738,146,317,944,1907,1090,2224
290070,202308,53160,100111,40695,82005,3295,6339,30469,59048,33764,65387
290080,202308,8660,19551,6948,16781,795,1975,4794,11204,5589,13179
290090,202308,2741,4331,1920,3437,43,73,1740,3043,1783,3116
290100,202308,12109,27503,8565,21494,1678,4097,4021,10159,5699,14256
290110,202308,6883,15633,5063,12236,889,1908,2733,6503,3622,8411
290115,202308,4887,12933,3827,10917,369,1054,2879,8016,3248,9070
290120,202308,8297,17458,6362,14514,219,577,5350,11662,5569,12239
290130,202308,5563,11515,3921,9143,249,508,2762,6563,3011,7071
290135,202308,5666,11489,4083,8738,280,622,3095,6186,3375,6808
290140,202308,5258,12072,3716,9738,200,511,2925,7464,3125,7975
290150,202308,4256,7861,3208,6500,125,330,2573,4867,2698,5197
290160,202308,4536,8575,3721,7367,218,367,3107,6022,3325,6389
290170,202308,4662,9259,3645,7990,134,324,3108,6605,3242,6929
290180,202308,3617,8485,2854,7210,78,264,2378,5779,2456,6043
290190,202308,6241,12998,5261,11604,115,319,4547,9746,4662,10065
290195,202308,3327,6702,2444,5523,157,312,1950,4346,2107,4658
290200,202308,4972,12335,3498,9637,231,544,2431,6547,2662,7091
290205,202308,4629,9695,3585,7928,178,449,2803,5900,2981,6349
290210,202308,17964,39639,14575,34109,1535,3084,10743,25070,12278,28154
290220,202308,4206,7716,3424,6689,113,278,2934,5508,3047,5786
290225,202308,3792,6636,2717,5436,50,148,2381,4521,2431,4669
290230,202308,3914,7484,3419,6854,191,285,2752,5611,2943,5896
290240,202308,5106,10079,3987,8665,154,385,3346,7043,3500,7428
290250,202308,5145,12117,3781,9964,175,460,3033,7910,3208,8370
290260,202308,6554,13935,5120,11662,248,618,4244,9202,4492,9820
290265,202308,3763,10265,2775,8242,359,1156,1650,4652,2009,5808
290270,202308,13191,39441,11135,35366,891,2862,7987,24891,8878,27753
290280,202308,7378,20307,5665,16507,705,2167,3502,9583,4207,11750
290290,202308,11959,31271,8436,24393,994,2986,4960,13496,5954,16482
290300,202308,4953,12080,3358,9012,220,685,2375,6031,2595,6716
290310,202308,2856,4980,2241,4228,19,55,2063,3781,2082,3836
290320,202308,38242,84323,27782,66979,5013,12388,15419,35278,20432,47666
290323,202308,4626,11197,3588,9381,149,426,2758,7085,2907,7511
290327,202308,5161,12923,3832,10110,388,907,2533,6470,2921,7377
290330,202308,3128,5022,2386,4196,26,70,2182,3762,2208,3832
290340,202308,7919,16084,5858,13316,421,941,4582,10104,5003,11045
290350,202308,5764,14445,4390,11957,286,865,3189,8370,3475,9235
290360,202308,6658,13727,5272,11704,206,572,4457,9475,4663,10047
290370,202308,5644,12337,3664,9425,213,580,2579,6544,2792,7124
290380,202308,7296,15312,5572,12743,178,392,4668,10557,4846,10949
290390,202308,18947,47201,14166,38622,1381,3765,9492,25102,10873,28867
290395,202308,3611,8710,2587,6854,112,381,1968,4947,2080,5328
290400,202308,4513,11039,3186,8616,163,515,2364,6085,2527,6600
290405,202308,5466,14050,4292,11888,564,1503,2682,7456,3246,8959
290410,202308,6872,15969,4800,12573,182,694,3605,8929,3787,9623
290420,202308,3739,9051,2779,7426,142,386,2010,5301,2152,5687
290430,202308,4594,9680,3596,8163,155,420,2887,6199,3042,6619
290440,202308,3466,7658,2332,5781,181,418,1638,4030,1819,4448
290450,202308,5318,10023,3873,7857,82,226,3403,6571,3485,6797
290460,202308,15645,39919,10806,29741,2545,7094,4004,10469,6549,17563
290470,202308,6058,11939,4178,9193,367,796,2901,6179,3268,6975
290475,202308,8073,19768,6155,16420,177,672,5013,12819,5190,13491
290480,202308,2287,4853,1687,3866,63,195,1242,2580,1305,2775
290485,202308,5678,14203,4620,12519,264,812,3511,9280,3775,10092
290490,202308,11981,23341,9934,20334,601,1195,7915,15769,8516,16964
290500,202308,5145,13683,3483,10076,769,2332,1289,3519,2058,5851
290510,202308,4453,9143,3487,7810,107,254,2961,6570,3068,6824
290515,202308,4184,10284,3259,8742,85,344,2590,6591,2675,6935
290520,202308,15185,37261,10536,27927,600,1974,7010,16787,7610,18761
290530,202308,5854,14994,4552,12723,125,455,3719,10132,3844,10587
290540,202308,5054,11227,4259,10187,152,381,3572,8325,3724,8706
290550,202308,5392,11544,4387,10234,131,403,3779,8635,3910,9038
290560,202308,7623,17438,5301,13689,528,1506,3233,7653,3761,9159
290570,202308,76307,159154,62194,137395,5534,13379,46989,98387,52523,111766
290580,202308,11423,25798,9416,22836,847,1911,6949,16874,7796,18785
290590,202308,8342,23081,6578,19911,184,666,5177,15617,5361,16283
290600,202308,23205,57245,18151,48187,1228,3411,13851,35337,15079,38748
290610,202308,2922,8164,2116,6496,104,362,1489,4390,1593,4752
290620,202308,7259,18941,5717,16135,455,1205,4337,12064,4792,13269
290630,202308,13256,25051,10373,21271,670,1430,8280,16523,8950,17953
290640,202308,3289,6987,2261,5329,237,494,1578,3769,1815,4263
290650,202308,24333,45665,20470,40333,726,1886,17908,33706,18634,35592
290660,202308,4529,10568,3228,8224,187,539,2328,5777,2515,6316
290670,202308,10819,21157,8647,17915,192,519,7601,15160,7793,15679
290680,202308,13701,32084,10737,27535,267,965,8759,21586,9026,22551
290682,202308,6766,13622,5509,11881,450,676,4023,9283,4473,9959
290685,202308,4315,8780,2871,6581,430,909,1689,3922,2119,4831
290687,202308,10419,21801,8169,18208,1186,2432,5150,11510,6336,13942
290689,202308,3402,8203,2288,6199,340,884,1407,3726,1747,4610
290690,202308,7044,16030,5183,12951,399,978,3650,8778,4049,9756
290700,202308,3876,7765,3151,6786,111,273,2627,5442,2738,5715
290710,202308,11255,25153,8965,21818,226,683,7759,18374,7985,19057
290720,202308,26184,58779,21249,50946,1602,3596,15762,36191,17364,39787
290730,202308,8845,18450,6845,15723,620,1204,4672,10822,5292,12026
290740,202308,1337,3030,960,2435,72,157,756,1891,828,2048
290750,202308,17890,34277,13492,26641,339,880,11279,20727,11618,21607
290755,202308,2354,6093,1704,4889,178,416,1100,3172,1278,3588
290760,202308,4461,11484,3367,9410,170,407,2387,6701,2557,7108
290770,202308,3937,8844,3374,8028,91,300,2870,6572,2961,6872
290780,202308,9408,21093,6965,17130,569,1199,4906,12006,5475,13205
290790,202308,6295,14838,5026,12853,312,853,3965,9939,4277,10792
290800,202308,8214,14643,5526,11257,458,800,3980,8170,4438,8970
290810,202308,6897,14785,5117,12001,223,574,3957,9041,4180,9615
290820,202308,6723,14842,5085,11996,287,664,3639,8181,3926,8845
290830,202308,5143,11462,3924,9236,156,554,2885,6060,3041,6614
290840,202308,22750,52849,17243,43229,1934,4158,10548,27363,12482,31521
290850,202308,11508,20741,8888,17373,637,1142,6908,13092,7545,14234
290860,202308,8082,18882,6625,16868,368,811,5430,13861,5798,14672
290870,202308,5831,14233,3927,10437,380,906,2575,6606,2955,7512
290880,202308,1710,3721,1225,3023,222,496,647,1703,869,2199
290890,202308,12284,21210,9619,18033,322,685,8294,15039,8616,15724
290900,202308,2760,6708,1836,4888,223,595,1067,2731,1290,3326
290910,202308,6206,12735,4350,9917,69,184,3746,8308,3815,8492
290920,202308,6380,13714,5225,12246,194,377,4265,10403,4459,10780
290930,202308,8597,21983,6321,17787,295,952,4529,12213,4824,13165
290940,202308,4116,10413,3118,8715,221,659,2303,6220,2524,6879
290950,202308,1709,3798,1237,3034,111,268,785,1926,896,2194
290960,202308,7503,16092,6059,13956,330,636,4962,11297,5292,11933
290970,202308,3643,10136,2679,8164,187,624,1910,5600,2097,6224
290980,202308,18608,37330,14260,30126,771,1836,10297,20034,11068,21870
290990,202308,12039,27864,9885,24244,428,1286,7946,18443,8374,19729
291000,202308,3960,8901,2877,7444,186,526,2183,5570,2369,6096
291005,202308,22010,46336,17432,39270,1097,2665,13536,28848,14633,31513
291010,202308,3573,10041,2493,7563,154,469,1600,4650,1754,5119
291020,202308,1531,3412,1109,2662,35,104,780,1686,815,1790
291030,202308,3089,6479,2030,4647,238,496,1226,2684,1464,3180
291040,202308,6471,15463,4856,12992,266,724,3636,9602,3902,10326
291050,202308,14759,28765,11947,24476,1463,2772,8544,17105,10007,19877
291060,202308,11200,24038,8993,20806,1099,2174,6367,14548,7466,16722
291070,202308,22779,48336,18110,40886,392,1128,15530,33601,15922,34729
291072,202308,36388,77059,24185,56419,3674,8497,13400,29797,17074,38294
291075,202308,6439,14332,5367,12506,107,309,4364,9641,4471,9950
291077,202308,2012,4748,1418,3693,103,211,936,2432,1039,2643
291080,202308,173043,360340,123380,281710,23928,55635,62546,135571,86474,191206
291085,202308,6815,15143,5102,12427,250,694,4093,9599,4343,10293
291090,202308,2573,4341,1709,3309,52,130,1417,2622,1469,2752
291100,202308,3881,7185,2626,5570,107,206,2075,4260,2182,4466
291110,202308,7047,19305,5219,15698,329,1131,3684,10416,4013,11547
291120,202308,10297,20520,8070,17406,574,1181,6064,12695,6638,13876
291125,202308,2835,4393,2006,3442,91,139,1738,2928,1829,3067
291130,202308,3834,9593,2557,7057,132,433,1863,4808,1995,5241
291140,202308,5735,13865,3675,9849,703,1579,1997,5485,2700,7064
291150,202308,3418,5828,2508,4779,98,160,2205,4162,2303,4322
291160,202308,6166,15106,4427,12012,587,1570,2564,6489,3151,8059
291165,202308,2450,6183,1531,4307,44,166,1026,2729,1070,2895
291170,202308,27605,62372,19997,48269,1590,3919,13157,29760,14747,33679
291180,202308,9692,16699,7000,13162,342,647,5968,10855,6310,11502
291185,202308,4299,9203,3521,7972,195,375,2816,6293,3011,6668
291190,202308,9357,19936,7248,17008,351,840,5404,12624,5755,13464
291200,202308,3244,8134,2130,5899,102,338,1389,3550,1491,3888
291210,202308,9713,17132,6699,13473,364,698,5294,10380,5658,11078
291220,202308,6002,14118,4761,11904,549,1314,3055,7318,3604,8632
291230,202308,6052,10184,4452,8299,96,180,4016,7318,4112,7498
291240,202308,5031,11639,3931,9758,113,317,3292,7889,3405,8206
291250,202308,3828,10380,2761,8342,208,570,1602,4907,1810,5477
291260,202308,1838,3641,1360,2987,31,71,1116,2379,1147,2450
291270,202308,6874,14943,5025,12311,657,1605,3413,8312,4070,9917
291280,202308,3404,7346,2154,5219,145,399,1508,3350,1653,3749
291290,202308,6643,15661,4513,12083,476,1313,2905,7433,3381,8746
291300,202308,4701,11051,3458,8892,262,571,2441,6163,2703,6734
291310,202308,6364,14631,4945,12091,141,417,4178,9814,4319,10231
291320,202308,7935,18989,5720,15072,1333,3387,2921,7722,4254,11109
291330,202308,2240,5144,1696,4207,69,212,1259,2975,1328,3187
291340,202308,5123,11714,3729,9299,271,633,2452,6001,2723,6634
291345,202308,3596,8764,3020,7821,236,615,2313,5919,2549,6534
291350,202308,8553,17735,6299,14677,287,731,4949,11050,5236,11781
291360,202308,55984,105994,40336,85135,5646,11349,25092,52485,30738,63834
291370,202308,10172,23908,8186,20500,985,2251,5512,13257,6497,15508
291380,202308,5946,11695,4744,10060,136,425,3974,7976,4110,8401
291390,202308,16789,30546,11894,24413,844,1479,9396,18759,10240,20238
291400,202308,20824,41677,15706,33637,1757,3537,10598,22342,12355,25879
291410,202308,3583,8335,2552,6474,65,211,1890,4567,1955,4778
291420,202308,2232,4832,1644,4045,30,104,1407,3382,1437,3486
291430,202308,3133,7679,2417,6391,149,420,1793,4501,1942,4921
291440,202308,8150,19989,6398,16996,499,1252,4521,12054,5020,13306
291450,202308,13960,25037,10839,21239,334,619,9567,18647,9901,19266
291460,202308,23111,49267,18143,40845,2037,4228,12526,27067,14563,31295
291465,202308,10493,22820,7816,19438,354,1167,6190,14719,6544,15886
291470,202308,26080,47099,19411,38098,1139,2050,14635,27221,15774,29271
291480,202308,55346,108121,39170,83139,4601,9977,23655,47186,28256,57163
291490,202308,9433,18150,7895,16274,412,886,6665,13352,7077,14238
291500,202308,6799,12837,5319,10934,134,380,4689,9254,4823,9634
291510,202308,5911,11255,4304,9151,102,291,3707,7623,3809,7914
291520,202308,5592,11253,3736,8599,210,510,2884,6310,3094,6820
291530,202308,2766,5630,1803,4274,169,401,1213,2788,1382,3189
291535,202308,4718,11339,3643,9514,204,532,2850,7351,3054,7883
291540,202308,2670,5037,1767,3872,87,172,1469,3201,1556,3373
291550,202308,8281,15044,5859,11750,415,742,4392,8615,4807,9357
291560,202308,21692,47248,14160,35600,3642,8987,5480,13595,9122,22582
291570,202308,2874,5739,2048,4750,68,179,1740,3949,1808,4128
291580,202308,7691,17114,5381,13589,419,1065,3783,9125,4202,10190
291590,202308,3509,6389,2825,5515,66,168,2469,4588,2535,4756
291600,202308,6792,13661,4768,10508,475,1143,3132,6606,3607,7749
291610,202308,8687,16702,7165,14757,659,1026,5509,11491,6168,12517
291620,202308,3562,6990,2486,5620,200,418,1777,4039,1977,4457
291630,202308,4304,7803,3035,6208,539,862,2098,4488,2637,5350
291640,202308,22970,45832,15442,34029,1274,2998,10196,21058,11470,24056
291650,202308,12693,25524,10453,22492,822,1460,8166,17513,8988,18973
291660,202308,2357,5169,1621,4007,127,346,1074,2422,1201,2768
291670,202308,2409,5726,1818,4783,278,652,1093,2978,1371,3630
291680,202308,5031,10810,3666,8721,691,1652,2081,4910,2772,6562
291685,202308,5661,12776,4144,10315,379,836,2939,7253,3318,8089
291690,202308,5551,9769,3760,7278,164,320,3260,6098,3424,6418
291700,202308,11940,27508,9894,24106,295,907,8459,19820,8754,20727
291710,202308,6755,13081,4709,10145,351,768,3461,7021,3812,7789
291720,202308,5361,14475,4036,11751,1022,2935,1918,5514,2940,8449
291730,202308,9962,18362,8181,16018,424,901,6843,13006,7267,13907
291733,202308,3571,7926,2668,6571,123,302,1960,4869,2083,5171
291735,202308,3131,7875,2170,6040,90,242,1503,4164,1593,4406
291740,202308,4976,11537,2995,7841,118,266,2079,5303,2197,5569
291750,202308,27423,56039,20555,44890,2858,5519,13532,29258,16390,34777
291760,202308,13778,34382,9617,27190,3086,9945,1859,4571,4945,14516
291770,202308,9487,22125,6934,17224,459,1328,5072,11649,5531,12977
291780,202308,6502,14499,5539,13051,206,524,4645,10625,4851,11149
291790,202308,3776,8115,3257,7395,420,642,2316,5515,2736,6157
291800,202308,45561,94003,32890,74470,4642,10596,19657,41327,24299,51923
291810,202308,13407,27644,10453,23540,549,988,8347,18745,8896,19733
291820,202308,4809,10927,3863,9487,154,403,3069,7363,3223,7766
291830,202308,6044,11403,4584,9421,400,604,3469,7153,3869,7757
291835,202308,7826,21050,5813,17188,1040,2982,3221,9540,4261,12522
291840,202308,67713,155295,54156,132604,6896,16839,35872,84539,42768,101378
291845,202308,4241,8181,3221,6830,343,670,2298,4898,2641,5568
291850,202308,5590,12942,4381,10966,135,361,3685,9133,3820,9494
291855,202308,2881,4673,2143,3843,70,147,1907,3350,1977,3497
291860,202308,2557,6244,1584,4309,63,189,1041,2691,1104,2880
291870,202308,1537,3517,899,2384,77,220,552,1385,629,1605
291875,202308,3538,9662,2726,7863,103,396,1920,5260,2023,5656
291880,202308,6825,16444,5325,13867,359,901,3956,10231,4315,11132
291890,202308,2107,3752,1231,2663,194,399,738,1525,932,1924
291900,202308,1652,3436,1164,2672,52,138,911,1950,963,2088
291905,202308,2523,6178,1853,5002,101,300,1361,3453,1462,3753
291910,202308,4558,8442,3566,7149,80,197,3155,6199,3235,6396
291915,202308,8819,22152,6605,18163,326,944,4529,12345,4855,13289
291920,202308,47086,99593,37570,85226,1935,5333,28684,60665,30619,65998
291930,202308,3440,7470,2715,6384,337,708,1864,4414,2201,5122
291940,202308,4483,10340,2692,7186,298,762,1601,4140,1899,4902
291950,202308,10941,30456,8208,24791,564,1676,5300,15645,5864,17321
291955,202308,26876,56916,21484,48853,1461,3515,16026,34812,17487,38327
291960,202308,4727,9402,3655,7914,296,501,2870,6318,3166,6819
291970,202308,6178,12479,4910,10785,224,583,3885,8199,4109,8782
291980,202308,12283,30745,8931,24569,906,2351,5791,15870,6697,18221
291990,202308,2773,6242,2149,5430,78,311,1835,4479,1913,4790
291992,202308,5757,11474,4445,9440,151,364,3681,7456,3832,7820
291995,202308,2861,6321,2117,5084,93,279,1661,3729,1754,4008
292000,202308,3416,6708,2670,5784,95,235,2238,4728,2333,4963
292010,202308,7177,14190,5432,11499,114,330,4676,9503,4790,9833
292020,202308,5814,13749,4540,11463,130,450,3703,8878,3833,9328
292030,202308,2654,6651,2031,5467,223,645,1232,3142,1455,3787
292040,202308,5767,12056,4283,9894,161,342,3515,7978,3676,8320
292045,202308,5544,10868,4157,8922,64,202,3768,7898,3832,8100
292050,202308,7912,19248,5598,14823,323,876,3738,9348,4061,10224
292060,202308,16307,30757,14084,27867,665,1321,11923,22703,12588,24024
292070,202308,8903,17661,7414,15751,586,1245,6015,12488,6601,13733
292080,202308,4727,8767,3750,7512,69,212,3384,6571,3453,6783
292090,202308,5262,9999,3462,7711,169,421,2675,5788,2844,6209
292100,202308,16573,34820,12157,27986,1839,4255,7258,15964,9097,20219
292105,202308,3951,9114,3019,7602,88,286,2367,5746,2455,6032
292110,202308,8320,16332,5669,12568,879,2009,3539,7608,4418,9617
292120,202308,8746,19389,6510,15379,757,1554,4393,10407,5150,11961
292130,202308,4046,8564,2994,7064,247,559,2066,4684,2313,5243
292140,202308,7243,13870,5668,11531,185,411,4965,9790,5150,10201
292145,202308,3249,7698,2432,6234,145,287,1809,4675,1954,4962
292150,202308,20160,43249,16154,36673,389,1049,13571,29378,13960,30427
292160,202308,3508,7373,2434,5914,33,112,1927,4820,1960,4932
292170,202308,10611,25091,7976,20627,583,1649,5700,13970,6283,15619
292180,202308,3436,8620,2293,6342,203,569,1451,3781,1654,4350
292190,202308,3804,8518,2834,6866,333,785,1827,4322,2160,5107
292200,202308,11695,25805,7473,18753,1903,4914,2986,7282,4889,12196
292205,202308,4715,11188,3759,9628,150,425,3089,7748,3239,8173
292210,202308,8271,15551,6550,13303,105,314,6010,11843,6115,12157
292220,202308,2781,5575,2087,4449,163,341,1534,3045,1697,3386
292225,202308,3834,9864,3077,8596,93,340,2475,6678,2568,7018
292230,202308,10844,22392,8445,18846,337,934,6642,13931,6979,14865
292240,202308,6277,15608,4940,13059,367,980,3441,8938,3808,9918
292250,202308,7793,16806,6310,14445,413,921,4888,10785,5301,11706
292260,202308,4182,9688,3376,8538,102,283,2881,7171,2983,7454
292265,202308,4566,10414,3578,8806,73,252,2991,7060,3064,7312
292270,202308,6088,11211,4636,9338,267,511,3698,7269,3965,7780
292273,202308,3432,6605,2500,5347,141,291,1820,3982,1961,4273
292275,202308,2221,4875,1746,4183,51,153,1442,3326,1493,3479
292280,202308,3360,6797,2536,5786,100,226,2126,4831,2226,5057
292285,202308,3146,6385,2322,5242,127,248,1856,4209,1983,4457
292290,202308,9213,20289,6960,16938,526,1000,5414,13157,5940,14157
292300,202308,13156,29167,9160,22823,1602,4005,5032,12263,6634,16268
292303,202308,4213,9289,3417,8018,88,223,2915,6599,3003,6822
292305,202308,2804,6504,2378,5848,116,285,1999,4814,2115,5099
292310,202308,8498,17926,6795,15499,197,600,5813,12714,6010,13314
292320,202308,6946,16524,5119,13302,211,549,3946,9950,4157,10499
292330,202308,3957,6658,3097,5624,158,242,2602,4738,2760,4980
292335,202308,6257,14374,5076,12474,352,848,3978,9642,4330,10490
292340,202308,6356,16287,4685,12900,455,1159,3138,8491,3593,9650
292350,202308,3460,7848,2761,6820,155,408,2206,5280,2361,5688
292360,202308,6023,14209,4508,11495,282,700,3223,7967,3505,8667
292370,202308,13499,27045,10783,23301,152,556,9855,20598,10007,21154
292380,202308,8295,20291,6719,17302,489,1304,5003,12348,5492,13652
292390,202308,5912,9355,4330,7474,156,271,3875,6591,4031,6862
292400,202308,30073,70942,23413,59161,2634,6395,15511,38031,18145,44426
292405,202308,5528,11775,4189,9552,156,389,3253,7409,3409,7798
292410,202308,3097,5676,2432,4808,109,215,2085,4031,2194,4246
292420,202308,6259,11984,5250,10580,130,258,4680,9182,4810,9440
292430,202308,6049,15994,4064,12058,344,1024,2611,7382,2955,8406
292440,202308,11579,29187,10098,26926,174,781,8806,22860,8980,23641
292450,202308,5025,12607,3382,9363,215,616,2363,6257,2578,6873
292460,202308,8000,16218,6328,13588,318,913,5208,10552,5526,11465
292465,202308,3124,6876,2349,5621,84,212,1640,4059,1724,4271
292467,202308,2656,6127,2245,5528,303,656,1511,3868,1814,4524
292470,202308,3345,7911,2230,6019,169,469,1561,4175,1730,4644
292480,202308,8193,15050,6484,12889,225,400,5729,11225,5954,11625
292490,202308,3499,6620,2622,5424,60,150,2218,4368,2278,4518
292500,202308,9061,19715,6550,15494,356,786,4953,11274,5309,12060
292510,202308,17550,39326,12446,30706,1427,3109,8422,20654,9849,23763
292520,202308,9360,20504,7313,16966,415,1087,5573,12270,5988,13357
292525,202308,8214,16447,6372,14129,189,515,5517,11921,5706,12436
292530,202308,48080,106368,34567,83838,6617,16965,17655,39873,24272,56838
292540,202308,5183,8585,3843,7099,222,412,3299,5998,3521,6410
292550,202308,10599,25339,7407,20801,716,2018,4633,13135,5349,15153
292560,202308,5612,12346,4168,10088,162,484,3242,7432,3404,7916
292570,202308,4508,10286,3390,8316,90,314,2725,6314,2815,6628
292575,202308,8250,21155,7001,19053,1324,3517,4472,12208,5796,15725
292580,202308,9703,19924,7572,16727,398,635,6200,13526,6598,14161
292590,202308,8952,21084,6926,17358,447,1159,5531,13462,5978,14621
292593,202308,3562,7770,2513,5928,112,286,1945,4373,2057,4659
292595,202308,6882,15518,5620,13690,333,713,4398,10690,4731,11403
292600,202308,13880,32552,11039,27977,744,1675,8537,21513,9281,23188
292610,202308,5635,12140,4261,9791,214,507,3314,7262,3528,7769
292620,202308,8259,18452,6338,15910,169,528,5408,13285,5577,13813
292630,202308,11678,24079,8532,18889,1381,3294,5507,11422,6888,14716
292640,202308,9733,24858,7260,20222,571,1556,4774,13210,5345,14766
292650,202308,5085,11328,4146,9949,117,438,3620,8372,3737,8810
292660,202308,13148,32618,10271,27753,577,1582,7523,20049,8100,21631
292665,202308,2458,6301,1938,5502,137,350,1434,4115,1571,4465
292670,202308,4056,10284,2889,8038,276,845,1837,4800,2113,5645
292680,202308,4654,10943,3431,8735,125,319,2604,6313,2729,6632
292690,202308,2856,6910,1808,5137,238,638,1071,3079,1309,3717
292700,202308,12978,29421,9993,24307,698,1462,7340,17425,8038,18887
292710,202308,4326,9043,3871,8434,92,272,3540,7504,3632,7776
292720,202308,10523,21603,8065,18257,481,1010,6018,13713,6499,14723
292730,202308,6948,13159,5742,11371,290,494,4839,9477,5129,9971
292740,202308,560265,1079149,453984,917007,51459,103143,314171,601719,365630,704862
292750,202308,9272,18952,7290,16167,333,797,5974,12880,6307,13677
292760,202308,4729,11837,3747,10029,185,524,2799,7274,2984,7798
292770,202308,9942,21137,7431,17472,975,2426,4876,11069,5851,13495
292780,202308,2553,4346,1771,3386,70,163,1448,2579,1518,2742
292790,202308,4700,8595,3187,6760,287,550,2401,5022,2688,5572
292800,202308,14828,31343,11686,26237,1076,2153,8643,19323,9719,21476
292805,202308,4615,9144,3459,7587,188,475,2776,5829,2964,6304
292810,202308,17025,32761,12845,26394,397,1084,10715,20523,11112,21607
292820,202308,7983,20615,5471,16046,540,1661,3594,10090,4134,11751
292830,202308,3632,7428,2913,6496,138,301,2362,5247,2500,5548
292840,202308,12727,25407,10046,21655,212,601,8880,18361,9092,18962
292850,202308,3199,7239,2453,6038,186,463,1740,4092,1926,4555
292860,202308,22679,42249,17912,35586,475,1302,15021,28044,15496,29346
292870,202308,29714,60406,22505,48626,2400,4603,14738,30215,17138,34818
292880,202308,13883,34532,10138,27513,427,1382,6759,16637,7186,18019
292890,202308,11055,23621,8917,20339,256,689,7338,15840,7594,16529
292895,202308,4134,7472,2969,5709,261,476,2277,4275,2538,4751
292900,202308,3738,8030,3039,6881,60,213,2444,5141,2504,5354
292905,202308,5488,12259,3995,9807,296,758,2886,6716,3182,7474
292910,202308,7150,15475,5863,13549,197,411,4741,10566,4938,10977
292920,202308,12625,28646,10257,24520,401,1253,8185,18488,8586,19741
292925,202308,6227,16159,4458,12519,414,993,2933,8094,3347,9087
292930,202308,8837,22591,6630,18052,992,2625,3400,8766,4392,11391
292935,202308,3346,6066,2519,5062,32,89,2263,4486,2295,4575
292937,202308,3224,7595,2527,6570,335,953,1277,3586,1612,4539
292940,202308,3722,8150,2740,6587,481,1049,1640,4013,2121,5062
292950,202308,11188,25962,8169,20395,596,1476,5711,13366,6307,14842
292960,202308,6896,14241,5256,11750,209,451,4083,8752,4292,9203
292970,202308,4986,12073,4150,10784,124,368,3325,8511,3449,8879
292975,202308,5269,10310,4281,8997,108,283,3763,7603,3871,7886
292980,202308,4822,9061,3734,7456,72,210,3307,6352,3379,6562
292990,202308,13944,34538,10657,28567,557,1718,7846,19779,8403,21497
293000,202308,3234,7048,2375,5591,221,466,1655,3872,1876,4338
293010,202308,23839,51761,17446,41245,2804,6583,10683,24517,13487,31100
293015,202308,10467,28037,7659,22558,716,2120,5074,14726,5790,16846
293020,202308,12740,29945,10850,27015,192,665,9636,23332,9828,23997
293030,202308,6272,14882,4406,11706,354,681,2827,7758,3181,8439
293040,202308,5389,12084,3918,9879,144,374,3139,7717,3283,8091
293050,202308,32462,62918,25491,51765,1809,3529,19536,37847,21345,41376
293060,202308,4637,10881,3385,8515,218,597,2459,5834,2677,6431
293070,202308,43403,81621,34638,68446,1956,4077,27116,50616,29072,54693
293075,202308,4434,11829,3559,10293,97,422,2985,8450,3082,8872
293076,202308,4154,8742,3461,7807,128,234,2984,6762,3112,6996
293077,202308,8319,19260,5978,15161,1000,2136,3352,8971,4352,11107
293080,202308,5318,13977,4169,11781,112,430,3293,8913,3405,9343
293090,202308,3807,10147,2562,7734,232,694,1678,4881,1910,5575
293100,202308,7184,16775,5359,13502,412,928,4019,9981,4431,10909
293105,202308,4697,13177,3686,11118,300,887,2498,7394,2798,8281
293110,202308,3215,6485,2462,5335,148,290,1946,4116,2094,4406
293120,202308,6538,13443,5479,11837,500,825,4209,9193,4709,10018
293130,202308,4506,10434,3641,9151,114,352,3134,7661,3248,8013
293135,202308,40171,86392,25346,62555,5303,14299,9479,21769,14782,36068
293140,202308,3618,6007,2827,5003,112,174,2377,4047,2489,4221
293150,202308,6244,16406,4451,12623,529,1368,2842,7732,3371,9100
293160,202308,5085,10250,4302,9292,527,724,3249,7554,3776,8278
293170,202308,6773,10898,4934,8643,117,261,4262,7088,4379,7349
293180,202308,5701,13438,4399,11125,142,456,3518,8486,3660,8942
293190,202308,21406,42335,17937,37316,247,875,16046,32015,16293,32890
293200,202308,11701,22953,8827,18517,616,1155,7007,14507,7623,15662
293210,202308,6892,14919,5272,12304,585,1233,3694,8553,4279,9786
293220,202308,7534,15058,5241,11406,791,1600,3351,7031,4142,8631
293230,202308,6020,11633,4280,9383,427,840,3099,6800,3526,7640
293240,202308,5471,12158,4133,9932,213,472,3043,7463,3256,7935
293245,202308,4868,11366,3987,9897,262,669,3041,7133,3303,7802
293250,202308,6967,14862,4931,11635,495,1195,3325,7424,3820,8619
293260,202308,6024,13206,4294,10280,213,513,3069,7263,3282,7776
293270,202308,9372,17642,6974,14876,479,728,5531,12162,6010,12890
293280,202308,5877,12567,4708,10770,312,711,3737,8262,4049,8973
293290,202308,22433,53295,18228,46140,1747,4472,12812,31258,14559,35730
293300,202308,8478,16993,6531,13807,718,1374,4612,9299,5330,10673
293305,202308,5696,11224,4111,9043,97,288,3568,7539,3665,7827
293310,202308,2753,6073,2100,4990,49,138,1714,3892,1763,4030
293315,202308,5763,10932,4429,9015,433,644,3482,7164,3915,7808
293317,202308,3431,7096,2764,5986,342,610,1931,4204,2273,4814
293320,202308,18472,34369,15201,30344,253,650,13541,25994,13794,26644
293325,202308,2336,4884,1661,3958,183,447,1068,2432,1251,2879
293330,202308,102259,230606,73207,177086,10006,25132,42855,95270,52861,120402
293340,202308,2665,6552,1927,5173,174,423,1305,3448,1479,3871
293345,202308,4806,10890,3353,8498,819,1978,1517,4183,2336,6161
293350,202308,7253,17461,5910,15570,377,972,4692,12278,5069,13250
293360,202308,19456,40425,15488,35102,578,1377,12985,29087,13563,30464
310010,202308,1227,2534,765,1836,126,325,330,668,456,993
310020,202308,4156,9706,2711,6898,448,1262,1228,2740,1676,4002
310030,202308,2458,6122,1796,4872,248,725,1128,2861,1376,3586
310040,202308,1047,2447,714,1805,76,227,366,789,442,1016
310050,202308,2124,5144,1576,4146,151,453,967,2335,1118,2788
310060,202308,3813,9153,2867,7641,248,776,1898,5007,2146,5783
310070,202308,426,948,276,696,17,38,188,465,205,503
310080,202308,893,2256,573,1616,86,276,266,696,352,972
310090,202308,6732,14077,5089,11440,222,640,4026,8500,4248,9140
310100,202308,4749,10523,3558,8559,114,406,2836,6398,2950,6804
310110,202308,6021,14101,4218,10811,552,1565,2490,5920,3042,7485
310120,202308,864,1893,503,1308,78,246,236,502,314,748
310130,202308,518,1186,423,1027,37,123,316,701,353,824
310140,202308,462,1175,321,924,71,215,138,343,209,558
310150,202308,8217,17909,5338,12649,448,1282,3284,6913,3732,8195
310160,202308,13930,30153,9249,21895,2070,4855,4093,8817,6163,13672
310163,202308,1512,4076,971,2858,250,797,257,589,507,1386
310170,202308,12459,26697,9242,21529,993,2230,6351,14239,7344,16469
310180,202308,2548,5406,1662,3926,185,486,1055,2330,1240,2816
310190,202308,3362,8676,2126,6115,497,1522,473,1176,970,2698
310200,202308,2526,6401,1738,4901,504,1562,623,1442,1127,3004
310205,202308,1493,3642,1085,2960,140,382,664,1798,804,2180
310210,202308,2928,7091,2098,5423,118,283,1490,3677,1608,3960
310220,202308,1440,3571,969,2658,97,309,591,1496,688,1805
310230,202308,3042,7002,2240,5437,376,924,1259,2813,1635,3737
310240,202308,1314,3337,964,2636,109,308,559,1433,668,1741
310250,202308,1555,3229,1136,2521,39,120,871,1806,910,1926
310260,202308,4988,11819,2873,7638,631,1939,950,1916,1581,3855
310270,202308,3617,6831,2589,5411,94,218,2088,4170,2182,4388
310280,202308,3685,7092,2458,5187,170,408,1737,3291,1907,3699
310285,202308,2239,6249,1615,4934,202,615,926,2776,1128,3391
310290,202308,2108,4951,1549,3833,210,618,917,1953,1127,2571
310300,202308,2131,5273,1318,3593,138,422,646,1476,784,1898
310310,202308,414,872,249,593,41,105,127,261,168,366
310320,202308,582,1352,340,913,34,94,170,415,204,509
310330,202308,634,1376,317,775,63,157,131,284,194,441
310340,202308,10367,23357,6581,16211,1016,2380,3201,7598,4217,9978
310350,202308,17883,39770,11122,27817,1735,4816,5603,12482,7338,17298
310360,202308,812,1550,603,1228,23,64,453,856,476,920
310370,202308,1510,4300,1145,3565,291,954,372,1179,663,2133
310375,202308,1092,2453,669,1748,244,610,186,478,430,1088
310380,202308,435,971,198,530,12,36,113,280,125,316
310390,202308,810,2223,604,1797,97,319,291,758,388,1077
310400,202308,16386,36646,10336,25929,1198,3259,5883,13531,7081,16790
310410,202308,1330,3493,651,1895,84,266,277,656,361,922
310420,202308,6289,15140,3828,10048,480,1319,1920,4385,2400,5704
310430,202308,2225,5515,1349,3725,249,731,609,1408,858,2139
310440,202308,817,1880,461,1190,75,175,203,484,278,659
310445,202308,1643,4154,1109,3028,91,226,779,2033,870,2259
310450,202308,6008,12618,3977,9296,323,924,2749,5902,3072,6826
310460,202308,2194,5343,1350,3629,260,694,328,746,588,1440
310470,202308,4077,8543,2925,6885,688,1465,1566,3766,2254,5231
310480,202308,1249,2946,819,2186,82,265,462,1082,544,1347
310490,202308,3721,8977,2537,6750,401,1106,1213,2887,1614,3993
310500,202308,1921,4441,1405,3537,206,529,846,1993,1052,2522
310510,202308,3101,7095,1958,4862,349,941,849,1895,1198,2836
310520,202308,1512,3546,863,2253,141,410,365,885,506,1295
310530,202308,1074,2575,647,1719,77,228,256,527,333,755
310540,202308,3525,9272,2327,6559,431,1295,878,2079,1309,3374
310550,202308,1568,3406,1022,2445,107,274,605,1313,712,1587
310560,202308,22281,52248,13894,35174,1566,4564,7372,15580,8938,20144
310570,202308,1570,3270,1110,2598,41,135,876,1896,917,2031
310590,202308,5389,12389,3424,8220,202,592,2186,4665,2388,5257
310600,202308,1810,4550,1207,3153,148,386,636,1496,784,1882
310610,202308,613,1568,332,1033,73,242,72,201,145,443
310620,202308,310648,684941,206798,484309,22517,60291,120461,244393,142978,304684
310630,202308,5977,14615,3606,9501,524,1375,1963,4746,2487,6121
310640,202308,2047,4520,1417,3341,103,300,1004,2103,1107,2403
310650,202308,2925,7054,1846,4892,115,348,1125,2777,1240,3125
310660,202308,1772,4060,1350,3448,39,155,1109,2717,1148,2872
310665,202308,1751,3737,1294,3042,68,228,1018,2276,1086,2504
310670,202308,88300,195117,62213,145524,7022,17833,39118,83457,46140,101290
310680,202308,986,2027,746,1644,21,67,577,1169,598,1236
310690,202308,3349,6854,2172,4990,300,627,1352,2905,1652,3532
310700,202308,661,1227,466,968,15,39,372,735,387,774
310710,202308,8128,20669,4751,14069,1237,3816,783,2027,2020,5843
310720,202308,1493,2996,1066,2362,50,151,808,1657,858,1808
310730,202308,13064,29653,9545,23340,585,1758,6801,15312,7386,17070
310740,202308,9048,21744,5694,14617,672,1945,2945,6532,3617,8477
310750,202308,1755,3705,1158,2668,186,459,626,1260,812,1719
310760,202308,928,2113,591,1523,77,192,352,882,429,1074
310770,202308,1363,3355,834,2367,106,335,394,953,500,1288
310780,202308,5059,10561,3548,8179,318,775,2383,5230,2701,6005
310790,202308,2363,6713,1782,5349,412,1373,440,1075,852,2448
310800,202308,2887,7956,1656,5165,342,1152,119,290,461,1442
310810,202308,1920,4038,1405,3130,115,261,989,2090,1104,2351
310820,202308,1487,3395,761,2109,156,422,227,583,383,1005
310825,202308,3206,7886,2316,6347,68,302,1839,4702,1907,5004
310830,202308,2863,6859,1822,4837,346,976,895,2034,1241,3010
310840,202308,2840,6934,1784,4850,378,1097,603,1343,981,2440
310850,202308,1657,4001,1189,3196,93,320,810,1999,903,2319
310855,202308,4226,9729,2889,7396,292,737,1844,4458,2136,5195
310860,202308,8390,21508,6129,17134,908,2299,3337,9277,4245,11576
310870,202308,1185,2591,855,2066,75,208,622,1393,697,1601
310880,202308,1090,2954,708,2097,101,290,364,1020,465,1310
310890,202308,2698,7191,1483,4520,283,914,199,490,482,1404
310900,202308,5567,14250,3512,9552,680,1996,1460,3383,2140,5379
310910,202308,2772,6228,1558,4044,274,785,404,893,678,1678
310920,202308,2313,5396,1540,4055,232,630,896,2229,1128,2859
310925,202308,1362,3069,923,2301,52,131,645,1497,697,1628
310930,202308,6988,16179,4177,11487,840,2341,1764,4875,2604,7216
310940,202308,8655,17957,5967,13644,287,825,4530,9660,4817,10485
310945,202308,1817,4027,1176,2899,146,395,666,1497,812,1892
310950,202308,2289,6280,1288,4000,222,767,336,797,558,1564
310960,202308,840,2159,419,1202,63,194,125,315,188,509
310970,202308,1449,4073,878,2763,225,719,155,414,380,1133
310980,202308,431,924,204,498,11,32,112,238,123,270
310990,202308,1890,4396,1339,3390,165,489,785,1743,950,2232
311000,202308,5421,13271,3699,9934,807,2225,1760,4262,2567,6487
311010,202308,1226,2956,927,2419,222,602,444,1134,666,1736
311020,202308,1459,3359,822,2148,61,188,463,1103,524,1291
311030,202308,2392,5399,1471,3779,396,1136,531,1182,927,2318
311040,202308,370,1043,251,766,83,283,57,138,140,421
311050,202308,3815,8522,2448,6095,372,1072,1318,2873,1690,3945
311060,202308,4780,10874,2852,7078,345,973,1399,2982,1744,3955
311070,202308,3224,6997,2024,4949,274,790,1091,2312,1365,3102
311080,202308,1443,2809,1030,2201,42,117,789,1537,831,1654
311090,202308,2896,8061,1943,5942,470,1437,561,1633,1031,3070
311100,202308,3156,8057,1934,5653,360,1161,534,1310,894,2471
311110,202308,4627,9292,1947,4832,492,1237,296,669,788,1906
311115,202308,1771,3319,1242,2587,25,86,984,2035,1009,2121
311120,202308,9336,21876,5847,14661,918,2503,2656,5520,3574,8023
311130,202308,2350,5688,1512,4164,171,548,845,2069,1016,2617
311140,202308,2021,4572,1264,3249,256,629,617,1521,873,2150
311150,202308,1764,5067,1245,3931,196,676,572,1625,768,2301
311160,202308,5297,13424,3360,9607,552,1736,1376,3471,1928,5207
311170,202308,1217,2825,847,2235,80,223,529,1409,609,1632
311180,202308,1979,4091,1054,2588,156,377,484,1078,640,1455
311190,202308,1039,2707,662,1899,80,260,300,711,380,971
311200,202308,2959,7037,1878,4827,394,1083,773,1652,1167,2735
311205,202308,1129,2942,830,2367,44,137,500,1317,544,1454
311210,202308,1281,3366,1048,2965,128,319,701,2054,829,2373
311220,202308,1120,2425,882,1947,21,64,721,1464,742,1528
311230,202308,9676,26608,6314,19161,1449,4508,1886,5563,3335,10071
311240,202308,1499,3311,1028,2515,134,385,619,1299,753,1684
311250,202308,1753,4331,1128,3044,221,617,486,1146,707,1763
311260,202308,3257,7353,1682,4303,225,610,771,1649,996,2259
311265,202308,1727,3628,1116,2627,58,147,821,1775,879,1922
311270,202308,3798,9804,2831,7933,201,764,1842,4668,2043,5432
311280,202308,1640,3883,869,2364,218,603,230,529,448,1132
311290,202308,2209,6202,1807,5342,145,442,1134,3254,1279,3696
311300,202308,5389,13076,4168,10983,224,706,3155,7891,3379,8597
311310,202308,649,1639,444,1193,35,92,289,724,324,816
311320,202308,3842,10585,2726,7886,386,1154,1276,3192,1662,4346
311330,202308,7982,17125,5216,12421,814,2124,2317,5404,3131,7528
311340,202308,13800,34394,9355,25466,2141,6018,2930,7201,5071,13219
311350,202308,2823,6368,1672,4145,359,862,642,1394,1001,2256
311360,202308,1446,3216,879,2273,216,573,383,932,599,1505
311370,202308,5673,12670,3622,9118,497,1404,1800,3965,2297,5369
311380,202308,487,1392,340,1058,41,139,183,545,224,684
311390,202308,2087,5757,1456,4528,436,1381,342,916,778,2297
311400,202308,2091,5062,1219,3162,232,633,457,939,689,1572
311410,202308,2396,6523,1671,4996,266,885,678,1736,944,2621
311420,202308,2076,5383,1324,3811,262,781,402,931,664,1712
311430,202308,5766,13776,3321,8747,511,1415,1388,3327,1899,4742
311440,202308,3915,9879,2415,6807,665,2105,408,793,1073,2898
311450,202308,3218,8560,1819,5426,450,1528,468,1054,918,2582
311455,202308,1332,2804,744,1808,72,193,465,1029,537,1222
311460,202308,759,2062,410,1264,74,250,101,237,175,487
311470,202308,588,1652,353,1130,82,283,55,149,137,432
311480,202308,1463,2912,1103,2336,102,201,854,1733,956,1934
311490,202308,367,984,238,699,37,132,103,237,140,369
311500,202308,662,1510,446,1123,46,125,251,561,297,686
311510,202308,4528,9836,2845,6870,424,1037,1527,3335,1951,4372
311520,202308,851,2037,629,1591,67,182,397,959,464,1141
311530,202308,11939,25032,6940,16569,1951,5359,2152,4153,4103,9512
311535,202308,1239,2950,716,1848,98,272,349,782,447,1054
311540,202308,668,1754,532,1496,92,264,315,862,407,1126
311545,202308,2518,6334,1968,5378,127,373,1428,3768,1555,4141
311547,202308,2215,4328,1652,3422,55,136,1422,2833,1477,2969
311550,202308,3679,8831,2593,6712,444,1239,1168,2548,1612,3787
311560,202308,368,747,184,432,32,87,71,138,103,225
311570,202308,1619,3478,983,2508,69,194,643,1658,712,1852
311580,202308,2730,4850,1646,3359,161,326,1115,2156,1276,2482
311590,202308,775,1796,572,1466,61,185,344,811,405,996
311600,202308,1784,4086,1378,3484,172,501,946,2301,1118,2802
311610,202308,2876,7480,1897,5427,126,400,1227,3268,1353,3668
311615,202308,4604,10363,3379,8319,153,472,2588,5936,2741,6408
311620,202308,732,1799,471,1328,54,173,244,627,298,800
311630,202308,1566,4000,1088,2970,147,373,569,1520,716,1893
311640,202308,987,2359,616,1648,103,287,326,794,429,1081
311650,202308,2297,5089,1615,3937,281,706,895,2029,1176,2735
311660,202308,4166,10677,2517,6956,367,1150,894,1903,1261,3053
311670,202308,2065,4544,1288,3105,156,372,662,1463,818,1835
311680,202308,2871,6684,2000,5128,133,310,1386,3500,1519,3810
311690,202308,753,1480,474,1076,47,101,283,618,330,719
311700,202308,2469,5310,1733,4201,38,125,1391,3220,1429,3345
311710,202308,1954,5202,1269,3801,347,1139,341,893,688,2032
311720,202308,536,1443,392,1133,56,172,224,632,280,804
311730,202308,6049,13293,3762,9038,747,2054,1924,4101,2671,6155
311740,202308,1199,2942,919,2494,74,203,638,1739,712,1942
311750,202308,4866,12835,3357,9599,306,965,1997,5068,2303,6033
311760,202308,933,2362,640,1707,105,337,272,545,377,882
311770,202308,2763,6975,1818,5052,394,1095,593,1453,987,2548
311780,202308,1950,4934,1162,3270,243,684,423,1003,666,1687
311783,202308,2873,6499,2105,5183,63,229,1686,3873,1749,4102
311787,202308,995,2633,608,1719,92,273,206,459,298,732
311790,202308,1937,4939,1112,3154,293,895,304,728,597,1623
311800,202308,6853,18241,4027,11305,1036,3023,922,1953,1958,4976
311810,202308,1250,3035,938,2440,58,170,716,1718,774,1888
311820,202308,1306,2739,843,1974,70,182,574,1232,644,1414
311830,202308,11761,29864,7567,20748,2124,6019,1480,3699,3604,9718
311840,202308,4984,10948,3591,8834,349,899,2386,5733,2735,6632
311850,202308,433,988,311,773,14,53,217,472,231,525
311860,202308,102570,222217,70194,162341,7571,19753,43448,89985,51019,109738
311870,202308,2258,5514,1363,3777,231,762,588,1368,819,2130
311880,202308,7579,17723,5578,14443,471,1179,3824,9712,4295,10891
311890,202308,2368,4753,1702,3712,67,202,1309,2596,1376,2798
311900,202308,784,1945,523,1523,91,250,232,659,323,909
311910,202308,5383,12193,3847,9723,703,1852,2059,4859,2762,6711
311920,202308,2676,5893,1991,4783,145,329,1373,3196,1518,3525
311930,202308,6189,12475,4076,9079,712,1763,2228,4387,2940,6150
311940,202308,19693,46248,11315,28895,1753,4744,4801,10799,6554,15543
311950,202308,2965,6831,1956,4928,166,428,1177,2852,1343,3280
311960,202308,598,1384,369,950,52,148,151,326,203,474
311970,202308,487,1455,314,1018,47,173,71,175,118,348
311980,202308,571,1393,264,774,42,132,98,249,140,381
311990,202308,631,1440,331,904,51,154,139,312,190,466
311995,202308,1201,3213,431,1314,51,168,80,150,131,318
312000,202308,989,2061,659,1536,25,61,481,1038,506,1099
312010,202308,1462,3233,992,2368,60,143,683,1529,743,1672
312015,202308,1692,4012,1358,3488,70,245,1033,2499,1103,2744
312020,202308,2401,6525,1450,4248,245,738,369,897,614,1635
312030,202308,2694,5284,2002,4365,52,193,1715,3556,1767,3749
312040,202308,1041,2796,604,1804,115,346,244,636,359,982
312050,202308,1478,4119,1105,3348,210,731,365,916,575,1647
312060,202308,1195,2749,714,1963,183,531,208,501,391,1032
312070,202308,1124,2928,692,1949,23,68,434,1127,457,1195
312080,202308,3738,8132,2587,6126,146,416,1752,3601,1898,4017
312083,202308,1370,2793,1024,2279,51,127,822,1731,873,1858
312087,202308,3064,6753,2239,5380,132,396,1741,3992,1873,4388
312090,202308,15211,34749,10481,26296,1097,3243,6054,13327,7151,16570
312100,202308,2071,5042,1364,3628,92,295,880,2136,972,2431
312110,202308,1233,3485,913,2763,157,582,454,1155,611,1737
312120,202308,1347,3378,794,2302,208,654,221,505,429,1159
312125,202308,2604,5590,1906,4493,113,291,1427,3170,1540,3461
312130,202308,1518,3186,962,2192,62,185,603,1149,665,1334
312140,202308,953,2533,685,1946,192,556,228,572,420,1128
312150,202308,700,1683,527,1343,46,116,343,798,389,914
312160,202308,12406,28670,8280,20680,1008,2725,4337,9475,5345,12200
312170,202308,1066,2456,724,1800,57,147,460,1083,517,1230
312180,202308,1739,4052,1184,2984,122,327,693,1563,815,1890
312190,202308,1024,2416,686,1747,93,247,337,752,430,999
312200,202308,5780,14055,3990,10900,928,3062,1975,4531,2903,7593
312210,202308,1775,3297,1210,2482,109,207,906,1771,1015,1978
312220,202308,2024,5467,1560,4549,180,578,978,2774,1158,3352
312230,202308,27938,62893,17281,42365,3339,8927,6586,13151,9925,22078
312235,202308,2785,5686,2007,4473,239,435,1435,3088,1674,3523
312240,202308,985,2796,634,2008,131,420,193,534,324,954
312245,202308,4046,7481,3228,6296,63,171,2924,5522,2987,5693
312247,202308,1256,2617,739,1772,98,236,434,948,532,1184
312250,202308,1128,2755,589,1656,76,242,205,499,281,741
312260,202308,1268,2940,937,2309,61,145,703,1622,764,1767
312270,202308,939,2293,618,1590,22,84,391,864,413,948
312280,202308,538,1474,392,1148,94,314,155,389,249,703
312290,202308,1244,3207,867,2457,171,522,286,687,457,1209
312300,202308,1526,4054,968,2751,222,659,255,570,477,1229
312310,202308,1300,3449,865,2468,109,372,455,1136,564,1508
312320,202308,2688,6068,1527,3828,250,640,558,1165,808,1805
312330,202308,1178,2913,850,2270,146,452,465,1115,611,1567
312340,202308,286,676,186,484,23,72,100,223,123,295
312350,202308,283,556,186,423,9,26,123,235,132,261
312352,202308,1804,5245,1445,4486,285,936,639,2102,924,3038
312360,202308,4575,11457,2869,7903,557,1605,1222,2878,1779,4483
312370,202308,2685,5889,1915,4633,227,642,1155,2535,1382,3177
312380,202308,2613,5258,1857,4098,43,143,1512,3143,1555,3286
312385,202308,1531,3722,1047,2806,362,1002,335,889,697,1891
312390,202308,2445,6260,1539,4282,244,760,446,1000,690,1760
312400,202308,3892,10015,2844,8027,1050,3227,448,1158,1498,4385
312410,202308,20646,46621,14736,35827,1890,4799,9013,20233,10903,25032
312420,202308,5092,12236,3753,9925,887,2589,1584,3852,2471,6441
312430,202308,11129,24134,8095,18798,396,1130,5903,12549,6299,13679
312440,202308,1365,3844,1044,3162,553,1756,178,497,731,2253
312450,202308,1742,4566,1126,3307,313,972,389,1084,702,2056
312460,202308,622,1333,396,966,23,68,282,636,305,704
312470,202308,576,1305,305,794,46,138,112,221,158,359
312480,202308,1258,2929,820,2134,76,215,438,1059,514,1274
312490,202308,3332,6581,2260,4877,214,504,1405,2772,1619,3276
312500,202308,1349,2821,975,2220,38,110,710,1499,748,1609
312510,202308,6832,16620,3322,9042,557,1489,978,2218,1535,3707
312520,202308,476,1069,318,796,45,126,191,431,236,557
312530,202308,940,1877,697,1549,45,113,516,1098,561,1211
312540,202308,1836,4525,1152,3115,139,369,669,1678,808,2047
312550,202308,1002,2275,614,1483,37,97,404,866,441,963
312560,202308,2200,5171,1592,4175,97,286,1119,2831,1216,3117
312570,202308,3461,7196,2267,5442,370,904,1145,2594,1515,3498
312580,202308,807,1979,462,1241,58,179,230,536,288,715
312590,202308,1819,4730,1320,3671,224,704,634,1533,858,2237
312595,202308,2693,6794,2019,5639,370,1040,957,2782,1327,3822
312600,202308,1605,3695,869,2105,131,348,298,642,429,990
312610,202308,9038,21230,5099,13297,1062,2926,1527,3309,2589,6235
312620,202308,3077,6772,2070,5202,59,238,1662,3947,1721,4185
312630,202308,412,1052,266,771,56,194,101,235,157,429
312640,202308,624,1576,450,1250,64,201,229,566,293,767
312650,202308,2532,5598,1501,3622,58,174,1128,2459,1186,2633
312660,202308,1652,3500,1117,2572,86,215,763,1593,849,1808
312670,202308,7580,15843,5766,12926,157,565,4655,9606,4812,10171
312675,202308,1421,3252,1081,2712,70,199,793,1878,863,2077
312680,202308,1983,4242,1618,3670,85,259,1333,2860,1418,3119
312690,202308,3681,6842,2457,5181,225,418,1802,3689,2027,4107
312695,202308,1293,2928,995,2402,49,102,829,1941,878,2043
312700,202308,2614,6372,1592,4343,188,594,863,2092,1051,2686
312705,202308,2152,3842,1753,3306,30,75,1641,3035,1671,3110
312707,202308,1663,4217,1029,2981,48,192,675,1753,723,1945
312710,202308,9809,21019,5509,13875,1547,3985,1420,3447,2967,7432
312720,202308,1295,3105,923,2442,99,230,551,1328,650,1558
312730,202308,1961,4228,1253,3132,115,292,812,1940,927,2232
312733,202308,1561,3815,1024,2753,35,139,679,1638,714,1777
312735,202308,998,2306,632,1565,62,169,410,903,472,1072
312737,202308,1021,2060,654,1512,65,182,447,962,512,1144
312738,202308,1051,2335,659,1620,71,206,408,893,479,1099
312740,202308,513,1286,287,823,62,182,82,177,144,359
312750,202308,1755,4474,1094,3126,164,504,473,1189,637,1693
312760,202308,2215,5938,1404,4192,252,743,488,1346,740,2089
312770,202308,57674,127187,32623,81669,5536,15021,13294,29269,18830,44290
312780,202308,3310,8228,2514,6752,415,1085,1387,3585,1802,4670
312790,202308,288,656,118,336,9,25,35,67,44,92
312800,202308,7597,17713,5316,13236,399,1218,3394,7538,3793,8756
312810,202308,1934,4902,1134,3388,347,1083,302,761,649,1844
312820,202308,2110,4981,1481,3805,106,243,991,2456,1097,2699
312825,202308,1935,3696,1410,2940,52,133,1153,2303,1205,2436
312830,202308,3406,8643,1793,5181,469,1259,576,1395,1045,2654
312840,202308,1816,4193,1229,3112,158,433,604,1317,762,1750
312850,202308,1455,2717,914,1845,29,104,683,1194,712,1298
312860,202308,1247,3052,768,2151,206,572,242,616,448,1188
312870,202308,7538,18461,3887,10905,666,1921,1171,2849,1837,4770
312880,202308,1914,4179,1264,2999,201,441,685,1587,886,2028
312890,202308,2879,6255,1794,4293,163,394,1079,2396,1242,2790
312900,202308,1661,3799,1098,2831,314,839,438,1030,752,1869
312910,202308,1759,3108,921,1959,135,264,512,1054,647,1318
312920,202308,1167,2873,696,1964,97,328,232,506,329,834
312930,202308,3080,6666,1950,4731,294,744,1037,2465,1331,3209
312940,202308,1220,2982,832,2286,69,207,441,1085,510,1292
312950,202308,4300,9256,2721,6581,421,1103,1552,3392,1973,4495
312960,202308,2146,5060,1615,4183,139,320,1094,2865,1233,3185
312965,202308,1978,4775,1454,3880,185,440,838,2245,1023,2685
312970,202308,2239,5392,1511,4086,150,497,857,2022,1007,2519
312980,202308,33488,82335,22315,58883,4328,11570,8995,21530,13323,33100
312990,202308,639,1463,377,1017,75,217,151,369,226,586
313000,202308,610,1540,419,1190,23,91,251,614,274,705
313005,202308,2942,7586,2176,6157,144,425,1551,4209,1695,4634
313010,202308,7744,18569,5452,14207,808,2379,2983,7020,3791,9399
313020,202308,1270,3491,883,2653,200,651,158,361,358,1012
313030,202308,1484,3071,849,2040,125,298,493,1066,618,1364
313040,202308,1129,3066,797,2333,47,174,466,1212,513,1386
313050,202308,2261,5771,1407,4184,239,773,326,808,565,1581
313055,202308,2238,5501,1713,4585,687,2025,638,1501,1325,3526
313060,202308,1358,3066,844,2105,165,495,227,449,392,944
313065,202308,2114,5082,1698,4292,33,151,1412,3354,1445,3505
313070,202308,1055,2621,723,1982,146,409,284,717,430,1126
313080,202308,487,1208,295,803,62,209,112,231,174,440
313090,202308,7040,15716,4893,11841,232,600,3549,8155,3781,8755
313100,202308,1600,3741,1168,2964,62,207,833,1927,895,2134
313110,202308,1893,4524,1169,3122,138,396,564,1333,702,1729
313115,202308,3561,8723,2394,6275,233,692,1349,3062,1582,3754
313120,202308,4483,9948,2942,7564,539,1479,1645,4016,2184,5495
313130,202308,41781,95496,25154,62591,3078,8323,13790,30447,16868,38770
313140,202308,1022,1972,614,1385,69,150,421,897,490,1047
313150,202308,1731,4504,1054,3086,284,928,147,313,431,1241
313160,202308,1840,4072,1195,2977,69,191,818,1917,887,2108
313170,202308,14656,37680,8901,24630,1424,4071,3432,8217,4856,12288
313180,202308,3186,7270,2193,5306,215,489,1441,3301,1656,3790
313190,202308,5883,14885,3554,9814,641,1884,1402,3228,2043,5112
313200,202308,1405,3105,1014,2364,43,130,792,1716,835,1846
313210,202308,5402,12273,3942,9787,349,1004,2646,5986,2995,6990
313220,202308,2468,5935,1410,3711,229,628,600,1309,829,1937
313230,202308,3407,8433,2572,7195,67,262,1980,5354,2047,5616
313240,202308,14540,32069,9105,22499,1134,3099,4689,10131,5823,13230
313250,202308,7915,20617,5394,15099,1136,3291,2307,5827,3443,9118
313260,202308,1008,2266,607,1584,63,210,314,660,377,870
313270,202308,8319,16207,6007,12875,549,1172,4457,9066,5006,10238
313280,202308,578,1391,346,936,43,122,161,382,204,504
313290,202308,1312,3859,949,3090,210,758,337,984,547,1742
313300,202308,2398,5925,1541,4153,317,922,609,1432,926,2354
313310,202308,1923,5068,1285,3544,252,722,409,885,661,1607
313320,202308,2409,5797,1545,4283,359,1088,492,1321,851,2409
313330,202308,5246,11878,3422,8837,295,814,2115,5206,2410,6020
313340,202308,2237,4524,1444,3221,107,275,1037,2084,1144,2359
313350,202308,3779,9379,2165,5729,306,877,952,2136,1258,3013
313360,202308,2212,4890,1261,3180,201,597,639,1359,840,1956
313370,202308,2116,5162,1209,3189,240,645,406,830,646,1475
313375,202308,2355,5677,1176,3225,252,737,318,711,570,1448
313380,202308,8563,19644,5485,13506,888,2466,2422,4950,3310,7416
313390,202308,1017,2781,767,2265,47,182,515,1400,562,1582
313400,202308,4712,10214,3160,7677,146,379,2336,5419,2482,5798
313410,202308,1811,4114,1185,3033,282,724,621,1455,903,2179
313420,202308,20135,41793,9826,24106,2313,6086,2778,5916,5091,12002
313430,202308,1588,3542,1159,2688,47,155,920,1917,967,2072
313440,202308,9455,17307,6127,12635,234,642,4752,9156,4986,9798
313450,202308,909,2266,531,1461,88,267,192,400,280,667
313460,202308,3076,7715,2274,6287,403,1204,983,2494,1386,3698
313470,202308,3396,7593,2474,6105,168,468,1845,4346,2013,4814
313480,202308,1507,3940,832,2443,139,397,335,868,474,1265
313490,202308,3907,9420,1677,4829,304,915,435,1037,739,1952
313500,202308,713,1681,398,1034,84,181,147,371,231,552
313505,202308,13350,30123,9892,24508,576,1507,7290,17334,7866,18841
313507,202308,1618,3685,1113,2825,49,174,809,1890,858,2064
313510,202308,19853,46815,13211,33288,1336,3554,7396,16650,8732,20204
313520,202308,20201,45585,15258,37441,760,2201,11548,26569,12308,28770
313530,202308,726,1996,417,1236,60,198,177,430,237,628
313535,202308,2766,7032,1962,5431,221,561,1139,3000,1360,3561
313540,202308,1132,2867,702,1863,93,288,351,786,444,1074
313545,202308,1390,4080,995,3170,164,556,461,1351,625,1907
313550,202308,2721,6900,2041,5421,229,646,1361,3480,1590,4126
313560,202308,3730,5957,2636,4605,49,95,2313,3923,2362,4018
313570,202308,1209,3110,855,2424,190,564,357,876,547,1440
313580,202308,7776,16037,5673,12564,300,779,4232,8696,4532,9475
313590,202308,1454,3430,952,2551,155,430,482,1207,637,1637
313600,202308,5553,11524,4394,9782,129,381,3745,7908,3874,8289
313610,202308,1217,2745,847,2018,82,219,542,1164,624,1383
313620,202308,7345,17525,5236,13467,557,1657,3068,7037,3625,8694
313630,202308,11097,24648,7168,17959,731,2148,4293,9772,5024,11920
313640,202308,1656,3071,1083,2279,77,187,803,1634,880,1821
313650,202308,1957,5407,1426,4416,158,537,790,2349,948,2886
313652,202308,1099,2775,852,2267,80,223,578,1426,658,1649
313655,202308,1461,3097,1045,2512,72,199,750,1736,822,1935
313657,202308,1300,3100,929,2435,30,133,660,1552,690,1685
313660,202308,1545,3489,1140,2782,96,317,773,1685,869,2002
313665,202308,7434,16922,5117,12436,573,1557,3112,6704,3685,8261
313670,202308,74306,164042,45867,113562,6304,16737,22498,49702,28802,66439
313680,202308,1365,3105,952,2356,45,130,629,1413,674,1543
313690,202308,1279,3502,829,2560,170,569,161,404,331,973
313695,202308,2123,5102,1431,3907,129,342,878,2384,1007,2726
313700,202308,3603,9754,2777,8347,230,674,2042,6028,2272,6702
313710,202308,1757,3660,1055,2540,153,466,624,1334,777,1800
313720,202308,8409,20760,5182,13662,741,2055,2505,5785,3246,7840
313730,202308,1662,3263,1081,2376,72,160,753,1625,825,1785
313740,202308,2108,6855,1535,5323,333,1259,405,1195,738,2454
313750,202308,3024,6936,2167,5349,291,837,1322,2910,1613,3747
313753,202308,2525,5803,1449,3840,416,1187,313,730,729,1917
313760,202308,8183,20415,5653,15162,946,2745,2553,5916,3499,8661
313770,202308,5152,13158,3723,10640,828,2328,2119,6049,2947,8377
313780,202308,5152,12027,3139,8302,739,1925,1023,2596,1762,4521
313790,202308,769,1966,563,1536,61,177,337,842,398,1019
313800,202308,1663,3456,1051,2473,113,277,581,1249,694,1526
313810,202308,2351,4856,1645,3710,57,180,1278,2675,1335,2855
313820,202308,21601,51192,11229,28313,1955,4959,3623,7792,5578,12751
313830,202308,502,1328,337,968,65,198,121,304,186,502
313835,202308,1167,2843,717,1976,64,209,360,875,424,1084
313840,202308,10646,24778,6808,17795,1690,4457,1903,4711,3593,9168
313850,202308,1241,2609,851,1958,149,350,451,910,600,1260
313860,202308,3715,8507,2474,6178,354,933,1247,2766,1601,3699
313862,202308,1395,2938,597,1590,58,152,291,712,349,864
313865,202308,3235,7385,2365,5917,91,279,1686,3834,1777,4113
313867,202308,1606,4689,1232,3897,358,1135,452,1438,810,2573
313868,202308,2060,5565,1481,4411,71,269,1098,3055,1169,3324
313870,202308,1345,3185,747,1974,142,378,292,682,434,1060
313880,202308,2907,6724,1885,4701,324,961,935,1907,1259,2868
313890,202308,2934,5192,2122,4121,59,132,1695,3103,1754,3235
313900,202308,7089,17812,4108,11443,1094,3113,1206,2733,2300,5846
313910,202308,959,2528,598,1724,122,367,160,413,282,780
313920,202308,3459,9125,2618,7445,540,1482,1197,3369,1737,4851
313925,202308,1957,4391,1303,3178,228,471,772,1803,1000,2274
313930,202308,6476,15355,4649,12181,429,1138,2986,7527,3415,8665
313940,202308,12853,34274,8433,25501,2131,7052,1772,5426,3903,12478
313950,202308,7032,13630,4883,10590,286,764,3613,7350,3899,8114
313960,202308,7169,15613,4283,10566,600,1707,1988,4222,2588,5929
313970,202308,2038,4656,1469,3570,54,146,1005,2230,1059,2376
313980,202308,1834,4383,1204,3318,225,652,448,1114,673,1766
313990,202308,2861,7272,1939,5330,328,1067,1069,2568,1397,3635
314000,202308,13670,30436,9001,21619,664,1915,5574,12375,6238,14290
314010,202308,1649,3572,1155,2801,84,215,794,1795,878,2010
314015,202308,3101,7471,2152,5581,277,814,1214,2776,1491,3590
314020,202308,687,1661,364,1085,135,480,18,35,153,515
314030,202308,1080,2729,658,1811,107,316,261,645,368,961
314040,202308,769,1942,576,1568,70,231,367,917,437,1148
314050,202308,2712,6230,1794,4448,130,398,1166,2581,1296,2979
314053,202308,2637,6645,1879,5138,311,822,1082,2985,1393,3807
314055,202308,2917,6356,2261,5366,76,224,1809,4145,1885,4369
314060,202308,1590,3710,1034,2674,42,103,731,1814,773,1917
314070,202308,6332,14903,4464,11229,629,1648,2343,5267,2972,6915
314080,202308,2496,5970,1553,4143,154,439,797,1881,951,2320
314085,202308,2869,6995,2091,5736,249,706,1277,3390,1526,4096
314090,202308,6281,14700,4622,11824,471,1254,2766,6864,3237,8118
314100,202308,3561,7970,2479,6270,123,353,1779,4376,1902,4729
314110,202308,6379,15977,4298,11352,726,2053,2011,4638,2737,6691
314120,202308,912,1957,314,830,56,165,129,293,185,458
314130,202308,886,2061,581,1473,23,76,408,960,431,1036
314140,202308,5683,13608,3945,10247,491,1360,2240,5380,2731,6740
314150,202308,1751,3964,1084,2798,174,455,586,1440,760,1895
314160,202308,2936,6609,1776,4488,190,481,715,1686,905,2167
314170,202308,1173,2852,749,1908,83,257,459,1014,542,1271
314180,202308,6785,16602,4513,12329,680,1909,2088,5390,2768,7299
314190,202308,753,1723,502,1275,61,190,285,604,346,794
314200,202308,3731,9235,2709,7332,264,665,1669,4338,1933,5003
314210,202308,2374,5620,1516,3922,296,831,494,1102,790,1933
314220,202308,2240,5459,1561,4238,284,854,639,1540,923,2394
314225,202308,1251,3286,848,2463,173,501,401,1082,574,1583
314230,202308,1095,2659,675,1866,122,338,288,715,410,1053
314240,202308,1364,3438,933,2650,197,567,368,1021,565,1588
314250,202308,509,1358,292,880,49,155,110,275,159,430
314260,202308,1339,3191,930,2507,343,949,211,479,554,1428
314270,202308,4042,9962,2965,8044,111,318,2099,5502,2210,5820
314280,202308,4448,9620,2707,6750,301,829,1518,3459,1819,4288
314290,202308,5579,12575,4068,9714,222,577,3001,6728,3223,7305
314300,202308,2446,6381,1351,3925,344,1056,363,875,707,1931
314310,202308,4496,11042,2658,7539,741,2410,323,654,1064,3064
314315,202308,1246,3363,919,2680,71,257,624,1703,695,1960
314320,202308,4301,10279,2551,6792,392,1182,1137,2579,1529,3761
314330,202308,72730,186003,47829,136348,11619,32785,12995,34463,24614,67248
314340,202308,3456,7955,2153,5495,382,1172,1023,2120,1405,3292
314345,202308,2028,4837,1445,3754,137,317,959,2318,1096,2635
314350,202308,1253,3226,650,1929,98,278,156,343,254,621
314360,202308,702,1831,394,1183,47,124,129,350,176,474
314370,202308,933,2090,646,1606,62,165,430,978,492,1143
314380,202308,1535,3836,933,2641,220,668,318,822,538,1490
314390,202308,20257,44905,12327,30439,1987,5349,5495,11534,7482,16883
314400,202308,4846,13396,3344,10310,1208,3925,814,2471,2022,6396
314410,202308,3769,9876,2259,6608,579,2040,421,908,1000,2948
314420,202308,952,2126,584,1495,29,102,372,880,401,982
314430,202308,9864,20981,6055,14482,944,2362,2772,6082,3716,8444
314435,202308,2324,5615,1438,3889,263,675,656,1634,919,2309
314437,202308,1114,2513,744,1854,62,171,513,1203,575,1374
314440,202308,773,2020,472,1379,96,335,161,364,257,699
314450,202308,1803,4270,1180,3013,173,489,614,1355,787,1844
314460,202308,4381,11704,2957,8540,656,2054,1228,3022,1884,5076
314465,202308,2877,7035,2161,5659,145,326,1526,3796,1671,4122
314467,202308,1194,2814,872,2266,130,396,521,1276,651,1672
314470,202308,2968,7426,2021,5323,423,1209,884,1986,1307,3195
314480,202308,11525,28377,7414,19432,1122,3185,3308,7425,4430,10610
314490,202308,1306,3057,871,2244,90,254,537,1286,627,1540
314500,202308,2541,5575,1465,3801,476,1204,269,676,745,1880
314505,202308,2893,5654,2094,4450,128,219,1566,3249,1694,3468
314510,202308,2780,6783,1926,5446,687,2211,508,1246,1195,3457
314520,202308,10669,28526,7564,21858,1568,4713,1722,4441,3290,9154
314530,202308,6725,18002,5341,15278,502,1469,3549,9564,4051,11033
314535,202308,3568,7445,2610,5940,147,381,2058,4501,2205,4882
314537,202308,1475,3704,1022,2829,83,219,652,1718,735,1937
314540,202308,528,1182,322,826,20,71,177,386,197,457
314545,202308,2395,5007,1692,3962,66,214,1236,2683,1302,2897
314550,202308,915,2025,511,1285,50,139,265,573,315,712
314560,202308,6379,16202,4056,10823,448,1352,2024,4479,2472,5831
314570,202308,417,1081,284,840,46,153,131,364,177,517
314580,202308,631,1649,398,1158,93,266,124,325,217,591
314585,202308,929,2507,562,1641,44,147,271,710,315,857
314587,202308,2835,6767,1996,5300,686,1917,866,2097,1552,4014
314590,202308,5462,13034,3580,9213,491,1332,1679,3847,2170,5179
314600,202308,2318,5881,1298,3851,270,887,155,378,425,1265
314610,202308,12360,28121,8026,19895,975,2710,3779,8679,4754,11389
314620,202308,3095,6085,2308,4998,166,311,1791,3873,1957,4184
314625,202308,2007,4367,1451,3510,65,261,1127,2484,1192,2745
314630,202308,6086,13785,4422,11219,204,632,3313,7994,3517,8626
314640,202308,1076,2062,745,1521,26,85,584,1075,610,1160
314650,202308,1024,2286,576,1465,72,213,288,606,360,819
314655,202308,1810,4440,1114,3138,218,543,539,1515,757,2058
314660,202308,452,872,310,634,13,37,232,422,245,459
314670,202308,1893,3920,1177,2807,53,154,821,1816,874,1970
314675,202308,2033,4687,1569,3885,100,240,1158,2755,1258,2995
314690,202308,2623,6626,1797,5133,460,1328,511,1360,971,2688
314700,202308,15214,36973,9147,24869,1388,4139,4201,10234,5589,14373
314710,202308,10168,25730,6367,17034,1067,3035,2479,5556,3546,8591
314720,202308,2999,8123,1723,5214,369,1220,300,645,669,1865
314730,202308,3279,7847,1750,4628,323,933,639,1355,962,2288
314740,202308,4163,10371,2934,8027,560,1643,1365,3293,1925,4936
314750,202308,372,890,243,618,20,58,141,311,161,369
314760,202308,2407,6402,1345,3959,253,796,336,694,589,1490
314770,202308,1296,3525,635,1923,78,226,116,294,194,520
314780,202308,459,1036,285,731,22,62,181,420,203,482
314790,202308,15796,38013,9677,25907,1847,5360,3923,9253,5770,14613
314795,202308,1840,4145,1379,3355,71,187,990,2224,1061,2411
314800,202308,15279,35815,9085,23703,1443,4136,3780,8344,5223,12480
314810,202308,13924,33028,8905,23402,2125,5672,3353,8100,5478,13772
314820,202308,1550,3406,1015,2509,66,190,634,1411,700,1601
314830,202308,2279,5536,1616,4245,144,403,986,2329,1130,2732
314840,202308,1099,2971,821,2427,84,317,538,1450,622,1767
314850,202308,3480,5809,2672,4808,53,128,2407,4239,2460,4367
314860,202308,4180,10121,3161,8250,129,427,2326,5709,2455,6136
314870,202308,8717,16627,5898,12821,306,719,4356,9265,4662,9984
314875,202308,2176,5992,1746,5233,276,747,1070,3203,1346,3950
314880,202308,947,2138,590,1497,46,132,337,782,383,914
314890,202308,594,1696,370,1147,79,292,108,234,187,526
314900,202308,1149,2501,732,1743,79,194,456,975,535,1169
314910,202308,2021,5342,1275,3876,262,939,512,1351,774,2290
314915,202308,2590,6805,1888,5497,219,615,1043,2970,1262,3585
314920,202308,708,1566,434,1105,30,77,269,656,299,733
314930,202308,8468,20978,5525,14590,978,2785,2451,5500,3429,8285
314940,202308,530,1125,362,830,40,103,214,455,254,558
314950,202308,864,1938,498,1291,45,141,286,654,331,795
314960,202308,1208,2613,834,1965,81,194,532,1197,613,1391
314970,202308,1564,4174,1056,3106,201,637,399,946,600,1583
314980,202308,2822,6438,1970,4919,199,518,1283,2969,1482,3487
314990,202308,3517,9280,2031,5782,353,988,512,1207,865,2195
314995,202308,2136,5188,1448,3831,92,309,900,2114,992,2423
315000,202308,1313,3006,850,2250,95,286,544,1339,639,1625
315010,202308,519,1250,375,1017,36,112,233,577,269,689
315015,202308,3085,7434,2436,6258,229,708,1658,3930,1887,4638
315020,202308,980,2554,554,1572,49,150,293,706,342,856
315030,202308,883,2061,524,1387,161,408,134,308,295,716
315040,202308,1245,2869,952,2334,150,419,601,1370,751,1789
315050,202308,1409,3310,860,2288,88,271,401,972,489,1243
315053,202308,1538,3434,1001,2460,130,299,558,1295,688,1594
315057,202308,2286,5634,1611,4456,146,364,975,2798,1121,3162
315060,202308,908,2421,594,1731,111,356,169,427,280,783
315070,202308,1166,2232,798,1680,101,241,540,1060,641,1301
315080,202308,4295,9973,2838,7195,142,386,1996,4675,2138,5061
315090,202308,1020,2714,694,2039,111,333,322,831,433,1164
315100,202308,1809,4807,1013,2948,172,526,404,986,576,1512
315110,202308,2902,6107,1824,4333,160,394,1045,2343,1205,2737
315120,202308,16023,33890,10161,24165,1325,3097,5569,12517,6894,15614
315130,202308,2313,5554,1637,4178,188,531,860,1900,1048,2431
315140,202308,4218,10351,3047,8014,490,1373,1729,4163,2219,5536
315150,202308,5818,13701,3538,9460,619,1755,1457,3468,2076,5223
315160,202308,2585,5552,1521,3675,214,556,868,1912,1082,2468
315170,202308,1798,5200,1142,3605,205,700,338,947,543,1647
315180,202308,22335,51393,10921,28638,1764,4820,3859,8435,5623,13255
315190,202308,2690,5481,1872,4308,320,683,1213,2785,1533,3468
315200,202308,6019,14651,4039,11032,1283,3664,1268,2978,2551,6642
315210,202308,10629,25644,6171,16005,728,2022,2825,6160,3553,8182
315213,202308,1264,3045,978,2546,26,79,769,1920,795,1999
315217,202308,3256,8231,2174,6266,854,2511,700,1824,1554,4335
315220,202308,10787,26516,7371,20173,662,1683,3911,10629,4573,12312
315230,202308,3679,7132,2680,5659,152,288,1984,4061,2136,4349
315240,202308,3148,7872,2258,6216,561,1669,895,2285,1456,3954
315250,202308,19894,48025,12277,32291,1914,5425,5557,12453,7471,17878
315260,202308,1166,2900,615,1763,105,286,158,374,263,660
315270,202308,1289,3287,886,2441,109,322,420,929,529,1251
315280,202308,4285,9785,2505,6433,662,1749,817,1894,1479,3643
315290,202308,1512,3421,821,2194,143,417,347,798,490,1215
315300,202308,800,1808,534,1394,39,116,349,865,388,981
315310,202308,1606,3597,1049,2544,66,187,742,1611,808,1798
315320,202308,755,2034,472,1424,79,243,175,452,254,695
315330,202308,872,2571,462,1483,63,218,190,516,253,734
315340,202308,3392,7840,1902,5088,533,1388,580,1517,1113,2905
315350,202308,2420,5312,1877,4422,157,392,1403,3155,1560,3547
315360,202308,2042,5270,1395,3905,202,597,623,1530,825,2127
315370,202308,781,1876,512,1361,71,198,244,550,315,748
315380,202308,274,710,162,471,35,107,19,38,54,145
315390,202308,1611,4045,1138,3056,128,433,615,1388,743,1821
315400,202308,5043,12123,3463,9126,445,1253,1937,4712,2382,5965
315410,202308,2609,5599,1500,3658,359,999,395,810,754,1809
315415,202308,1875,4773,1268,3569,382,1254,218,498,600,1752
315420,202308,1918,4953,1170,3397,306,914,288,695,594,1609
315430,202308,4330,9896,2623,7035,453,1325,1164,2840,1617,4165
315440,202308,1266,2933,825,2110,99,286,501,1152,600,1438
315445,202308,2847,5495,1927,4173,147,301,1455,3072,1602,3373
315450,202308,2668,6608,1843,5016,192,530,1177,2961,1369,3491
315460,202308,62539,145923,46313,114816,4693,13581,28863,63914,33556,77495
315470,202308,846,2149,497,1308,68,203,225,510,293,713
315480,202308,1999,4869,1213,3132,167,443,609,1348,776,1791
315490,202308,3543,8162,1994,5265,335,866,714,1719,1049,2585
315500,202308,652,1579,349,919,18,43,225,535,243,578
315510,202308,1714,3737,1275,3068,25,100,1025,2277,1050,2377
315520,202308,1384,3044,1073,2534,44,94,861,1917,905,2011
315530,202308,1059,2308,806,1843,61,173,596,1235,657,1408
315540,202308,2092,4982,1175,3173,132,402,502,1193,634,1595
315550,202308,2245,5600,1291,3666,195,618,432,1131,627,1749
315560,202308,8189,21136,6288,17327,503,1309,4303,11387,4806,12696
315570,202308,3143,7171,1824,4572,323,934,922,1941,1245,2875
315580,202308,4154,8639,2729,6168,363,952,1271,2523,1634,3475
315590,202308,1641,3004,1297,2478,35,111,1061,1814,1096,1925
315600,202308,3065,8282,1926,5951,544,1600,660,2165,1204,3765
315610,202308,1255,2841,785,1934,87,258,404,807,491,1065
315620,202308,655,1571,421,1162,34,112,229,606,263,718
315630,202308,1561,3737,1049,2690,171,463,485,1064,656,1527
315640,202308,509,1123,355,877,34,95,220,490,254,585
315645,202308,1194,2859,745,2037,155,461,278,672,433,1133
315650,202308,2296,4533,1694,3611,87,205,1331,2716,1418,2921
315660,202308,2559,6008,1773,4593,253,694,915,2230,1168,2924
315670,202308,21438,50573,14557,36914,2670,6980,6710,15235,9380,22215
315680,202308,3911,9677,2568,7077,373,1119,1261,3235,1634,4354
315690,202308,4873,11212,2391,6490,499,1303,669,1903,1168,3206
315700,202308,10960,26146,7461,19119,734,2044,4253,9788,4987,11832
315710,202308,2129,4616,1367,3415,97,258,889,2068,986,2326
315720,202308,5658,13482,3837,9747,185,616,2594,5951,2779,6567
315725,202308,2926,6602,2079,5228,276,651,1306,3336,1582,3987
315727,202308,807,1863,553,1424,63,194,296,683,359,877
315730,202308,772,2086,541,1566,110,330,198,474,308,804
315733,202308,1898,4348,1271,3166,239,607,554,1225,793,1832
315737,202308,1439,3473,921,2448,44,136,646,1599,690,1735
315740,202308,1075,2724,772,2074,59,175,506,1225,565,1400
315750,202308,1594,3618,1122,2895,106,253,685,1786,791,2039
315760,202308,1479,3027,1016,2323,31,93,812,1734,843,1827
315765,202308,2520,5270,1995,4597,34,133,1767,3968,1801,4101
315770,202308,1638,4138,1123,3178,313,908,321,864,634,1772
315780,202308,40987,98594,29562,75349,2523,7323,18107,41712,20630,49035
315790,202308,4283,12005,3409,10304,366,1117,1915,5998,2281,7115
315800,202308,1678,4744,1117,3361,129,461,503,1238,632,1699
315810,202308,1762,3676,1314,2949,70,197,1017,2119,1087,2316
315820,202308,3680,7904,2736,6465,289,603,1845,4267,2134,4870
315830,202308,1620,4258,819,2372,103,296,242,541,345,837
315840,202308,1113,2413,668,1594,65,159,374,761,439,920
315850,202308,1465,3711,1043,2944,190,562,529,1412,719,1974
315860,202308,654,1743,432,1314,77,230,129,324,206,554
315870,202308,573,1409,420,1132,33,91,297,754,330,845
315880,202308,1429,3155,874,2096,119,325,478,965,597,1290
315890,202308,2215,5573,1711,4799,575,1808,553,1427,1128,3235
315895,202308,8103,19981,4768,12811,610,1811,2196,5172,2806,6983
315900,202308,1121,2675,837,2169,126,337,473,1149,599,1486
315910,202308,811,1808,647,1551,36,100,493,1118,529,1218
315920,202308,1621,3771,805,2162,145,502,339,730,484,1232
315930,202308,1410,2826,829,1924,62,147,537,1162,599,1309
315935,202308,1483,3841,1020,2892,174,524,485,1274,659,1798
315940,202308,726,1765,496,1346,64,199,258,631,322,830
315950,202308,1588,3789,1262,3239,148,396,876,2192,1024,2588
315960,202308,6644,17294,3553,10263,797,2428,741,1541,1538,3969
315970,202308,683,1720,505,1435,61,191,296,783,357,974
315980,202308,5266,10734,2620,6041,392,958,1358,2766,1750,3724
315990,202308,4317,10075,2800,7098,477,1238,1377,3150,1854,4388
316000,202308,981,2095,673,1601,65,189,415,881,480,1070
316010,202308,825,2172,547,1547,85,247,219,498,304,745
316020,202308,1167,2826,855,2214,77,220,562,1338,639,1558
316030,202308,3340,8154,2255,6132,380,1025,1181,3266,1561,4291
316040,202308,3295,8733,1919,5828,346,1194,526,1240,872,2434
316045,202308,2791,5718,2321,5048,150,293,1932,4126,2082,4419
316050,202308,542,1271,365,952,31,79,233,550,264,629
316060,202308,873,1852,552,1368,32,101,378,848,410,949
316070,202308,7682,18383,5383,13595,960,2338,2483,5793,3443,8131
316080,202308,1057,2824,714,2054,121,369,330,836,451,1205
316090,202308,676,1635,444,1104,40,133,258,552,298,685
316095,202308,1541,4346,1021,3086,253,816,297,785,550,1601
316100,202308,3059,7793,1913,5304,320,1009,806,1906,1126,2915
316105,202308,879,2084,613,1619,48,136,367,956,415,1092
316110,202308,18349,42806,13937,35089,886,2759,10211,23911,11097,26670
316120,202308,1515,3772,779,2109,136,420,260,528,396,948
316130,202308,1564,3255,872,2030,91,253,507,1041,598,1294
316140,202308,1285,3158,693,1997,166,493,201,531,367,1024
316150,202308,2746,5740,1656,3762,186,420,965,1984,1151,2404
316160,202308,1208,2829,853,2162,24,72,594,1393,618,1465
316165,202308,1081,2332,722,1744,67,180,474,1045,541,1225
316170,202308,1820,3670,1232,2696,59,166,912,1804,971,1970
316180,202308,2036,5177,1136,3195,201,594,386,907,587,1501
316190,202308,3335,8731,1516,4286,171,533,679,1564,850,2097
316200,202308,4856,11710,3272,8639,472,1364,1686,3911,2158,5275
316210,202308,7380,19406,4218,11832,1318,3929,460,1026,1778,4955
316220,202308,935,2621,497,1618,101,351,115,346,216,697
316225,202308,1998,4086,1379,3117,64,237,1030,2035,1094,2272
316230,202308,612,1437,417,1085,93,259,206,496,299,755
316240,202308,6945,17526,5424,14577,409,1191,3901,9895,4310,11086
316245,202308,3898,10780,3200,9511,248,972,2185,5985,2433,6957
316250,202308,14909,32348,9520,22424,1818,4529,3948,8430,5766,12959
316255,202308,3547,9360,2746,7853,282,813,1841,5195,2123,6008
316257,202308,1999,4079,1315,2985,113,255,889,1922,1002,2177
316260,202308,3356,6640,2379,5083,250,485,1536,3179,1786,3664
316265,202308,1327,3213,918,2449,30,68,680,1739,710,1807
316270,202308,4740,12689,3606,10202,480,1440,1921,4876,2401,6316
316280,202308,3853,9099,2831,7172,415,1100,1528,3601,1943,4701
316290,202308,5177,12371,3204,8298,372,978,1318,3025,1690,4003
316292,202308,7954,18932,5547,14391,620,1821,3462,8148,4082,9969
316294,202308,1205,3325,758,2400,178,615,246,668,424,1283
316295,202308,4727,11695,3166,8488,292,894,1860,4410,2152,5304
316300,202308,1368,3178,1010,2616,57,168,728,1766,785,1934
316310,202308,912,2395,557,1582,101,315,177,436,278,751
316320,202308,829,2143,505,1434,81,258,137,359,218,617
316330,202308,1298,2972,893,2265,41,115,678,1614,719,1729
316340,202308,1280,3096,897,2334,124,342,497,1139,621,1481
316350,202308,1801,4119,1415,3440,147,355,1012,2325,1159,2680
316360,202308,782,1876,565,1513,88,225,365,971,453,1196
316370,202308,7871,17945,5158,12821,602,1800,2758,5696,3360,7496
316380,202308,2175,4517,1490,3407,85,197,1084,2363,1169,2560
316390,202308,930,2309,611,1710,233,724,139,324,372,1048
316400,202308,1533,3956,772,2308,103,315,259,651,362,966
316410,202308,1545,3451,1177,2810,21,56,944,2129,965,2185
316420,202308,2271,5506,1744,4660,68,222,1279,3199,1347,3421
316430,202308,1168,2786,710,1934,127,409,297,689,424,1098
316440,202308,1078,3099,652,2114,125,419,159,459,284,878
316443,202308,707,1770,418,1182,93,302,147,355,240,657
316447,202308,2766,5957,2175,5019,163,286,1740,3942,1903,4228
316450,202308,2568,6692,1733,4973,229,675,983,2705,1212,3380
316460,202308,1741,4153,1184,3070,94,287,727,1692,821,1979
316470,202308,9489,24283,5978,16562,959,2795,2503,5880,3462,8675
316480,202308,280,633,212,504,31,76,122,256,153,332
316490,202308,419,1075,241,692,48,151,85,205,133,356
316500,202308,1722,4692,1054,3119,229,699,347,869,576,1568
316510,202308,992,2855,706,2212,121,376,313,932,434,1308
316520,202308,1696,3715,1117,2609,194,491,387,746,581,1237
316530,202308,1527,3412,1034,2507,105,295,614,1305,719,1600
316540,202308,1413,3151,970,2382,177,464,392,858,569,1322
316550,202308,1874,4451,1482,3764,48,177,1194,2879,1242,3056
316553,202308,6358,16472,3801,10280,534,1615,1863,4277,2397,5892
316555,202308,3298,8416,2615,7410,117,487,2097,5650,2214,6137
316556,202308,695,1472,454,1004,33,73,288,545,321,618
316557,202308,1566,4200,1218,3548,418,1277,429,1174,847,2451
316560,202308,501,1402,291,936,54,189,70,185,124,374
316570,202308,1870,4625,1266,3421,306,728,399,1131,705,1859
316580,202308,450,950,236,574,32,80,95,188,127,268
316590,202308,1594,3582,950,2293,101,202,614,1401,715,1603
316600,202308,1273,3207,1007,2654,141,435,651,1532,792,1967
316610,202308,774,1997,551,1586,60,181,323,840,383,1021
316620,202308,2906,6403,2188,5133,175,391,1638,3670,1813,4061
316630,202308,1878,5086,1465,4233,429,1210,549,1740,978,2950
316640,202308,225,556,159,424,39,116,55,120,94,236
316650,202308,1429,3497,1039,2810,94,274,674,1704,768,1978
316660,202308,203,483,93,250,7,19,33,70,40,89
316670,202308,2035,4560,1367,3458,414,1092,389,891,803,1983
316680,202308,2924,6946,1897,4888,190,518,1128,2755,1318,3273
316690,202308,1649,4415,933,2817,163,508,155,334,318,842
316695,202308,1185,3135,829,2420,25,106,547,1486,572,1592
316700,202308,669,1133,512,938,7,15,442,753,449,768
316710,202308,4534,12040,3247,9241,420,1307,1831,4638,2251,5945
316720,202308,30120,72290,20262,52256,2958,8229,10427,23970,13385,32199
316730,202308,697,1500,479,1100,50,108,279,582,329,690
316740,202308,1109,2678,795,2103,108,315,515,1285,623,1600
316750,202308,518,1291,337,947,80,231,139,358,219,589
316760,202308,4972,13629,3833,11355,1296,4330,1414,3913,2710,8243
316770,202308,1926,3877,1339,3032,48,129,1062,2372,1110,2501
316780,202308,763,2033,545,1605,189,590,84,171,273,761
316790,202308,928,2271,577,1576,110,308,168,422,278,730
316800,202308,8463,20894,5922,16073,937,2762,2857,7086,3794,9848
316805,202308,1517,2770,1141,2303,33,92,961,1861,994,1953
316810,202308,980,2379,623,1672,55,167,416,1044,471,1211
316820,202308,499,949,271,596,13,30,188,373,201,403
316830,202308,1153,2597,803,2002,98,240,472,1109,570,1349
316840,202308,3784,8199,2714,6448,116,353,2089,4566,2205,4919
316850,202308,2984,6432,1937,4548,166,475,1266,2619,1432,3094
316860,202308,30303,66286,20671,50193,2915,8052,11071,24415,13986,32467
316870,202308,11486,27138,7148,18176,880,2503,3706,7968,4586,10471
316880,202308,1482,3417,1088,2716,151,396,609,1339,760,1735
316890,202308,1423,3039,807,2133,116,358,465,1103,581,1461
316900,202308,3896,8845,2558,6292,448,1185,1206,2599,1654,3784
316905,202308,601,1615,403,1205,221,665,83,255,304,920
316910,202308,1266,3050,748,2048,164,480,178,418,342,898
316920,202308,2554,5177,1745,3897,341,622,1017,2175,1358,2797
316930,202308,12368,30779,8224,22383,1716,4949,3113,7250,4829,12199
316935,202308,5680,13406,3645,9432,638,1744,1699,3888,2337,5632
316940,202308,7762,20407,5407,15253,981,2854,2253,5448,3234,8302
316950,202308,2536,5017,1802,3970,131,308,1401,2928,1532,3236
316960,202308,7005,13569,4338,9605,326,792,3028,6323,3354,7115
316970,202308,5475,12994,3774,9618,688,1840,1698,3723,2386,5563
316980,202308,1148,2884,805,2274,226,698,328,805,554,1503
316990,202308,16973,40542,10579,27147,2717,7248,2678,5812,5395,13060
317000,202308,3423,8101,2700,6977,113,289,2191,5502,2304,5791
317005,202308,3245,8204,2213,6067,404,1194,1061,2623,1465,3817
317010,202308,39173,85261,24392,60314,3591,9767,13193,29659,16784,39426
317020,202308,99226,218331,54897,136247,10853,28613,20168,43502,31021,72115
317030,202308,829,2000,611,1641,15,51,440,1127,455,1178
317040,202308,14771,34221,8189,22072,2128,6100,1794,4653,3922,10753
317043,202308,1182,2243,711,1543,30,71,563,1163,593,1234
317047,202308,1363,2916,844,2028,52,147,576,1273,628,1420
317050,202308,1477,4323,852,2703,122,377,275,687,397,1064
317052,202308,3025,7052,2083,5420,237,659,1305,3144,1542,3803
317057,202308,2881,5273,1948,3864,41,115,1607,2967,1648,3082
317060,202308,591,1479,296,859,59,182,104,257,163,439
317065,202308,1346,3520,952,2629,62,208,602,1448,664,1656
317070,202308,11025,27929,7744,21233,1194,3626,3611,8525,4805,12151
317075,202308,1384,3120,930,2254,158,390,513,1147,671,1537
317080,202308,8543,18156,5690,13161,1111,2763,2713,5864,3824,8627
317090,202308,5856,14776,4637,12647,455,1144,3228,8639,3683,9783
317100,202308,3215,7135,1869,4669,441,1113,755,1704,1196,2817
317103,202308,3117,6511,2276,5150,160,377,1696,3602,1856,3979
317107,202308,1847,4249,1245,3071,54,167,816,1700,870,1867
317110,202308,842,1821,430,1128,85,237,193,452,278,689
317115,202308,1412,3588,1045,2881,154,474,587,1533,741,2007
317120,202308,26019,59798,18418,45543,1660,4726,11482,25459,13142,30185
317130,202308,14520,31206,8705,20670,1303,3232,3464,7530,4767,10762
317140,202308,1200,2586,751,1819,108,249,482,1134,590,1383
317150,202308,1314,2621,921,2062,30,105,750,1550,780,1655
317160,202308,4107,9256,2307,6077,311,750,1068,2993,1379,3743
317170,202308,2640,5881,1879,4438,117,357,1300,2647,1417,3004
317180,202308,2255,6344,1346,4166,280,873,227,637,507,1510
317190,202308,1351,3348,898,2525,171,516,431,1093,602,1609
317200,202308,8369,20256,4898,12806,1043,2827,1283,2832,2326,5659
317210,202308,1537,3260,1018,2428,37,114,710,1576,747,1690
317220,202308,435,1058,326,858,58,195,186,405,244,600
320010,202308,6084,16493,4013,12015,876,2807,1389,3989,2265,6796
320013,202308,2597,6404,1592,4396,332,985,702,1888,1034,2873
320016,202308,3530,8361,2372,6348,276,773,1517,3888,1793,4661
320020,202308,6390,14391,4329,10604,622,1751,2398,5309,3020,7060
320030,202308,2335,5751,1386,3798,220,669,616,1434,836,2103
320035,202308,2473,5894,1794,4651,282,792,1047,2565,1329,3357
320040,202308,5891,14696,4175,11139,609,1687,2152,5102,2761,6789
320050,202308,2503,5060,1780,3913,189,539,1218,2366,1407,2905
320060,202308,19964,48948,12283,32862,2441,6878,5240,12473,7681,19351
320070,202308,2528,6027,1620,4170,190,561,871,1924,1061,2485
320080,202308,7257,16831,4500,11301,743,2001,2097,4683,2840,6684
320090,202308,10504,25834,5971,16363,1275,3779,2031,4748,3306,8527
320100,202308,4521,10229,3308,8031,417,1152,2064,4595,2481,5747
320110,202308,3273,6559,2063,4633,364,837,1168,2344,1532,3181
320115,202308,2784,7997,2187,6838,756,2448,626,1941,1382,4389
320120,202308,35410,79887,21494,53340,2929,7662,11022,24404,13951,32066
320130,202308,80324,185455,56616,140497,7460,19975,33064,75139,40524,95114
320140,202308,5396,13077,3321,8697,645,1871,1526,3538,2171,5409
320150,202308,18737,43753,10976,28540,2908,8275,1746,3407,4654,11682
320160,202308,8705,20978,5803,15466,865,2501,3100,7654,3965,10155
320170,202308,2347,5998,1495,4276,417,1223,460,1383,877,2606
320180,202308,956,2729,677,2146,221,796,123,315,344,1111
320190,202308,4096,11572,2680,8411,572,1968,485,1255,1057,3223
320200,202308,1724,4322,1068,3044,233,721,289,768,522,1489
320210,202308,5774,13306,3969,10027,673,1803,1960,4491,2633,6294
320220,202308,4892,10996,3090,7680,665,1711,1349,3067,2014,4778
320225,202308,1993,5547,1264,3913,365,1239,277,794,642,2033
320230,202308,7360,17472,4791,12675,1289,3511,1246,3316,2535,6827
320240,202308,22949,53127,14909,38925,4059,11428,3865,9060,7924,20488
320245,202308,4160,11337,2685,8057,685,2190,294,774,979,2964
320250,202308,3858,9032,2092,5162,354,961,1040,2210,1394,3171
320255,202308,2801,7416,2187,6217,382,1171,1372,3776,1754,4947
320260,202308,1820,4705,987,2889,268,776,252,609,520,1385
320265,202308,2958,8368,1957,6190,634,2174,191,509,825,2683
320270,202308,2892,7269,1876,5238,506,1575,595,1516,1101,3091
320280,202308,11714,26120,8447,20350,903,2504,5747,12595,6650,15099
320290,202308,1657,4579,967,2927,251,846,254,710,505,1556
320300,202308,5784,15239,4148,11936,1248,3996,1173,3073,2421,7069
320305,202308,7152,17750,4913,13412,865,2575,2343,5897,3208,8472
320310,202308,2763,6695,1697,4447,301,832,788,1838,1089,2670
320313,202308,3302,7373,1778,4322,348,941,654,1288,1002,2229
320316,202308,1996,5176,1344,3939,248,736,663,1932,911,2668
320320,202308,27677,67738,17591,48578,4721,13430,4608,11907,9329,25337
320330,202308,3667,8774,2598,6905,422,1117,1422,3727,1844,4844
320332,202308,11262,26240,7973,20122,1791,4599,4082,9621,5873,14220
320334,202308,2627,6611,1498,4300,238,802,352,732,590,1534
320335,202308,2423,6376,1383,4045,300,990,424,1057,724,2047
320340,202308,7538,15501,5372,11967,463,1072,3760,7951,4223,9023
320350,202308,6709,14592,4149,9886,513,1382,2327,5006,2840,6388
320360,202308,1739,4106,1064,2779,136,378,535,1261,671,1639
320370,202308,3822,10247,2691,7797,707,2282,968,2513,1675,4795
320380,202308,4064,8752,3029,6836,232,652,2210,4511,2442,5163
320390,202308,10591,25042,6707,17111,1470,3975,2701,6236,4171,10211
320400,202308,4133,10679,2641,7553,855,2594,864,2272,1719,4866
320405,202308,6826,15774,4372,11162,640,1691,2316,5485,2956,7176
320410,202308,5928,14234,3950,10647,798,2124,1727,4535,2525,6659
320420,202308,5768,12663,3886,9428,931,2417,1573,3575,2504,5992
320425,202308,2740,5782,1857,4262,141,347,1269,2669,1410,3016
320430,202308,3984,9263,2664,6766,371,951,1525,3615,1896,4566
320435,202308,3155,8776,2365,7077,863,2817,617,1786,1480,4603
320440,202308,1923,4797,1219,3375,222,700,524,1223,746,1923
320450,202308,2822,6728,2047,5244,309,1007,1184,2599,1493,3606
320455,202308,5939,16529,3575,11048,889,3044,884,2240,1773,5284
320460,202308,2681,7288,1666,5029,479,1566,436,1117,915,2683
320465,202308,2081,5343,1257,3633,318,965,481,1342,799,2307
320470,202308,5729,13875,3691,9802,731,2099,1219,2798,1950,4897
320480,202308,3517,7395,2402,5472,320,728,1502,3129,1822,3857
320490,202308,34960,78468,21648,53647,4200,10195,9537,22881,13737,33076
320495,202308,1838,4571,1189,3250,294,912,166,287,460,1199
320500,202308,94709,217946,66439,164879,8443,22880,38432,86140,46875,109020
320501,202308,6431,16704,3836,11297,1011,3081,904,2411,1915,5492
320503,202308,3406,8867,1997,5904,585,1905,527,1308,1112,3213
320506,202308,3812,10167,2366,6755,710,2139,652,1569,1362,3708
320510,202308,16425,38789,10898,28204,2079,5296,4901,12017,6980,17313
320515,202308,2355,5914,1480,4033,453,1325,438,1075,891,2400
320517,202308,3002,7939,2195,6254,645,2003,843,2282,1488,4285
320520,202308,66275,148920,44786,109618,6802,17889,22313,49371,29115,67260
320530,202308,48725,108866,33479,80395,2672,7708,21569,45469,24241,53177
330010,202308,38478,83408,28547,65787,2267,5890,20411,43556,22678,49446
330015,202308,2418,5021,1680,3780,251,610,981,1999,1232,2609
330020,202308,32592,68708,25150,56985,2400,6212,18278,38843,20678,45055
330022,202308,2618,6432,1656,4626,329,971,611,1572,940,2543
330023,202308,10160,21263,7237,16491,1013,2577,4363,8989,5376,11566
330025,202308,10592,21204,6721,14834,983,2460,3598,7129,4581,9589
330030,202308,16330,35914,11488,27582,1013,2764,7569,16361,8582,19125
330040,202308,26458,58324,19419,45529,979,2872,14394,30793,15373,33665
330045,202308,149086,280141,117338,236709,6138,13116,96687,188117,102825,201233
330050,202308,5088,11087,3711,8770,544,1566,2322,4798,2866,6364
330060,202308,8780,19124,5598,13548,1041,2835,2186,4641,3227,7476
330070,202308,47209,97788,36397,81412,4259,10055,24276,51899,28535,61954
330080,202308,15204,30713,11757,25372,1488,3150,8160,16954,9648,20104
330090,202308,4597,8536,3064,6326,276,449,2058,4243,2334,4692
330093,202308,4240,8666,2797,6376,164,475,2147,4540,2311,5015
330095,202308,2093,4960,1342,3482,120,343,801,1871,921,2214
330100,202308,108717,235781,88111,202294,5484,13541,67597,146807,73081,160348
330110,202308,3362,7743,2582,6359,236,690,1751,3910,1987,4600
330115,202308,4046,8441,2486,5824,421,1067,1370,2805,1791,3872
330120,202308,4858,9242,3326,7092,160,396,2565,5078,2725,5474
330130,202308,8274,18834,6241,15473,800,2043,3898,9056,4698,11099
330140,202308,6298,12277,4873,10234,225,634,3997,7839,4222,8473
330150,202308,3753,8384,2606,6388,409,1051,1388,3142,1797,4193
330160,202308,2336,5346,1734,4281,262,756,984,2114,1246,2870
330170,202308,239882,456648,188921,383112,20902,44262,139036,270422,159938,314684
330180,202308,3216,6228,2352,4917,75,218,1810,3436,1885,3654
330185,202308,17649,34105,13604,28254,480,1318,11138,21487,11618,22805
330187,202308,8821,18163,6300,14048,854,2102,4093,8383,4947,10485
330190,202308,69321,133203,54394,110876,2632,6294,43735,84036,46367,90330
330200,202308,29386,60656,22532,50672,2680,6313,15973,34417,18653,40730
330205,202308,3058,6720,2022,4911,200,550,1313,2861,1513,3411
330210,202308,4679,10053,3149,7432,458,1121,1612,3379,2070,4500
330220,202308,20958,44336,13654,31381,2326,5758,7003,14216,9329,19974
330225,202308,6519,14147,4573,10940,321,886,3022,6600,3343,7486
330227,202308,29414,58169,23513,49818,607,1720,20158,40239,20765,41959
330230,202308,2511,5305,1454,3605,161,395,683,1627,844,2022
330240,202308,43128,92354,33138,75046,3510,8684,22770,48345,26280,57029
330245,202308,2299,5200,1288,3372,279,807,543,1191,822,1998
330250,202308,73636,145576,59161,123629,5950,13124,43999,87940,49949,101064
330260,202308,10123,20014,7672,16579,439,1189,6036,12301,6475,13490
330270,202308,49643,104617,28640,68400,3719,9595,15269,33253,18988,42848
330280,202308,4214,8713,2966,6607,264,646,2029,4123,2293,4769
330285,202308,46685,88230,35940,72266,1754,4297,29263,54953,31017,59250
330290,202308,7015,13329,5207,10800,337,985,4035,7633,4372,8618
330300,202308,8277,16646,5579,12608,414,1001,4078,8767,4492,9768
330310,202308,3861,7890,2672,5917,116,292,2040,4214,2156,4506
330320,202308,27857,54684,19957,43484,2597,5569,13855,28620,16452,34189
330330,202308,79877,150210,59564,120633,4708,10184,45410,87008,50118,97192
330340,202308,29499,60829,20013,45220,2675,7123,11731,23330,14406,30453
330350,202308,258886,479121,204471,405765,9351,20448,172941,328897,182292,349345
330360,202308,11305,22196,8834,18416,388,843,7240,14195,7628,15038
330370,202308,8341,19599,5861,15005,962,2700,3016,7055,3978,9755
330380,202308,10878,23021,7892,17826,453,1289,5828,12051,6281,13340
330385,202308,6480,14987,4848,12302,859,2399,2454,5737,3313,8136
330390,202308,54355,116418,38042,87532,3320,9295,25920,53035,29240,62330
330395,202308,5313,10844,3941,8795,156,506,3071,6336,3227,6842
330400,202308,5205,11554,4000,9509,243,742,2842,6029,3085,6771
330410,202308,4884,10401,3386,7854,354,1018,2361,4947,2715,5965
330411,202308,4099,9715,2792,7171,171,534,1821,4220,1992,4754
330412,202308,2521,5761,1892,4638,153,442,1295,2860,1448,3302
330414,202308,37699,80387,28986,66870,2324,5740,21489,47195,23813,52935
330415,202308,6437,15203,4149,10893,444,1272,2432,5855,2876,7127
330420,202308,18938,41534,12572,30157,1412,3750,7418,15956,8830,19706
330430,202308,16297,30594,12688,25255,529,1204,10404,19516,10933,20720
330440,202308,4463,9867,2880,6923,312,867,1908,4102,2220,4969
330450,202308,2123,5019,1501,3843,112,327,951,2218,1063,2545
330452,202308,31303,66529,23740,53971,1939,5298,17255,36227,19194,41525
330455,202308,1121960,2134860,866337,1755032,86915,188415,624873,1197599,711788,1386014
330460,202308,1743,4044,1239,3211,174,441,652,1640,826,2081
330470,202308,8911,18630,5689,13356,1348,3447,2309,4865,3657,8312
330475,202308,13778,29701,10569,25086,1463,3852,6880,15489,8343,19341
330480,202308,8075,17956,6203,14708,559,1435,4174,9097,4733,10532
330490,202308,179698,351668,134547,283466,11238,24941,99295,198216,110533,223157
330500,202308,12439,25881,9358,21135,593,1507,6990,14951,7583,16458
330510,202308,77034,158219,57832,129665,4980,12272,42754,89858,47734,102130
330513,202308,1873,4092,1317,3216,202,539,705,1588,907,2127
330515,202308,3986,9210,2879,7371,531,1477,1274,2928,1805,4405
330520,202308,21988,46989,17090,39089,1614,4244,11711,24885,13325,29129
330530,202308,2273,4918,1470,3591,267,705,701,1641,968,2346
330540,202308,4471,10152,3115,7707,613,1568,1589,3655,2202,5223
330550,202308,31206,60395,20650,44338,2743,6319,12673,25491,15416,31810
330555,202308,32352,55419,25318,46337,921,1991,21522,38100,22443,40091
330560,202308,5907,12863,4408,10422,671,1644,2790,6246,3461,7890
330570,202308,4474,9910,3627,8614,554,1498,2395,5434,2949,6932
330575,202308,9388,19345,7497,16058,333,876,6096,12055,6429,12931
330580,202308,35823,77009,26623,60488,3739,8810,16187,33628,19926,42438
330590,202308,2230,4937,1778,4289,256,593,1034,2491,1290,3084
330600,202308,19529,42401,13939,32405,875,2492,9973,21127,10848,23619
330610,202308,14649,31490,11035,25359,1140,2866,7483,15942,8623,18808
330615,202308,3054,6958,2340,5929,393,846,1483,3867,1876,4713
330620,202308,6656,15483,4822,12234,718,1933,2727,6284,3445,8217
330630,202308,47227,97760,31746,71108,1564,4542,23370,47378,24934,51920
350010,202308,3142,7457,1606,4192,281,784,395,831,676,1615
350020,202308,846,2076,435,1205,67,190,170,392,237,582
350030,202308,5156,12496,3567,9414,749,2117,1798,4245,2547,6362
350040,202308,988,2594,523,1568,78,261,171,382,249,643
350050,202308,2011,4528,1142,2947,192,566,354,672,546,1238
350055,202308,1261,2786,865,2068,113,278,508,1066,621,1344
350060,202308,438,950,186,454,42,104,71,151,113,255
350070,202308,4559,10879,2832,7535,464,1344,1180,2663,1644,4007
350075,202308,883,2259,529,1521,141,383,87,246,228,629
350080,202308,875,2129,484,1310,55,179,251,571,306,750
350090,202308,809,1623,464,1044,55,150,299,589,354,739
350100,202308,3475,7934,2147,5389,124,368,1459,3232,1583,3600
350110,202308,680,1477,439,1023,15,48,319,673,334,721
350115,202308,1413,3847,954,2754,156,469,409,1054,565,1523
350120,202308,706,1569,350,918,39,103,180,436,219,539
350130,202308,4575,10882,3068,7775,393,1088,1778,4001,2171,5089
350140,202308,913,2270,500,1395,41,138,285,700,326,838
350150,202308,582,1631,321,988,83,265,91,221,174,486
350160,202308,17081,39756,10737,26849,1440,3959,6217,13893,7657,17852
350170,202308,3980,9641,2784,6879,499,1290,1499,3226,1998,4516
350180,202308,1268,2794,696,1699,83,217,401,864,484,1081
350190,202308,5278,13327,3374,8730,428,1295,1914,4104,2342,5399
350200,202308,730,1693,487,1210,47,115,290,674,337,789
350210,202308,8924,18590,5558,12758,410,1163,3825,7814,4235,8977
350220,202308,4249,10516,2559,6865,480,1369,1170,2663,1650,4032
350230,202308,1530,3383,1020,2579,128,378,613,1399,741,1777
350240,202308,806,2115,392,1155,89,264,82,204,171,468
350250,202308,4902,12003,3169,8718,821,2294,873,2255,1694,4549
350260,202308,1082,2371,555,1421,83,212,278,658,361,870
350270,202308,5789,13604,4001,10107,564,1503,2213,5043,2777,6546
350275,202308,4184,9599,3032,7480,169,521,2199,4934,2368,5455
350280,202308,25554,54237,14985,35513,2124,5316,7742,16309,9866,21625
350290,202308,4702,11726,2995,8077,578,1659,1262,2902,1840,4561
350300,202308,1052,2257,626,1470,90,253,426,904,516,1157
350310,202308,1288,3256,801,2191,111,337,384,901,495,1238
350315,202308,896,1933,488,1221,25,87,295,638,320,725
350320,202308,23866,55698,15620,39318,2695,7458,7791,16817,10486,24275
350330,202308,18809,41734,11921,28206,1132,3106,7885,16784,9017,19890
350335,202308,467,1223,279,819,34,100,120,336,154,436
350340,202308,1768,4276,967,2582,137,418,471,1068,608,1486
350350,202308,915,2110,656,1707,99,223,369,930,468,1153
350360,202308,1581,4025,1019,2731,166,441,454,1101,620,1542
350370,202308,942,2122,591,1399,166,380,230,483,396,863
350380,202308,6634,16836,3873,10562,863,2456,1375,3287,2238,5743
350390,202308,16001,36899,10702,26661,1480,4136,6422,14420,7902,18556
350395,202308,500,1190,197,574,23,71,72,191,95,262
350400,202308,11787,26972,7267,18452,1929,5192,2332,5305,4261,10497
350410,202308,14896,37740,9448,26574,1918,5731,3443,8762,5361,14493
350420,202308,1621,3827,939,2421,191,490,297,624,488,1114
350430,202308,869,2092,621,1656,106,323,307,724,413,1047
350440,202308,2815,6285,1905,4581,220,586,1244,2734,1464,3320
350450,202308,10057,25095,6924,18955,1488,4437,3123,7496,4611,11933
350460,202308,3317,7809,1888,5017,300,869,897,2072,1197,2941
350470,202308,342,764,228,560,10,31,175,398,185,429
350480,202308,1175,2776,695,1887,183,565,142,305,325,870
350490,202308,2736,6113,1727,4329,254,735,896,1864,1150,2599
350500,202308,813,2029,521,1461,93,285,191,476,284,761
350510,202308,1610,3607,1071,2575,122,307,660,1431,782,1738
350520,202308,3290,8702,2245,6484,337,1034,1065,2763,1402,3797
350530,202308,4211,9619,2713,6527,205,602,1742,3694,1947,4296
350535,202308,1971,4681,1456,3764,208,587,926,2265,1134,2852
350540,202308,2609,5264,1806,4006,231,667,1255,2439,1486,3106
350550,202308,13654,30525,8636,21333,953,2686,4826,10385,5779,13071
350560,202308,6422,14193,4755,11135,184,574,3708,8067,3892,8641
350570,202308,44312,107602,30716,80004,5302,14593,15160,35289,20462,49882
350580,202308,2894,6934,1524,4099,406,1123,358,710,764,1833
350590,202308,7154,17217,4729,11874,683,1969,2822,6249,3505,8218
350600,202308,45586,100427,25666,63920,4417,11913,11366,24616,15783,36529
350610,202308,9611,23485,6160,16248,683,2024,3554,8199,4237,10223
350620,202308,517,1238,275,747,31,79,152,375,183,454
350630,202308,2385,5038,1488,3434,92,249,1035,2173,1127,2422
350635,202308,16024,33742,11174,25553,1098,2750,7843,16653,8941,19403
350640,202308,1141,2873,516,1509,85,263,144,346,229,609
350650,202308,11820,28769,7400,19507,1407,3959,3078,7005,4485,10964
350660,202308,6599,15039,4618,11545,718,1708,2693,6464,3411,8172
350670,202308,2468,6057,1585,4353,269,766,787,1972,1056,2738
350680,202308,1597,3842,983,2633,141,405,510,1208,651,1613
350690,202308,1962,4655,1237,3302,208,592,581,1388,789,1980
350700,202308,7321,16499,4980,12356,1152,3103,2483,5421,3635,8524
350710,202308,4277,9904,2971,7397,544,1515,1568,3461,2112,4976
350715,202308,908,2415,675,1922,127,410,328,761,455,1171
350720,202308,216,498,115,300,17,50,40,84,57,134
350730,202308,832,2238,501,1488,46,146,270,697,316,843
350740,202308,2085,5036,1250,3292,223,618,440,985,663,1603
350745,202308,795,1927,377,1032,26,86,211,506,237,592
350750,202308,16466,38637,11497,29061,1997,5538,5260,11735,7257,17273
350760,202308,25170,54561,16060,37624,2081,5725,9020,18221,11101,23946
350770,202308,1359,2996,793,1977,83,223,521,1182,604,1405
350775,202308,940,1974,511,1226,71,188,273,600,344,788
350780,202308,3062,6857,2011,5203,549,1370,726,1959,1275,3329
350790,202308,2572,6343,1422,4050,340,994,328,738,668,1732
350800,202308,4749,11814,3575,9534,523,1429,2124,5246,2647,6675
350810,202308,3755,8218,2454,5977,570,1453,1110,2483,1680,3936
350820,202308,1242,2653,672,1581,58,167,419,869,477,1036
350830,202308,1109,2697,567,1528,112,308,199,434,311,742
350840,202308,4493,12270,2988,8952,619,2016,1141,2931,1760,4947
350850,202308,11581,28317,8116,21457,1362,3814,4216,10173,5578,13987
350860,202308,5424,12238,4165,10130,490,1285,2682,6094,3172,7379
350870,202308,3507,8694,2244,6406,468,1357,939,2485,1407,3842
350880,202308,2217,5384,1557,4005,412,1099,696,1504,1108,2603
350890,202308,650,1591,307,812,71,192,111,245,182,437
350900,202308,13401,31670,8377,20882,1303,3468,4549,10120,5852,13588
350910,202308,1254,2632,912,2043,96,193,628,1349,724,1542
350920,202308,17573,40186,12284,30108,901,2479,8438,18954,9339,21433
350925,202308,5907,13941,3971,10375,628,1839,2153,4800,2781,6639
350930,202308,1890,4498,990,2584,73,190,579,1387,652,1577
350940,202308,3760,8383,2744,6616,284,790,1864,4050,2148,4840
350945,202308,1269,3190,809,2211,158,449,341,823,499,1272
350950,202308,139708,317472,93066,224860,12247,32072,54287,118326,66534,150398
350960,202308,10376,24397,6929,17420,1076,3018,3574,7814,4650,10832
350970,202308,5254,13262,3063,8385,760,2366,1033,2137,1793,4503
350980,202308,1029,2355,779,1887,109,298,480,1057,589,1355
350990,202308,2950,6838,2131,5430,498,1451,1088,2484,1586,3935
350995,202308,1150,3105,880,2456,53,187,596,1510,649,1697
351000,202308,3912,10089,2154,6186,446,1387,530,1312,976,2699
351010,202308,538,1268,290,781,56,160,123,308,179,468
351015,202308,1324,3534,840,2357,149,468,375,896,524,1364
351020,202308,11013,26368,7107,18597,1440,3786,3181,7368,4621,11154
351030,202308,4193,11072,2884,8194,642,1977,1216,3060,1858,5037
351040,202308,7916,16636,5576,12583,402,1060,4087,8359,4489,9419
351050,202308,24531,55180,16507,41137,2980,7847,8473,19247,11453,27094
351060,202308,69918,156379,46806,113801,4607,12603,30488,68334,35095,80937
351070,202308,2007,4609,1007,2798,274,782,175,421,449,1203
351080,202308,3824,8313,2571,6365,328,878,1496,3317,1824,4195
351090,202308,449,1096,302,822,55,142,131,325,186,467
351100,202308,3809,9252,2043,5451,329,946,831,1987,1160,2933
351110,202308,7770,18596,5046,13333,921,2622,2334,5474,3255,8096
351120,202308,1030,2434,577,1489,105,310,216,454,321,764
351130,202308,1569,4075,605,1804,117,372,129,325,246,697
351140,202308,3009,7503,1949,5345,429,1281,727,1651,1156,2932
351150,202308,3681,9620,2154,6218,385,1204,583,1427,968,2631
351160,202308,1944,5390,1165,3553,201,632,185,437,386,1069
351170,202308,2227,5174,1683,4117,133,403,1167,2579,1300,2982
351190,202308,1272,3285,734,2100,179,532,192,499,371,1031
351200,202308,1981,4602,1261,3284,159,455,606,1323,765,1778
351210,202308,1922,4274,1113,2736,78,219,740,1656,818,1875
351220,202308,5220,12012,3796,9361,496,1195,2379,5516,2875,6711
351230,202308,3081,7095,2031,5096,350,965,983,2104,1333,3069
351240,202308,3027,7572,1412,3929,265,751,179,332,444,1083
351250,202308,1301,3285,603,1722,92,265,228,585,320,850
351260,202308,1031,2344,635,1608,124,323,248,558,372,881
351270,202308,692,1711,408,1097,52,152,200,426,252,578
351280,202308,5196,12625,3331,8707,798,2179,1152,2721,1950,4900
351290,202308,1995,4266,1159,2736,84,245,843,1841,927,2086
351300,202308,32251,77633,21175,55845,3846,10792,10039,23862,13885,34654
351310,202308,5331,11582,3546,8297,293,741,2382,5041,2675,5782
351320,202308,1041,2803,624,1912,99,302,158,418,257,720
351330,202308,375,915,185,514,21,58,82,192,103,250
351340,202308,11330,25165,8764,20244,1673,4275,5219,10546,6892,14821
351350,202308,18654,41396,13094,30610,1177,3106,9268,19686,10445,22792
351360,202308,5228,12002,3920,9775,761,2102,1960,4285,2721,6387
351370,202308,2643,6831,1470,4239,352,1105,305,665,657,1770
351380,202308,63682,138091,39098,92748,4169,10711,24480,53331,28649,64042
351385,202308,479,1191,159,460,34,99,58,141,92,240
351390,202308,1900,4258,1202,3205,79,244,881,2187,960,2431
351400,202308,1586,3896,1044,2703,248,573,476,1196,724,1769
351410,202308,3540,8780,2257,6099,452,1270,913,2229,1365,3499
351420,202308,629,1424,332,859,71,166,168,409,239,575
351430,202308,1340,3069,893,2180,101,259,573,1259,674,1518
351440,202308,4954,11709,2855,7236,506,1345,1093,2260,1599,3605
351450,202308,2303,5498,1246,3346,236,765,451,951,687,1716
351460,202308,1382,3201,924,2346,167,427,536,1247,703,1674
351470,202308,1574,3632,1000,2514,83,224,639,1471,722,1695
351480,202308,3159,8094,2191,6249,387,1148,1005,2580,1392,3728
351490,202308,3040,7497,2194,5772,96,323,1603,3915,1699,4238
351492,202308,491,1149,345,834,17,52,259,572,276,624
351495,202308,295,726,185,493,19,39,107,257,126,296
351500,202308,61507,130694,41749,95750,6015,14595,26468,55677,32483,70272
351510,202308,18854,40594,12394,28779,1419,3727,7952,17045,9371,20772
351512,202308,596,1495,340,919,60,164,106,238,166,402
351515,202308,4146,9256,2163,5469,459,1258,530,1237,989,2495
351518,202308,2571,6296,1535,4228,272,809,589,1340,861,2149
351519,202308,816,2084,381,1146,78,247,84,205,162,452
351520,202308,1316,3043,572,1594,75,227,279,681,354,908
351530,202308,444,1051,230,591,37,101,100,195,137,296
351535,202308,2070,4827,1267,3306,226,636,562,1343,788,1979
351540,202308,3550,7854,2144,5277,255,749,1147,2407,1402,3156
351550,202308,9961,22603,5851,14606,896,2306,2984,6612,3880,8918
351560,202308,709,1867,437,1262,74,217,184,476,258,693
351565,202308,369,881,234,619,32,104,123,275,155,379
351570,202308,32500,75383,22434,54942,1913,5390,14941,33596,16854,38986
351580,202308,290,719,140,411,24,76,59,177,83,253
351590,202308,534,1164,237,627,25,82,117,266,142,348
351600,202308,1668,4132,1057,2795,185,479,457,1038,642,1517
351610,202308,851,1858,436,1057,57,108,251,583,308,691
351620,202308,33402,80699,21347,57827,3147,9567,9731,22883,12878,32450
351630,202308,39954,90733,27567,67385,2392,6574,18720,41676,21112,48250
351640,202308,28282,63196,19793,47166,1548,4338,13731,29742,15279,34080
351650,202308,488,1284,189,593,35,115,43,122,78,237
351660,202308,773,2014,473,1345,86,266,130,307,216,573
351670,202308,8141,20265,4369,11554,916,2448,1914,4366,2830,6814
351680,202308,540,1378,326,947,58,165,121,315,179,480
351685,202308,641,1620,397,1099,74,194,153,352,227,546
351690,202308,1516,3589,774,2134,119,388,299,677,418,1065
351700,202308,1818,4005,1136,2742,174,447,665,1416,839,1863
351710,202308,1032,2443,624,1604,53,166,356,797,409,963
351720,202308,1992,4774,1189,3165,210,568,551,1335,761,1903
351730,202308,1347,3018,898,2217,72,176,563,1253,635,1429
351740,202308,4278,9804,3050,7437,402,1054,1778,3897,2180,4951
351750,202308,2571,6258,1356,3705,184,528,684,1641,868,2169
351760,202308,4297,10576,2890,7739,589,1796,1276,2914,1865,4710
351770,202308,2787,6595,2078,5156,532,1296,1052,2420,1584,3716
351780,202308,1374,3188,693,1824,83,229,318,759,401,988
351790,202308,2043,4382,1377,3281,253,592,745,1676,998,2268
351800,202308,539,1189,237,613,33,102,90,173,123,275
351810,202308,1488,3497,993,2549,265,762,436,969,701,1731
351820,202308,4200,10045,2684,6878,621,1677,1076,2392,1697,4069
351830,202308,6929,15470,4539,10997,376,1095,3011,6465,3387,7560
351840,202308,13195,32111,9292,24457,840,2510,5926,14070,6766,16580
351850,202308,1858,4898,1023,3094,196,658,301,689,497,1347
351860,202308,3677,9401,2491,6944,845,2394,846,2088,1691,4482
351870,202308,41201,93458,29546,72468,5533,13981,15284,35506,20817,49487
351880,202308,239547,520587,165151,384444,22828,62936,103373,213853,126201,276789
351885,202308,1384,3068,999,2402,47,125,748,1685,795,1810
351890,202308,1028,2498,533,1542,105,336,137,334,242,670
351900,202308,1666,4051,1100,3016,115,323,699,1852,814,2175
351905,202308,815,2131,512,1423,61,174,216,514,277,688
351907,202308,31891,75243,21071,53665,2614,7531,12320,28078,14934,35609
351910,202308,2361,5372,1438,3452,153,445,901,1875,1054,2320
351920,202308,1163,2757,772,1960,149,369,300,674,449,1043
351925,202308,1318,3147,878,2248,92,282,509,1151,601,1433
351930,202308,6145,13424,4899,11124,629,1489,3310,6986,3939,8475
351940,202308,1449,3424,927,2418,187,505,372,925,559,1430
351950,202308,2109,4099,1412,3011,69,186,1070,2116,1139,2302
351960,202308,7487,17064,4812,11980,1125,2920,1937,4243,3062,7163
351970,202308,15150,34960,11426,28441,1434,4214,7500,16832,8934,21046
351980,202308,1420,3144,763,1931,147,399,336,732,483,1131
351990,202308,1829,3995,1064,2571,48,150,652,1362,700,1512
352000,202308,3731,9004,2719,6803,266,806,1838,4132,2104,4938
352010,202308,3158,7495,2173,5666,605,1595,576,1423,1181,3018
352020,202308,2292,5356,1591,4027,271,735,832,1909,1103,2644
352030,202308,8401,18656,6071,14489,778,2167,3924,8472,4702,10639
352040,202308,6247,14325,3954,9810,725,1946,1682,3667,2407,5613
352042,202308,5244,11097,3167,7620,362,962,1992,4448,2354,5410
352044,202308,2703,6627,1372,3880,228,715,316,680,544,1395
352050,202308,18632,45548,10489,28298,2983,8559,2314,4720,5297,13279
352060,202308,1024,2432,665,1725,127,364,322,740,449,1104
352070,202308,1203,2397,659,1517,101,242,352,729,453,971
352080,202308,573,1357,252,656,37,101,101,215,138,316
352090,202308,2088,5357,1446,3933,188,595,750,1717,938,2312
352100,202308,5222,13222,3418,9471,719,2119,1393,3473,2112,5592
352110,202308,1003,2523,608,1654,119,324,265,624,384,948
352115,202308,626,1614,483,1386,141,451,193,463,334,914
352120,202308,1095,2814,792,2187,72,203,487,1219,559,1422
352130,202308,2464,6477,1355,3701,230,644,613,1450,843,2094
352140,202308,1892,4590,1175,3052,234,618,471,1101,705,1719
352150,202308,1107,2698,744,2006,119,326,435,1115,554,1441
352160,202308,1233,2814,718,1845,75,212,358,840,433,1052
352170,202308,3838,9535,2550,6767,498,1481,1089,2440,1587,3921
352180,202308,3671,9196,2499,6872,482,1420,1013,2480,1495,3900
352190,202308,2224,5068,1613,4011,271,695,853,1992,1124,2687
352200,202308,438,1290,262,858,39,127,90,256,129,383
352210,202308,32617,64757,23927,51891,1378,3477,18741,38109,20119,41586
352215,202308,803,1980,564,1531,114,312,269,686,383,998
352220,202308,39958,84055,27033,60521,3586,9150,17288,34376,20874,43526
352230,202308,20995,53737,14146,39304,3783,11001,4957,11644,8740,22645
352240,202308,14193,33504,10019,26009,2153,6103,5019,11387,7172,17490
352250,202308,34985,88265,25932,71321,3689,11010,15366,39139,19055,50149
352260,202308,6690,15428,4024,9858,747,1999,1874,3808,2621,5807
352265,202308,1126,3014,931,2672,238,728,415,1117,653,1845
352270,202308,2885,7319,2083,5602,413,1151,910,2203,1323,3354
352280,202308,3191,6975,2272,5487,469,1222,1160,2499,1629,3721
352290,202308,2062,5110,1278,3389,195,538,616,1390,811,1928
352300,202308,1211,2854,625,1609,70,207,313,684,383,891
352310,202308,63727,149302,44798,114648,7417,19102,27230,66020,34647,85122
352320,202308,9214,20723,6597,15784,894,2354,3977,8305,4871,10659
352330,202308,3514,7716,2536,6176,230,747,1695,3665,1925,4412
352340,202308,11161,26490,7155,18200,1099,3111,3768,8336,4867,11447
352350,202308,3387,8179,2291,5833,151,455,1531,3532,1682,3987
352360,202308,2085,4824,1459,3622,175,476,884,1911,1059,2387
352370,202308,1343,3370,993,2687,84,264,677,1704,761,1968
352380,202308,1274,2960,782,1992,165,427,284,655,449,1082
352390,202308,20100,45921,12554,31345,1841,5142,7110,15646,8951,20788
352400,202308,5231,13481,3372,9476,802,2356,1045,2480,1847,4836
352410,202308,5151,11411,3507,8396,531,1318,1901,4164,2432,5482
352420,202308,1082,2563,650,1712,114,299,303,696,417,995
352430,202308,12040,25439,7815,17670,973,2450,4674,9607,5647,12057
352440,202308,26598,65131,17318,45829,4019,10725,5976,14615,9995,25340
352450,202308,1023,2419,475,1360,67,221,211,511,278,732
352460,202308,3418,8563,2307,6397,432,1322,1051,2590,1483,3912
352470,202308,3847,9470,2570,6908,283,884,1462,3502,1745,4386
352480,202308,6086,13150,3456,8285,522,1361,1677,3461,2199,4822
352490,202308,1119,2785,710,1920,136,359,289,715,425,1074
352500,202308,15773,37161,8788,23265,2947,8480,1559,2601,4506,11081
352510,202308,6354,14951,4484,11337,530,1426,2919,6854,3449,8280
352520,202308,3790,9354,2506,6885,452,1329,1220,2892,1672,4221
352530,202308,16011,36948,9627,24203,2234,6142,3329,6728,5563,12870
352540,202308,733,1864,482,1319,63,181,253,620,316,801
352550,202308,1470,3547,923,2563,182,599,331,739,513,1338
352560,202308,895,2102,602,1474,38,113,408,885,446,998
352570,202308,2838,7247,1745,5106,469,1482,251,480,720,1962
352580,202308,1003,2252,741,1747,105,286,452,952,557,1238
352585,202308,503,1276,270,769,41,132,98,204,139,336
352590,202308,16854,41346,10490,28492,1880,5583,4946,11469,6826,17052
352600,202308,2585,6190,1825,4656,323,911,1037,2311,1360,3222
352610,202308,3946,9267,2737,7120,426,1216,1379,3231,1805,4447
352620,202308,8014,17616,5409,13318,1404,3372,2392,5714,3796,9086
352630,202308,1064,2383,705,1783,118,340,323,738,441,1078
352640,202308,4518,10392,2916,7191,268,709,1761,3819,2029,4528
352650,202308,714,1865,404,1177,68,215,162,413,230,628
352660,202308,1477,3791,1041,2824,72,231,708,1759,780,1990
352670,202308,14135,33484,9119,23008,1726,4610,4336,9567,6062,14177
352680,202308,4482,11851,2940,8262,585,1889,1324,2912,1909,4801
352690,202308,35528,81756,23815,59060,1347,4028,16761,38042,18108,42070
352700,202308,1085,2528,702,1818,96,274,369,858,465,1132
352710,202308,7357,17296,4671,12103,1418,3850,1582,3454,3000,7304
352720,202308,13865,31029,9931,23442,1285,3379,6117,13147,7402,16526
352725,202308,664,1436,314,807,28,88,175,373,203,461
352730,202308,4791,13026,3412,9580,535,1614,1581,3608,2116,5222
352740,202308,3043,6880,1888,4753,265,734,882,1905,1147,2639
352750,202308,540,1255,271,741,33,90,119,269,152,359
352760,202308,1790,4470,1302,3480,190,527,682,1674,872,2201
352770,202308,1207,2862,748,1940,96,263,418,997,514,1260
352780,202308,820,2168,447,1333,112,293,126,355,238,648
352790,202308,511,1231,300,764,52,129,131,282,183,411
352800,202308,1758,4781,986,2938,185,554,226,512,411,1066
352810,202308,2165,4704,1537,3510,153,382,1102,2375,1255,2757
352820,202308,546,1438,328,977,68,210,79,192,147,402
352830,202308,681,1621,279,771,39,103,94,222,133,325
352840,202308,5138,13190,3552,9858,806,2361,1418,3568,2224,5929
352850,202308,18013,38228,11709,27531,1879,4908,6631,13760,8510,18668
352860,202308,1526,3837,924,2553,181,496,338,869,519,1365
352870,202308,1040,2512,614,1591,73,178,348,832,421,1010
352880,202308,2220,4916,1255,2995,219,551,531,1101,750,1652
352885,202308,457,1134,300,813,35,100,170,404,205,504
352890,202308,897,1913,506,1110,52,124,362,704,414,828
352900,202308,26148,61705,15549,40228,2625,7005,6199,14383,8824,21388
352910,202308,463,1142,217,622,10,29,95,230,105,259
352920,202308,3640,8443,2469,6190,148,446,1778,4077,1926,4523
352930,202308,7753,18296,5491,13564,910,2609,2809,5919,3719,8528
352940,202308,37601,90053,26911,67588,4103,10971,15406,35227,19509,46198
352950,202308,701,1775,391,1168,80,255,124,303,204,558
352960,202308,930,2278,456,1234,72,203,155,338,227,541
352965,202308,289,739,157,465,28,71,49,141,77,212
352970,202308,5210,9639,3924,7655,119,308,3303,6053,3422,6361
352980,202308,2039,4437,1422,3471,386,997,667,1461,1053,2458
352990,202308,5854,13521,3981,10148,716,1896,2110,5030,2826,6926
353000,202308,552,1374,274,771,35,107,94,224,129,331
353010,202308,3611,8078,2106,5168,352,957,1012,2132,1364,3089
353020,202308,4060,9671,2185,5857,357,1095,930,2203,1287,3298
353030,202308,6304,14827,3656,9865,918,2632,981,2370,1899,5002
353040,202308,956,2094,622,1509,59,159,414,920,473,1079
353050,202308,6821,17460,4360,12190,742,2290,2124,5264,2866,7554
353060,202308,69106,155021,51066,122824,3652,10570,36854,81159,40506,91729
353070,202308,15378,38468,9684,25511,1699,4868,4559,10372,6258,15240
353080,202308,6891,16468,4343,11261,842,2413,1829,3893,2671,6306
353090,202308,743,2027,483,1451,51,167,252,654,303,821
353100,202308,398,962,153,448,26,82,50,112,76,194
353110,202308,11239,25541,8214,20769,1798,4567,4072,10272,5870,14839
353120,202308,677,1579,457,1163,73,228,230,476,303,704
353130,202308,4091,8926,2359,5618,542,1393,1030,2004,1572,3397
353140,202308,4151,9005,2751,6486,446,1258,1589,3295,2035,4553
353150,202308,2257,5184,1436,3652,282,755,667,1505,949,2260
353160,202308,803,1926,444,1197,55,171,196,425,251,596
353170,202308,914,2084,615,1578,58,180,387,893,445,1073
353180,202308,13072,30220,8485,21344,1984,5337,3566,7921,5550,13258
353190,202308,4685,11197,2989,7555,375,1000,1713,3939,2088,4939
353200,202308,2282,5638,1223,3369,164,507,532,1266,696,1773
353205,202308,625,1620,403,1069,44,127,240,554,284,681
353210,202308,1161,2271,652,1424,25,63,501,1006,526,1069
353215,202308,496,1224,318,833,47,142,144,321,191,463
353220,202308,980,2492,530,1489,104,297,182,439,286,736
353230,202308,1094,2795,776,2243,206,659,165,427,371,1086
353240,202308,3400,7944,2516,6389,370,1090,1481,3396,1851,4486
353250,202308,1779,3569,1056,2328,126,318,674,1341,800,1659
353260,202308,1521,3284,784,2044,179,521,314,702,493,1223
353270,202308,1118,2530,782,1854,100,279,480,1000,580,1279
353280,202308,968,2357,600,1657,123,344,217,537,340,881
353282,202308,2114,5481,1528,4240,169,530,839,2061,1008,2591
353284,202308,462,1061,218,585,22,77,93,204,115,281
353286,202308,201,505,103,315,23,63,16,45,39,108
353290,202308,1672,4076,764,2085,165,412,218,551,383,963
353300,202308,2910,7117,1753,4610,362,1052,789,1751,1151,2803
353310,202308,503,1116,316,731,21,55,225,474,246,529
353320,202308,823,2037,525,1408,68,203,276,644,344,847
353325,202308,1042,2660,574,1571,92,276,267,630,359,906
353330,202308,824,1879,430,1094,57,145,211,468,268,613
353340,202308,4259,10511,3003,7858,498,1502,1545,3431,2043,4933
353350,202308,5983,13284,3706,8937,1036,2689,1048,2136,2084,4825
353360,202308,906,2306,611,1642,50,150,377,904,427,1054
353370,202308,784,2045,552,1617,77,241,308,833,385,1074
353380,202308,382,954,269,725,35,111,159,363,194,474
353390,202308,8425,19384,5126,13051,496,1467,2973,6675,3469,8142
353400,202308,760,1850,482,1261,80,220,220,444,300,664
353410,202308,687,1633,439,1133,149,380,151,310,300,690
353420,202308,651,1518,393,1006,83,241,117,244,200,485
353430,202308,2988,7524,2016,5535,466,1321,805,1985,1271,3306
353440,202308,109546,259349,72596,183560,9774,27192,42443,95229,52217,122421
353450,202308,496,1181,289,799,35,85,125,327,160,412
353460,202308,4254,10585,2389,6581,486,1479,603,1280,1089,2759
353470,202308,12583,29597,7992,20520,1436,3953,3587,7928,5023,11881
353475,202308,2060,4743,1089,2784,162,463,455,990,617,1453
353480,202308,2076,4690,1421,3463,95,263,1002,2240,1097,2503
353490,202308,1408,3298,888,2254,124,354,498,1106,622,1460
353500,202308,1625,3624,1080,2625,235,607,512,1118,747,1725
353510,202308,1351,3441,781,2068,146,411,327,716,473,1127
353520,202308,1355,3243,762,2110,135,383,280,616,415,999
353530,202308,3311,7626,2356,5713,269,747,1520,3302,1789,4049
353540,202308,2940,6940,2055,5308,306,826,1234,2921,1540,3747
353550,202308,8279,18354,5559,13132,811,2057,3371,7160,4182,9217
353560,202308,3084,7484,2115,5755,585,1683,671,1483,1256,3166
353570,202308,826,2071,429,1235,70,212,155,369,225,581
353580,202308,3246,7703,2204,5592,413,1027,1176,2793,1589,3820
353590,202308,947,2216,603,1560,101,252,320,779,421,1031
353600,202308,1994,4742,1188,3150,188,505,562,1388,750,1893
353610,202308,1089,2889,664,1976,101,310,274,729,375,1039
353620,202308,3865,9026,2410,6370,588,1623,736,1648,1324,3271
353625,202308,814,1848,396,1045,52,170,213,491,265,661
353630,202308,2103,5499,1534,4215,216,638,823,1988,1039,2626
353640,202308,1820,4281,1206,3093,155,380,755,1821,910,2201
353650,202308,9205,22982,5932,16036,906,2655,3109,7472,4015,10127
353657,202308,468,1159,262,730,24,77,116,271,140,348
353660,202308,1751,3376,1140,2494,151,375,769,1564,920,1939
353670,202308,5881,14482,3674,9660,742,2221,1545,3375,2287,5596
353680,202308,933,2156,605,1623,100,294,302,717,402,1011
353690,202308,533,1377,197,591,30,90,43,101,73,191
353700,202308,2940,6693,2039,5101,224,577,1256,2912,1480,3489
353710,202308,5449,11675,3434,7797,605,1449,1907,3706,2512,5155
353715,202308,533,1327,255,713,24,74,122,292,146,366
353720,202308,2505,5995,1697,4518,371,1045,699,1685,1070,2730
353730,202308,7008,16130,5005,12384,719,2003,2953,6547,3672,8550
353740,202308,2889,6887,1896,4935,366,1063,899,1980,1265,3043
353750,202308,1167,3191,709,2211,173,546,119,324,292,870
353760,202308,20065,39795,14009,30945,2832,6686,7464,15423,10296,22109
353770,202308,811,2171,392,1232,60,218,38,83,98,301
353780,202308,9388,21874,6826,16797,1286,3516,3713,8221,4999,11737
353790,202308,3581,9661,2296,6741,552,1740,486,1099,1038,2839
353800,202308,25447,59414,18059,45687,2487,6738,10975,25542,13462,32280
353810,202308,1670,4047,989,2556,193,491,395,950,588,1441
353820,202308,2453,5881,1473,3949,436,1171,387,891,823,2062
353830,202308,781,1806,475,1264,67,203,246,562,313,765
353850,202308,2077,5078,1406,3721,253,707,650,1567,903,2274
353860,202308,3707,8914,2642,7013,611,1879,1116,2408,1727,4287
353870,202308,40071,96420,25153,65626,4402,12069,10857,25003,15259,37072
353880,202308,3969,9688,2921,7600,232,713,1918,4511,2150,5224
353890,202308,4352,8215,2767,5765,202,507,1951,3607,2153,4114
353900,202308,959,2455,575,1590,90,280,219,514,309,794
353910,202308,4260,9809,3144,7778,275,782,2144,4876,2419,5658
353920,202308,2629,6522,1637,4473,470,1418,360,694,830,2112
353930,202308,7448,17569,4856,12437,920,2523,2104,4647,3024,7170
353940,202308,1766,4601,1011,2883,191,539,377,921,568,1460
353950,202308,4620,11107,3108,8059,980,2634,829,1933,1809,4567
353960,202308,951,2316,567,1544,133,367,86,204,219,571
353970,202308,896,1862,588,1355,55,146,440,943,495,1089
353980,202308,24015,52609,16539,38827,810,2431,12414,26659,13224,29090
353990,202308,1295,2778,806,1885,115,301,486,1034,601,1335
354000,202308,3299,7504,1516,3834,252,692,668,1446,920,2138
354010,202308,423,1017,275,735,47,133,160,402,207,535
354020,202308,5409,12649,3652,8865,851,2224,1551,3335,2402,5559
354025,202308,897,2291,493,1395,91,272,141,332,232,604
354030,202308,647,1385,288,707,45,120,144,316,189,436
354040,202308,969,2068,537,1339,61,175,323,714,384,889
354050,202308,1378,3546,857,2566,181,575,316,871,497,1446
354060,202308,5614,13823,3593,9286,546,1573,1902,4183,2448,5756
354070,202308,5461,12632,3340,8297,585,1515,1383,2932,1968,4447
354075,202308,3811,9391,2803,7494,590,1681,1497,3564,2087,5245
354080,202308,2009,5059,1252,3465,194,578,604,1440,798,2018
354085,202308,528,972,346,691,5,13,269,490,274,503
354090,202308,2279,5582,1731,4391,113,338,1258,2949,1371,3287
354100,202308,34573,84497,23729,64555,4452,13208,11473,28002,15925,41210
354105,202308,1467,3493,877,2354,128,365,440,1039,568,1404
354110,202308,633,1566,386,1079,56,157,180,447,236,604
354120,202308,1854,4545,1054,2789,231,629,383,868,614,1497
354130,202308,7931,18748,4517,11671,1263,3331,1163,2512,2426,5843
354140,202308,25513,58917,16091,40033,2487,6641,8288,18056,10775,24697
354150,202308,3610,7976,2497,6044,655,1567,728,1732,1383,3299
354160,202308,3600,9292,2646,7296,646,1838,1114,2767,1760,4605
354165,202308,950,2464,666,1856,71,237,419,1022,490,1259
354170,202308,2621,6553,1615,4327,327,979,719,1585,1046,2564
354180,202308,583,1514,354,980,43,130,176,420,219,550
354190,202308,1990,5069,1210,3354,85,286,720,1781,805,2067
354200,202308,1172,2674,753,1884,101,278,425,927,526,1205
354210,202308,1430,3366,908,2263,91,248,577,1299,668,1547
354220,202308,4159,9920,2726,7014,549,1475,1092,2461,1641,3936
354230,202308,1034,2340,769,1938,52,156,523,1216,575,1372
354240,202308,2398,6055,1394,3830,274,767,558,1295,832,2062
354250,202308,865,2033,483,1300,121,328,158,394,279,722
354260,202308,12084,27320,8273,20266,1357,3470,3941,8933,5298,12403
354270,202308,1276,3360,874,2434,135,375,431,1038,566,1413
354280,202308,1038,2331,733,1770,47,145,519,1109,566,1254
354290,202308,1279,3561,919,2737,134,416,497,1356,631,1772
354300,202308,4271,11299,3309,9356,907,2606,1275,3261,2182,5867
354310,202308,1059,2675,752,2040,103,322,464,1123,567,1445
354320,202308,1193,2651,660,1679,117,313,309,659,426,972
354323,202308,564,1252,298,750,41,116,160,361,201,477
354325,202308,1684,4776,834,2631,175,562,132,333,307,895
354330,202308,13590,30643,8325,19824,1169,3035,4813,10271,5982,13306
354340,202308,58040,132024,37990,95321,6516,17088,19577,44907,26093,61995
354350,202308,1510,3419,1126,2717,150,419,700,1496,850,1915
354360,202308,828,1815,451,1160,117,294,157,354,274,648
354370,202308,1264,3153,879,2408,155,461,496,1250,651,1711
354380,202308,674,1689,436,1262,56,195,157,369,213,564
354390,202308,20902,45612,12697,30146,1789,4632,6984,14667,8773,19299
354400,202308,2102,6028,1346,4180,242,788,418,1163,660,1951
354410,202308,9593,21448,6344,14891,1000,2588,3647,7667,4647,10255
354420,202308,1865,4453,1138,3021,192,539,537,1249,729,1788
354425,202308,3788,8290,2388,5688,393,960,1349,2985,1742,3945
354430,202308,2322,5333,1537,3852,145,432,979,2205,1124,2637
354440,202308,747,1801,367,947,44,127,193,432,237,559
354450,202308,644,1595,311,892,42,127,112,252,154,379
354460,202308,997,2403,592,1638,173,534,151,323,324,857
354470,202308,501,1259,227,622,20,62,88,187,108,249
354480,202308,1803,3769,1047,2456,75,205,704,1482,779,1687
354490,202308,1057,2844,658,1891,141,386,292,765,433,1151
354500,202308,3159,7693,2185,5865,551,1567,766,1840,1317,3407
354510,202308,953,2432,603,1665,78,227,302,689,380,916
354515,202308,564,1495,320,946,60,186,95,230,155,416
354520,202308,11390,27616,7171,18521,983,2843,3993,8943,4976,11786
354530,202308,7068,17124,4689,12088,1208,3078,1846,4322,3054,7400
354540,202308,1617,3878,1011,2669,183,510,453,1085,636,1595
354550,202308,739,1841,479,1312,77,235,235,544,312,779
354560,202308,2794,6256,1327,3400,167,414,730,1708,897,2122
354570,202308,1098,2573,405,1159,73,220,62,163,135,383
354580,202308,11073,27552,6844,18812,1023,3080,3458,8441,4481,11521
354600,202308,2745,6708,1779,4747,321,855,894,2193,1215,3048
354610,202308,593,1483,273,779,32,92,124,306,156,398
354620,202308,629,1642,339,1026,32,117,179,479,211,596
354625,202308,391,1030,194,589,18,65,62,136,80,201
354630,202308,3374,8493,2502,6653,849,2250,685,1659,1534,3909
354640,202308,5172,12887,3495,9343,482,1459,1836,4283,2318,5742
354650,202308,1116,2648,685,1709,199,463,305,729,504,1192
354660,202308,4507,9918,2220,5844,307,892,924,2101,1231,2993
354670,202308,1591,3959,1033,2767,215,613,360,808,575,1421
354680,202308,8708,19408,6059,14669,967,2547,3529,7829,4496,10376
354690,202308,689,1924,397,1218,64,193,155,405,219,598
354700,202308,1212,2841,750,1905,103,296,411,934,514,1230
354710,202308,601,1487,330,909,35,86,156,364,191,450
354720,202308,389,868,168,450,64,155,37,86,101,241
354730,202308,15502,40105,10500,29478,1529,4431,5552,14011,7081,18442
354740,202308,382,987,141,430,33,99,18,45,51,144
354750,202308,3154,7463,1837,4744,289,804,839,1847,1128,2651
354760,202308,2982,7059,1854,4852,355,975,749,1655,1104,2630
354765,202308,434,1089,153,458,16,64,43,103,59,167
354770,202308,3217,7326,2043,4961,437,1195,992,2113,1429,3308
354780,202308,88022,191973,59458,135106,4155,11545,42330,86020,46485,97565
354790,202308,1173,2982,870,2457,88,264,497,1307,585,1571
354800,202308,3598,8518,2194,5802,492,1331,761,1700,1253,3031
354805,202308,1852,3968,1160,2741,78,213,812,1727,890,1940
354810,202308,663,1876,368,1226,76,284,96,257,172,541
354820,202308,1224,3274,788,2377,157,486,226,555,383,1041
354830,202308,686,1531,343,871,68,189,132,274,200,463
354840,202308,1078,2603,531,1402,45,119,300,692,345,811
354850,202308,31995,71011,21278,51397,1804,5207,14487,31254,16291,36461
354860,202308,2099,5135,1209,3344,155,478,521,1236,676,1714
354870,202308,96950,214842,63986,149496,5511,14797,42094,87104,47605,101901
354880,202308,8473,19617,4150,10346,567,1610,1989,3920,2556,5530
354890,202308,25951,57438,17954,42430,2381,6215,10230,21733,12611,27948
354900,202308,487,1132,272,731,84,235,81,184,165,419
354910,202308,8262,19919,4476,12416,962,2852,1404,3236,2366,6088
354920,202308,592,1521,216,644,28,89,57,130,85,219
354925,202308,329,889,149,487,16,59,28,65,44,124
354930,202308,442,1020,225,555,21,56,133,297,154,353
354940,202308,3725,9782,2511,7038,719,2087,977,2309,1696,4396
354950,202308,2032,4537,1388,3377,71,228,1002,2219,1073,2447
354960,202308,1072,2601,687,1918,78,272,331,800,409,1072
354970,202308,5859,14212,4057,10866,296,956,2648,6435,2944,7391
354980,202308,49093,106943,30970,73966,3976,10835,19023,40215,22999,51050
354990,202308,109404,241649,69419,166189,5056,14541,46341,98619,51397,113160
354995,202308,4587,8548,3213,6554,169,401,2538,4818,2707,5219
355000,202308,1953,4471,1260,3276,212,607,577,1309,789,1916
355010,202308,5474,13356,3086,8224,958,2472,853,2070,1811,4542
355020,202308,3955,10637,2939,8747,753,2451,961,2412,1714,4863
355030,202308,1842573,4129005,1155211,2748069,171399,442307,634135,1350343,805534,1792650
355040,202308,4849,10331,3388,8122,461,1217,2232,4891,2693,6108
355050,202308,1494,3220,954,2316,225,550,367,820,592,1370
355060,202308,9409,22845,6190,16390,1031,2941,3120,7275,4151,10216
355070,202308,15350,34289,11017,26281,1302,3476,6985,14962,8287,18438
355080,202308,1269,3311,674,2073,169,516,112,290,281,806
355090,202308,1818,4411,1251,3300,203,538,674,1567,877,2105
355100,202308,45763,102152,35247,83915,3378,9058,25196,55467,28574,64525
355110,202308,1320,3295,799,2344,153,468,51,134,204,602
355120,202308,919,2202,533,1505,79,238,258,633,337,871
355130,202308,1121,2215,523,1095,16,47,405,773,421,820
355140,202308,3036,5567,2346,4577,97,241,1954,3563,2051,3804
355150,202308,6830,15653,4882,11935,614,1624,3019,6793,3633,8417
355160,202308,3247,7959,1938,5386,432,1242,560,1330,992,2572
355170,202308,16896,38032,11455,27809,1841,4897,6534,14395,8375,19292
355180,202308,3777,8586,2555,6564,613,1712,1175,2705,1788,4417
355190,202308,2444,5984,1561,4248,605,1644,332,943,937,2587
355200,202308,1185,3198,888,2639,241,807,316,811,557,1618
355210,202308,4289,10423,2757,7194,767,1949,963,2291,1730,4240
355220,202308,75321,174517,52880,128434,6524,18188,31931,68590,38455,86778
355230,202308,1535,3707,657,1792,141,421,258,579,399,1000
355240,202308,34027,81509,21371,55230,2462,7055,13021,30401,15483,37456
355250,202308,56674,134519,38063,95984,9165,23286,17912,41620,27077,64906
355255,202308,835,1925,368,982,42,126,168,368,210,494
355260,202308,2033,4318,1267,2949,108,315,888,1864,996,2179
355270,202308,1647,4325,1129,3198,290,786,425,1108,715,1894
355280,202308,45242,102095,28401,69156,3650,9654,16175,35540,19825,45194
355290,202308,1227,2971,803,2120,180,470,370,876,550,1346
355300,202308,1894,4886,1371,3777,239,696,611,1440,850,2136
355310,202308,1173,2915,757,2074,106,326,396,995,502,1321
355320,202308,715,1766,427,1139,91,271,164,339,255,610
355330,202308,4145,9370,2753,6669,131,394,2068,4588,2199,4982
355340,202308,5331,11190,3354,7890,667,1581,1403,3339,2070,4920
355350,202308,1851,4708,1248,3464,239,742,581,1420,820,2162
355360,202308,1653,3802,1084,2798,166,467,569,1251,735,1718
355365,202308,431,989,185,521,33,91,65,153,98,244
355370,202308,7598,17353,5107,12865,1071,2412,2490,6222,3561,8634
355380,202308,3905,9440,2602,6864,466,1328,983,2156,1449,3484
355385,202308,1795,4248,1200,3058,121,344,699,1578,820,1922
355390,202308,945,2367,614,1644,105,300,293,649,398,949
355395,202308,2259,6076,1242,3698,218,706,496,1244,714,1950
355400,202308,13290,33482,9360,24994,1846,5418,4268,9664,6114,15082
355410,202308,33048,82505,20608,56066,3951,11520,8745,21000,12696,32520
355420,202308,743,2153,527,1662,115,391,149,407,264,798
355430,202308,4742,11027,3096,7713,539,1467,1676,3879,2215,5346
355440,202308,880,2180,467,1295,94,279,134,316,228,595
355450,202308,4905,11435,2745,6936,358,988,1416,2967,1774,3955
355460,202308,603,1388,360,942,42,127,166,380,208,507
355465,202308,572,1344,396,1032,62,158,221,533,283,691
355470,202308,1489,3507,731,1960,209,609,264,637,473,1246
355475,202308,445,962,291,694,15,35,195,423,210,458
355480,202308,5544,14063,3943,11152,603,1879,2225,5793,2828,7672
355490,202308,1119,2834,524,1556,68,227,218,550,286,777
355495,202308,1270,3045,785,2169,100,325,375,837,475,1162
355500,202308,9358,21587,5260,13242,697,1981,2511,5430,3208,7411
355510,202308,1837,4226,1052,2709,174,476,496,1100,670,1576
355520,202308,392,884,178,508,27,77,28,69,55,146
355530,202308,374,811,153,387,13,38,93,206,106,244
355535,202308,692,1714,480,1299,99,317,214,452,313,769
355540,202308,18378,39687,13961,32614,1405,3572,9689,21066,11094,24638
355550,202308,816,2191,603,1762,74,249,341,877,415,1126
355560,202308,1451,3542,694,1993,176,545,33,95,209,640
355570,202308,389,936,180,497,34,78,73,178,107,256
355580,202308,1493,3422,708,1897,127,342,132,322,259,664
355590,202308,200,496,135,376,14,39,73,180,87,219
355600,202308,1728,4102,1016,2750,142,422,301,678,443,1100
355610,202308,2681,6084,1533,3882,326,828,697,1561,1023,2389
355620,202308,6861,16410,4358,11148,530,1639,2499,5487,3029,7126
355630,202308,3456,8414,2185,5799,286,805,1286,3098,1572,3903
355635,202308,1358,3519,792,2248,110,332,325,807,435,1139
355640,202308,4683,11885,2742,7877,783,2242,451,1324,1234,3566
355645,202308,4734,12168,2926,8465,422,1324,1381,3555,1803,4879
355650,202308,11136,26410,7481,18970,1345,3557,3682,8329,5027,11886
355660,202308,1649,4232,811,2500,162,479,127,338,289,817
355670,202308,6219,14853,3714,9287,492,1431,1915,4034,2407,5465
355680,202308,3175,8305,1288,3835,354,1138,122,318,476,1456
355690,202308,932,2546,552,1716,198,625,14,29,212,654
355695,202308,324,825,171,500,18,53,33,68,51,121
355700,202308,12181,29972,8873,22612,1079,3097,5227,11838,6306,14935
355710,202308,13482,29630,7934,18546,1212,3168,4160,8266,5372,11434
355715,202308,614,1553,294,824,76,205,87,204,163,409
355720,202308,1934,4730,1328,3522,241,659,688,1634,929,2293
355730,202308,1410,3448,927,2467,91,273,539,1290,630,1563
410010,202308,1493,3888,944,2648,214,598,220,543,434,1141
410020,202308,1452,3744,932,2610,272,757,236,573,508,1330
410030,202308,2197,5319,1576,4189,248,701,841,2136,1089,2837
410040,202308,19698,49111,12186,33712,2571,7445,3774,9255,6345,16700
410045,202308,886,2235,546,1498,129,362,133,309,262,671
410050,202308,2638,6503,1552,4328,256,795,461,1085,717,1880
410060,202308,2576,6631,1758,4960,452,1419,556,1347,1008,2766
410070,202308,2461,5786,1336,3503,246,659,502,1111,748,1770
410080,202308,1726,4270,1083,3020,273,792,255,605,528,1397
410090,202308,1431,3128,960,2286,253,587,310,798,563,1385
410100,202308,2615,6846,1297,3740,223,702,87,228,310,930
410105,202308,718,1635,374,962,39,91,191,418,230,509
410110,202308,3991,8857,2545,6177,372,977,1463,3187,1835,4164
410115,202308,670,1628,402,1081,51,161,150,302,201,463
410120,202308,4278,9780,3328,8094,732,1511,1863,4447,2595,5958
410130,202308,1691,3998,1310,3220,182,494,794,1813,976,2307
410140,202308,22613,51115,12257,31186,2537,6748,4148,9247,6685,15995
410150,202308,19890,44459,9128,23028,1566,4361,3359,7065,4925,11426
410160,202308,3753,9761,2504,7047,568,1749,906,2281,1474,4030
410165,202308,755,1922,535,1416,81,243,246,580,327,823
410170,202308,3716,8917,1724,4515,348,933,416,939,764,1872
410180,202308,23099,58158,14513,39110,2642,7634,6660,15482,9302,23116
410185,202308,580,1536,364,1036,64,198,148,349,212,547
410190,202308,2756,6491,1561,4086,332,860,316,706,648,1566
410200,202308,7263,15463,3358,8455,809,2139,632,1307,1441,3446
410210,202308,3845,9162,2024,5628,352,1069,637,1424,989,2493
410220,202308,792,1911,380,971,81,208,133,293,214,501
410230,202308,2655,6455,1561,4081,248,723,677,1473,925,2196
410240,202308,6295,15597,3481,9657,778,2566,624,1415,1402,3981
410250,202308,2847,6419,1701,4293,228,591,778,1809,1006,2400
410260,202308,2550,5756,1395,3564,292,801,663,1462,955,2263
410270,202308,623,1521,336,914,52,161,156,345,208,506
410275,202308,738,1906,399,1166,82,268,161,415,243,683
410280,202308,2889,7050,1598,4358,230,686,713,1631,943,2317
410290,202308,4066,10399,2410,6860,993,2758,491,1351,1484,4109
410300,202308,849,1949,569,1413,69,215,296,607,365,822
410302,202308,404,955,207,582,37,107,90,229,127,336
410304,202308,1850,4026,1360,3153,178,440,766,1725,944,2165
410305,202308,2183,4803,1355,3440,188,542,835,1936,1023,2478
410310,202308,4126,9374,2836,6881,205,652,1963,4276,2168,4928
410315,202308,865,1875,495,1227,129,331,158,352,287,683
410320,202308,1126,2998,569,1710,68,220,98,251,166,471
410322,202308,757,1936,293,838,36,100,95,207,131,307
410330,202308,1751,4062,997,2577,192,485,315,714,507,1199
410335,202308,1039,2597,621,1710,126,367,184,423,310,790
410337,202308,994,2338,527,1348,74,191,196,430,270,621
410340,202308,560,1454,295,776,24,80,154,309,178,389
410345,202308,3526,8630,1721,4601,455,1198,629,1486,1084,2684
410347,202308,966,2324,552,1481,100,270,133,330,233,600
410350,202308,2050,4670,1193,3079,111,341,675,1498,786,1839
410360,202308,4835,11658,2875,7729,569,1596,795,1918,1364,3514
410370,202308,18499,46015,9551,24607,1298,3760,4282,9021,5580,12781
410380,202308,2217,5072,1156,2949,175,502,377,831,552,1333
410390,202308,3554,7790,2084,5167,418,1218,875,1771,1293,2989
410395,202308,1103,2916,758,2199,167,467,254,741,421,1208
410400,202308,10425,23504,6581,15926,678,1900,4119,8815,4797,10715
410405,202308,1151,2503,669,1706,83,257,334,765,417,1022
410410,202308,2036,4783,1512,3811,132,366,979,2362,1111,2728
410420,202308,16478,39915,10293,26864,1777,4985,4612,10280,6389,15265
410425,202308,4935,12345,2955,8149,533,1546,1029,2479,1562,4025
410430,202308,17107,39234,9691,24398,1524,4186,3982,8789,5506,12975
410440,202308,3050,7764,2341,6312,434,1167,1196,2983,1630,4150
410442,202308,3188,8524,2077,5979,544,1595,455,1159,999,2754
410445,202308,2793,7296,1610,4856,378,1268,170,516,548,1784
410450,202308,2035,4689,1198,3194,222,605,327,758,549,1363
410460,202308,3293,7319,1976,4830,310,818,982,2085,1292,2903
410465,202308,3775,9928,2212,6381,567,1641,506,1192,1073,2833
410470,202308,3059,7751,1892,5515,668,2198,131,340,799,2538
410480,202308,53352,119517,25027,66380,4090,11722,8056,17960,12146,29682
410490,202308,15132,37683,9216,24640,1632,4706,4449,10370,6081,15076
410500,202308,2267,5470,1177,3236,240,648,200,428,440,1076
410510,202308,2223,5128,1230,3168,284,691,400,988,684,1679
410520,202308,3884,10740,3134,9142,994,3100,1186,3214,2180,6314
410530,202308,1851,4362,659,1757,88,264,187,396,275,660
410540,202308,3556,8684,2068,5568,400,1172,912,2126,1312,3298
410550,202308,9656,24086,5436,14658,927,2718,1734,3695,2661,6413
410560,202308,1857,4500,1064,2808,206,623,271,571,477,1194
410570,202308,3421,8358,2031,5696,743,2357,193,443,936,2800
410580,202308,37555,88194,24393,62688,4051,11148,11620,26641,15671,37789
410590,202308,2123,5461,1225,3366,191,560,337,718,528,1278
410600,202308,2294,5448,1575,4058,335,864,662,1567,997,2431
410610,202308,870,2049,536,1380,46,125,284,648,330,773
410620,202308,3757,9147,2372,6191,595,1624,760,1786,1355,3410
410630,202308,3047,7296,1648,4367,328,1034,331,580,659,1614
410640,202308,6587,14320,3660,8882,892,2300,685,1553,1577,3853
410645,202308,1783,4051,1292,3304,133,387,880,2120,1013,2507
410650,202308,3349,8314,1795,4934,412,1118,685,1665,1097,2783
410655,202308,1067,2436,565,1432,118,319,212,459,330,778
410657,202308,728,1844,395,1083,65,205,192,422,257,627
410660,202308,4718,10844,2340,5841,377,996,899,1923,1276,2919
410670,202308,1207,2861,580,1542,88,256,207,464,295,720
410680,202308,2998,8289,1899,5651,555,1640,497,1434,1052,3074
410685,202308,652,1572,407,1104,107,314,155,359,262,673
410690,202308,185863,419662,107843,264799,17715,47817,46329,96018,64044,143835
410700,202308,3044,7221,2049,5298,505,1352,713,1632,1218,2984
410710,202308,1122,2665,577,1563,152,435,207,458,359,893
410712,202308,826,2076,538,1481,102,288,257,664,359,952
410715,202308,1078,2839,567,1672,72,242,244,639,316,881
410720,202308,5001,11450,3299,8109,519,1568,1275,2776,1794,4344
410725,202308,1455,3349,720,1929,173,492,178,397,351,889
410730,202308,1127,2650,593,1553,107,332,128,293,235,625
410740,202308,1043,2715,583,1706,51,171,325,905,376,1076
410750,202308,2463,5529,1561,3775,251,656,691,1524,942,2180
410752,202308,489,1132,205,561,82,202,28,71,110,273
410753,202308,432,1161,229,702,42,129,70,179,112,308
410754,202308,1445,3229,995,2466,89,251,696,1645,785,1896
410755,202308,666,1619,398,1063,50,157,187,428,237,585
410760,202308,4431,10808,2690,7390,767,2495,624,1438,1391,3933
410765,202308,24892,60870,16242,42678,3360,9683,5772,12651,9132,22334
410770,202308,1236,2797,703,1827,79,192,347,858,426,1050
410773,202308,1655,3955,1190,3073,279,743,584,1326,863,2069
410775,202308,2083,4206,1572,3321,50,134,1221,2372,1271,2506
410780,202308,726,1718,405,1060,69,182,142,341,211,523
410785,202308,1029,2294,631,1612,100,297,302,698,402,995
410790,202308,1466,3939,937,2741,207,683,207,503,414,1186
410800,202308,4314,8517,2626,5549,84,240,1901,3699,1985,3939
410810,202308,571,1421,351,976,39,102,168,413,207,515
410820,202308,1249,3235,550,1507,122,349,129,285,251,634
410830,202308,60244,130207,37132,88231,6036,15888,18997,39934,25033,55822
410832,202308,1371,3331,894,2347,102,313,488,1103,590,1416
410840,202308,11579,27220,5499,14820,1438,3914,1107,2376,2545,6290
410845,202308,1515,3182,1055,2411,113,319,715,1493,828,1812
410850,202308,2640,6767,1933,5306,394,1172,882,2235,1276,3407
410855,202308,870,2051,476,1262,73,227,223,490,296,717
410860,202308,6220,13253,4210,9549,183,545,3040,6174,3223,6719
410865,202308,1774,4555,1311,3647,248,715,657,1855,905,2570
410870,202308,1456,3633,959,2671,135,413,499,1267,634,1680
410880,202308,6032,14782,3363,9525,571,1668,529,1573,1100,3241
410890,202308,1481,3693,997,2651,197,497,470,1141,667,1638
410895,202308,1221,3520,924,2838,265,894,278,751,543,1645
410900,202308,1073,2695,595,1713,111,338,113,237,224,575
410910,202308,547,1193,270,652,17,49,158,334,175,383
410920,202308,1172,2547,650,1548,50,128,415,908,465,1036
410930,202308,2171,5165,1228,3422,277,856,192,427,469,1283
410940,202308,32718,80473,20064,54942,4199,12676,8195,19772,12394,32448
410950,202308,2473,6183,2034,5387,202,483,1476,3754,1678,4237
410960,202308,11247,24815,7192,17896,2192,5912,2338,5051,4530,10963
410965,202308,1375,3315,677,1889,135,403,255,624,390,1027
410970,202308,5421,13526,3130,8617,804,2603,607,1249,1411,3852
410975,202308,1867,4157,1056,2667,225,588,405,939,630,1527
410980,202308,9749,22227,5547,14174,638,1883,2872,6325,3510,8208
410990,202308,1934,4151,1207,2952,241,633,582,1348,823,1981
411000,202308,840,2142,488,1398,91,276,158,387,249,663
411005,202308,576,1346,271,700,37,99,109,225,146,324
411007,202308,3150,7603,1894,5097,394,1196,676,1533,1070,2729
411010,202308,6072,15800,3638,10413,964,2878,818,1887,1782,4765
411020,202308,2894,7424,2018,5699,566,1599,587,1586,1153,3185
411030,202308,849,1989,475,1200,63,169,199,412,262,581
411040,202308,1271,3019,524,1413,98,243,156,350,254,593
411050,202308,2524,7230,1686,5287,355,1201,265,654,620,1855
411060,202308,2921,7093,1526,4124,282,810,558,1200,840,2010
411065,202308,474,1136,231,629,23,61,93,226,116,287
411070,202308,10011,22802,6599,16350,1138,2971,3229,7092,4367,10063
411080,202308,2591,6213,1648,4324,397,1159,578,1265,975,2424
411090,202308,967,2499,455,1350,68,241,135,326,203,567
411095,202308,2942,6664,1243,3290,229,602,198,408,427,1010
411100,202308,1491,3577,822,2234,138,455,310,716,448,1171
411110,202308,769,1930,287,859,31,90,24,40,55,130
411120,202308,2156,5139,1351,3533,222,688,606,1354,828,2042
411125,202308,6934,18078,4893,13696,1487,4210,1577,4020,3064,8230
411130,202308,934,2289,515,1396,153,394,151,397,304,791
411140,202308,2653,7598,1809,5629,468,1490,472,1432,940,2922
411150,202308,5082,11952,2761,7150,604,1659,245,498,849,2157
411155,202308,1383,3148,776,1917,131,365,426,896,557,1261
411160,202308,504,1076,262,676,44,125,71,183,115,308
411170,202308,970,2519,664,1900,139,440,307,800,446,1240
411180,202308,6939,16033,4977,12151,749,2044,2748,5906,3497,7950
411190,202308,2766,6576,1610,4165,229,637,762,1702,991,2339
411200,202308,6380,15654,4137,10993,878,2635,1445,3104,2323,5739
411210,202308,4476,9545,2440,5697,296,826,1217,2403,1513,3229
411220,202308,1226,2828,678,1750,131,362,261,561,392,923
411230,202308,1044,2589,644,1766,141,392,167,397,308,789
411240,202308,1898,4215,1077,2674,230,595,372,801,602,1396
411250,202308,2836,6897,1673,4585,434,1272,426,996,860,2268
411260,202308,401,951,214,569,33,104,99,208,132,312
411270,202308,2529,6226,1536,4157,233,660,731,1726,964,2386
411275,202308,2048,4208,1240,2798,119,342,714,1354,833,1696
411280,202308,1921,4732,1145,3073,258,724,418,950,676,1674
411290,202308,1016,2453,563,1520,67,211,272,660,339,871
411295,202308,1605,3804,989,2594,203,513,378,861,581,1374
411300,202308,1220,2919,578,1535,64,193,220,443,284,636
411310,202308,1205,2471,742,1692,131,322,399,785,530,1107
411320,202308,7412,16921,4803,11840,746,2051,2305,4752,3051,6803
411325,202308,1898,4667,1371,3651,217,598,776,2008,993,2606
411330,202308,3955,9788,2607,7263,700,2131,691,1740,1391,3871
411340,202308,1004,2542,467,1302,76,218,169,403,245,621
411342,202308,1268,2931,582,1535,141,379,201,432,342,811
411345,202308,1503,3480,924,2394,67,200,608,1467,675,1667
411350,202308,3761,9387,2004,5651,471,1407,262,601,733,2008
411360,202308,859,1978,535,1332,89,262,237,507,326,769
411370,202308,76260,174531,45867,115734,4325,12434,26584,59384,30909,71818
411373,202308,1740,3985,1153,2918,200,508,490,1164,690,1672
411375,202308,1345,3154,719,1901,123,324,245,551,368,875
411380,202308,1422,3048,743,1679,35,81,516,1062,551,1143
411390,202308,1926,4754,1203,3082,211,619,518,1057,729,1676
411400,202308,2971,6688,1881,4602,227,628,1033,2219,1260,2847
411410,202308,3860,10100,2247,6419,573,1684,526,1237,1099,2921
411420,202308,5233,12154,2124,5803,336,1007,401,739,737,1746
411430,202308,5289,12473,3478,8920,690,1983,1292,2714,1982,4697
411435,202308,537,1351,227,654,41,128,39,78,80,206
411440,202308,3422,8441,2099,5763,591,1605,536,1299,1127,2904
411450,202308,3112,7631,2057,5554,331,854,1123,2955,1454,3809
411460,202308,5699,13761,2806,7780,415,1289,779,1707,1194,2996
411470,202308,1147,2561,773,1893,66,222,491,1046,557,1268
411480,202308,7061,17210,4004,10897,799,2443,1225,2875,2024,5318
411490,202308,2135,4895,1409,3569,181,556,781,1743,962,2299
411500,202308,1724,4229,959,2516,201,567,266,529,467,1096
411510,202308,2800,6345,1754,4395,337,993,499,1141,836,2134
411520,202308,47117,107507,22751,57400,2975,8651,10624,22572,13599,31223
411530,202308,1152,2771,539,1530,98,296,129,311,227,607
411535,202308,638,1786,330,1039,37,136,82,217,119,353
411540,202308,3475,7715,1896,4665,205,572,1094,2460,1299,3032
411545,202308,1075,2852,803,2279,69,219,491,1336,560,1555
411550,202308,860,1981,565,1388,107,268,215,462,322,730
411560,202308,2368,6257,959,2901,138,442,71,156,209,598
411570,202308,9809,21071,5961,14602,1350,3541,2131,4704,3481,8245
411573,202308,963,2364,695,1828,100,335,405,933,505,1268
411575,202308,2562,6218,1582,4231,315,910,568,1370,883,2280
411580,202308,5450,12669,2638,7315,383,1203,498,1022,881,2225
411585,202308,726,2055,277,878,37,122,34,79,71,201
411590,202308,601,1473,359,945,50,163,178,386,228,549
411600,202308,431,993,205,552,38,99,79,180,117,279
411605,202308,1999,4290,1013,2549,118,371,489,1193,607,1564
411610,202308,3621,7318,2204,4732,72,209,1642,3141,1714,3350
411620,202308,3790,8805,2774,7004,596,1513,1183,2904,1779,4417
411630,202308,1098,2602,598,1602,80,267,279,613,359,880
411640,202308,568,1438,295,787,43,121,105,239,148,360
411650,202308,242,640,130,384,20,59,42,94,62,153
411660,202308,1049,2524,589,1561,103,293,223,485,326,778
411670,202308,1932,4235,1101,2681,127,325,591,1284,718,1609
411680,202308,1730,4191,1066,2861,228,638,398,959,626,1597
411690,202308,5056,11786,2957,7662,610,1581,1065,2494,1675,4075
411695,202308,801,2192,455,1301,33,99,213,562,246,661
411700,202308,2019,4851,1112,2963,252,673,305,685,557,1358
411705,202308,3114,7658,2301,6137,362,1005,1387,3605,1749,4610
411710,202308,2683,6261,1480,3801,315,839,525,1121,840,1960
411720,202308,1273,2971,688,1804,100,262,225,520,325,782
411721,202308,1224,2872,764,1970,156,393,215,516,371,909
411722,202308,1227,3235,572,1665,90,243,200,488,290,731
411725,202308,1580,4191,855,2621,224,770,169,416,393,1186
411727,202308,1788,4584,1016,2927,209,626,134,227,343,853
411729,202308,708,1722,332,945,84,285,85,166,169,451
411730,202308,7052,16902,4522,11743,1160,3281,1609,3811,2769,7092
411740,202308,585,1432,270,760,76,190,51,130,127,320
411745,202308,981,2587,518,1508,78,239,118,269,196,508
411750,202308,8572,20342,5094,13266,735,1994,2389,5707,3124,7701
411760,202308,9592,22495,6076,16148,1990,5429,1268,3341,3258,8770
411770,202308,3947,10487,2400,6835,537,1619,570,1396,1107,3015
411780,202308,3155,8309,2312,6695,630,1878,564,1684,1194,3562
411790,202308,4067,9069,2124,5343,315,860,843,1715,1158,2575
411800,202308,1458,3887,864,2369,171,525,262,601,433,1126
411810,202308,1928,4636,1124,2909,208,537,418,957,626,1494
411820,202308,22743,53266,17335,43144,4024,9977,8928,21149,12952,31126
411830,202308,565,1387,328,883,67,180,67,145,134,325
411840,202308,16462,39583,9227,24237,1522,4249,3693,8249,5215,12498
411845,202308,803,2115,390,1169,75,239,92,214,167,453
411850,202308,10248,24458,5574,15098,1572,4535,909,1802,2481,6337
411860,202308,951,2474,576,1633,155,420,112,287,267,707
411870,202308,738,1931,458,1297,132,422,97,191,229,613
411880,202308,3012,6578,1833,4470,358,897,788,1715,1146,2612
411885,202308,1283,3182,677,1877,106,322,183,426,289,748
411890,202308,1855,4610,1118,3109,229,658,150,388,379,1046
411900,202308,1070,2728,508,1502,174,520,36,113,210,633
411910,202308,1447,3913,893,2705,173,573,317,807,490,1380
411915,202308,21124,48099,12165,30242,1845,4965,5367,11305,7212,16270
411920,202308,1511,3875,1064,2965,271,812,397,959,668,1771
411925,202308,612,1480,368,993,98,260,142,343,240,603
411930,202308,6508,17422,4748,13785,2435,7218,529,1644,2964,8862
411940,202308,4154,10883,2785,7819,671,1885,965,2340,1636,4225
411950,202308,20468,49175,14569,37657,1844,5372,8460,19599,10304,24971
411960,202308,7442,17984,4868,12649,1049,2998,1954,4333,3003,7331
411965,202308,646,1634,362,1008,62,177,151,345,213,522
411970,202308,1457,2959,885,2010,166,297,399,1005,565,1302
411980,202308,2118,4550,1243,3044,299,702,419,977,718,1679
411990,202308,51640,123583,29608,80147,5726,16513,11862,28132,17588,44645
411995,202308,6568,14538,4422,10899,1321,3574,1271,2810,2592,6384
412000,202308,2512,5175,1529,3355,70,202,1144,2226,1214,2428
412010,202308,769,2117,378,1116,39,130,127,293,166,423
412015,202308,620,1604,446,1251,106,312,189,520,295,832
412020,202308,568,1527,294,943,45,157,83,219,128,376
412030,202308,781,2027,539,1544,105,276,237,626,342,902
412033,202308,1135,2762,576,1532,67,177,261,603,328,780
412035,202308,861,2200,445,1340,91,261,166,447,257,708
412040,202308,877,2168,414,1123,71,194,155,354,226,548
412050,202308,1781,4204,1033,2752,294,842,190,470,484,1312
412060,202308,9082,23471,6163,17208,1744,5463,1646,3842,3390,9305
412065,202308,755,1886,420,1164,78,234,120,277,198,511
412070,202308,1708,3945,1097,2714,118,330,561,1124,679,1454
412080,202308,3527,8313,2199,5497,269,714,1189,2507,1458,3221
412085,202308,415,993,127,387,21,72,34,87,55,159
412090,202308,8212,18708,5126,13084,1147,3219,2185,5252,3332,8471
412100,202308,2358,5769,1462,4109,431,1296,277,788,708,2084
412110,202308,1182,2924,596,1667,91,266,167,384,258,650
412120,202308,2937,7448,1963,5518,438,1340,585,1401,1023,2741
412125,202308,994,2603,465,1380,81,242,110,281,191,523
412130,202308,966,2258,499,1328,111,298,129,326,240,624
412135,202308,664,1674,283,812,34,123,131,311,165,434
412140,202308,2539,5764,1434,3622,268,711,335,793,603,1504
412150,202308,3421,8044,2434,6108,606,1578,1092,2371,1698,3949
412160,202308,1164,3395,431,1438,35,127,34,69,69,196
412170,202308,5844,14158,4331,11307,908,2502,2057,4751,2965,7253
412175,202308,1603,4261,1132,3241,257,745,347,956,604,1701
412180,202308,2101,5391,1255,3591,252,798,413,981,665,1779
412190,202308,3859,9247,2253,6054,335,1011,933,2212,1268,3223
412200,202308,2426,6357,1447,4117,404,1231,240,574,644,1805
412210,202308,797,1810,412,1089,64,175,185,433,249,608
412215,202308,4119,10087,2585,7094,523,1529,1092,2892,1615,4421
412217,202308,1254,2868,911,2216,25,73,698,1555,723,1628
412220,202308,7688,20569,4855,14245,1140,3305,1068,2904,2208,6209
412230,202308,3526,9278,2105,6051,373,1197,534,1276,907,2473
412240,202308,10358,25277,5374,14703,1021,3034,1706,3730,2727,6764
412250,202308,2352,5743,1400,3809,379,1075,220,476,599,1551
412260,202308,1686,3982,928,2304,176,440,341,728,517,1168
412265,202308,1307,3086,886,2305,114,329,523,1227,637,1556
412270,202308,1400,3576,772,2149,84,248,336,780,420,1028
412280,202308,520,1343,324,922,66,174,75,192,141,366
412290,202308,1321,3050,836,2131,152,403,346,793,498,1196
412300,202308,2334,5421,1417,3649,296,814,480,1052,776,1866
412310,202308,779,2131,445,1390,75,245,130,341,205,586
412320,202308,842,2044,468,1275,65,214,162,382,227,596
412330,202308,1995,4841,1117,3093,243,714,302,749,545,1463
412340,202308,1553,3879,881,2457,139,420,83,212,222,632
412350,202308,3832,9637,1954,5597,325,1021,588,1345,913,2366
412360,202308,369,861,232,594,12,40,153,351,165,391
412370,202308,1507,3669,800,2184,165,486,192,460,357,946
412380,202308,1785,4620,1048,3002,257,790,76,206,333,996
412382,202308,618,1435,358,936,39,127,184,393,223,520
412385,202308,2924,6943,1993,5134,626,1598,627,1634,1253,3232
412390,202308,3082,6996,1824,4644,403,1026,564,1316,967,2342
412395,202308,929,2301,551,1463,66,177,279,676,345,853
412400,202308,1172,2798,706,1867,117,337,255,546,372,883
412402,202308,3074,7034,1688,4409,380,977,573,1445,953,2422
412405,202308,3794,9608,2010,5915,603,1734,344,904,947,2638
412410,202308,8299,20078,4985,13791,984,3006,1672,4107,2656,7113
412420,202308,648,1536,325,853,42,130,122,280,164,410
412430,202308,638,1548,266,723,51,132,96,249,147,381
412440,202308,3727,8921,2171,5815,486,1312,711,1774,1197,3086
412450,202308,678,1835,355,1034,39,122,46,94,85,216
412460,202308,1465,3318,899,2230,195,516,386,875,581,1391
412470,202308,1987,5591,1494,4481,373,1212,434,1144,807,2356
412480,202308,1789,4081,956,2325,185,484,360,729,545,1213
412490,202308,1619,3675,1018,2516,78,226,598,1275,676,1501
412500,202308,2542,5935,1470,3781,267,727,482,1047,749,1774
412510,202308,2329,6488,1485,4472,374,1218,216,455,590,1673
412520,202308,1713,4088,836,2267,155,418,95,227,250,645
412530,202308,847,2141,457,1292,104,277,108,280,212,557
412535,202308,971,2426,470,1335,88,269,67,127,155,396
412540,202308,1243,3116,758,2172,160,572,137,307,297,879
412545,202308,906,2192,470,1296,84,250,157,393,241,643
412550,202308,49099,118188,29276,75716,4208,11998,13992,31161,18200,43159
412555,202308,357,853,168,429,19,55,64,119,83,174
412560,202308,6909,17639,4204,11518,1169,3509,702,1543,1871,5052
412570,202308,5342,12329,2789,7380,569,1737,732,1590,1301,3327
412575,202308,1437,3233,958,2325,282,670,397,824,679,1494
412580,202308,1982,4540,1115,2805,128,315,626,1407,754,1722
412590,202308,559,1386,252,714,55,152,33,63,88,215
412600,202308,2151,4939,1493,3617,97,302,992,2119,1089,2421
412610,202308,1024,2572,572,1540,96,254,230,509,326,763
412620,202308,1651,3880,1127,2916,224,621,518,1175,742,1796
412625,202308,12939,31909,7200,19874,1478,4351,1627,3708,3105,8059
412627,202308,1364,3556,767,2253,178,545,178,449,356,994
412630,202308,3328,9083,1846,5567,348,1142,419,1063,767,2205
412635,202308,613,1480,307,833,83,224,51,106,134,330
412640,202308,1190,3024,566,1610,80,244,117,249,197,493
412650,202308,2108,5278,1339,3604,246,731,504,1165,750,1896
412660,202308,3614,8370,2167,5448,276,769,878,1880,1154,2649
412665,202308,531,1223,339,866,76,192,124,283,200,475
412667,202308,2066,5137,1272,3493,234,721,499,1244,733,1965
412670,202308,1154,2455,657,1555,111,318,311,616,422,934
412680,202308,2701,6585,1403,3841,205,661,448,959,653,1620
412690,202308,1414,3357,808,2098,160,457,285,589,445,1046
412700,202308,2179,5352,1528,4013,357,1016,672,1603,1029,2619
412710,202308,6715,17758,4031,11579,744,2306,1150,2587,1894,4893
412720,202308,1673,4459,1104,3106,194,565,303,649,497,1214
412730,202308,3424,8128,2093,5351,327,956,1068,2362,1395,3318
412740,202308,2524,6528,1385,4085,256,853,265,714,521,1567
412750,202308,4901,12038,3355,9050,502,1485,1734,4198,2236,5683
412760,202308,4015,9667,2841,7414,560,1619,1425,3326,1985,4945
412770,202308,15922,38909,7173,20600,1022,3181,1878,4329,2900,7510
412780,202308,1561,3746,967,2583,249,759,283,593,532,1352
412785,202308,2756,5891,1693,4077,279,783,989,2135,1268,2918
412788,202308,1733,4485,1213,3452,344,973,424,1084,768,2057
412790,202308,1717,4148,900,2446,145,438,371,796,516,1234
412795,202308,1473,3572,675,1954,130,328,160,474,290,802
412796,202308,2739,7296,1897,5473,460,1312,528,1366,988,2678
412800,202308,5346,11493,3210,7417,312,917,1847,3618,2159,4535
412810,202308,17418,40743,9500,24333,1139,3245,4515,9827,5654,13072
412820,202308,7890,20109,4675,13224,1238,3605,1087,2848,2325,6453
412830,202308,447,1162,250,702,41,118,93,211,134,329
412840,202308,2514,5253,1616,3548,143,379,1070,2036,1213,2415
412850,202308,3408,8145,2285,6086,276,871,1223,2855,1499,3726
412853,202308,2023,4458,1450,3296,187,496,858,1710,1045,2206
412855,202308,1668,4040,704,1935,111,332,169,354,280,686
412860,202308,978,2286,548,1476,111,345,220,504,331,849
412862,202308,799,1944,468,1305,80,234,215,529,295,763
412863,202308,1632,4324,1265,3540,267,843,614,1473,881,2316
412865,202308,791,2046,512,1445,126,385,98,243,224,628
412870,202308,1227,2936,731,2022,239,705,171,430,410,1135
412880,202308,1198,3040,734,2117,154,435,250,651,404,1086
420005,202308,571,1563,279,850,29,95,127,352,156,447
420010,202308,3719,8519,2189,5757,151,447,1492,3741,1643,4188
420020,202308,518,1526,342,1076,64,221,100,249,164,470
420030,202308,175,576,109,396,33,125,23,66,56,191
420040,202308,721,2084,332,1117,52,191,26,59,78,250
420050,202308,982,2318,538,1366,100,276,282,602,382,878
420055,202308,234,643,105,313,16,49,43,108,59,157
420060,202308,299,790,212,590,31,95,105,256,136,351
420070,202308,1120,3041,784,2327,145,474,414,1116,559,1590
420075,202308,95,251,50,143,8,26,16,28,24,54
420080,202308,530,1455,300,864,66,197,76,183,142,380
420090,202308,574,1644,317,1025,72,250,75,185,147,435
420100,202308,1847,4176,1289,3159,150,359,754,1759,904,2118
420110,202308,385,1124,281,873,43,132,129,375,172,507
420120,202308,840,2200,462,1342,73,234,187,441,260,675
420125,202308,481,1374,282,898,59,182,77,192,136,374
420127,202308,392,1021,135,424,11,36,51,140,62,176
420130,202308,6792,17564,4370,12551,865,2756,1683,3947,2548,6703
420140,202308,6375,15737,4139,11330,1092,3289,1110,2536,2202,5825
420150,202308,878,2178,523,1445,61,199,259,633,320,832
420160,202308,262,634,90,258,12,39,31,88,43,127
420165,202308,223,658,96,317,12,49,26,70,38,119
420170,202308,450,1241,321,956,37,133,182,466,219,599
420180,202308,180,554,83,297,13,56,21,67,34,123
420190,202308,261,726,127,394,21,68,34,86,55,154
420195,202308,2746,6628,1843,4904,295,896,994,2353,1289,3249
420200,202308,11100,24513,6055,14697,803,2176,2754,5445,3557,7621
420205,202308,2844,6939,1660,4535,249,737,815,1971,1064,2708
420207,202308,3045,7218,1784,4804,363,1063,703,1628,1066,2691
420208,202308,458,1237,219,690,78,258,50,114,128,372
420209,202308,230,675,117,366,20,75,59,161,79,236
420210,202308,6254,14934,3918,10462,639,1863,1933,4593,2572,6456
420213,202308,993,2735,699,2065,131,416,260,691,391,1107
420215,202308,312,841,180,526,49,156,44,112,93,268
420220,202308,457,1286,249,797,48,184,94,233,142,417
420230,202308,8553,20709,5607,14659,808,2313,2994,6870,3802,9183
420240,202308,21552,55827,11753,32437,1667,5091,5092,11288,6759,16379
420243,202308,658,1527,476,1188,86,238,282,666,368,904
420245,202308,2858,6663,1938,4925,183,511,1175,2667,1358,3178
420250,202308,896,1946,673,1563,56,168,472,980,528,1148
420253,202308,571,1340,344,920,52,131,195,489,247,620
420257,202308,215,525,126,361,17,63,65,169,82,232
420260,202308,1608,3748,1051,2849,81,257,697,1768,778,2025
420270,202308,797,2008,308,825,42,106,140,339,182,445
420280,202308,2155,5627,1427,3964,213,684,632,1516,845,2200
420285,202308,155,426,93,291,17,59,15,26,32,85
420287,202308,578,1270,324,830,53,159,143,322,196,481
420290,202308,7534,19594,4820,13306,747,2314,2455,5787,3202,8101
420300,202308,10671,28091,5032,14521,990,2952,1665,4048,2655,7000
420310,202308,946,2096,483,1235,50,135,203,451,253,586
420315,202308,1199,3089,635,1898,95,302,302,801,397,1103
420320,202308,8807,22137,5727,16353,1552,4544,1537,4007,3089,8551
420325,202308,419,1148,245,749,38,133,80,192,118,325
420330,202308,1438,3952,756,2313,169,529,198,524,367,1053
420340,202308,1760,4044,1133,2833,258,685,513,1101,771,1786
420350,202308,1815,3973,1235,2932,168,400,803,1788,971,2188
420360,202308,3841,10093,1709,5210,281,930,161,425,442,1355
420370,202308,1905,4458,1428,3596,105,341,1047,2425,1152,2766
420380,202308,5911,14509,3586,9743,658,1966,1605,3800,2263,5766
420390,202308,1480,3622,845,2237,145,415,285,535,430,950
420395,202308,1778,4624,1017,2951,161,484,214,480,375,964
420400,202308,1580,3908,911,2499,117,358,506,1234,623,1592
420410,202308,751,1868,435,1194,70,213,214,541,284,754
420415,202308,454,1203,279,787,49,162,124,314,173,476
420417,202308,800,2225,510,1544,112,322,210,632,322,954
420419,202308,151,485,94,326,27,103,5,22,32,125
420420,202308,20786,51092,12095,33282,3125,9322,3452,7950,6577,17272
420425,202308,826,2171,482,1379,61,194,222,547,283,741
420430,202308,4535,11353,2411,6701,375,1178,1006,2294,1381,3472
420435,202308,462,1164,230,692,53,160,115,330,168,490
420440,202308,1082,2708,597,1637,212,539,158,425,370,964
420445,202308,289,682,160,425,31,88,44,82,75,170
420450,202308,1159,3136,696,2030,141,423,284,688,425,1111
420455,202308,2753,6136,1731,4338,517,1262,581,1461,1098,2723
420460,202308,13733,33454,8964,23805,1350,4014,4594,10514,5944,14528
420470,202308,894,2262,417,1138,68,199,137,281,205,480
420475,202308,91,234,33,104,6,23,10,26,16,49
420480,202308,7403,17360,4093,11001,810,2257,1629,4049,2439,6306
420490,202308,509,1360,287,827,46,136,130,332,176,468
420500,202308,1771,4578,1033,3096,201,710,447,1162,648,1872
420510,202308,160,464,89,271,15,54,30,64,45,118
420515,202308,183,526,100,306,14,55,37,83,51,138
420517,202308,936,2196,663,1625,101,264,377,862,478,1126
420519,202308,375,964,216,636,28,89,103,295,131,384
420520,202308,352,917,153,494,16,66,4,8,20,74
420530,202308,966,2823,492,1577,100,358,155,393,255,751
420535,202308,282,790,84,276,12,42,24,61,36,103
420540,202308,56943,127121,33507,82380,4569,12688,14530,29154,19099,41842
420543,202308,321,874,187,552,31,104,73,184,104,288
420545,202308,2161,6062,1372,4109,252,796,566,1427,818,2223
420550,202308,5747,13822,2970,8181,525,1512,1192,2849,1717,4361
420555,202308,429,1160,245,740,32,108,123,329,155,437
420560,202308,555,1197,333,825,43,94,169,414,212,508
420570,202308,4341,10219,2855,7307,512,1365,1422,3300,1934,4665
420580,202308,2314,6190,1306,4070,291,955,348,923,639,1878
420590,202308,4370,11190,2464,6887,426,1291,724,1595,1150,2886
420600,202308,1906,4757,1311,3497,112,384,871,2110,983,2494
420610,202308,801,2054,452,1296,83,227,218,572,301,799
420620,202308,1104,2708,608,1722,104,308,229,583,333,891
420630,202308,1473,4176,943,2850,172,560,370,978,542,1538
420640,202308,606,1613,240,773,45,148,16,39,61,187
420650,202308,4860,11835,2793,7348,453,1321,1214,2636,1667,3957
420660,202308,585,1424,269,730,54,154,42,74,96,228
420665,202308,929,2263,482,1319,90,252,173,365,263,617
420670,202308,1563,4298,754,2391,88,337,142,327,230,664
420675,202308,279,692,156,465,14,49,94,248,108,297
420680,202308,352,806,166,483,25,93,85,209,110,302
420690,202308,1265,3431,693,2031,114,347,247,569,361,916
420700,202308,4400,10820,2965,7946,262,798,1929,4767,2191,5565
420710,202308,1452,3957,1105,3163,156,502,574,1365,730,1867
420720,202308,1768,4399,1196,3245,187,570,696,1697,883,2267
420730,202308,5047,12233,3443,9102,644,1878,1549,3570,2193,5448
420740,202308,536,1479,274,844,61,198,86,246,147,444
420750,202308,3038,8278,1713,5058,304,997,560,1341,864,2338
420757,202308,157,399,68,217,7,23,26,75,33,98
420760,202308,476,1317,186,558,42,123,60,156,102,279
420765,202308,804,2119,334,989,55,184,154,411,209,595
420768,202308,1841,4611,1315,3554,168,424,818,2125,986,2549
420770,202308,283,828,107,382,16,67,14,30,30,97
420775,202308,385,988,198,603,36,100,66,185,102,285
420780,202308,1301,3437,621,1796,132,386,107,267,239,653
420785,202308,287,706,160,414,7,24,80,162,87,186
420790,202308,1451,3857,1023,2898,232,827,546,1269,778,2096
420800,202308,1006,2317,522,1390,126,343,244,587,370,930
420810,202308,1821,5063,1353,4040,318,1050,527,1301,845,2351
420820,202308,19402,46300,12174,32459,1698,4905,6007,13991,7705,18896
420830,202308,6983,16909,4295,11654,879,2645,1682,4042,2561,6687
420840,202308,781,2344,331,1153,56,226,35,96,91,322
420845,202308,4120,9928,2520,6931,481,1537,1061,2628,1542,4165
420850,202308,1321,3789,865,2629,166,544,274,651,440,1195
420860,202308,468,1205,248,763,82,266,58,136,140,402
420870,202308,1022,2715,599,1775,116,373,203,523,319,896
420880,202308,1614,4484,1103,3340,255,863,426,1077,681,1940
420890,202308,10557,27187,5663,16358,972,2997,1962,4651,2934,7648
420895,202308,252,697,122,365,16,46,58,154,74,200
420900,202308,2291,5352,1091,3024,140,455,454,996,594,1451
420910,202308,47876,118453,28323,77887,4748,14259,12257,28305,17005,42564
420915,202308,583,2015,447,1666,71,270,204,725,275,995
420917,202308,616,1506,234,606,40,86,116,281,156,367
420920,202308,119,308,33,102,5,18,6,13,11,31
420930,202308,24971,57729,15761,40030,2200,6232,8483,18906,10683,25138
420940,202308,5101,11749,2936,7671,644,1941,968,1902,1612,3843
420945,202308,267,794,114,356,15,54,39,101,54,155
420950,202308,547,1446,304,890,55,181,98,241,153,422
420960,202308,1414,3313,810,2092,134,388,347,749,481,1137
420970,202308,2893,7343,1713,4986,372,1090,478,1363,850,2453
420980,202308,312,1025,228,815,65,249,28,87,93,336
420985,202308,478,1255,200,634,33,100,48,128,81,228
420990,202308,489,1412,265,847,49,164,49,120,98,284
421000,202308,750,2189,433,1392,115,363,63,137,178,500
421003,202308,538,1296,120,346,15,46,10,22,25,68
421005,202308,135,382,80,247,13,43,24,67,37,110
421010,202308,5180,12659,3255,8810,521,1632,1362,2937,1883,4569
421020,202308,522,1543,348,1118,54,203,180,490,234,693
421030,202308,1365,3576,923,2623,181,553,342,856,523,1409
421040,202308,874,2078,433,1233,47,144,237,610,284,754
421050,202308,1610,4213,844,2368,174,505,244,537,418,1042
421055,202308,180,511,95,289,16,54,43,114,59,168
421060,202308,959,2589,601,1774,101,335,254,622,355,957
421070,202308,868,2370,457,1365,86,261,202,524,288,785
421080,202308,654,1759,430,1261,70,246,175,427,245,673
421085,202308,394,1092,120,406,13,40,18,48,31,88
421090,202308,381,959,175,461,20,71,81,175,101,246
421100,202308,1110,2351,424,1158,51,147,86,179,137,326
421105,202308,2024,5047,1125,3153,244,669,355,885,599,1554
421110,202308,1705,4020,1192,3075,135,421,750,1769,885,2190
421120,202308,1478,4163,879,2722,130,448,293,731,423,1179
421125,202308,523,1266,325,831,64,177,129,281,193,458
421130,202308,9155,23823,6676,18470,1236,3697,3140,7675,4376,11372
421140,202308,441,1155,244,713,53,137,88,235,141,372
421145,202308,445,1189,283,815,96,278,53,132,149,410
421150,202308,1034,2724,603,1720,118,379,236,503,354,882
421160,202308,896,2293,592,1603,69,228,337,768,406,996
421165,202308,302,838,143,415,24,68,45,95,69,163
421170,202308,1592,3915,1117,2955,101,297,703,1714,804,2011
421175,202308,1449,3583,752,2199,178,558,289,759,467,1317
421180,202308,514,1236,248,673,31,99,118,246,149,345
421185,202308,405,989,251,667,40,119,108,229,148,348
421187,202308,308,921,127,408,25,73,51,154,76,227
421189,202308,546,1427,328,964,55,180,117,305,172,485
421190,202308,20644,51248,13560,36261,2390,6990,6234,14460,8624,21450
421200,202308,1073,2677,671,1822,83,262,367,898,450,1160
421205,202308,325,834,204,583,42,116,81,229,123,345
421210,202308,1406,3411,666,1961,201,574,153,408,354,982
421220,202308,1795,4837,1234,3613,298,904,366,928,664,1832
421223,202308,550,1307,315,838,53,160,148,345,201,505
421225,202308,1468,3824,1106,3123,111,378,707,1846,818,2224
421227,202308,910,2416,472,1422,98,305,176,497,274,802
421230,202308,855,2168,535,1516,97,306,228,584,325,890
421240,202308,355,1007,139,474,23,99,33,82,56,181
421250,202308,3567,8524,2297,6147,369,1014,1282,3171,1651,4185
421260,202308,339,1046,66,186,14,40,10,26,24,66
421265,202308,1312,2915,940,2287,109,251,599,1367,708,1618
421270,202308,486,1261,223,726,56,191,73,219,129,410
421280,202308,3726,8994,2465,6613,389,1247,1262,2933,1651,4180
421290,202308,1447,3774,557,1597,89,271,91,221,180,492
421300,202308,425,1114,136,420,17,45,26,62,43,107
421310,202308,314,837,197,571,66,198,52,128,118,326
421315,202308,429,1109,217,633,43,136,64,157,107,293
421320,202308,809,2449,334,1057,31,93,52,82,83,175
421330,202308,796,2200,433,1341,87,273,108,289,195,562
421335,202308,541,1535,368,1162,50,173,162,464,212,637
421340,202308,1840,4893,997,3139,170,555,399,1097,569,1652
421350,202308,2320,5480,1284,3507,272,737,409,1001,681,1738
421360,202308,2744,6952,1467,4279,378,1278,401,774,779,2052
421370,202308,968,2972,532,1796,88,310,115,323,203,633
421380,202308,1107,2564,806,2014,75,255,517,1146,592,1401
421390,202308,201,528,70,232,16,49,19,60,35,109
421400,202308,864,2185,463,1324,89,281,180,418,269,699
421410,202308,244,627,116,354,30,81,20,64,50,145
421415,202308,256,677,157,428,30,86,52,127,82,213
421420,202308,793,2048,453,1266,71,206,211,489,282,695
421430,202308,153,426,73,224,12,38,11,21,23,59
421440,202308,956,2440,476,1414,103,316,174,462,277,778
421450,202308,504,1524,292,984,47,177,18,71,65,248
421460,202308,389,1184,180,650,10,30,11,23,21,53
421470,202308,490,1326,258,798,45,124,74,228,119,352
421480,202308,4430,11214,2720,7443,384,1233,1231,2837,1615,4070
421490,202308,155,467,80,254,10,49,29,75,39,124
421500,202308,3327,8841,1978,5806,385,1215,721,1679,1106,2894
421505,202308,419,1039,304,844,27,78,153,393,180,471
421507,202308,553,1376,275,747,50,130,86,195,136,325
421510,202308,616,1628,332,972,48,165,160,355,208,520
421520,202308,580,1492,280,768,45,121,92,200,137,321
421530,202308,422,1226,209,724,34,140,40,87,74,227
421535,202308,569,1423,298,830,45,127,154,366,199,493
421540,202308,478,1090,221,612,30,81,76,200,106,281
421545,202308,886,2468,566,1738,111,353,208,532,319,885
421550,202308,2912,7328,1875,5207,353,1064,820,2029,1173,3093
421555,202308,284,787,62,201,13,52,6,9,19,61
421560,202308,129,404,75,252,12,42,20,50,32,92
421565,202308,1358,3341,839,2347,221,671,356,882,577,1553
421567,202308,581,1675,389,1166,100,304,109,319,209,623
421568,202308,398,1111,160,510,33,123,48,116,81,239
421569,202308,189,517,69,199,14,46,32,72,46,118
421570,202308,2176,5746,1336,3787,223,701,550,1269,773,1970
421575,202308,414,1197,220,647,26,77,77,190,103,267
421580,202308,6940,17601,3568,9925,544,1664,1468,3316,2012,4980
421590,202308,256,676,181,513,42,126,71,171,113,297
421600,202308,808,1981,428,1129,50,143,210,453,260,596
421605,202308,893,2216,552,1557,125,355,202,515,327,870
421610,202308,1301,3238,726,2029,145,439,277,706,422,1145
421620,202308,5195,12737,3359,9213,711,2208,1370,3197,2081,5405
421625,202308,162,448,81,232,10,28,26,53,36,81
421630,202308,3847,9626,2050,5776,343,1036,571,1280,914,2316
421635,202308,582,1473,348,958,31,99,200,471,231,570
421640,202308,974,2368,681,1876,177,497,324,826,501,1323
421650,202308,3712,9158,2220,6239,425,1315,748,1830,1173,3145
421660,202308,17670,44578,11510,31714,1646,5134,5838,13969,7484,19103
421670,202308,1191,3156,681,1896,146,444,270,646,416,1090
421680,202308,2353,4866,1732,3791,155,398,1243,2476,1398,2874
421690,202308,1950,5435,1115,3482,231,773,242,606,473,1379
421700,202308,795,2283,402,1279,62,211,90,216,152,427
421710,202308,270,811,122,392,20,72,49,139,69,211
421715,202308,216,515,143,341,23,69,81,151,104,220
421720,202308,2759,7186,1396,4055,315,955,408,924,723,1879
421725,202308,367,875,164,446,21,61,77,166,98,227
421730,202308,740,2074,345,991,47,138,158,380,205,518
421740,202308,1127,2965,597,1738,136,395,195,458,331,853
421750,202308,1272,2958,609,1669,142,427,202,466,344,893
421755,202308,204,546,79,235,17,54,26,63,43,117
421760,202308,1465,3530,747,2045,126,376,282,640,408,1016
421770,202308,3260,7964,1959,5434,344,1022,727,1723,1071,2745
421775,202308,261,689,118,360,14,42,32,69,46,111
421780,202308,1274,3313,763,2169,126,375,319,754,445,1129
421790,202308,1186,3037,470,1413,90,259,144,356,234,615
421795,202308,322,934,146,455,19,69,46,127,65,196
421800,202308,4040,10471,2543,7346,468,1429,944,2376,1412,3805
421810,202308,734,1936,391,1168,51,183,174,476,225,659
421820,202308,1520,4099,775,2222,137,431,262,608,399,1039
421825,202308,2114,4676,1556,3740,118,310,1061,2404,1179,2714
421830,202308,2558,7036,1621,4944,345,1108,375,1086,720,2194
421835,202308,330,766,202,506,28,81,128,299,156,380
421840,202308,500,1507,328,1044,59,208,100,261,159,469
421850,202308,508,1443,241,826,49,165,29,73,78,238
421860,202308,292,750,130,400,19,67,43,93,62,160
421870,202308,7750,17998,4918,12110,693,2006,2708,5546,3401,7552
421875,202308,391,1142,125,398,17,46,19,51,36,97
421880,202308,913,2417,473,1381,93,243,113,284,206,527
421885,202308,377,1033,168,524,25,90,42,109,67,199
421890,202308,1408,3552,948,2646,119,391,567,1384,686,1775
421895,202308,544,1326,388,1044,50,138,247,661,297,799
421900,202308,1473,3658,818,2122,136,398,362,759,498,1157
421910,202308,439,1270,177,618,29,100,27,75,56,175
421915,202308,475,1271,234,695,61,182,50,113,111,295
421917,202308,804,1767,365,1003,92,259,78,193,170,452
421920,202308,541,1530,322,1004,83,253,82,237,165,490
421930,202308,4420,10512,2132,5860,410,1192,651,1450,1061,2642
421935,202308,511,1460,365,1152,82,260,140,419,222,679
421940,202308,434,1212,159,467,29,90,58,145,87,235
421950,202308,4226,10466,2149,6112,398,1192,600,1396,998,2588
421960,202308,189,466,91,263,13,33,36,102,49,135
421970,202308,2770,6864,1371,3755,256,747,537,1212,793,1959
421985,202308,406,1081,228,659,25,81,106,280,131,361
422000,202308,2657,6268,1742,4640,143,447,1131,2821,1274,3268
430003,202308,872,2096,517,1440,68,191,273,725,341,916
430005,202308,478,1115,326,833,19,61,217,496,236,557
430010,202308,2307,4888,1509,3571,315,704,689,1591,1004,2295
430020,202308,693,1489,454,1092,59,156,255,534,314,690
430030,202308,1256,2719,676,1594,103,269,405,825,508,1094
430040,202308,12421,27035,6886,17303,1932,5117,1971,4353,3903,9470
430045,202308,688,1491,432,1051,29,75,294,645,323,720
430047,202308,296,655,89,223,17,36,32,76,49,112
430050,202308,1063,2519,504,1378,109,269,149,373,258,642
430055,202308,311,698,126,321,17,40,60,135,77,175
430057,202308,117,263,44,119,11,24,12,29,23,53
430060,202308,29362,68637,20823,53465,3630,9862,11041,26164,14671,36026
430063,202308,833,2157,650,1798,142,391,357,945,499,1336
430064,202308,1427,3538,930,2576,228,679,398,1016,626,1695
430066,202308,123,282,79,207,8,21,51,117,59,138
430070,202308,669,1685,140,409,24,78,22,51,46,129
430080,202308,1195,2881,541,1474,96,302,230,501,326,803
430085,202308,1150,2291,617,1445,113,266,254,589,367,855
430087,202308,1164,2740,690,1841,84,245,352,867,436,1112
430090,202308,561,1406,198,615,47,153,38,108,85,261
430100,202308,1466,3291,632,1576,80,219,297,650,377,869
430105,202308,1996,4553,1254,3234,175,526,686,1574,861,2100
430107,202308,210,554,94,269,14,40,28,67,42,107
430110,202308,2733,6229,1787,4522,353,943,904,2117,1257,3060
430120,202308,1494,3861,932,2494,158,412,422,1058,580,1470
430130,202308,4362,8976,2825,6608,1084,2477,545,1477,1629,3954
430140,202308,1305,3085,809,2125,137,380,385,951,522,1331
430150,202308,704,1732,337,997,75,230,86,228,161,458
430155,202308,264,616,90,242,13,34,26,49,39,83
430160,202308,28278,57025,19672,43475,1551,3899,14024,28855,15575,32754
430163,202308,4477,8836,2815,6330,72,253,2235,4646,2307,4899
430165,202308,416,1045,107,323,16,38,9,23,25,61
430170,202308,1153,2821,308,967,82,303,52,106,134,409
430175,202308,1054,2393,833,1966,118,279,515,1181,633,1460
430180,202308,825,1933,485,1262,109,256,187,485,296,741
430185,202308,792,1916,303,874,77,214,58,142,135,356
430187,202308,1092,2128,695,1589,74,168,465,1015,539,1183
430190,202308,1877,4267,1252,3172,270,686,558,1291,828,1977
430192,202308,133,335,40,111,8,22,12,28,20,50
430195,202308,531,1443,68,202,7,17,14,29,21,46
430200,202308,1391,3588,978,2756,265,795,170,480,435,1275
430205,202308,710,1364,578,1153,20,55,493,938,513,993
430210,202308,9485,22731,4481,11680,637,1787,1366,2779,2003,4566
430215,202308,461,1030,240,604,27,87,112,237,139,324
430220,202308,708,1681,241,707,49,146,82,188,131,334
430222,202308,314,779,169,469,36,102,60,145,96,247
430223,202308,359,862,237,630,29,72,134,322,163,394
430225,202308,42,92,27,64,3,6,16,33,19,39
430230,202308,2783,6392,1995,5035,154,449,1415,3299,1569,3748
430235,202308,593,1487,306,863,51,159,73,158,124,317
430237,202308,672,1354,406,904,23,67,289,581,312,648
430240,202308,1682,3737,700,1823,108,299,288,613,396,912
430245,202308,902,2178,674,1760,140,345,347,931,487,1276
430250,202308,1348,3024,809,2050,246,653,226,515,472,1168
430258,202308,157,389,86,235,13,32,44,113,57,145
430260,202308,891,2050,504,1306,68,196,273,662,341,858
430265,202308,296,807,184,587,32,104,67,198,99,302
430270,202308,4240,8779,2944,6606,524,1150,1815,3869,2339,5019
430280,202308,6498,13405,4057,9168,682,1631,2154,4505,2836,6136
430290,202308,2797,5636,2038,4571,194,442,1498,3190,1692,3632
430300,202308,13928,30090,9267,21607,1393,3399,5433,11650,6826,15049
430310,202308,18753,42360,11467,28180,1469,3822,6711,15049,8180,18871
430320,202308,1108,2640,555,1546,51,147,309,807,360,954
430330,202308,781,1789,378,979,88,227,130,284,218,511
430340,202308,868,1752,517,1177,68,153,349,750,417,903
430350,202308,11235,24842,7511,18064,1094,2804,4451,9890,5545,12694
430355,202308,418,1107,110,332,31,89,11,22,42,111
430360,202308,1119,2545,575,1554,152,444,151,346,303,790
430367,202308,441,900,244,568,35,95,155,318,190,413
430370,202308,562,1474,175,511,44,119,50,119,94,238
430380,202308,763,1788,309,885,58,171,98,249,156,420
430390,202308,4523,10318,2374,6062,460,1237,300,532,760,1769
430400,202308,1296,2499,813,1753,111,295,493,946,604,1241
430410,202308,709,1482,478,1105,43,118,334,709,377,827
430420,202308,3738,8524,2583,6238,375,1096,1472,3013,1847,4109
430430,202308,589,1411,208,603,42,126,29,78,71,204
430435,202308,2426,5398,1498,3700,253,647,735,1726,988,2373
430440,202308,6413,14594,4293,10461,441,1182,2695,5915,3136,7097
430450,202308,10196,21249,7468,16507,1191,3025,4397,8726,5588,11751
430460,202308,54160,119832,33607,83110,5224,13737,17765,40630,22989,54367
430461,202308,231,584,76,225,14,47,35,89,49,136
430462,202308,387,937,174,490,34,104,59,152,93,256
430463,202308,9695,22996,6430,16730,1187,3456,3154,7435,4341,10891
430465,202308,708,1572,420,1025,66,186,236,531,302,717
430466,202308,6370,14060,4462,10813,700,1801,2640,5783,3340,7584
430467,202308,638,1440,388,967,43,121,229,531,272,652
430468,202308,1930,4182,1332,3168,72,214,951,2065,1023,2279
430469,202308,724,1909,106,298,10,26,38,84,48,110
430470,202308,7398,17500,4146,11256,1047,3156,964,2098,2011,5254
430471,202308,1052,2416,808,1959,80,211,550,1202,630,1413
430480,202308,808,2078,422,1189,65,210,134,277,199,487
430485,202308,210,512,86,228,19,44,25,52,44,96
430490,202308,610,1442,258,704,38,123,109,225,147,348
430495,202308,492,1255,272,814,47,143,129,352,176,495
430500,202308,1183,2777,715,1918,228,665,208,463,436,1128
430510,202308,35883,86371,21950,56857,4316,12148,9156,20176,13472,32324
430511,202308,394,1035,118,359,26,74,20,40,46,114
430512,202308,1284,2628,911,2055,216,512,366,769,582,1281
430513,202308,967,2129,441,1071,61,159,251,522,312,681
430515,202308,485,1179,281,759,49,129,132,344,181,473
430517,202308,1779,4414,1226,3235,268,664,630,1632,898,2296
430520,202308,1611,3809,788,2041,147,398,199,460,346,858
430530,202308,1098,2573,388,1085,74,222,127,317,201,539
430535,202308,4606,10580,2766,7028,399,1056,1386,3233,1785,4289
430537,202308,691,1505,548,1242,76,161,381,821,457,982
430540,202308,711,1630,367,997,63,171,163,424,226,595
430543,202308,1353,2301,714,1506,188,403,167,368,355,771
430544,202308,835,2192,494,1435,116,364,140,366,256,730
430545,202308,3130,7240,2088,5519,413,1112,1040,2562,1453,3674
430550,202308,488,1217,272,744,84,207,77,203,161,410
430558,202308,190,415,65,158,1,1,42,96,43,97
430560,202308,355,803,142,412,17,64,45,100,62,164
430570,202308,1019,2295,551,1329,128,362,245,465,373,827
430580,202308,953,2284,666,1788,175,445,210,602,385,1047
430583,202308,211,514,35,90,6,25,11,14,17,39
430585,202308,253,604,111,294,23,70,39,82,62,152
430587,202308,249,636,133,377,22,70,57,145,79,215
430590,202308,1657,3700,1082,2694,122,311,640,1499,762,1810
430593,202308,38,100,23,61,2,7,13,27,15,34
430595,202308,513,1276,96,294,13,29,20,47,33,76
430597,202308,558,1321,186,492,17,43,67,136,84,179
430600,202308,2339,5800,846,2383,152,444,151,388,303,832
430605,202308,1711,3962,1058,2739,156,417,528,1265,684,1682
430607,202308,850,1781,469,1085,61,126,285,627,346,753
430610,202308,7580,16379,4879,12039,1398,3752,1859,4000,3257,7752
430613,202308,303,684,66,179,15,41,16,37,31,78
430620,202308,1051,2290,657,1550,113,296,319,598,432,894
430630,202308,486,1287,153,437,30,92,40,95,70,187
430632,202308,511,1269,155,448,23,66,57,143,80,209
430635,202308,695,1441,438,971,70,138,277,600,347,738
430637,202308,647,1418,415,1018,50,137,261,579,311,716
430640,202308,1365,3537,668,1957,88,259,220,512,308,771
430642,202308,464,1204,218,622,35,99,87,220,122,319
430645,202308,195,446,81,219,16,38,21,44,37,82
430650,202308,2243,5492,1562,4342,459,1211,578,1731,1037,2942
430655,202308,403,924,191,482,23,65,110,232,133,297
430660,202308,6746,15164,4425,11037,736,2040,2323,5286,3059,7326
430670,202308,714,1604,406,1015,78,194,186,434,264,628
430673,202308,596,1283,234,626,57,144,78,179,135,323
430675,202308,286,805,55,186,11,38,12,40,23,78
430676,202308,7701,17198,5448,13355,896,2303,3157,7323,4053,9626
430680,202308,1553,3697,806,2182,235,694,250,465,485,1159
430690,202308,4253,9688,3008,7388,986,2536,1117,2557,2103,5093
430692,202308,237,641,170,525,9,31,113,333,122,364
430693,202308,1123,2801,560,1629,135,403,132,344,267,747
430695,202308,490,1143,263,651,49,138,151,324,200,462
430697,202308,662,1477,436,1101,52,148,283,673,335,821
430700,202308,10485,23997,5439,14022,1233,3410,1425,2956,2658,6366
430705,202308,420,959,175,495,23,72,69,161,92,233
430710,202308,2569,4373,1574,3069,64,186,1290,2331,1354,2517
430720,202308,935,2129,434,1205,62,186,215,538,277,724
430730,202308,1145,2883,655,1857,127,361,248,642,375,1003
430740,202308,855,2154,374,1072,56,159,129,337,185,496
430745,202308,629,1369,409,943,57,177,267,514,324,691
430750,202308,2144,4862,1269,3211,264,685,634,1449,898,2134
430755,202308,572,1298,328,796,35,106,200,420,235,526
430760,202308,3342,7526,2170,5364,456,1151,1015,2263,1471,3414
430770,202308,10021,21971,7001,16690,879,2238,4307,9500,5186,11738
430780,202308,2824,6488,1634,4287,194,574,909,2117,1103,2691
430781,202308,847,1978,487,1197,155,399,184,392,339,791
430783,202308,432,936,253,636,62,158,120,269,182,427
430786,202308,45,136,24,88,4,13,3,5,7,18
430790,202308,6218,13916,3737,9146,414,1183,2198,4610,2612,5793
430800,202308,1095,2107,726,1547,48,125,552,1088,600,1213
430805,202308,478,1045,302,693,13,31,230,487,243,518
430807,202308,749,1725,370,990,58,162,143,307,201,469
430810,202308,890,2052,378,1001,64,187,147,317,211,504
430820,202308,1756,4533,816,2347,137,397,254,601,391,998
430825,202308,322,721,112,251,14,30,52,102,66,132
430830,202308,2601,5708,1863,4301,113,264,1391,2984,1504,3248
430840,202308,1577,3331,928,2232,159,379,559,1304,718,1683
430843,202308,241,562,92,257,8,19,27,63,35,82
430845,202308,643,1351,361,857,57,148,199,410,256,558
430850,202308,3029,7313,1743,4785,518,1531,390,919,908,2450
430860,202308,1527,3556,677,1814,96,303,284,602,380,905
430865,202308,767,1717,415,1069,116,320,163,367,279,687
430870,202308,619,1588,215,642,43,126,42,110,85,236
430880,202308,1855,3792,1189,2683,142,360,754,1546,896,1906
430885,202308,224,555,119,326,17,50,60,153,77,203
430890,202308,1391,3256,705,1931,189,601,70,124,259,725
430900,202308,4401,8087,2499,5232,125,366,1840,3424,1965,3790
430905,202308,1145,2686,649,1694,121,331,251,608,372,939
430910,202308,2962,7359,1712,4491,246,720,767,1661,1013,2381
430912,202308,661,1725,363,1066,68,193,169,496,237,689
430915,202308,639,1677,362,1076,96,299,81,233,177,532
430920,202308,36729,82049,25369,61407,3235,8350,15667,35260,18902,43610
430925,202308,108,223,46,114,6,15,21,48,27,63
430930,202308,16081,33609,10124,23568,1117,2925,6570,13837,7687,16762
430940,202308,1650,3846,988,2557,193,500,392,883,585,1383
430950,202308,1023,2057,595,1319,71,190,396,759,467,949
430955,202308,547,1370,130,349,19,51,40,73,59,124
430957,202308,254,708,212,612,39,105,108,315,147,420
430960,202308,1723,3835,818,2118,214,562,227,518,441,1080
430965,202308,1956,4086,1371,3165,59,146,1042,2354,1101,2500
430970,202308,478,1117,231,630,26,71,93,238,119,309
430975,202308,607,1559,425,1169,86,269,141,336,227,605
430980,202308,551,1207,277,705,38,97,126,293,164,390
430990,202308,717,1794,474,1277,80,230,204,507,284,737
430995,202308,682,1520,388,983,74,186,193,443,267,629
431000,202308,1802,4004,611,1649,85,240,85,170,170,410
431010,202308,3567,8506,2133,5692,389,1182,896,1978,1285,3160
431020,202308,11609,23852,5930,14322,1007,2669,2733,5661,3740,8330
431030,202308,397,1039,175,552,39,148,23,69,62,217
431033,202308,5379,11758,3132,7838,741,1810,1189,2842,1930,4652
431036,202308,350,772,75,222,10,32,20,54,30,86
431040,202308,1081,2466,619,1584,70,235,393,860,463,1095
431041,202308,495,1103,276,704,48,124,116,240,164,364
431043,202308,415,1003,273,685,25,65,170,374,195,439
431046,202308,113,284,36,93,6,15,8,17,14,32
431050,202308,1530,3311,1003,2413,181,445,536,1219,717,1664
431053,202308,879,2069,425,1165,86,240,148,338,234,578
431055,202308,792,1730,509,1237,67,160,326,776,393,936
431057,202308,231,670,116,359,29,94,38,113,67,207
431060,202308,7183,15867,4425,11038,1118,3003,1797,3911,2915,6914
431065,202308,576,1311,310,831,38,107,170,410,208,517
431070,202308,507,1257,238,662,50,139,68,209,118,348
431075,202308,328,801,161,428,25,81,83,180,108,261
431080,202308,844,2166,422,1203,64,200,138,312,202,512
431085,202308,963,2318,416,1112,69,182,173,438,242,620
431087,202308,491,1243,341,918,55,159,193,488,248,647
431090,202308,511,1144,179,492,28,87,74,170,102,257
431100,202308,5661,10819,3798,8236,419,989,2483,4919,2902,5908
431110,202308,1802,3830,1143,2612,172,445,668,1368,840,1813
431112,202308,780,1800,577,1430,72,217,362,815,434,1032
431113,202308,684,1561,485,1187,111,264,268,621,379,885
431115,202308,1394,3323,947,2506,97,325,629,1505,726,1830
431120,202308,3378,7730,2016,5093,484,1375,833,1784,1317,3159
431123,202308,433,1041,253,676,46,104,115,295,161,399
431125,202308,1553,3587,987,2550,233,627,538,1337,771,1964
431127,202308,301,739,56,166,10,33,10,22,20,55
431130,202308,4226,9449,2823,6972,498,1313,1462,3253,1960,4566
431140,202308,7758,17446,3984,9855,554,1478,1881,3770,2435,5248
431142,202308,830,1807,520,1264,62,146,329,751,391,897
431150,202308,1281,3067,866,2293,105,309,512,1260,617,1569
431160,202308,841,2050,479,1310,135,382,147,343,282,725
431162,202308,757,1740,408,1052,43,138,237,544,280,682
431164,202308,200,452,38,108,8,28,10,17,18,45
431170,202308,575,1406,373,999,102,268,80,184,182,452
431171,202308,1211,2388,904,1947,124,274,675,1399,799,1673
431173,202308,577,1363,375,1051,118,361,99,231,217,592
431175,202308,1642,3525,864,2125,131,313,428,979,559,1292
431177,202308,1214,2807,806,2093,172,502,407,969,579,1471
431179,202308,369,799,98,278,25,81,36,87,61,168
431180,202308,3177,7717,1623,4407,404,1043,453,1088,857,2131
431190,202308,734,1741,241,675,25,75,62,120,87,195
431198,202308,513,1364,396,1116,90,262,159,432,249,694
431200,202308,349,834,91,236,20,49,14,30,34,79
431205,202308,285,717,142,393,38,108,41,102,79,210
431210,202308,813,1758,560,1328,119,276,267,619,386,895
431213,202308,387,964,232,642,23,68,126,316,149,384
431215,202308,764,1717,288,789,34,93,129,320,163,413
431217,202308,204,479,122,323,25,66,40,95,65,161
431220,202308,805,1809,418,1063,110,287,191,430,301,717
431225,202308,1996,4101,1318,2946,146,349,897,1896,1043,2245
431230,202308,978,2392,573,1495,102,288,281,592,383,880
431235,202308,201,538,29,90,2,4,7,15,9,19
431237,202308,469,1297,290,887,37,121,137,393,174,514
431238,202308,46,134,30,96,5,23,11,24,16,47
431240,202308,6956,15219,4785,11231,501,1350,2971,6228,3472,7578
431242,202308,396,892,269,625,33,92,149,304,182,396
431244,202308,488,1151,193,510,52,117,56,132,108,249
431245,202308,1615,3505,864,2147,105,264,385,839,490,1103
431247,202308,357,818,174,449,20,57,73,155,93,212
431250,202308,2494,5385,1750,4218,353,893,955,2163,1308,3056
431260,202308,411,1007,200,567,22,71,77,174,99,245
431261,202308,354,942,235,686,25,86,140,364,165,450
431262,202308,335,893,157,497,27,106,65,190,92,296
431265,202308,1959,4380,636,1693,154,448,164,317,318,765
431267,202308,282,659,159,413,26,74,83,196,109,270
431270,202308,3710,7486,1743,4174,525,1265,531,1180,1056,2445
431275,202308,199,501,98,257,15,47,57,134,72,181
431280,202308,326,858,119,364,25,77,28,73,53,150
431290,202308,442,1258,224,709,39,125,46,123,85,248
431295,202308,94,237,32,100,7,18,9,28,16,46
431300,202308,377,969,83,243,17,58,28,69,45,127
431301,202308,325,883,74,236,8,24,11,24,19,48
431303,202308,842,1920,426,1092,34,97,231,492,265,589
431306,202308,2917,6562,1347,3521,204,563,570,1242,774,1805
431308,202308,45,121,34,95,14,40,9,22,23,62
431310,202308,685,1607,368,934,62,135,183,437,245,572
431320,202308,843,2170,418,1210,78,242,130,287,208,529
431330,202308,2608,5711,1227,3074,177,507,617,1309,794,1816
431333,202308,244,610,110,315,22,58,32,86,54,144
431335,202308,37,108,23,79,7,21,3,12,10,33
431337,202308,5469,11351,4073,9074,189,530,3203,6666,3392,7196
431339,202308,580,1355,338,894,71,187,144,353,215,540
431340,202308,25339,56866,15405,38431,2292,6200,8049,17903,10341,24103
431342,202308,482,1063,301,748,50,133,187,441,237,574
431344,202308,458,1109,228,649,46,120,109,296,155,416
431346,202308,259,610,86,251,19,59,27,71,46,130
431349,202308,1281,2692,677,1531,113,287,399,810,512,1097
431350,202308,6364,14359,4309,10732,659,1744,2513,5712,3172,7456
431360,202308,702,1601,289,775,86,261,87,181,173,442
431365,202308,3026,5919,2070,4525,149,404,1614,3263,1763,3667
431370,202308,6765,14302,4288,10119,747,1945,2321,4996,3068,6941
431380,202308,1183,2880,832,2219,180,459,413,1074,593,1533
431390,202308,3301,7552,1717,4424,199,583,901,1962,1100,2545
431395,202308,2287,4669,1562,3533,156,368,1097,2312,1253,2680
431400,202308,378,1012,157,478,22,61,34,89,56,150
431402,202308,1103,2279,713,1656,90,210,432,941,522,1151
431403,202308,244,649,159,454,32,94,51,120,83,214
431405,202308,7526,17613,4805,12392,873,2405,2287,5219,3160,7624
431406,202308,712,1806,416,1180,114,303,105,318,219,621
431407,202308,656,1632,360,1003,75,198,128,335,203,533
431410,202308,25537,57001,15686,38856,1986,5716,9195,19926,11181,25642
431413,202308,306,825,58,168,9,25,17,35,26,60
431415,202308,929,2160,524,1405,113,333,201,451,314,784
431417,202308,687,1383,382,875,71,175,190,411,261,586
431420,202308,2156,4298,1419,3205,99,257,985,2032,1084,2289
431430,202308,690,1634,284,798,46,137,101,243,147,380
431440,202308,51974,105990,35973,79867,5862,14236,20584,40444,26446,54680
431442,202308,212,565,72,227,10,32,6,13,16,45
431445,202308,459,1197,124,388,17,49,24,55,41,104
431446,202308,337,872,246,688,28,85,140,369,168,454
431447,202308,930,2226,438,1211,78,221,159,398,237,619
431449,202308,980,2255,526,1373,89,244,271,626,360,870
431450,202308,3292,5792,2256,4280,212,347,1695,3077,1907,3424
431454,202308,56,183,36,127,5,20,15,49,20,69
431455,202308,636,1420,282,716,44,97,129,312,173,409
431460,202308,4065,8431,2344,5388,462,1174,1168,2445,1630,3619
431470,202308,1707,4253,1039,2862,257,711,326,857,583,1568
431475,202308,298,781,45,141,3,10,6,10,9,20
431477,202308,606,1410,299,801,90,215,97,246,187,461
431478,202308,290,786,52,154,12,37,9,18,21,55
431480,202308,4154,9910,2622,6945,573,1516,916,2207,1489,3723
431490,202308,183820,375410,125695,279553,7551,21450,90947,183233,98498,204683
431500,202308,587,1360,344,889,60,149,158,381,218,530
431505,202308,297,653,177,446,24,67,110,256,134,323
431507,202308,345,785,114,332,37,114,23,62,60,176
431510,202308,2107,5000,1172,3105,436,1146,234,583,670,1729
431513,202308,253,532,112,274,29,88,34,55,63,143
431514,202308,152,365,92,239,9,19,48,110,57,129
431515,202308,694,1480,461,1058,99,233,233,498,332,731
431517,202308,88,241,57,167,10,35,27,75,37,110
431520,202308,433,1004,163,440,31,92,65,132,96,224
431530,202308,6726,13782,3517,8522,755,1942,1525,3358,2280,5300
431531,202308,259,595,116,314,26,75,29,77,55,152
431532,202308,793,1657,403,970,74,179,188,425,262,604
431535,202308,350,877,133,372,31,87,28,68,59,155
431540,202308,2444,6380,1870,5361,138,492,1254,3384,1392,3876
431545,202308,441,1015,97,224,12,26,49,103,61,129
431550,202308,2926,6624,1760,4380,254,667,871,1953,1125,2620
431555,202308,880,1811,460,1072,41,115,271,604,312,719
431560,202308,33902,75325,19532,50003,3404,8955,8447,20383,11851,29338
431570,202308,7028,13751,5136,10781,518,1193,3527,6703,4045,7896
431575,202308,492,1067,326,758,58,148,183,355,241,503
431580,202308,865,2066,477,1217,47,130,256,541,303,671
431590,202308,1090,2775,583,1643,155,478,214,507,369,985
431595,202308,442,1098,230,651,52,160,81,187,133,347
431600,202308,2350,5420,1392,3676,233,687,539,1181,772,1868
431610,202308,1894,4142,987,2457,187,482,365,953,552,1435
431620,202308,582,1351,285,727,61,180,155,317,216,497
431630,202308,1582,3671,646,1782,159,449,178,432,337,881
431640,202308,8967,17966,6392,14109,995,2259,3978,8273,4973,10532
431642,202308,829,1763,411,979,81,193,178,370,259,563
431643,202308,469,1094,159,417,18,40,66,149,84,189
431645,202308,3132,5397,2251,4188,44,107,1903,3361,1947,3468
431647,202308,374,867,92,249,14,40,14,22,28,62
431650,202308,168,448,103,306,17,50,45,118,62,168
431660,202308,1026,2540,451,1321,77,245,105,245,182,490
431670,202308,1582,3455,786,1930,125,332,420,912,545,1244
431673,202308,253,635,88,280,10,39,30,82,40,121
431675,202308,436,1077,94,310,7,25,9,17,16,42
431680,202308,13224,28834,8005,18945,1681,4335,3342,6794,5023,11129
431690,202308,36524,79508,23245,55111,4434,11205,12005,25425,16439,36630
431695,202308,278,656,136,369,15,47,69,142,84,189
431697,202308,562,1198,361,858,64,141,195,455,259,596
431700,202308,1893,4090,1316,3046,219,461,683,1583,902,2044
431710,202308,19832,39989,13059,29794,1461,3787,8632,18332,10093,22119
431720,202308,8994,19955,4281,10819,1238,3253,759,1561,1997,4814
431725,202308,42,107,24,73,7,26,5,8,12,34
431730,202308,5920,12573,3548,8720,673,1823,1807,3924,2480,5747
431740,202308,6560,14679,3666,9444,802,2244,1178,2589,1980,4833
431750,202308,11056,25617,6474,17097,1755,4903,1912,4550,3667,9453
431755,202308,400,1034,66,208,8,23,9,28,17,51
431760,202308,6878,14428,4186,9662,485,1373,2566,5119,3051,6492
431770,202308,2820,5668,1838,4181,381,795,1044,2335,1425,3130
431775,202308,300,696,116,317,23,66,37,84,60,150
431780,202308,2716,6057,1456,3670,295,808,450,988,745,1796
431790,202308,929,2352,522,1487,145,427,166,426,311,853
431795,202308,315,768,133,384,17,51,32,87,49,138
431800,202308,10450,22898,5622,14587,1752,4989,657,1463,2409,6452
431805,202308,314,796,46,166,3,9,0,0,3,9
431810,202308,4025,8424,2424,5547,444,1092,1340,2793,1784,3885
431820,202308,2794,6569,1865,4949,459,1284,795,1942,1254,3226
431830,202308,10930,22853,6701,16242,2105,5533,1184,2766,3289,8299
431840,202308,3679,8078,2596,6236,404,1010,1554,3498,1958,4508
431842,202308,612,1433,184,514,33,95,32,66,65,161
431843,202308,370,956,195,551,51,154,77,192,128,346
431844,202308,219,575,57,187,14,46,20,63,34,109
431845,202308,578,1364,312,812,30,75,174,446,204,521
431846,202308,373,805,279,652,18,54,220,474,238,528
431848,202308,175,441,65,191,8,22,14,29,22,51
431849,202308,421,1030,56,163,10,29,7,18,17,47
431850,202308,5389,13236,3349,9002,958,2660,848,2124,1806,4784
431860,202308,860,1920,421,1036,73,185,244,549,317,734
431861,202308,121,300,63,176,8,25,24,55,32,80
431862,202308,619,1832,436,1452,86,313,188,562,274,875
431870,202308,32207,71003,21828,52500,2704,6875,13471,29830,16175,36705
431880,202308,5174,11976,3373,8693,527,1513,1747,4038,2274,5551
431890,202308,6230,14379,3313,8613,1027,2682,817,1941,1844,4623
431900,202308,1315,3058,744,1929,147,428,329,698,476,1126
431910,202308,940,2099,315,820,75,182,85,167,160,349
431912,202308,727,1603,525,1250,85,193,321,736,406,929
431915,202308,1477,3066,1032,2318,70,171,767,1627,837,1798
431920,202308,1701,3233,1224,2556,46,114,1019,2037,1065,2151
431930,202308,968,2282,564,1531,186,514,170,433,356,947
431935,202308,99,238,48,135,8,22,8,14,16,36
431936,202308,368,937,172,476,34,99,86,213,120,312
431937,202308,244,560,104,270,27,61,26,61,53,122
431940,202308,3829,8116,2104,4977,234,540,1220,2733,1454,3273
431950,202308,2953,6708,1844,4667,434,1112,677,1563,1111,2675
431960,202308,3791,8469,2476,6008,762,1952,531,1214,1293,3166
431970,202308,527,1271,190,498,39,112,59,113,98,225
431971,202308,96,233,44,127,10,24,14,35,24,59
431973,202308,724,1985,469,1450,34,95,326,998,360,1093
431975,202308,131,275,35,90,8,25,10,18,18,43
431980,202308,1594,3372,1138,2611,116,331,769,1525,885,1856
431990,202308,9116,19554,5658,13994,376,1144,3717,8361,4093,9505
432000,202308,21102,43546,14026,31713,1750,4504,9167,18906,10917,23410
432010,202308,3631,7796,1889,4667,458,1152,698,1570,1156,2722
432020,202308,1919,4782,1017,2819,355,994,154,405,509,1399
432023,202308,684,1525,265,704,29,83,114,234,143,317
432026,202308,1254,3034,889,2320,268,714,320,856,588,1570
432030,202308,556,1252,242,652,20,61,139,337,159,398
432032,202308,381,917,224,595,22,72,109,243,131,315
432035,202308,873,2179,650,1759,171,455,270,705,441,1160
432040,202308,1205,2843,421,1192,51,170,177,415,228,585
432045,202308,228,544,112,309,15,46,47,117,62,163
432050,202308,702,1584,428,1077,63,181,225,515,288,696
432055,202308,906,2077,540,1387,173,422,165,447,338,869
432057,202308,182,447,135,339,27,53,75,175,102,228
432060,202308,545,1251,124,381,17,51,24,65,41,116
432065,202308,287,698,192,508,41,114,103,242,144,356
432067,202308,1019,2539,759,1982,142,370,371,928,513,1298
432070,202308,1998,4575,1292,3224,191,554,647,1389,838,1943
432080,202308,6623,13696,3978,9180,807,2182,1809,3496,2616,5678
432085,202308,492,1248,350,959,62,169,162,402,224,571
432090,202308,3590,8235,1677,4345,311,783,765,1730,1076,2513
432100,202308,1150,2692,470,1353,78,248,67,135,145,383
432110,202308,2696,6239,1734,4422,401,1120,594,1276,995,2396
432120,202308,4822,11653,3256,8699,510,1519,1672,3953,2182,5472
432130,202308,3554,7836,2367,5751,507,1265,1095,2604,1602,3869
432132,202308,343,841,162,423,27,81,82,189,109,270
432135,202308,1230,2581,717,1706,105,236,402,971,507,1207
432140,202308,2503,5961,1816,4637,243,622,1144,2745,1387,3367
432143,202308,2068,4863,1351,3581,137,386,795,1993,932,2379
432145,202308,2351,5717,1113,3039,182,537,378,822,560,1359
432146,202308,168,423,103,292,29,75,24,60,53,135
432147,202308,705,1757,325,932,97,275,47,140,144,415
432149,202308,629,1378,233,589,32,72,110,245,142,317
432150,202308,5529,12267,3708,9030,861,2290,1712,3547,2573,5837
432160,202308,8921,19920,5989,15103,1450,3801,2398,5674,3848,9475
432162,202308,242,527,37,103,5,15,6,6,11,21
432163,202308,202,468,31,87,1,2,8,17,9,19
432166,202308,816,2047,510,1393,110,309,167,385,277,694
432170,202308,1941,4853,1019,2949,212,633,346,866,558,1499
432180,202308,3712,8170,1678,4282,269,759,763,1663,1032,2422
432183,202308,524,1325,346,933,60,194,195,463,255,657
432185,202308,1094,2524,563,1484,122,362,260,603,382,965
432190,202308,2950,6364,1767,4303,140,415,1156,2477,1296,2892
432195,202308,1247,2972,578,1602,108,307,168,436,276,743
432200,202308,4815,10715,3135,7746,312,775,2024,4689,2336,5464
432210,202308,506,1171,298,778,51,156,127,277,178,433
432215,202308,807,2045,565,1564,128,352,212,621,340,973
432218,202308,260,601,93,243,10,31,43,84,53,115
432220,202308,4855,10193,3001,6951,526,1275,1679,3543,2205,4818
432225,202308,204,503,122,338,29,64,31,80,60,144
432230,202308,905,2055,378,1046,85,250,91,203,176,453
432232,202308,586,1349,339,881,54,151,164,370,218,521
432234,202308,320,760,152,410,35,88,43,100,78,188
432235,202308,62,138,31,73,4,10,20,41,24,51
432237,202308,362,838,292,719,25,51,215,514,240,565
432240,202308,22304,47597,14801,36390,1458,3978,9638,22306,11096,26284
432250,202308,9543,23105,6010,15773,969,2777,3147,7373,4116,10150
432252,202308,579,1317,332,816,40,112,164,347,204,459
432253,202308,1184,3081,736,2027,229,657,151,376,380,1033
432254,202308,702,1626,152,423,21,67,36,82,57,149
432255,202308,124,314,60,164,4,10,30,67,34,77
432260,202308,7678,17247,4609,11306,833,2193,2122,4542,2955,6735
432270,202308,3049,7133,1957,5020,569,1459,557,1365,1126,2824
432280,202308,1480,3559,578,1661,83,251,152,334,235,585
432285,202308,163,482,22,57,3,5,5,14,8,19
432290,202308,434,1072,239,633,46,138,93,202,139,340
432300,202308,42189,91233,29041,68815,2440,6914,19801,42461,22241,49375
432310,202308,1361,2921,958,2276,141,297,662,1579,803,1876
432320,202308,194,452,90,252,20,59,32,79,52,138
432330,202308,201,444,61,178,20,54,10,29,30,83
432335,202308,208,587,63,213,2,4,15,42,17,46
432340,202308,405,950,148,402,22,58,61,158,83,216
432345,202308,1153,2069,913,1755,27,65,769,1421,796,1486
432350,202308,373,895,163,483,33,110,54,134,87,244
432360,202308,258,746,46,145,7,21,10,26,17,47
432370,202308,482,1089,221,611,20,51,111,284,131,335
432375,202308,617,1403,352,877,129,331,68,166,197,497
432377,202308,208,608,42,148,3,11,9,24,12,35
432380,202308,2445,6328,1431,4249,233,744,588,1591,821,2335
500020,202308,4365,9754,2501,6479,302,898,1455,3469,1757,4367
500025,202308,1457,3287,762,1957,102,263,412,981,514,1244
500060,202308,10889,26702,7256,19246,971,2818,4135,10254,5106,13072
500070,202308,6625,14872,4125,10420,796,2153,1873,4507,2669,6660
500080,202308,1950,4466,1046,2783,191,525,440,1052,631,1577
500085,202308,2717,6140,1522,3905,348,929,585,1307,933,2236
500090,202308,2516,6051,1567,4449,305,916,413,1215,718,2131
500100,202308,5204,12003,3304,8590,547,1542,1427,3332,1974,4874
500110,202308,14015,31305,8564,21980,1960,5198,3869,9343,5829,14541
500124,202308,2870,7112,2118,5863,371,997,1210,3301,1581,4298
500150,202308,2014,4216,1252,3019,184,474,711,1568,895,2042
500190,202308,6510,15453,3508,9251,875,2277,1042,2441,1917,4718
500200,202308,3409,7257,1841,4464,253,675,981,2144,1234,2819
500210,202308,6596,13801,4165,10426,1049,2839,2139,4973,3188,7812
500215,202308,1833,4562,1121,3216,142,404,588,1652,730,2056
500220,202308,4536,10982,2967,8057,406,1193,1582,3867,1988,5060
500230,202308,2699,5976,1728,4327,275,733,947,2214,1222,2947
500240,202308,5324,14118,3448,10127,524,1686,1340,3717,1864,5403
500260,202308,4001,8021,2317,5422,250,684,1403,3002,1653,3686
500270,202308,194615,422876,109623,274158,15223,42729,51626,112993,66849,155722
500280,202308,1758,4005,1032,2832,169,447,550,1474,719,1921
500290,202308,4663,10563,2377,6359,397,1224,868,1960,1265,3184
500295,202308,5485,12133,3116,7772,510,1403,1307,2785,1817,4188
500310,202308,1308,2435,698,1597,123,209,334,751,457,960
500315,202308,6205,13275,4820,11326,306,816,3898,8776,4204,9592
500320,202308,26346,63910,16165,45654,3919,10421,6750,19699,10669,30120
500325,202308,8168,16480,5001,11523,678,1766,3070,6495,3748,8261
500330,202308,8686,18285,5017,12395,669,1770,2637,6242,3306,8012
500345,202308,2841,6522,1549,4130,310,838,506,1203,816,2041
500348,202308,3045,6922,2145,5388,350,941,1372,3237,1722,4178
500350,202308,1499,3790,783,2270,132,398,256,633,388,1031
500370,202308,36361,87529,23143,63558,3537,10673,10550,26538,14087,37211
500375,202308,3171,7915,1647,4655,214,642,599,1438,813,2080
500380,202308,4593,10706,2546,6800,710,1837,361,1003,1071,2840
500390,202308,939,1825,524,1272,74,202,340,780,414,982
500400,202308,2141,5101,1187,3184,197,584,425,992,622,1576
500410,202308,3009,6584,1831,4720,217,554,949,2440,1166,2994
500430,202308,3601,8248,2058,5623,347,932,761,2175,1108,3107
500440,202308,2028,4557,886,2440,155,438,335,899,490,1337
500450,202308,2534,5964,1370,3812,304,864,305,839,609,1703
500460,202308,4877,11923,2585,7274,476,1518,469,1128,945,2646
500470,202308,3768,9348,2163,6021,514,1568,623,1414,1137,2982
500480,202308,2396,6861,1790,5806,197,692,1158,3699,1355,4391
500490,202308,1467,3316,734,2069,156,500,172,439,328,939
500500,202308,5020,12483,2855,8641,897,3142,270,796,1167,3938
500510,202308,890,2122,511,1377,51,140,313,750,364,890
500515,202308,2015,4791,1273,3435,215,591,616,1636,831,2227
500520,202308,4333,11288,2951,8731,554,1658,1516,4405,2070,6063
500525,202308,1278,3416,891,2689,134,389,448,1298,582,1687
500540,202308,6746,16597,3488,10401,1034,3422,545,1249,1579,4671
500560,202308,7411,17539,5600,14904,410,1097,4247,11102,4657,12199
500568,202308,5873,12035,3221,7835,825,2016,1251,2735,2076,4751
500570,202308,11572,24802,7040,16944,975,2698,3977,8497,4952,11195
500580,202308,4013,9541,2500,6712,669,1794,935,2428,1604,4222
500600,202308,4769,11112,2831,7558,693,1884,784,1980,1477,3864
500620,202308,10759,25347,6164,16166,921,2503,3035,7169,3956,9672
500625,202308,713,1776,427,1202,67,189,185,460,252,649
500627,202308,976,2519,491,1481,94,312,110,279,204,591
500630,202308,10110,21301,5065,12571,1133,3062,1597,3506,2730,6568
500635,202308,3288,9742,2308,8260,358,1175,1348,5262,1706,6437
500640,202308,2178,4383,1314,3098,79,187,900,2013,979,2200
500660,202308,28460,64263,16694,45549,4498,12842,5529,14646,10027,27488
500690,202308,3515,8271,2203,6068,745,2270,711,1814,1456,4084
500710,202308,4324,10639,2469,6965,539,1616,593,1479,1132,3095
500720,202308,6502,15523,3684,10299,761,2271,1057,2652,1818,4923
500730,202308,1382,3125,661,1799,164,435,187,490,351,925
500740,202308,5710,12823,3174,8539,801,2209,1001,2622,1802,4831
500750,202308,1523,3443,856,2226,125,351,389,888,514,1239
500755,202308,1439,3463,745,2062,127,380,220,491,347,871
500769,202308,6641,15395,2973,8164,762,2176,438,959,1200,3135
500770,202308,1718,4351,1124,3305,201,631,334,960,535,1591
500780,202308,1666,4033,843,2374,142,425,202,452,344,877
500790,202308,10240,25128,6132,17103,1124,3398,2219,5615,3343,9013
500793,202308,2769,6471,1622,4185,351,953,610,1403,961,2356
500795,202308,3816,7999,2788,6552,649,1663,1674,3697,2323,5360
500797,202308,1048,2414,571,1486,172,456,186,433,358,889
500800,202308,4550,9842,2390,6249,571,1630,674,1692,1245,3322
500830,202308,27446,62780,15077,38458,3545,9360,5196,11890,8741,21250
500840,202308,1846,4110,992,2446,111,280,506,1102,617,1382
510010,202308,2189,4445,1406,3337,172,371,912,2116,1084,2487
510020,202308,5739,13781,2318,6619,378,1081,685,1775,1063,2856
510025,202308,9859,22361,5636,15006,704,2009,3068,7479,3772,9488
510030,202308,3963,8210,2108,5063,166,434,1060,2467,1226,2901
510035,202308,1325,3407,788,2469,209,670,288,962,497,1632
510040,202308,3074,6265,1947,4569,266,600,1131,2650,1397,3250
510050,202308,2927,5483,1832,4008,206,555,1265,2559,1471,3114
510060,202308,1964,4742,1114,2982,305,873,276,609,581,1482
510080,202308,1959,4684,1161,3309,203,661,401,938,604,1599
510100,202308,860,1788,563,1309,68,178,351,743,419,921
510120,202308,336,584,184,398,8,23,142,277,150,300
510125,202308,2626,6319,1648,4461,255,779,639,1473,894,2252
510130,202308,2120,4809,1315,3425,254,747,621,1413,875,2160
510140,202308,3759,9488,2335,7208,1018,3299,561,1747,1579,5046
510160,202308,2625,5591,1876,4554,49,144,1656,3949,1705,4093
510170,202308,6414,15039,4188,10962,706,2001,2178,5234,2884,7235
510180,202308,19035,38840,11387,27237,1555,3961,6141,14349,7696,18310
510185,202308,2132,5254,1281,3856,409,1305,448,1432,857,2737
510190,202308,3199,8263,1741,5565,375,1257,503,1572,878,2829
510250,202308,22875,51987,14705,38424,2150,6067,8163,20213,10313,26280
510260,202308,2343,9326,1885,8493,248,1116,1173,5785,1421,6901
510263,202308,5140,13317,2821,8159,516,1603,693,1591,1209,3194
510267,202308,7322,19712,3547,10677,682,2153,711,1797,1393,3950
510268,202308,1563,3914,886,2564,226,679,165,431,391,1110
510269,202308,1195,3017,699,2047,138,447,306,811,444,1258
510270,202308,3660,9815,2265,7112,380,1279,861,2541,1241,3820
510279,202308,2339,5643,1140,3311,195,602,331,803,526,1405
510285,202308,1352,3290,791,2242,207,643,269,683,476,1326
510300,202308,5330,11593,3621,9038,258,701,2589,6125,2847,6826
510305,202308,1921,4912,1144,3376,265,812,404,1167,669,1979
510310,202308,1383,3154,899,2322,233,590,353,901,586,1491
510320,202308,5272,12035,2950,7766,715,2045,849,1936,1564,3981
510325,202308,5539,15003,3506,10895,878,2975,576,1645,1454,4620
510330,202308,3423,8766,2154,6496,589,1802,910,2683,1499,4485
510335,202308,6354,16462,4354,12939,1091,3445,1836,5149,2927,8594
510336,202308,683,1795,444,1393,53,155,244,812,297,967
510337,202308,1830,4854,1088,3475,394,1311,239,683,633,1994
510340,202308,129370,271154,76614,186627,14603,40470,35221,75559,49824,116029
510343,202308,1561,3480,919,2369,127,350,479,1145,606,1495
510345,202308,1857,4330,1124,2877,216,598,618,1424,834,2022
510350,202308,4020,9713,2107,6101,539,1546,529,1482,1068,3028
510360,202308,2308,4338,1218,2941,49,114,902,2196,951,2310
510370,202308,2273,5917,1594,4772,306,857,881,2714,1187,3571
510380,202308,675,1531,354,977,55,187,160,407,215,594
510385,202308,1635,4854,1123,3832,76,328,795,2669,871,2997
510390,202308,1850,4066,1209,3261,226,633,728,1909,954,2542
510395,202308,848,1728,499,1204,37,80,334,798,371,878
510410,202308,6949,16761,4612,12649,549,1587,2921,7694,3470,9281
510420,202308,3386,6166,2078,4301,62,160,1652,3263,1714,3423
510450,202308,634,1454,327,891,60,157,151,385,211,542
510452,202308,1250,3163,876,2393,157,398,500,1358,657,1756
510454,202308,1501,3636,902,2548,164,418,464,1376,628,1794
510455,202308,1174,2960,658,1907,133,433,230,573,363,1006
510460,202308,2454,5780,1484,3993,522,1583,452,878,974,2461
510480,202308,6291,14188,3493,8756,635,1722,1616,3510,2251,5232
510490,202308,2187,5016,1496,3999,190,478,915,2429,1105,2907
510500,202308,1792,4089,951,2650,223,657,259,699,482,1356
510510,202308,5099,13090,3122,9446,920,3007,904,2579,1824,5586
510515,202308,6896,16849,4168,11680,802,2342,1682,4338,2484,6680
510517,202308,2084,4966,1278,3633,423,1338,417,1077,840,2415
510520,202308,2929,5764,1288,3241,212,582,555,1403,767,1985
510523,202308,1431,3177,896,2253,162,431,483,1116,645,1547
510525,202308,10984,28319,6356,18267,1274,3750,1976,4992,3250,8742
510530,202308,742,1727,511,1385,32,92,372,974,404,1066
510550,202308,3278,8629,2221,6610,419,1275,1125,3160,1544,4435
510558,202308,2832,7187,1877,5555,277,769,943,2874,1220,3643
510560,202308,2549,6825,1378,4335,310,1011,223,676,533,1687
510562,202308,7919,16985,5002,11791,804,2088,2700,5597,3504,7685
510590,202308,4186,9418,2728,7241,355,979,1801,4602,2156,5581
510600,202308,1621,3254,1019,2321,239,677,508,952,747,1629
510610,202308,3583,7850,2226,5792,293,851,1320,3217,1613,4068
510615,202308,3606,8572,2227,6212,442,1294,1072,2841,1514,4135
510617,202308,1355,3685,1028,3152,119,391,726,2275,845,2666
510618,202308,1647,3914,1053,2877,195,608,550,1378,745,1986
510619,202308,897,2192,438,1309,98,293,91,230,189,523
510620,202308,1757,3711,716,1945,260,802,83,183,343,985
510621,202308,2001,5046,1029,3082,263,861,262,622,525,1483
510622,202308,7278,18735,3565,10417,923,2750,440,1013,1363,3763
510623,202308,3621,8113,2090,5334,408,1121,841,1935,1249,3056
510624,202308,1898,4777,873,2667,105,372,167,427,272,799
510625,202308,4684,10531,2533,6602,573,1607,840,2105,1413,3712
510626,202308,1655,3924,1012,2812,318,1017,230,560,548,1577
510627,202308,832,1987,403,1142,125,384,105,303,230,687
510628,202308,1780,3763,1025,2671,344,1003,312,695,656,1698
510629,202308,2271,5847,1279,3862,304,1030,257,685,561,1715
510630,202308,4372,11088,2413,7268,563,1689,705,2259,1268,3948
510631,202308,743,1616,501,1217,32,81,377,894,409,975
510637,202308,4554,10006,2559,6533,755,2090,801,1813,1556,3903
510642,202308,7390,18491,5060,14646,1000,3130,2570,7024,3570,10154
510645,202308,1249,2430,684,1652,177,416,271,675,448,1091
510650,202308,9843,21169,6705,17118,810,1460,4647,12623,5457,14083
510665,202308,2103,4343,1131,2714,255,565,428,1063,683,1628
510670,202308,505,1067,290,749,38,94,158,414,196,508
510675,202308,8447,21677,4919,14464,1201,3816,990,2473,2191,6289
510677,202308,2646,6457,1757,4949,311,933,1013,2752,1324,3685
510680,202308,876,2120,408,1194,63,203,106,264,169,467
510682,202308,2264,5824,1546,4531,399,1239,697,1938,1096,3177
510685,202308,670,1682,418,1191,41,116,235,638,276,754
510700,202308,5426,11897,3386,8748,374,1119,2150,5240,2524,6359
510704,202308,14709,32480,8106,20405,1844,4929,2727,5944,4571,10873
510706,202308,3328,8911,2167,6711,418,1309,985,3088,1403,4397
510710,202308,3762,8633,2003,5166,629,1602,466,1076,1095,2678
510715,202308,779,1616,431,1074,37,98,269,625,306,723
510718,202308,2751,6200,1531,4358,289,855,716,2192,1005,3047
510719,202308,591,1176,319,762,50,134,150,289,200,423
510720,202308,1117,2382,663,1690,132,377,286,628,418,1005
510724,202308,1085,2909,618,1919,88,304,236,625,324,929
510726,202308,1116,2035,547,1219,55,138,354,740,409,878
510729,202308,803,1740,332,889,52,138,95,247,147,385
510730,202308,3656,8261,2260,5851,519,1485,1067,2428,1586,3913
510735,202308,1696,4360,1247,3594,119,338,951,2716,1070,3054
510740,202308,1214,2705,684,1665,41,117,471,1041,512,1158
510757,202308,649,1940,462,1575,115,426,166,503,281,929
510760,202308,56985,119782,29151,73154,6773,18570,8548,18264,15321,36834
510770,202308,5461,10846,3579,8236,200,492,2602,5832,2802,6324
510774,202308,555,1355,368,1027,64,185,211,584,275,769
510775,202308,846,2027,454,1315,95,296,117,297,212,593
510776,202308,987,2384,569,1510,104,283,275,717,379,1000
510777,202308,1724,4325,1134,3444,228,798,604,1685,832,2483
510779,202308,1038,2647,637,1894,76,213,386,1192,462,1405
510780,202308,5499,12392,3460,9163,580,1553,1792,4861,2372,6414
510785,202308,2515,6094,1307,3787,293,892,430,1184,723,2076
510787,202308,4584,11993,2532,7465,924,2791,278,730,1202,3521
510788,202308,598,1342,367,968,59,139,170,485,229,624
510790,202308,25799,63223,13549,39543,2974,9310,1509,3863,4483,13173
510792,202308,14642,37968,8144,24276,1994,6214,1943,5076,3937,11290
510794,202308,1554,4038,975,2923,276,887,138,312,414,1199
510795,202308,14818,34574,9144,24172,1998,5741,3291,7545,5289,13286
510800,202308,1890,4808,1082,3169,330,967,149,344,479,1311
510805,202308,1865,4843,1012,3137,207,673,347,968,554,1641
510810,202308,843,1629,505,1152,152,309,261,637,413,946
510820,202308,928,1708,499,1133,33,96,341,701,374,797
510830,202308,974,2284,694,1874,123,368,403,1075,526,1443
510835,202308,745,1622,440,1156,61,186,250,597,311,783
510840,202308,82886,161565,51660,117595,8063,17974,30335,66740,38398,84714
510850,202308,2200,5477,1099,3389,257,860,72,140,329,1000
510860,202308,3450,8394,2113,6167,772,2406,435,1212,1207,3618
510880,202308,918,2458,565,1758,203,641,84,248,287,889
510885,202308,782,1824,419,1157,95,255,121,323,216,578
510890,202308,1047,2727,627,1885,186,601,137,357,323,958
510895,202308,1864,4410,1133,3074,244,750,527,1239,771,1989
520005,202308,5019,12132,3548,9834,1099,2771,1252,3970,2351,6741
520010,202308,3925,9473,2545,6697,561,1594,1035,2353,1596,3947
520013,202308,4636,10839,2593,6905,743,1921,650,1803,1393,3724
520015,202308,613,1456,365,1024,86,225,132,387,218,612
520017,202308,1600,3668,963,2518,165,511,414,973,579,1484
520020,202308,708,1257,470,937,52,96,347,664,399,760
520025,202308,51483,123702,39660,103753,6403,17219,22774,56588,29177,73807
520030,202308,9222,19248,6775,15401,532,1138,4989,10921,5521,12059
520050,202308,522,1188,250,672,50,136,100,261,150,397
520055,202308,2170,5026,1003,2525,176,453,436,976,612,1429
520060,202308,2498,5828,1528,4089,295,854,421,1090,716,1944
520080,202308,2381,5468,1613,4278,351,920,687,1778,1038,2698
520082,202308,1024,2449,628,1696,157,460,217,567,374,1027
520085,202308,1276,2912,879,2237,188,452,425,1024,613,1476
520090,202308,1103,1993,740,1554,111,152,541,1192,652,1344
520110,202308,58200,142140,32364,92356,8577,25870,1982,4769,10559,30639
520120,202308,321,708,155,405,28,90,67,151,95,241
520130,202308,5110,11138,3108,7492,655,1602,1294,2855,1949,4457
520140,202308,67802,164055,41354,115530,12942,38067,4359,11714,17301,49781
520145,202308,781,1677,394,1036,80,216,113,262,193,478
520150,202308,907,2069,589,1537,76,180,329,807,405,987
520160,202308,1113,2525,646,1656,123,303,286,729,409,1032
520170,202308,5855,11858,3419,8339,472,1243,2036,4591,2508,5834
520180,202308,3625,8159,2635,6601,331,935,1693,4003,2024,4938
520215,202308,2277,4958,1497,3678,140,406,993,2267,1133,2673
520235,202308,965,1881,545,1261,100,245,306,640,406,885
520250,202308,2274,5237,1423,3816,534,1560,118,353,652,1913
520260,202308,911,2031,474,1239,101,261,156,382,257,643
520280,202308,1048,2166,677,1552,161,363,308,687,469,1050
520310,202308,1156,2354,699,1657,162,428,322,746,484,1174
520320,202308,2726,6423,1644,4341,224,586,803,2081,1027,2667
520330,202308,6567,15296,4526,11563,741,2076,2550,5989,3291,8065
520340,202308,2828,5728,1526,3745,205,456,733,1862,938,2318
520350,202308,4458,10117,2544,6730,794,2104,689,1815,1483,3919
520355,202308,2315,5889,1485,4184,467,1415,222,558,689,1973
520357,202308,1118,2432,751,1879,96,249,510,1246,606,1495
520360,202308,1034,2360,691,1721,99,271,333,717,432,988
520380,202308,1715,4050,867,2357,163,447,232,542,395,989
520390,202308,1462,3262,836,2240,227,702,137,352,364,1054
520393,202308,895,1886,527,1273,68,185,260,551,328,736
520396,202308,1096,2476,774,1882,73,160,514,1180,587,1340
520400,202308,2032,4389,1407,3454,129,323,962,2357,1091,2680
520410,202308,2768,5684,1648,3835,274,689,889,1925,1163,2614
520420,202308,461,959,338,758,20,56,243,502,263,558
520425,202308,1935,4408,904,2303,260,708,195,399,455,1107
520430,202308,3081,6782,1525,3937,320,832,291,633,611,1465
520440,202308,3802,8699,1900,5075,392,1127,403,995,795,2122
520450,202308,18791,42026,10986,28314,2672,7005,2932,6982,5604,13987
520455,202308,1019,2408,590,1677,168,492,161,447,329,939
520460,202308,1298,2807,859,2136,235,502,350,892,585,1394
520465,202308,1108,2356,825,1931,41,113,607,1340,648,1453
520470,202308,3124,6896,2124,5335,690,1881,799,1876,1489,3757
520480,202308,1315,3222,823,2285,178,506,334,855,512,1361
520485,202308,1963,5364,1452,4386,247,780,766,2192,1013,2972
520490,202308,5611,13066,3786,9978,612,1697,2150,5376,2762,7073
520495,202308,2010,3834,1406,2991,132,301,1020,2097,1152,2398
520500,202308,2287,5090,1466,3532,263,751,783,1646,1046,2397
520505,202308,1193,2232,860,1782,94,162,624,1272,718,1434
520510,202308,13313,30010,8890,22301,1446,4227,4568,10218,6014,14445
520520,202308,1420,3346,986,2585,271,758,388,937,659,1695
520530,202308,3315,7937,2192,5950,439,1172,967,2771,1406,3943
520540,202308,3885,9309,2094,5655,338,958,729,1682,1067,2640
520545,202308,1898,4284,1233,3143,305,772,468,1162,773,1934
520547,202308,1907,4496,1301,3367,266,677,653,1652,919,2329
520549,202308,22429,51422,16776,42082,2162,5832,10569,24779,12731,30611
520551,202308,6678,14925,5030,12199,435,1311,3673,8230,4108,9541
520552,202308,1285,2964,872,2326,243,636,323,889,566,1525
520570,202308,682,1430,383,936,61,130,185,431,246,561
520580,202308,3036,5897,1878,4379,407,968,975,2211,1382,3179
520590,202308,1726,3988,1032,2752,220,618,402,995,622,1613
520620,202308,12751,29663,9038,23409,1556,4206,4851,11859,6407,16065
520630,202308,1091,2543,715,1891,104,291,339,875,443,1166
520640,202308,2783,6320,1814,4473,481,1203,490,1200,971,2403
520650,202308,1323,2616,845,1897,170,376,461,1022,631,1398
520660,202308,606,1489,301,866,79,239,85,246,164,485
520670,202308,1241,2866,880,2233,87,186,577,1397,664,1583
520680,202308,1065,2269,724,1693,102,198,461,1073,563,1271
520690,202308,439,1057,274,739,71,192,86,207,157,399
520710,202308,558,1268,310,800,17,53,200,474,217,527
520725,202308,1683,3772,1024,2612,243,626,387,956,630,1582
520735,202308,1176,2512,720,1743,225,531,209,489,434,1020
520740,202308,3279,6990,1964,4855,383,989,838,2023,1221,3012
520750,202308,932,1923,604,1407,114,254,329,736,443,990
520753,202308,1626,3852,1122,2951,196,565,524,1218,720,1783
520760,202308,1870,3560,1374,2920,52,140,1138,2302,1190,2442
520780,202308,2027,4443,1292,3221,219,553,633,1473,852,2026
520790,202308,3941,8685,2296,5841,379,890,1245,3235,1624,4125
520800,202308,24778,55899,17172,43250,3422,8429,8736,21593,12158,30022
520810,202308,1426,2923,939,2289,269,652,369,921,638,1573
520815,202308,707,2002,425,1338,79,243,126,392,205,635
520830,202308,2159,4340,1430,3340,87,205,1062,2393,1149,2598
520840,202308,3712,9083,2619,7304,681,2059,803,2143,1484,4202
520850,202308,1200,2424,713,1658,137,352,355,742,492,1094
520860,202308,12471,30225,7696,20900,1978,5602,2377,5763,4355,11365
520870,202308,203750,432663,127113,304157,23796,59958,57966,126113,81762,186071
520880,202308,12853,33437,8918,25396,1796,5088,3574,9610,5370,14698
520890,202308,6244,12657,3832,8688,630,1654,2090,4205,2720,5859
520910,202308,5923,13772,3465,9121,830,2272,816,1919,1646,4191
520915,202308,1060,2508,596,1539,106,306,277,627,383,933
520920,202308,5591,11504,3663,8702,741,1629,1968,4704,2709,6333
520929,202308,790,1744,518,1270,101,194,214,567,315,761
520940,202308,1212,2945,839,2305,85,241,537,1383,622,1624
520945,202308,586,1224,368,872,43,103,212,483,255,586
520960,202308,1438,2922,986,2265,373,795,344,848,717,1643
520970,202308,4896,11461,3185,8484,1076,2855,686,1873,1762,4728
520980,202308,956,2021,628,1518,88,211,313,691,401,902
520990,202308,3977,8585,2916,7056,438,948,1992,4816,2430,5764
520993,202308,1515,3474,806,2039,272,675,212,506,484,1181
520995,202308,3231,7478,1955,5133,569,1600,359,1018,928,2618
521000,202308,12263,29030,6877,18096,1194,3221,2331,5492,3525,8713
521010,202308,5151,11943,3378,8602,560,1589,1703,3902,2263,5491
521015,202308,969,2207,567,1426,25,70,401,926,426,996
521020,202308,6194,13977,3377,8717,823,2146,930,2256,1753,4402
521030,202308,1032,1754,675,1261,27,58,558,994,585,1052
521040,202308,11016,25080,6775,17506,1731,4453,1941,4985,3672,9438
521056,202308,1312,3218,815,2305,242,663,128,375,370,1038
521060,202308,1240,2982,772,2090,203,575,220,568,423,1143
521080,202308,1287,2638,609,1550,116,295,174,393,290,688
521090,202308,3870,9740,2135,5958,485,1469,226,539,711,2008
521100,202308,2449,4959,1624,3753,208,513,970,2155,1178,2668
521120,202308,6258,14054,4157,10703,1331,3501,919,2539,2250,6040
521130,202308,1298,2922,614,1639,91,272,289,733,380,1005
521140,202308,2129,4828,1348,3369,161,425,803,1821,964,2246
521150,202308,18540,39074,10580,26397,2799,7502,3771,8477,6570,15979
521160,202308,1055,1984,592,1236,53,103,397,760,450,863
521170,202308,1341,2909,819,2022,153,404,331,728,484,1132
521180,202308,11071,26061,7642,19813,1640,4569,3370,8290,5010,12859
521190,202308,15261,35295,8678,23424,2027,5869,2794,6694,4821,12563
521200,202308,876,2001,515,1363,99,276,202,466,301,742
521205,202308,778,1676,554,1307,34,90,418,921,452,1011
521210,202308,1117,2745,560,1558,148,418,129,278,277,696
521220,202308,4837,10651,2879,7266,726,2072,1186,2500,1912,4572
521225,202308,550,1056,360,817,26,63,277,611,303,674
521230,202308,1858,4271,1326,3394,520,1376,377,897,897,2273
521250,202308,48438,110186,34815,88536,7229,19896,17996,42011,25225,61907
521260,202308,677,1394,470,1073,70,171,257,534,327,705
521270,202308,2729,5960,2079,5006,241,544,1423,3422,1664,3966
521280,202308,2298,5600,1483,4106,318,916,535,1399,853,2315
521290,202308,716,1500,397,985,42,115,223,507,265,622
521295,202308,1480,3017,958,2224,158,368,518,1104,676,1472
521300,202308,2316,5218,1533,3882,331,865,746,1832,1077,2697
521305,202308,837,1787,517,1276,47,119,329,775,376,894
521308,202308,6065,14559,3595,9668,344,1002,2136,5300,2480,6302
521310,202308,14338,33453,8123,21178,1717,4686,2831,6626,4548,11312
521340,202308,533,1124,306,758,29,79,167,373,196,452
521350,202308,2391,5668,1662,4474,127,389,1168,2985,1295,3374
521370,202308,1611,3923,864,2482,296,886,140,434,436,1320
521375,202308,2186,5277,1242,3418,278,738,331,919,609,1657
521377,202308,1594,3216,1039,2455,131,274,704,1696,835,1970
521380,202308,8404,20724,4303,12358,754,2317,794,2184,1548,4501
521385,202308,873,1921,546,1422,73,179,306,817,379,996
521390,202308,888,2127,510,1446,108,349,103,230,211,579
521400,202308,3846,8315,2470,6083,376,945,1391,3276,1767,4221
521405,202308,1668,4089,923,2571,106,317,450,1141,556,1458
521410,202308,1173,2548,836,1999,212,450,423,1057,635,1507
521440,202308,1785,4064,1166,2991,318,751,480,1225,798,1976
521450,202308,5518,14776,3458,10246,911,2667,758,2144,1669,4811
521460,202308,8517,19639,4876,12815,1298,3466,1367,3426,2665,6892
521470,202308,1086,2472,621,1548,105,229,315,739,420,968
521480,202308,726,1423,409,900,49,107,234,446,283,553
521483,202308,2859,6420,1822,4704,618,1578,555,1441,1173,3019
521486,202308,2155,4815,1429,3602,127,258,909,2204,1036,2462
521487,202308,613,1325,413,1004,78,169,239,570,317,739
521490,202308,1029,2477,695,1877,38,133,480,1166,518,1299
521500,202308,2495,6085,1568,4298,224,670,768,1906,992,2576
521520,202308,1065,2245,749,1732,99,211,462,1048,561,1259
521523,202308,19419,50722,13608,39374,4175,12007,4885,13272,9060,25279
521525,202308,1325,2937,892,2241,132,380,513,1189,645,1569
521530,202308,2780,6835,1605,4423,316,861,466,1144,782,2005
521540,202308,903,2187,612,1678,158,474,231,561,389,1035
521550,202308,2221,5202,937,2531,191,559,216,600,407,1159
521560,202308,7503,17304,4863,13226,1373,3847,1739,4737,3112,8584
521565,202308,846,1945,521,1368,99,279,226,551,325,830
521570,202308,5727,14144,3365,9397,822,2453,534,1473,1356,3926
521580,202308,697,1527,372,937,72,184,151,329,223,513
521590,202308,1121,2290,723,1688,110,278,409,881,519,1159
521600,202308,551,1326,294,812,55,161,129,314,184,475
521630,202308,2151,4338,1120,2685,367,915,259,550,626,1465
521640,202308,2448,5442,1362,3585,294,867,360,853,654,1720
521645,202308,655,1590,311,919,142,394,22,53,164,447
521680,202308,1799,4401,1265,3430,328,910,518,1322,846,2232
521690,202308,646,1499,457,1182,68,198,244,576,312,774
521710,202308,4385,9866,2600,6664,540,1488,819,1869,1359,3357
521720,202308,3090,6509,1683,4170,201,519,878,2066,1079,2585
521730,202308,5598,13656,3427,9537,949,2902,697,1537,1646,4439
521740,202308,6100,13998,3901,9974,1163,3179,1234,2573,2397,5752
521760,202308,24579,55861,18086,45438,3816,10360,9884,22815,13700,33175
521770,202308,4079,8895,2229,5703,445,1179,495,1243,940,2422
521800,202308,9177,21597,5605,15220,1834,4997,1282,3723,3116,8720
521805,202308,1428,2813,767,1805,153,332,343,826,496,1158
521810,202308,935,1997,597,1472,97,246,352,858,449,1104
521830,202308,7755,18773,5651,15042,684,1915,3600,8954,4284,10869
521839,202308,1101,2337,725,1676,58,151,493,1025,551,1176
521850,202308,9268,19924,5067,12823,1692,4359,652,1550,2344,5909
521860,202308,2101,5343,1211,3483,249,753,321,807,570,1560
521870,202308,933,2344,583,1629,118,362,238,563,356,925
521878,202308,1111,2672,607,1624,62,175,319,770,381,945
521880,202308,33211,75118,20909,53591,4107,11279,9065,20770,13172,32049
521890,202308,4260,9983,2371,6301,656,1724,606,1467,1262,3191
521900,202308,1772,3924,875,2324,304,752,60,160,364,912
521910,202308,1708,3592,1120,2699,287,675,412,936,699,1611
521920,202308,709,1642,475,1218,55,174,274,630,329,804
521925,202308,1088,2472,650,1696,141,343,302,756,443,1099
521930,202308,7012,15815,4003,10782,1248,2911,1410,4087,2658,6998
521935,202308,1251,2814,755,1912,93,249,438,1034,531,1283
521940,202308,1636,3417,946,2329,148,394,530,1220,678,1614
521945,202308,866,1985,480,1268,93,223,231,597,324,820
521950,202308,944,2052,574,1422,116,259,250,620,366,879
521960,202308,825,1974,529,1400,64,194,291,675,355,869
521970,202308,3491,7312,2415,5791,293,653,1559,3669,1852,4322
521971,202308,983,2245,475,1283,114,298,116,279,230,577
521973,202308,2146,5132,1305,3528,220,594,580,1477,800,2071
521975,202308,18200,41451,13222,33200,2184,5838,7828,18235,10012,24073
521980,202308,2779,6054,1893,4746,153,428,1359,3269,1512,3697
521990,202308,1802,4016,1309,3193,247,640,726,1698,973,2338
522000,202308,3285,7802,2241,6189,862,2483,634,1770,1496,4253
522005,202308,526,1073,272,682,46,136,101,235,147,371
522010,202308,6132,14174,3744,9777,868,2355,1202,2852,2070,5207
522015,202308,1350,3209,894,2405,255,665,335,881,590,1546
522020,202308,6917,14914,4042,10086,910,2391,1755,4206,2665,6597
522026,202308,973,2355,581,1617,94,291,194,471,288,762
522028,202308,673,1504,392,965,53,155,217,475,270,630
522040,202308,4863,9734,2838,6572,569,1291,1401,2944,1970,4235
522045,202308,27611,69418,17589,49844,3965,11626,4478,11731,8443,23357
522050,202308,1542,3634,950,2492,187,553,433,978,620,1531
522060,202308,4134,9919,2523,6967,520,1383,1007,2726,1527,4109
522068,202308,2274,4867,1605,3915,185,392,1078,2547,1263,2939
522070,202308,1084,2099,820,1717,30,69,681,1359,711,1428
522100,202308,1112,2573,650,1753,105,281,259,660,364,941
522108,202308,1502,2994,1051,2347,59,155,808,1683,867,1838
522119,202308,2515,5314,1839,4347,268,579,1131,2635,1399,3214
522130,202308,687,1507,459,1132,33,81,339,807,372,888
522140,202308,32664,76681,19573,51364,4391,12020,5917,13859,10308,25879
522145,202308,938,2105,606,1566,142,400,296,718,438,1118
522150,202308,1388,3027,786,1970,174,418,238,600,412,1018
522155,202308,1222,2907,751,2004,140,372,410,1057,550,1429
522157,202308,940,1845,688,1500,47,108,517,1126,564,1234
522160,202308,8013,18738,4451,11916,1173,3334,469,1291,1642,4625
522170,202308,3463,8191,2422,6421,386,984,1374,3559,1760,4543
522180,202308,959,2021,516,1177,108,236,144,324,252,560
522185,202308,32989,74088,20993,55496,8730,24651,3056,8192,11786,32843
522190,202308,1030,2180,616,1512,91,249,311,644,402,893
522200,202308,2767,6880,1777,4950,429,1181,631,1676,1060,2857
522205,202308,2021,4595,1243,3194,514,1431,254,545,768,1976
522220,202308,1528,3261,965,2436,138,339,518,1313,656,1652
522230,202308,1703,3732,1089,2684,123,333,658,1518,781,1851
530010,202308,378113,869695,287568,712335,43952,114032,163452,376147,207404,490179
110001,202307,4836,12476,2891,8657,730,2349,795,2172,1525,4521
110002,202307,18230,42662,11382,30122,2756,7734,3234,7950,5990,15684
110003,202307,918,2508,584,1782,149,465,115,317,264,782
110004,202307,17950,41868,10139,27217,2269,6330,3395,8366,5664,14696
110005,202307,3095,7585,1854,5260,504,1461,559,1556,1063,3017
110006,202307,1825,4770,1008,3030,200,654,196,510,396,1164
110007,202307,1493,3556,767,2215,209,618,141,416,350,1034
110008,202307,4334,10056,2959,8008,600,1432,1575,4698,2175,6130
110009,202307,5591,14489,3140,9725,678,2248,918,2597,1596,4845
110010,202307,10226,27964,7204,22470,1878,5192,3111,10998,4989,16190
110011,202307,9672,23402,5857,16176,1629,4708,1240,3119,2869,7827
110012,202307,22673,52134,12836,34258,3204,8531,3491,8626,6695,17157
110013,202307,7504,19507,4704,13952,1747,5438,751,2170,2498,7608
110014,202307,4692,11334,2719,7521,515,1517,1101,2870,1616,4387
110015,202307,7683,17933,4306,11498,1041,3102,1297,2759,2338,5861
110018,202307,5820,13591,3025,8123,683,1927,732,1705,1415,3632
110020,202307,121459,253208,82520,193985,17082,41797,42675,96828,59757,138625
110025,202307,5881,13324,3524,8997,574,1626,1756,4052,2330,5678
110026,202307,721,1788,425,1229,101,300,115,340,216,640
110028,202307,9325,21974,4853,13481,1230,3770,479,1202,1709,4972
110029,202307,1935,4486,988,2755,196,554,401,1063,597,1617
110030,202307,18275,40197,9568,25420,2857,8030,1338,3390,4195,11420
110032,202307,4639,11787,2435,7211,774,2325,382,1137,1156,3462
110033,202307,5873,15876,4132,12552,1221,3753,1392,4335,2613,8088
110034,202307,3874,8683,2290,6208,859,2477,489,1366,1348,3843
110037,202307,1828,5122,1131,3703,316,1086,271,834,587,1920
110040,202307,3579,9203,2285,6729,642,2044,492,1277,1134,3321
110045,202307,5605,14819,3592,10892,1006,3248,1046,2979,2052,6227
110050,202307,2068,5209,1117,3375,378,1259,108,233,486,1492
110060,202307,1148,3152,627,1925,178,530,121,346,299,876
110070,202307,1789,5099,1153,3688,341,1158,248,658,589,1816
110080,202307,8042,17886,5387,13871,1286,3387,2486,6352,3772,9739
110090,202307,741,1896,441,1309,113,377,130,360,243,737
110092,202307,1745,4645,1076,3291,258,817,504,1475,762,2292
110094,202307,3575,9549,2405,7272,770,2404,437,1384,1207,3788
110100,202307,2128,5620,1511,4451,544,1659,432,1242,976,2901
110110,202307,2294,5689,1425,4129,414,1293,228,706,642,1999
110120,202307,1670,4331,1006,2979,272,825,265,744,537,1569
110130,202307,3267,7542,1687,4616,417,1200,189,498,606,1698
110140,202307,3089,7948,2082,5954,461,1445,942,2489,1403,3934
110143,202307,1739,4393,1121,3204,301,934,364,964,665,1898
110145,202307,1123,2726,588,1674,176,484,196,571,372,1055
110146,202307,646,1584,386,1094,140,379,105,334,245,713
110147,202307,960,2262,499,1328,63,173,245,563,308,736
110148,202307,1185,2985,492,1481,122,399,54,100,176,499
110149,202307,4339,10338,2644,7335,877,2497,589,1651,1466,4148
110150,202307,2965,7312,1665,5007,577,1902,182,530,759,2432
110155,202307,1062,2846,652,1860,127,407,255,641,382,1048
110160,202307,1820,4966,1130,3458,407,1284,153,451,560,1735
110170,202307,2469,5852,1456,3953,262,777,778,1877,1040,2654
110175,202307,2741,6982,1644,4742,286,912,718,1904,1004,2816
110180,202307,1621,4030,1014,2858,265,798,289,763,554,1561
120001,202307,4447,11117,3286,9253,478,1543,2074,5550,2552,7093
120005,202307,2533,8469,2196,7894,261,971,1547,5645,1808,6616
120010,202307,7754,18334,6459,16330,619,1486,4868,12154,5487,13640
120013,202307,3185,8915,2583,7975,950,2930,887,2973,1837,5903
120017,202307,3793,9113,2934,7791,435,1129,1853,5067,2288,6196
120020,202307,19786,60110,17323,55340,1305,4461,12948,40705,14253,45166
120025,202307,4698,10536,3628,9155,560,1408,2268,5928,2828,7336
120030,202307,7693,27422,6780,25649,562,2399,4737,18092,5299,20491
120032,202307,2157,8449,1988,8098,108,650,1631,6454,1739,7104
120033,202307,5513,16062,5009,15176,137,602,4251,12511,4388,13113
120034,202307,3680,10971,3090,9984,163,693,2494,7802,2657,8495
120035,202307,5229,16159,4716,15269,244,935,4009,12668,4253,13603
120038,202307,4157,10554,3358,9246,580,1642,1949,5384,2529,7026
120039,202307,2522,9476,2262,8921,170,892,1707,6554,1877,7446
120040,202307,79597,190174,62663,161792,8157,21706,38478,95003,46635,116709
120042,202307,4360,13127,3842,12148,167,672,3151,9723,3318,10395
120043,202307,1826,6405,1510,5916,76,492,1184,4440,1260,4932
120045,202307,7342,16590,5681,14315,692,1814,3834,9507,4526,11321
120050,202307,12360,36322,10889,33912,506,1978,8747,26828,9253,28806
120060,202307,12355,40619,10876,38173,558,2686,8845,30277,9403,32963
120070,202307,4442,12085,3597,10741,693,1951,2034,6388,2727,8339
120080,202307,7020,16113,6018,14566,705,1654,4479,10717,5184,12371
130002,202307,4330,13585,3701,12703,405,1092,2923,10478,3328,11570
130006,202307,3215,9930,2531,8789,459,1452,1539,5710,1998,7162
130008,202307,3317,9907,2770,9082,202,676,2177,7246,2379,7922
130010,202307,5424,12778,4535,11660,164,444,3961,10009,4125,10453
130014,202307,4983,12429,3412,9883,752,2206,1721,5165,2473,7371
130020,202307,3402,12058,2809,11032,215,1176,2040,7703,2255,8879
130030,202307,20044,40964,17832,38343,224,590,16769,35540,16993,36130
130040,202307,5029,13548,3940,12095,620,1761,2667,8486,3287,10247
130050,202307,8784,29062,7168,26599,600,2357,5383,19885,5983,22242
130060,202307,8894,32135,7419,29994,322,1861,6045,23871,6367,25732
130063,202307,8012,22883,6894,21497,217,908,6153,18868,6370,19776
130068,202307,4799,13393,3897,12133,257,968,3119,9606,3376,10574
130070,202307,9024,23359,7073,20920,792,2029,5120,15556,5912,17585
130080,202307,9547,27829,7917,25780,332,1130,6702,21846,7034,22976
130083,202307,3729,10255,3092,9415,241,735,2470,7728,2711,8463
130090,202307,5030,12311,4311,11420,93,284,3725,10025,3818,10309
130100,202307,9018,25405,7338,23509,189,709,6365,20375,6554,21084
130110,202307,10994,26246,8510,22947,1742,4163,5083,15012,6825,19175
130115,202307,6313,17131,5112,15503,154,491,4318,13126,4472,13617
130120,202307,21180,57642,17897,53011,1814,5708,13823,40630,15637,46338
130130,202307,7265,19346,5453,16862,738,2157,3690,12022,4428,14179
130140,202307,9087,27517,7692,25727,370,1581,6471,21414,6841,22995
130150,202307,4949,14582,4464,13916,251,1047,3709,11390,3960,12437
130160,202307,8123,21671,6820,19953,337,937,5926,17349,6263,18286
130165,202307,4250,13588,3842,12995,133,581,3295,11025,3428,11606
130170,202307,17971,40436,14327,35902,434,1329,12571,30644,13005,31973
130180,202307,5383,15261,5012,14800,55,327,4751,13868,4806,14195
130185,202307,25596,53374,20025,46836,1573,2507,16372,39437,17945,41944
130190,202307,26534,73739,20836,65006,2348,6977,14903,46736,17251,53713
130195,202307,3047,9976,2504,9244,127,565,2040,7573,2167,8138
130200,202307,3779,8909,2912,7692,220,698,2190,5582,2410,6280
130210,202307,2001,6599,1772,6310,180,733,1383,4889,1563,5622
130220,202307,3309,8897,2663,8098,123,363,2290,7027,2413,7390
130230,202307,6374,22133,5489,20873,201,1100,4801,18153,5002,19253
130240,202307,18159,40395,14753,36076,212,973,13495,32057,13707,33030
130250,202307,32486,85674,26399,77714,1616,4275,20973,62439,22589,66714
130255,202307,6155,16277,4935,14142,256,719,3907,10998,4163,11717
130260,202307,494610,1080267,386116,919541,66586,170086,246962,559421,313548,729507
130270,202307,12555,37717,9962,33591,2021,6086,6169,21734,8190,27820
130280,202307,4663,15161,4145,14518,156,677,3646,12662,3802,13339
130290,202307,21966,52367,18947,48603,580,1793,17137,43166,17717,44959
130300,202307,6207,17595,5243,16203,211,823,4276,12945,4487,13768
130310,202307,10740,25034,9082,22869,557,1434,7457,18496,8014,19930
130320,202307,4281,12691,3349,11232,515,1699,2079,7040,2594,8739
130330,202307,5674,15632,4391,13974,246,835,3535,11328,3781,12163
130340,202307,31422,79838,25949,73066,1757,4325,21093,60695,22850,65020
130350,202307,4615,15071,4046,14284,157,792,3448,11985,3605,12777
130353,202307,9664,23344,7311,19989,1332,3410,4395,12384,5727,15794
130356,202307,6978,18812,5510,16445,1261,3552,2955,9126,4216,12678
130360,202307,3642,10858,2750,9620,166,722,2240,7648,2406,8370
130370,202307,6308,24913,5117,22938,678,3654,3017,13456,3695,17110
130380,202307,10042,38710,9071,36930,773,3549,6845,27488,7618,31037
130390,202307,9181,30890,7677,28464,541,2560,6280,22730,6821,25290
130395,202307,3130,8539,2475,7462,162,580,1978,5788,2140,6368
130400,202307,3670,9675,2949,8652,98,313,2557,7395,2655,7708
130406,202307,14761,45352,12115,41774,3040,9141,6994,25616,10034,34757
130410,202307,5591,16930,4639,15413,1254,4197,2500,8590,3754,12787
130420,202307,19681,56781,16222,52186,2361,7131,11050,36514,13411,43645
130423,202307,5411,15516,4554,14405,221,884,3942,12215,4163,13099
130426,202307,3935,12128,3460,11548,80,276,3002,10444,3082,10720
130430,202307,6275,13753,5179,12316,218,567,4451,10279,4669,10846
130440,202307,7287,17225,6031,15645,136,449,5497,14037,5633,14486
140002,202307,3101,8186,2517,7421,331,839,1788,5511,2119,6350
140005,202307,4224,11100,3412,10016,1883,5699,919,2691,2802,8390
140010,202307,71611,184130,52852,152504,13750,41190,17868,51268,31618,92458
140015,202307,7629,15364,6252,13829,280,597,5514,12096,5794,12693
140017,202307,7274,16625,5753,14575,389,970,4495,11345,4884,12315
140020,202307,7093,17276,5719,15423,764,1968,3799,10551,4563,12519
140023,202307,3575,9026,2695,7718,355,1075,1924,5461,2279,6536
140028,202307,2542,6012,2005,5287,142,371,1518,4015,1660,4386
140030,202307,7760,16064,6319,14268,367,711,5339,11968,5706,12679
140040,202307,3664,12782,3299,12282,147,819,2806,10198,2953,11017
140045,202307,5192,16240,4287,14866,1236,3571,2190,8623,3426,12194
140047,202307,7774,19906,6115,17223,946,2667,3668,10440,4614,13107
140050,202307,2245,5687,1734,4851,323,754,1002,2915,1325,3669
140060,202307,2853,6117,2362,5427,227,455,1846,4200,2073,4655
140070,202307,2540,11842,2391,11515,166,1128,1871,8771,2037,9899
150010,202307,65979,135062,54620,119224,1365,2845,47875,101755,49240,104600
150013,202307,2749,5596,2174,4915,87,180,1850,4122,1937,4302
150020,202307,19340,48480,16867,44882,1691,3661,13182,35755,14873,39416
150030,202307,11645,36269,10120,34212,818,2172,7874,28249,8692,30421
150034,202307,5298,11382,3803,9239,250,597,2930,6955,3180,7552
150040,202307,20260,47379,16558,42718,1039,1777,14199,37615,15238,39392
150050,202307,9990,26504,8685,24650,268,871,7694,21815,7962,22686
150060,202307,30665,73620,22694,60734,3570,9490,13476,35971,17046,45461
150070,202307,10955,30751,9211,28436,287,1161,8166,24799,8453,25960
150080,202307,115757,244761,82996,194357,22560,51530,28837,73191,51397,124721
150085,202307,12372,28311,10512,25912,182,499,9754,23715,9936,24214
150090,202307,16020,40333,14332,37502,563,1461,12478,32016,13041,33477
150095,202307,9240,19631,7499,17327,845,1402,5837,13773,6682,15175
150100,202307,3742,11281,3120,10239,183,635,2564,8320,2747,8955
150110,202307,5754,19194,5196,18495,167,694,4651,16522,4818,17216
150120,202307,10107,26655,8777,24651,379,875,7565,21233,7944,22108
150125,202307,1121,2623,756,2074,91,297,468,1229,559,1526
150130,202307,31873,79439,24903,67655,4885,11853,14590,41035,19475,52888
150140,202307,388099,734669,295910,601035,24019,49982,218519,421938,242538,471920
150145,202307,5144,14688,3846,12447,1520,4913,949,3656,2469,8569
150150,202307,23240,50077,17996,42770,1759,4008,12538,29191,14297,33199
150157,202307,4493,11031,3273,9171,469,1371,1909,5343,2378,6714
150160,202307,5189,10746,4394,9528,303,718,3493,7130,3796,7848
150170,202307,36213,90582,30657,80843,5599,12959,19155,53188,24754,66147
150172,202307,7314,16110,5527,13460,377,975,4249,10157,4626,11132
150175,202307,2580,6232,2061,5352,161,552,1614,3911,1775,4463
150178,202307,16000,33379,11516,27895,1067,1519,8873,22870,9940,24389
150180,202307,36488,91682,31540,85601,2696,4811,25115,72873,27811,77684
150190,202307,9848,23860,8603,22265,140,448,7739,19632,7879,20080
150195,202307,6517,17394,5757,16239,176,566,5132,14269,5308,14835
150200,202307,7379,18492,6362,17200,83,271,5695,15277,5778,15548
150210,202307,42010,106797,37781,100768,1283,3343,33178,88093,34461,91436
150215,202307,14559,36948,10963,29833,1836,5229,6243,16262,8079,21491
150220,202307,18027,42392,14310,36403,732,1784,10864,26824,11596,28608
150230,202307,18134,42191,15253,37838,1209,2675,11614,28660,12823,31335
150240,202307,45889,111013,34741,90593,7376,19293,15557,38213,22933,57506
150250,202307,5452,17752,4950,17141,347,1219,4270,14834,4617,16053
150260,202307,3755,9761,3089,8702,108,342,2559,6980,2667,7322
150270,202307,11040,28234,6861,20177,1933,5861,1826,5385,3759,11246
150275,202307,9753,24339,8547,22587,206,799,7454,18938,7660,19737
150276,202307,2953,7264,2343,6396,261,683,1590,4504,1851,5187
150277,202307,7032,15316,4858,12262,654,1616,3146,7758,3800,9374
150280,202307,9487,30083,8770,28905,768,2101,6965,23749,7733,25850
150285,202307,4431,12834,3703,11577,236,710,2851,8791,3087,9501
150290,202307,14048,32348,11731,29368,429,950,10227,25576,10656,26526
150293,202307,11899,26293,8541,21370,926,2424,5668,13521,6594,15945
150295,202307,9187,22059,5613,16483,1861,5264,1857,5979,3718,11243
150300,202307,4264,8679,3697,7972,52,141,3437,7313,3489,7454
150304,202307,5463,14143,4264,12185,812,2226,2585,7491,3397,9717
150307,202307,7163,19814,6092,17964,274,793,4761,13871,5035,14664
150309,202307,8002,20413,5857,16576,977,2706,3297,9377,4274,12083
150310,202307,9152,30932,8394,29853,398,1719,7105,25374,7503,27093
150320,202307,11911,27500,9874,24197,1209,2659,6842,16772,8051,19431
150330,202307,19487,50783,17048,47198,2604,5762,11315,34107,13919,39869
150340,202307,3012,7956,2437,7008,256,634,1726,4951,1982,5585
150345,202307,11566,27305,9690,24733,447,1277,8155,20317,8602,21594
150350,202307,12889,26063,10799,23216,1013,1675,8745,18905,9758,20580
150360,202307,32111,78822,23566,66427,2115,4724,17185,49177,19300,53901
150370,202307,14413,36714,10951,31562,1471,3634,7533,22692,9004,26326
150375,202307,4975,17947,4338,16856,281,1198,3474,13258,3755,14456
150380,202307,12805,28471,9523,23778,445,1244,7544,18245,7989,19489
150390,202307,9909,35008,8315,32114,1966,6378,4649,19814,6615,26192
150400,202307,8212,25391,7476,24073,176,573,6279,20608,6455,21181
150405,202307,11169,25391,8790,22018,806,1390,6681,17291,7487,18681
150410,202307,2383,6394,1899,5566,172,470,1303,3774,1475,4244
150420,202307,60373,144132,43022,116300,9481,26876,20971,55704,30452,82580
150430,202307,10186,25610,8435,22933,686,1519,6416,17188,7102,18707
150440,202307,8642,20001,7288,18022,474,1152,6030,14609,6504,15761
150442,202307,39503,78872,29703,65344,1624,3792,22811,47641,24435,51433
150445,202307,10142,23788,8496,21386,180,537,7502,18509,7682,19046
150450,202307,8189,24280,7508,23326,249,1221,6834,20550,7083,21771
150460,202307,10942,29396,9561,27501,529,1259,7835,23050,8364,24309
150470,202307,25647,61332,21264,55321,570,2204,18273,45575,18843,47779
150475,202307,6982,18742,5459,16132,956,2576,3341,10205,4297,12781
150480,202307,17979,47755,15363,43699,4051,10142,8834,27119,12885,37261
150490,202307,10184,31261,8780,29020,792,2295,6632,22548,7424,24843
150495,202307,6851,18574,6071,17370,222,879,5214,14446,5436,15325
150497,202307,3355,9378,2364,7548,437,1414,1220,3925,1657,5339
150500,202307,3822,9031,3099,7841,195,508,2382,5769,2577,6277
150503,202307,7475,17559,4980,14100,1624,4068,1853,5824,3477,9892
150506,202307,17187,42069,14087,37653,2258,5666,9540,26484,11798,32150
150510,202307,16416,42254,13292,36806,1130,2865,10324,28430,11454,31295
150520,202307,10619,31193,9882,30142,134,727,9230,27652,9364,28379
150530,202307,15967,47346,13162,43011,1213,3444,9910,32677,11123,36121
150540,202307,6563,14719,5380,12917,343,783,4355,10262,4698,11045
150543,202307,9157,23278,6830,19696,653,1988,4734,13536,5387,15524
150548,202307,13168,34858,11093,31666,586,1581,9223,26273,9809,27854
150549,202307,2361,5825,1853,5027,113,360,1422,3779,1535,4139
150550,202307,25529,66962,18089,52839,5235,15353,6128,17790,11363,33143
150553,202307,52117,127787,34896,95805,9995,27389,13455,36420,23450,63809
150555,202307,2574,6069,1816,4879,152,398,1228,3326,1380,3724
150560,202307,2506,6070,1983,5121,206,543,1308,3256,1514,3799
150563,202307,3392,8824,2511,7231,590,1774,1253,3519,1843,5293
150565,202307,5668,16138,4575,14136,181,575,3531,10891,3712,11466
150570,202307,9966,23421,8651,21530,227,730,7668,18549,7895,19279
150580,202307,14832,49699,12237,46568,1710,5322,8981,36140,10691,41462
150590,202307,10645,30473,8833,28219,387,1289,7603,24366,7990,25655
150600,202307,13288,34612,11740,32434,494,1390,10200,28054,10694,29444
150610,202307,4076,9073,3392,8021,135,382,2830,6446,2965,6828
150611,202307,4085,9615,3291,8401,106,384,2745,6645,2851,7029
150613,202307,18502,46230,12490,35396,2671,8106,5520,14699,8191,22805
150616,202307,4751,11974,3065,8756,604,1813,1441,3950,2045,5763
150618,202307,9227,22895,6933,19037,1054,3102,4193,11218,5247,14320
150619,202307,8099,20585,6203,17730,1089,2791,3866,11393,4955,14184
150620,202307,9669,27863,7863,24390,1840,5250,3924,12529,5764,17779
150630,202307,9293,18962,8098,17363,146,362,7339,15285,7485,15647
150635,202307,6921,16229,5242,13295,618,1453,3350,8391,3968,9844
150640,202307,2567,6768,2223,6307,69,223,1939,5468,2008,5691
150650,202307,15387,36711,12221,31367,3650,9153,4756,12745,8406,21898
150655,202307,6970,17192,5885,15510,188,743,4871,12323,5059,13066
150658,202307,5460,14515,3573,11118,1025,3348,1379,4207,2404,7555
150660,202307,7032,17819,5667,15563,1363,3592,2913,7887,4276,11479
150670,202307,12828,24877,9260,20385,1169,2802,6430,13802,7599,16604
150680,202307,99759,246572,73189,203018,16368,41774,37534,109240,53902,151014
150690,202307,3289,7080,2555,6063,150,325,2075,4863,2225,5188
150700,202307,8826,21907,7214,19457,999,2084,4968,13891,5967,15975
150710,202307,4753,13405,3967,12069,760,2345,2350,7153,3110,9498
150715,202307,6664,15562,5038,13125,400,1114,3880,9824,4280,10938
150720,202307,10651,25955,9173,23692,357,1181,7790,19285,8147,20466
150730,202307,17056,44841,13369,38925,2209,6684,8540,24946,10749,31630
150740,202307,5080,12362,4013,10606,460,968,2793,7482,3253,8450
150745,202307,7039,17120,5211,14310,712,2111,3431,9219,4143,11330
150746,202307,2186,5449,1820,4886,70,202,1467,3826,1537,4028
150747,202307,6827,16433,5727,14722,400,926,4557,11599,4957,12525
150750,202307,4808,12583,3588,10691,386,1149,2439,7385,2825,8534
150760,202307,14661,37517,12238,33591,2418,6122,7161,20277,9579,26399
150770,202307,8996,26253,7982,24943,264,625,7071,22597,7335,23222
150775,202307,1496,3474,1091,2915,107,333,742,1916,849,2249
150780,202307,6372,16747,5374,15428,248,751,4602,13253,4850,14004
150790,202307,7889,18271,6224,16240,531,1100,4156,12450,4687,13550
150795,202307,21506,54518,17486,48163,3318,8957,10345,28517,13663,37474
150796,202307,5145,10450,4055,9053,265,651,3276,7093,3541,7744
150797,202307,5724,14558,4557,12705,487,1299,3481,9597,3968,10896
150800,202307,18737,50372,15672,45797,3040,8384,9407,28366,12447,36750
150803,202307,11104,25165,9428,22675,300,850,8127,18709,8427,19559
150805,202307,4523,12210,3457,10462,451,1311,2342,7123,2793,8434
150808,202307,8257,22141,5562,17291,1907,6590,763,2395,2670,8985
150810,202307,27242,60274,19277,49390,4576,11343,9680,26511,14256,37854
150812,202307,8464,19059,6885,16393,454,1318,5220,11523,5674,12841
150815,202307,11740,31158,9304,27849,1572,4627,6330,19164,7902,23791
150820,202307,19116,38691,15530,33873,1541,2423,12078,27232,13619,29655
150830,202307,16485,45471,14645,42777,605,1630,12661,36944,13266,38574
150835,202307,4607,12078,3765,10738,432,1256,2611,7359,3043,8615
150840,202307,10914,27005,7867,21642,1087,3247,4595,11833,5682,15080
160005,202307,1865,3870,1526,3452,53,135,1308,2868,1361,3003
160010,202307,2780,6737,2411,6282,44,186,2181,5516,2225,5702
160015,202307,5138,10597,4412,9737,435,786,3739,8358,4174,9144
160020,202307,3226,8295,2670,7518,338,852,1910,5568,2248,6420
160021,202307,1632,5147,1331,4758,73,364,905,3277,978,3641
160023,202307,1770,5311,1470,4776,296,941,833,2803,1129,3744
160025,202307,2314,6070,2077,5782,204,376,1757,5059,1961,5435
160027,202307,14677,29799,12440,26767,975,2049,10117,21566,11092,23615
160030,202307,116680,270372,89980,232018,16135,39457,52299,137867,68434,177324
160040,202307,7922,22500,6756,20811,548,1509,5421,16832,5969,18341
160050,202307,8490,20275,6853,18147,2342,5482,3424,10051,5766,15533
160053,202307,5617,14198,4643,12697,258,632,3772,10448,4030,11080
160055,202307,2216,4246,2015,4004,27,66,1888,3677,1915,3743
160060,202307,39727,83658,31180,72977,3643,7105,23026,54857,26669,61962
160070,202307,4079,11960,3382,10875,430,1171,2427,8206,2857,9377
160080,202307,4071,10442,3404,9657,82,262,3001,8516,3083,8778
170025,202307,780,1939,415,1234,105,300,93,276,198,576
170030,202307,1368,3764,884,2748,188,560,305,955,493,1515
170035,202307,1695,4014,1075,2868,109,317,613,1523,722,1840
170040,202307,2204,5393,1498,4232,248,690,741,2146,989,2836
170070,202307,2356,4981,1452,3630,113,322,860,2067,973,2389
170100,202307,3014,7414,2143,5843,299,720,1339,3629,1638,4349
170105,202307,779,2051,452,1377,106,321,134,356,240,677
170110,202307,1319,3394,855,2528,74,263,477,1300,551,1563
170130,202307,1782,4381,1182,3316,106,351,751,1992,857,2343
170190,202307,1861,4348,1288,3366,159,505,793,1887,952,2392
170200,202307,2353,5214,1280,3298,285,707,455,1096,740,1803
170210,202307,33978,84344,21524,60789,5795,17030,4091,11434,9886,28464
170215,202307,1517,3654,1039,2870,99,333,684,1783,783,2116
170220,202307,6842,19378,5114,16104,2379,7523,949,3424,3328,10947
170230,202307,1496,3877,988,2840,188,559,438,1167,626,1726
170240,202307,3582,8154,2563,6451,236,665,1748,4129,1984,4794
170255,202307,4398,11676,2932,8884,511,1606,1408,4128,1919,5734
170270,202307,985,2280,617,1641,77,205,357,895,434,1100
170290,202307,3735,9203,3004,8065,319,625,2203,6117,2522,6742
170300,202307,2578,5834,1825,4618,132,367,1312,3104,1444,3471
170305,202307,804,2000,546,1474,91,248,252,666,343,914
170307,202307,1355,3704,1005,3002,119,391,623,1706,742,2097
170310,202307,1933,4306,1206,3096,188,503,599,1448,787,1951
170320,202307,1250,3025,799,2231,103,313,446,1192,549,1505
170330,202307,1195,3202,992,2830,45,185,745,1973,790,2158
170360,202307,708,1631,462,1231,43,116,268,627,311,743
170370,202307,1604,3637,960,2513,135,395,519,1205,654,1600
170380,202307,2153,5620,1494,4490,122,385,852,2549,974,2934
170382,202307,587,1569,427,1273,17,73,268,711,285,784
170384,202307,2075,6265,1537,5131,298,962,740,2335,1038,3297
170386,202307,1129,2911,539,1662,71,241,187,511,258,752
170388,202307,843,2046,546,1516,90,261,297,760,387,1021
170389,202307,987,2861,693,2305,111,404,366,1213,477,1617
170390,202307,2153,4294,1439,3360,71,204,1115,2546,1186,2750
170410,202307,722,1645,471,1201,32,90,308,716,340,806
170460,202307,502,1250,330,935,43,128,179,471,222,599
170510,202307,1068,2698,649,1892,41,157,414,1094,455,1251
170550,202307,8203,19560,5454,14766,1374,3986,1897,4802,3271,8788
170555,202307,1630,3928,1080,2920,138,346,524,1396,662,1742
170560,202307,1137,2910,762,2280,103,291,396,1202,499,1493
170600,202307,1629,3987,1096,3086,163,424,606,1686,769,2110
170610,202307,1982,4548,1280,3325,97,306,836,1984,933,2290
170625,202307,517,1252,307,835,44,109,130,313,174,422
170650,202307,1816,4430,1355,3639,135,438,891,2218,1026,2656
170700,202307,4307,11434,2847,8339,568,1717,1158,3098,1726,4815
170710,202307,2072,4456,1367,3351,140,358,912,2139,1052,2497
170720,202307,2262,4932,1504,3722,150,346,1013,2396,1163,2742
170730,202307,1318,3160,841,2336,114,268,492,1354,606,1622
170740,202307,2420,7030,1872,5959,162,606,1328,4039,1490,4645
170755,202307,1025,2480,626,1761,117,354,276,688,393,1042
170765,202307,1337,3160,825,2228,142,377,413,1054,555,1431
170770,202307,2229,5667,1631,4638,121,380,1186,3218,1307,3598
170820,202307,4695,12180,3106,9169,637,1873,1386,3916,2023,5789
170825,202307,1282,2666,891,2073,84,190,650,1449,734,1639
170830,202307,1601,3761,1070,2851,340,951,372,839,712,1790
170900,202307,3764,10064,3049,8977,442,1155,2082,6202,2524,7357
170930,202307,4884,11929,3264,8786,747,2111,1157,2837,1904,4948
170950,202307,14109,36189,8193,24357,2422,7559,1065,3001,3487,10560
170980,202307,625,1431,342,917,44,122,157,396,201,518
171050,202307,1993,5546,1558,4744,136,426,1108,3354,1244,3780
171070,202307,1605,3986,1242,3398,261,610,626,1914,887,2524
171090,202307,1171,2878,838,2332,142,420,431,1142,573,1562
171110,202307,667,1697,388,1127,67,196,172,455,239,651
171150,202307,1141,2599,623,1708,121,390,295,685,416,1075
171180,202307,815,2149,432,1368,84,266,148,459,232,725
171190,202307,2420,6851,1890,5860,310,1003,1042,3184,1352,4187
171195,202307,1011,2787,691,2132,93,312,394,1116,487,1428
171200,202307,721,1889,440,1353,111,366,110,297,221,663
171215,202307,490,1165,355,909,53,156,163,369,216,525
171240,202307,907,2632,624,2086,17,89,425,1329,442,1418
171245,202307,898,2396,590,1752,62,222,281,721,343,943
171250,202307,1098,2837,643,1951,93,285,245,723,338,1008
171270,202307,579,1834,396,1409,74,303,186,618,260,921
171280,202307,1034,2780,737,2240,59,183,441,1311,500,1494
171320,202307,4740,12121,3063,8832,639,1844,1112,3122,1751,4966
171330,202307,3641,8962,2349,6567,609,1721,958,2526,1567,4247
171360,202307,1904,4649,1211,3532,127,327,714,2208,841,2535
171370,202307,817,1935,550,1524,74,228,317,811,391,1039
171380,202307,1642,4051,1175,3284,159,406,709,1985,868,2391
171395,202307,1189,2803,753,2074,118,333,408,1085,526,1418
171420,202307,2396,5863,1568,4261,269,714,813,2073,1082,2787
171430,202307,1295,3385,899,2585,82,254,540,1417,622,1671
171488,202307,2994,7462,2031,5712,366,1077,982,2601,1348,3678
171500,202307,1039,2427,611,1622,86,255,330,828,416,1083
171510,202307,1010,2819,763,2323,64,257,491,1364,555,1621
171515,202307,574,1279,372,948,36,110,237,538,273,648
171525,202307,851,2066,523,1461,63,187,308,782,371,969
171550,202307,409,1062,264,818,37,156,117,303,154,459
171570,202307,1311,3431,964,2749,143,414,559,1509,702,1923
171575,202307,1847,4457,1117,3124,139,383,601,1594,740,1977
171610,202307,7244,18812,4535,13638,1190,3864,795,2361,1985,6225
171620,202307,3624,8016,2865,6850,165,409,2261,5226,2426,5635
171630,202307,1321,3163,891,2480,135,382,513,1436,648,1818
171650,202307,2721,7196,1770,5304,460,1478,367,1029,827,2507
171660,202307,2751,6311,1688,4457,126,364,1157,2906,1283,3270
171665,202307,1479,3809,1006,2934,240,774,366,1000,606,1774
171670,202307,2177,5264,1457,3947,266,773,647,1601,913,2374
171700,202307,1374,3491,900,2542,136,372,509,1374,645,1746
171720,202307,872,2016,544,1444,64,168,331,851,395,1019
171750,202307,1611,4477,995,3211,214,691,291,1053,505,1744
171780,202307,1506,3433,958,2497,91,283,587,1408,678,1691
171790,202307,1620,4794,1203,3921,180,602,614,1898,794,2500
171800,202307,859,2074,562,1543,69,187,308,771,377,958
171820,202307,14447,36839,8932,26348,2054,6377,2255,6511,4309,12888
171830,202307,1876,5250,1478,4483,367,1015,650,2184,1017,3199
171840,202307,850,2004,539,1446,27,82,333,825,360,907
171845,202307,829,1821,531,1342,41,115,353,817,394,932
171850,202307,1239,3198,945,2601,47,189,733,1860,780,2049
171855,202307,1191,3319,819,2539,105,337,452,1309,557,1646
171865,202307,587,1508,417,1171,68,215,219,538,287,753
171870,202307,943,2371,562,1659,121,384,231,642,352,1026
171875,202307,1763,4199,1319,3468,56,234,1023,2509,1079,2743
171880,202307,1825,4204,1427,3607,61,188,1117,2719,1178,2907
171884,202307,1375,3160,920,2353,144,362,547,1361,691,1723
171886,202307,1744,4332,1105,3248,313,975,276,825,589,1800
171888,202307,669,1784,421,1261,39,133,243,661,282,794
171889,202307,509,1448,299,994,85,285,88,273,173,558
171890,202307,1575,4074,979,2943,110,355,552,1553,662,1908
171900,202307,679,2031,461,1556,63,190,226,754,289,944
172000,202307,664,1857,439,1363,82,257,151,445,233,702
172010,202307,1585,4284,1167,3480,109,284,745,2190,854,2474
172015,202307,433,1359,288,1032,57,221,123,398,180,619
172020,202307,3471,8755,2687,7472,298,827,1760,4861,2058,5688
172025,202307,860,2104,528,1489,40,125,348,905,388,1030
172030,202307,1475,3959,1090,3258,97,338,737,2084,834,2422
172049,202307,1391,3278,820,2375,109,301,429,1262,538,1563
172065,202307,1798,4088,1240,3266,161,382,648,1849,809,2231
172080,202307,2737,7274,1993,5827,124,397,1326,3758,1450,4155
172085,202307,491,1255,271,798,46,130,85,222,131,352
172090,202307,4937,10600,3588,8595,157,499,2776,6190,2933,6689
172093,202307,535,1471,348,1084,23,116,201,556,224,672
172097,202307,755,1830,413,1176,64,201,159,415,223,616
172100,202307,64601,146207,39983,102685,7374,20442,17059,40816,24433,61258
172110,202307,2093,6420,1623,5592,115,513,1207,3995,1322,4508
172120,202307,6285,16267,4281,12616,575,1663,2414,6948,2989,8611
172125,202307,482,1183,298,829,22,74,157,367,179,441
172130,202307,643,1528,416,1115,21,70,247,580,268,650
172208,202307,2993,6536,2091,5213,166,394,1468,3541,1634,3935
172210,202307,3164,7011,2167,5514,223,534,1452,3724,1675,4258
210005,202307,24036,61203,15978,46711,4489,13566,5987,17057,10476,30623
210010,202307,2662,6639,2341,6199,51,212,2093,5414,2144,5626
210015,202307,3808,10109,3088,9013,141,440,2515,7245,2656,7685
210020,202307,9565,18630,7739,16366,430,737,6561,13767,6991,14504
210030,202307,5453,16207,4660,14880,488,1608,3465,10829,3953,12437
210040,202307,2553,5048,2107,4481,66,179,1833,3765,1899,3944
210043,202307,6792,17465,5325,15202,362,1134,3975,11122,4337,12256
210047,202307,8368,21762,6256,18778,184,746,5145,15206,5329,15952
210050,202307,2995,8078,2245,6636,190,744,1620,4484,1810,5228
210055,202307,2569,6564,2117,5848,58,165,1804,5028,1862,5193
210060,202307,8724,28776,7318,26050,964,3482,4729,17029,5693,20511
210070,202307,8019,18616,6968,17155,143,392,6245,15140,6388,15532
210080,202307,5381,14598,4867,13929,82,374,4294,12060,4376,12434
210083,202307,7211,16469,5881,14900,119,459,5359,13264,5478,13723
210087,202307,3126,8044,2515,7166,132,406,2044,5743,2176,6149
210090,202307,10872,29705,9495,27316,572,1316,7809,22390,8381,23706
210095,202307,7320,22679,6274,20997,708,2330,4501,15499,5209,17829
210100,202307,7638,20869,6082,17906,922,2533,3776,11100,4698,13633
210110,202307,3739,9222,3270,8590,63,274,2884,7371,2947,7645
210120,202307,35360,75329,27283,63931,1223,2552,21732,49315,22955,51867
210125,202307,5485,12944,4477,11635,908,1863,2959,8243,3867,10106
210130,202307,4918,11315,3763,9766,59,178,3307,8450,3366,8628
210135,202307,2146,4703,1672,3984,55,147,1443,3346,1498,3493
210140,202307,25633,61268,17705,48700,2496,6655,10195,27209,12691,33864
210150,202307,5572,11890,4501,10329,100,280,3807,8416,3907,8696
210160,202307,26623,59701,21283,52324,2105,4393,15726,38670,17831,43063
210170,202307,21312,53765,18273,49318,2113,4990,13202,36218,15315,41208
210173,202307,2570,8324,2338,7909,83,364,2034,6731,2117,7095
210177,202307,3820,9536,3107,8537,440,1106,2201,6168,2641,7274
210180,202307,1847,4095,1498,3603,44,122,1281,3048,1325,3170
210190,202307,6870,15028,5343,12748,111,248,4654,10844,4765,11092
210193,202307,1584,3992,1266,3470,69,215,962,2605,1031,2820
210197,202307,2351,6526,1969,5925,167,452,1503,4569,1670,5021
210200,202307,9654,26329,8007,23676,751,2287,5892,17100,6643,19387
210203,202307,8185,21740,6430,19235,629,1809,4708,14253,5337,16062
210207,202307,4543,10112,3414,8621,203,560,2603,6489,2806,7049
210210,202307,8850,24657,7623,22843,217,1009,6224,18149,6441,19158
210215,202307,2890,8130,2409,7373,155,630,1902,5671,2057,6301
210220,202307,8545,23368,7645,21911,280,1341,6540,17844,6820,19185
210230,202307,6868,17245,5905,15642,187,524,5216,13588,5403,14112
210232,202307,14684,39000,11420,33848,1518,4334,7643,22850,9161,27184
210235,202307,3989,10707,3236,9459,147,509,2613,7484,2760,7993
210237,202307,5015,10724,4103,9624,56,159,3767,8627,3823,8786
210240,202307,3026,8123,2551,7322,113,302,2026,5772,2139,6074
210250,202307,7197,17567,6268,16325,137,482,5553,14143,5690,14625
210255,202307,3147,8585,2354,6977,281,866,1419,4002,1700,4868
210260,202307,6351,16609,5243,14876,518,1557,4038,11196,4556,12753
210270,202307,5680,13629,4722,12326,173,657,3975,10065,4148,10722
210275,202307,3951,9039,3142,7979,186,424,2502,6342,2688,6766
210280,202307,7643,17202,5948,14557,152,641,4738,10769,4890,11410
210290,202307,9924,21587,8435,19716,141,395,7729,17698,7870,18093
210300,202307,37837,96208,28443,81053,7901,22619,10581,33149,18482,55768
210310,202307,3592,7971,2957,7057,39,116,2668,6256,2707,6372
210312,202307,3458,7186,2915,6545,38,147,2613,5649,2651,5796
210315,202307,4363,9550,3755,8837,129,335,3435,7995,3564,8330
210317,202307,5165,14238,4532,13372,132,528,3988,11614,4120,12142
210320,202307,33481,70437,29569,65298,388,1456,26968,57828,27356,59284
210325,202307,4148,10762,3125,9221,539,1734,2017,5754,2556,7488
210330,202307,33082,76453,24304,64817,3319,7110,15925,45842,19244,52952
210340,202307,15188,33285,12579,29592,654,1327,10228,24064,10882,25391
210350,202307,11665,27919,9717,25150,175,557,8465,21391,8640,21948
210355,202307,4373,13301,3668,12071,98,518,2977,9594,3075,10112
210360,202307,14798,42411,12171,37632,663,2691,8675,25593,9338,28284
210370,202307,14589,27234,10461,22779,302,515,9514,20751,9816,21266
210375,202307,3794,9664,2459,7396,965,2919,467,1447,1432,4366
210380,202307,6644,15255,5270,13359,230,657,4327,10651,4557,11308
210390,202307,3862,9676,3418,8969,103,381,2985,7653,3088,8034
210400,202307,5450,13723,4404,12249,274,604,3665,10237,3939,10841
210405,202307,8873,20424,6526,16825,970,2293,3930,10055,4900,12348
210407,202307,2458,6930,1931,5913,168,470,1405,4265,1573,4735
210408,202307,3274,10489,2918,9930,177,747,2296,7760,2473,8507
210409,202307,4562,13738,3816,12461,270,1087,2776,8999,3046,10086
210410,202307,4357,11293,3346,9341,84,316,2645,7040,2729,7356
210420,202307,4543,13036,3706,11465,223,697,2945,8951,3168,9648
210430,202307,2698,7010,2218,6267,192,540,1776,4966,1968,5506
210440,202307,4978,12201,3966,10718,201,437,3353,8986,3554,9423
210450,202307,2677,7025,2140,6150,279,629,1478,4364,1757,4993
210455,202307,5888,13562,4131,11020,999,2766,1792,4588,2791,7354
210460,202307,3935,10359,3057,9040,133,456,2410,6960,2543,7416
210462,202307,1978,5356,1521,4593,59,185,1163,3487,1222,3672
210465,202307,3134,8041,2574,7203,126,442,2127,5787,2253,6229
210467,202307,7296,18979,5956,17011,858,2328,4190,12084,5048,14412
210470,202307,2010,5278,1444,4353,185,514,964,2905,1149,3419
210480,202307,20018,53507,15625,47302,2171,4923,10337,33880,12508,38803
210490,202307,3845,8728,2831,7302,104,300,2340,5934,2444,6234
210500,202307,7599,24927,6685,23198,397,1526,5391,18343,5788,19869
210510,202307,8126,20763,6818,19059,177,678,6109,16754,6286,17432
210515,202307,4361,11596,3522,10425,229,725,2805,8293,3034,9018
210520,202307,3049,7983,2510,7140,161,469,1993,5514,2154,5983
210530,202307,67906,152640,46212,117222,9127,23994,21271,53782,30398,77776
210535,202307,4505,12226,3857,11211,163,519,3284,9421,3447,9940
210540,202307,18163,46703,14048,40167,2337,6076,8342,24870,10679,30946
210542,202307,7552,16395,5248,13464,577,1487,3757,9510,4334,10997
210545,202307,2466,7024,2104,6342,71,290,1692,4936,1763,5226
210547,202307,4360,13872,3697,12647,303,945,2758,9666,3061,10611
210550,202307,6810,19038,4814,15509,689,2251,2663,8603,3352,10854
210560,202307,4324,12197,3574,10868,120,369,2953,8796,3073,9165
210565,202307,1779,4602,1381,4007,105,337,989,2845,1094,3182
210570,202307,12772,31929,10633,28869,316,857,8972,24087,9288,24944
210580,202307,3396,7913,2451,6554,221,563,1741,4802,1962,5365
210590,202307,4776,12938,3800,11511,89,400,3178,9384,3267,9784
210592,202307,3351,8215,2904,7415,43,165,2474,6066,2517,6231
210594,202307,2861,7495,2017,6032,238,694,1348,4051,1586,4745
210596,202307,3472,10324,2909,9326,353,1143,2103,6838,2456,7981
210598,202307,2400,5823,2048,5325,122,338,1707,4371,1829,4709
210600,202307,3529,8915,2636,7493,359,976,1661,4682,2020,5658
210610,202307,3713,8513,2849,7261,72,270,2360,5766,2432,6036
210620,202307,3549,7774,2742,6720,141,312,2297,5522,2438,5834
210630,202307,3746,10568,3112,9367,267,862,2285,6686,2552,7548
210632,202307,7280,16522,6223,15050,179,555,5437,12741,5616,13296
210635,202307,1836,6062,1647,5676,200,589,1190,4216,1390,4805
210637,202307,3170,8820,2516,7785,170,591,1898,5862,2068,6453
210640,202307,5895,16671,5316,15942,83,408,4738,13947,4821,14355
210650,202307,8149,20516,6844,18636,139,457,5899,15832,6038,16289
210660,202307,9357,24314,7812,21687,173,743,6644,17692,6817,18435
210663,202307,3643,8187,3057,7401,317,587,2244,5756,2561,6343
210667,202307,2238,6425,1890,5857,89,336,1521,4652,1610,4988
210670,202307,6906,17190,5927,15621,161,609,5132,13075,5293,13684
210675,202307,6542,14431,5224,12666,653,1408,3892,9487,4545,10895
210680,202307,5826,11752,4694,10359,91,210,4327,9407,4418,9617
210690,202307,11315,25365,8915,22226,242,685,7876,18980,8118,19665
210700,202307,3208,7847,2412,6621,165,388,1806,4914,1971,5302
210710,202307,6383,16412,5364,14959,112,417,4681,12810,4793,13227
210720,202307,3595,10058,2969,9196,115,465,2508,7665,2623,8130
210725,202307,1530,4349,1150,3613,46,128,836,2674,882,2802
210730,202307,1732,3570,1345,3027,48,94,1172,2619,1220,2713
210735,202307,5274,13267,4160,11695,393,982,3180,9182,3573,10164
210740,202307,6230,13927,4904,12229,123,272,4085,9952,4208,10224
210745,202307,4946,12022,4117,10802,129,464,3475,8849,3604,9313
210750,202307,31943,75739,25185,65007,4229,9442,14967,39780,19196,49222
210760,202307,7685,15752,6214,14072,139,322,5655,12776,5794,13098
210770,202307,7358,16207,5861,14285,88,339,5234,12416,5322,12755
210780,202307,8654,23858,6863,20662,526,1634,5049,14806,5575,16440
210790,202307,5200,14169,4329,12846,313,897,3298,9902,3611,10799
210800,202307,5783,13737,4698,12176,87,352,4080,10210,4167,10562
210805,202307,5007,15384,4350,14249,245,909,3395,10916,3640,11825
210810,202307,5896,15250,4950,13838,487,1176,3806,10844,4293,12020
210820,202307,8428,21766,6478,18387,1088,2880,3548,10188,4636,13068
210825,202307,10536,23694,9193,21848,238,719,8313,19168,8551,19887
210830,202307,10632,24517,9116,22430,925,1641,7174,18255,8099,19896
210840,202307,6028,10347,5235,9336,38,138,4945,8552,4983,8690
210845,202307,7304,17339,5868,15509,140,378,5218,13645,5358,14023
210850,202307,8495,21869,6732,19124,497,1471,5196,14454,5693,15925
210860,202307,25699,56130,19754,48295,1502,3093,15377,38207,16879,41300
210870,202307,8813,19190,6638,16479,198,446,5745,14075,5943,14521
210880,202307,4906,13031,3969,11524,290,972,2923,8281,3213,9253
210890,202307,5982,13042,5139,11812,164,439,4543,10099,4707,10538
210900,202307,5791,15133,4023,11763,1460,4230,834,2701,2294,6931
210905,202307,2724,5594,2223,4941,52,117,2074,4572,2126,4689
210910,202307,8702,24430,6489,20299,1190,3586,3475,10700,4665,14286
210920,202307,3682,10188,3117,9364,93,390,2705,7918,2798,8308
210923,202307,2323,5193,1883,4507,89,199,1499,3460,1588,3659
210927,202307,5423,16269,4435,14744,779,2421,2637,9055,3416,11476
210930,202307,3471,8957,2886,7938,92,336,2445,6424,2537,6760
210940,202307,4035,10841,3427,10017,276,1201,2692,7220,2968,8421
210945,202307,10102,22869,8575,20899,696,1256,6716,16739,7412,17995
210950,202307,6386,15742,4625,13114,602,1390,2972,8839,3574,10229
210955,202307,1784,4867,1369,4146,186,541,848,2527,1034,3068
210960,202307,11006,29436,8574,25129,3472,9987,2393,7859,5865,17846
210970,202307,2081,4790,1592,3936,90,237,1271,2963,1361,3200
210975,202307,1995,5532,1671,4962,225,683,1154,3347,1379,4030
210980,202307,12697,24606,10837,22466,255,448,9912,20326,10167,20774
210990,202307,21521,52436,15604,43728,1734,4362,10408,29559,12142,33921
211000,202307,17158,43752,13223,38194,3042,7706,7885,24148,10927,31854
211003,202307,7554,17436,6038,15503,146,593,5079,12693,5225,13286
211010,202307,8331,23510,7295,22091,159,730,6315,18851,6474,19581
211020,202307,11263,26052,9426,23763,238,683,8192,20525,8430,21208
211023,202307,2460,7001,2101,6402,132,370,1645,4913,1777,5283
211027,202307,4737,11515,4249,10751,97,336,3834,9447,3931,9783
211030,202307,4512,11268,3768,10115,410,1071,2771,7487,3181,8558
211040,202307,5266,16556,4609,15397,151,736,3962,12952,4113,13688
211050,202307,10823,24338,9107,22028,176,550,7915,18722,8091,19272
211060,202307,9214,22411,7965,20564,256,863,6885,17214,7141,18077
211065,202307,2946,6754,2277,5828,120,268,1910,4874,2030,5142
211070,202307,10138,26969,8113,23691,378,1212,6628,18954,7006,20166
211080,202307,1554,3735,1142,3045,27,114,863,2103,890,2217
211085,202307,2616,6435,2007,5583,226,516,1460,4215,1686,4731
211090,202307,3692,9066,3153,8329,48,168,2807,7254,2855,7422
211100,202307,9112,18428,8027,17087,87,204,7379,15448,7466,15652
211102,202307,3904,10995,3349,10098,532,1616,2323,6924,2855,8540
211105,202307,2737,7622,2210,6678,122,361,1712,5050,1834,5411
211107,202307,5442,15444,4281,13494,167,569,3333,10602,3500,11171
211110,202307,7665,17682,5754,14628,322,961,4597,11248,4919,12209
211120,202307,62033,134742,46547,113269,7759,17121,28362,69982,36121,87103
211125,202307,2148,5850,1658,5042,36,147,1351,4014,1387,4161
211130,202307,227217,486989,179761,414157,23729,49362,117518,269865,141247,319227
211140,202307,5514,14597,4410,12886,167,487,3565,10278,3732,10765
211150,202307,11536,27013,9009,23444,567,1158,6907,18405,7474,19563
211153,202307,3601,8699,2291,6880,438,1147,1276,4064,1714,5211
211157,202307,1512,4151,1213,3590,106,343,806,2317,912,2660
211160,202307,6557,14169,4894,11642,192,679,3841,8467,4033,9146
211163,202307,1718,4938,1462,4516,81,262,1162,3612,1243,3874
211167,202307,2043,5198,1788,4811,42,134,1562,4131,1604,4265
211170,202307,8791,17029,7620,15526,106,279,7040,13951,7146,14230
211172,202307,3019,7589,2343,6482,104,324,1872,4951,1976,5275
211174,202307,3407,8576,2926,7973,53,225,2654,7103,2707,7328
211176,202307,4923,12515,3594,10430,240,758,2756,7773,2996,8531
211178,202307,6448,12150,5350,10939,48,189,5064,10119,5112,10308
211180,202307,4918,14272,4223,13109,170,668,3391,10271,3561,10939
211190,202307,3817,9392,3097,8276,51,220,2687,6954,2738,7174
211195,202307,1905,4379,1528,3780,70,166,1287,3121,1357,3287
211200,202307,2458,6732,1702,5284,171,568,1145,3411,1316,3979
211210,202307,7145,19889,5942,17940,595,1802,4345,12981,4940,14783
211220,202307,53276,113317,40761,95903,3912,8602,29549,67924,33461,76526
211223,202307,6244,15173,4571,12604,625,1750,2677,7212,3302,8962
211227,202307,1990,5537,1638,4996,65,253,1304,3956,1369,4209
211230,202307,10345,24969,8300,21853,321,755,6950,18054,7271,18809
211240,202307,12639,28169,11545,26777,161,586,10819,24534,10980,25120
211245,202307,8999,18791,7441,17032,186,430,6853,15407,7039,15837
211250,202307,18353,46809,15739,42508,1369,3733,12075,31929,13444,35662
211260,202307,9930,27000,8145,24727,293,1046,6978,21064,7271,22110
211270,202307,11943,33038,9776,29995,437,1536,7671,23439,8108,24975
211280,202307,19433,40725,16338,36516,348,887,14676,31868,15024,32755
211285,202307,2421,6735,2019,6102,200,663,1403,4141,1603,4804
211290,202307,8517,22637,7031,20172,423,1310,5341,14963,5764,16273
211300,202307,8336,22350,6707,19448,466,1458,4839,13569,5305,15027
211400,202307,13871,33968,10527,28913,1512,3867,6717,18952,8229,22819
220005,202307,2366,5294,1954,4625,75,186,1625,3681,1700,3867
220010,202307,1774,4413,1309,3556,88,186,964,2581,1052,2767
220020,202307,5638,11780,4504,10106,269,527,3781,8260,4050,8787
220025,202307,2726,5312,2137,4406,56,100,1806,3585,1862,3685
220027,202307,1657,3499,1299,2948,33,88,1093,2378,1126,2466
220030,202307,4679,9721,3934,8581,114,245,3459,7328,3573,7573
220040,202307,10070,26521,8018,22520,1580,4063,4381,12542,5961,16605
220045,202307,1944,4831,1474,4030,50,220,1172,2988,1222,3208
220050,202307,6835,14304,5502,12466,85,290,4869,10478,4954,10768
220060,202307,3463,5859,2729,4970,85,149,2481,4422,2566,4571
220070,202307,2803,6436,2130,5436,90,255,1675,4118,1765,4373
220080,202307,882,2247,677,1895,21,84,530,1403,551,1487
220090,202307,2018,4263,1481,3416,58,140,1174,2625,1232,2765
220095,202307,1248,2203,1049,1931,26,61,945,1665,971,1726
220100,202307,1674,3967,1188,3152,37,122,924,2269,961,2391
220105,202307,2370,6430,1870,5550,175,567,1304,3787,1479,4354
220110,202307,4256,9901,3361,8434,80,304,2800,6787,2880,7091
220115,202307,3496,8794,2892,7803,182,540,2225,5778,2407,6318
220117,202307,1586,3395,1140,2705,26,76,913,2065,939,2141
220120,202307,20837,39484,18012,35837,202,543,16497,31923,16699,32466
220130,202307,1326,3086,1038,2674,34,131,890,2179,924,2310
220140,202307,2847,5100,2152,4245,82,146,1803,3532,1885,3678
220150,202307,7920,19595,6596,17191,188,613,5353,13324,5541,13937
220155,202307,1410,3665,1036,2957,30,93,737,2016,767,2109
220157,202307,1304,2772,1015,2338,47,111,785,1738,832,1849
220160,202307,3466,8252,2632,6717,75,241,2082,5073,2157,5314
220170,202307,1808,4384,1365,3690,40,150,1090,2847,1130,2997
220173,202307,2494,6289,1771,4947,57,182,1390,3728,1447,3910
220177,202307,2872,6142,2557,5745,38,134,2353,5080,2391,5214
220180,202307,1388,2831,1046,2241,6,23,898,1794,904,1817
220190,202307,10252,20209,7940,17036,641,1201,5764,12370,6405,13571
220191,202307,2000,5182,1681,4610,143,422,1222,3220,1365,3642
220192,202307,2401,5677,1622,4307,56,183,1271,3292,1327,3475
220194,202307,2273,5306,1780,4384,39,158,1478,3417,1517,3575
220196,202307,2554,5764,2147,5078,26,108,1802,4081,1828,4189
220198,202307,1553,3414,1256,3024,19,58,1122,2692,1141,2750
220200,202307,6003,15611,4974,14040,203,694,3992,10972,4195,11666
220202,202307,2548,6163,2004,5245,30,117,1665,4163,1695,4280
220205,202307,3279,7513,2702,6461,65,205,2248,5164,2313,5369
220207,202307,936,2459,733,2098,77,199,437,1242,514,1441
220208,202307,2146,5920,1624,4892,512,1614,567,1638,1079,3252
220209,202307,1857,4921,1393,3978,24,100,1074,2957,1098,3057
220210,202307,2272,4583,1783,3833,38,85,1524,3138,1562,3223
220211,202307,1997,4148,1677,3695,39,127,1419,3016,1458,3143
220213,202307,2141,4956,1633,4015,44,126,1270,2906,1314,3032
220217,202307,2941,6976,2554,6492,162,307,2199,5705,2361,6012
220220,202307,16733,33009,13298,27809,385,925,11306,22657,11691,23582
220225,202307,1216,2655,942,2283,18,71,830,1933,848,2004
220230,202307,6927,15050,5335,12597,365,719,4249,9820,4614,10539
220240,202307,3953,9660,3017,7991,96,332,2387,6015,2483,6347
220245,202307,2508,4339,1773,3446,25,73,1598,3012,1623,3085
220250,202307,3663,8726,3010,7859,52,176,2663,6805,2715,6981
220253,202307,2001,4815,1540,4064,38,117,1259,3210,1297,3327
220255,202307,2415,4975,1930,4277,54,172,1643,3448,1697,3620
220260,202307,6270,15062,4995,12806,277,745,3897,9722,4174,10467
220265,202307,1900,4826,1596,4340,72,241,1282,3307,1354,3548
220270,202307,7380,21125,6462,19290,199,771,5296,14970,5495,15741
220271,202307,1789,3936,1446,3386,57,135,1208,2754,1265,2889
220272,202307,2071,5345,1644,4511,64,199,1235,3217,1299,3416
220273,202307,1497,3910,1126,3216,69,219,811,2278,880,2497
220275,202307,3118,5916,2296,4789,80,137,1978,4032,2058,4169
220277,202307,2815,5836,2130,4778,97,191,1754,3769,1851,3960
220280,202307,2402,4344,1907,3709,22,45,1713,3253,1735,3298
220285,202307,2032,4014,1637,3517,25,77,1466,3048,1491,3125
220290,202307,8402,20467,6092,16870,583,1439,4055,11314,4638,12753
220300,202307,2281,5908,1636,4947,68,285,1217,3531,1285,3816
220310,202307,3894,8977,2841,7558,108,338,2320,6043,2428,6381
220320,202307,3701,9318,2674,7493,63,284,2094,5582,2157,5866
220323,202307,2043,5031,1453,4029,56,211,1162,3033,1218,3244
220325,202307,1453,3942,1093,3259,34,128,817,2342,851,2470
220327,202307,2010,4858,1591,4138,64,238,1250,3034,1314,3272
220330,202307,6610,12989,5283,11309,131,354,4588,9426,4719,9780
220335,202307,2238,5486,1917,4990,132,290,1535,3972,1667,4262
220340,202307,2081,5199,1415,3989,154,454,790,2135,944,2589
220342,202307,1502,3660,1231,3205,119,230,912,2433,1031,2663
220345,202307,3571,7212,2480,5647,35,93,2125,4650,2160,4743
220350,202307,3866,8924,2747,7037,227,579,1857,4588,2084,5167
220360,202307,1602,3557,1143,2789,28,86,904,2083,932,2169
220370,202307,11012,27152,9230,24118,494,1307,7426,18827,7920,20134
220375,202307,2071,4799,1731,4350,31,111,1591,3925,1622,4036
220380,202307,1867,3725,1359,3002,25,54,1167,2535,1192,2589
220385,202307,1125,2209,813,1677,8,25,723,1440,731,1465
220390,202307,16175,33724,11691,26726,2030,4642,6494,14288,8524,18930
220400,202307,1820,3885,1229,2909,29,93,958,2101,987,2194
220410,202307,1416,3456,1032,2766,31,112,820,2084,851,2196
220415,202307,987,2330,732,1869,23,50,546,1349,569,1399
220420,202307,2198,5695,1564,4437,146,448,996,2664,1142,3112
220430,202307,3564,7537,2907,6612,61,129,2529,5604,2590,5733
220435,202307,2502,5284,1980,4424,41,109,1633,3487,1674,3596
220440,202307,3960,8962,3200,7825,68,299,2748,6286,2816,6585
220450,202307,3332,7299,2591,6249,56,205,2189,5063,2245,5268
220455,202307,1739,4204,1531,3907,33,99,1289,3207,1322,3306
220460,202307,1396,2800,1178,2470,28,54,1010,2034,1038,2088
220465,202307,2954,7838,2428,6953,174,458,1835,5150,2009,5608
220470,202307,4693,11132,3672,9281,205,452,2759,6778,2964,7230
220480,202307,3150,7461,2184,5771,248,516,1401,3679,1649,4195
220490,202307,2882,6348,2236,5400,41,127,1922,4494,1963,4621
220500,202307,4008,8584,2991,6911,144,311,2321,5121,2465,5432
220510,202307,3256,7542,2421,6053,143,355,1857,4612,2000,4967
220515,202307,2199,4466,1860,3938,76,118,1574,3290,1650,3408
220520,202307,6290,13858,5194,12087,127,331,4366,9836,4493,10167
220525,202307,1672,3541,1301,3053,46,112,1127,2631,1173,2743
220527,202307,2014,4235,1566,3516,79,164,1369,3038,1448,3202
220530,202307,2025,4047,1543,3423,161,338,1104,2462,1265,2800
220535,202307,951,2345,822,2114,15,47,638,1527,653,1574
220540,202307,3838,10622,3252,9458,236,685,2457,7021,2693,7706
220545,202307,1828,4689,1500,4137,83,273,1241,3319,1324,3592
220550,202307,10445,29520,8457,25492,635,2006,5680,16299,6315,18305
220551,202307,1745,4132,1402,3522,22,62,1173,2840,1195,2902
220552,202307,1899,4956,1412,4031,29,117,1114,2990,1143,3107
220553,202307,2586,5068,1988,4229,25,54,1812,3786,1837,3840
220554,202307,1166,2528,839,2008,64,124,615,1428,679,1552
220555,202307,4757,8555,3928,7510,57,165,3444,6465,3501,6630
220556,202307,1553,3845,1122,2980,46,192,752,1768,798,1960
220557,202307,2298,5971,1554,4426,99,343,1126,3034,1225,3377
220558,202307,1768,4052,1326,3390,34,121,1093,2668,1127,2789
220559,202307,2216,4702,1704,3845,68,103,1400,3128,1468,3231
220560,202307,2368,4441,1877,3831,37,105,1695,3352,1732,3457
220570,202307,9902,25289,8370,22730,782,1959,6055,16139,6837,18098
220580,202307,8121,19343,6844,17319,150,447,5906,14624,6056,15071
220585,202307,2511,6865,1868,5531,77,224,1442,4167,1519,4391
220590,202307,2014,4201,1550,3477,111,237,1239,2696,1350,2933
220595,202307,3360,7966,2752,7022,81,289,2247,5460,2328,5749
220600,202307,2223,3734,1770,3196,22,32,1651,2927,1673,2959
220605,202307,1697,4568,1331,3830,28,119,1017,2806,1045,2925
220610,202307,3537,8333,3067,7624,38,104,2822,6895,2860,6999
220620,202307,10885,25940,9250,23443,159,658,8178,19987,8337,20645
220630,202307,426,1121,299,893,29,93,177,471,206,564
220635,202307,2143,5584,1709,4697,55,174,1380,3656,1435,3830
220640,202307,2862,7050,2297,6126,78,263,1793,4601,1871,4864
220650,202307,3018,6653,2399,5682,65,147,2008,4679,2073,4826
220660,202307,3102,8405,2363,7048,79,335,1917,5520,1996,5855
220665,202307,1697,4169,1333,3543,31,141,1152,2906,1183,3047
220667,202307,1901,4981,1610,4453,75,218,1269,3424,1344,3642
220669,202307,1976,5181,1712,4712,36,127,1486,3960,1522,4087
220670,202307,2844,5967,2105,4884,45,134,1805,4054,1850,4188
220672,202307,4113,8977,3178,7735,113,359,2641,6154,2754,6513
220675,202307,1541,3767,1267,3250,105,287,931,2304,1036,2591
220680,202307,3769,7851,3381,7353,172,283,2979,6460,3151,6743
220690,202307,1868,4368,1369,3492,109,302,953,2286,1062,2588
220695,202307,1105,2739,922,2413,29,80,765,1963,794,2043
220700,202307,15364,29344,11633,24008,426,957,9517,18639,9943,19596
220710,202307,1057,2547,704,1939,28,98,536,1401,564,1499
220720,202307,2700,5370,2207,4676,34,86,1911,3891,1945,3977
220730,202307,1701,3870,1319,3218,19,71,1102,2532,1121,2603
220735,202307,1205,2420,840,1825,54,119,634,1319,688,1438
220740,202307,1618,3732,1173,3073,80,200,907,2340,987,2540
220750,202307,5307,10926,4309,9516,243,389,3723,8217,3966,8606
220755,202307,1824,3663,1342,2921,46,91,1102,2330,1148,2421
220760,202307,4216,8955,3462,7965,62,202,3114,6936,3176,7138
220770,202307,35095,86752,27412,72744,7908,21548,10532,27159,18440,48707
220775,202307,1769,3642,1482,3284,19,53,1388,3031,1407,3084
220777,202307,1826,4121,1339,3335,33,70,943,2428,976,2498
220779,202307,1448,3499,1147,3018,75,154,915,2396,990,2550
220780,202307,7285,15569,6106,13793,430,927,4652,10359,5082,11286
220785,202307,1754,3482,1446,3076,24,51,1349,2821,1373,2872
220790,202307,12674,30444,10626,27221,310,1013,8725,21740,9035,22753
220793,202307,1193,2641,900,2148,26,80,770,1793,796,1873
220795,202307,1636,3753,1309,3259,52,141,1111,2684,1163,2825
220800,202307,26583,49872,20730,41426,2086,4336,15401,29137,17487,33473
220810,202307,3751,8985,2902,7566,81,201,2230,5807,2311,6008
220820,202307,7416,15304,6055,13227,317,558,5054,10936,5371,11494
220830,202307,9357,20822,7688,18155,442,978,5939,13471,6381,14449
220840,202307,16695,41049,12996,33844,1575,3989,8603,21370,10178,25359
220850,202307,3536,9617,2969,8770,77,314,2518,7289,2595,7603
220855,202307,1055,1963,864,1716,22,50,786,1541,808,1591
220860,202307,1502,2895,1190,2458,22,62,1076,2143,1098,2205
220865,202307,2675,6646,1855,5106,54,229,1329,3411,1383,3640
220870,202307,3984,8808,3001,7425,65,219,2548,6049,2613,6268
220880,202307,8225,14512,6678,12610,182,382,5948,10953,6130,11335
220885,202307,1828,4349,1446,3758,111,305,1122,2854,1233,3159
220887,202307,1983,3603,1525,2981,49,71,1397,2688,1446,2759
220890,202307,1669,4448,1282,3759,54,192,980,2774,1034,2966
220900,202307,2603,5186,2035,4394,42,120,1753,3609,1795,3729
220910,202307,2189,4673,1701,3905,292,488,1177,2828,1469,3316
220915,202307,1077,2684,739,2049,38,113,511,1323,549,1436
220920,202307,1963,4951,1580,4369,122,345,1201,3257,1323,3602
220930,202307,2397,5025,1859,4293,42,126,1585,3642,1627,3768
220935,202307,1254,3288,912,2563,23,98,603,1571,626,1669
220937,202307,1760,4059,1318,3272,40,134,1050,2449,1090,2583
220940,202307,2295,4749,1745,3855,54,143,1423,2980,1477,3123
220945,202307,588,1802,416,1437,38,161,251,826,289,987
220950,202307,1633,3339,1048,2440,15,40,852,1852,867,1892
220955,202307,2033,4336,1496,3442,45,138,1253,2759,1298,2897
220960,202307,877,2067,579,1546,54,177,351,844,405,1021
220965,202307,2257,5085,1807,4361,32,141,1574,3626,1606,3767
220970,202307,2601,4989,1823,3869,26,90,1578,3198,1604,3288
220975,202307,917,2099,681,1741,20,65,579,1402,599,1467
220980,202307,1603,3615,1340,3212,31,88,1134,2598,1165,2686
220985,202307,1778,3730,1387,3062,99,177,1063,2285,1162,2462
220987,202307,1806,4543,1497,4002,52,187,1230,3185,1282,3372
220990,202307,1965,4832,1587,4200,35,129,1279,3286,1314,3415
220995,202307,1710,3783,1318,3134,22,64,1129,2597,1151,2661
220997,202307,2901,7375,2508,6699,63,239,2111,5376,2174,5615
221000,202307,5870,13472,4626,11497,225,633,3600,8551,3825,9184
221005,202307,1994,4353,1715,3876,34,107,1427,3037,1461,3144
221010,202307,1555,2949,1134,2407,33,84,955,1932,988,2016
221020,202307,1812,4952,1450,4238,33,118,1111,3152,1144,3270
221030,202307,2068,4098,1616,3477,25,71,1435,3036,1460,3107
221035,202307,1896,4124,1427,3427,55,112,1172,2758,1227,2870
221037,202307,842,2006,613,1567,17,58,458,1071,475,1129
221038,202307,609,1513,432,1193,31,78,293,781,324,859
221039,202307,985,2405,761,2036,33,105,584,1491,617,1596
221040,202307,5417,13551,4055,11081,286,799,2966,7812,3252,8611
221050,202307,5654,11034,4649,9586,90,213,4216,8496,4306,8709
221060,202307,11985,28218,8965,22946,471,1117,6821,16860,7292,17977
221062,202307,1641,4081,1291,3506,115,269,932,2525,1047,2794
221063,202307,1520,3529,1144,2841,43,117,913,2156,956,2273
221065,202307,3588,7527,2871,6372,32,74,2556,5514,2588,5588
221070,202307,3971,10931,2966,8874,493,1389,1705,5169,2198,6558
221080,202307,4397,9347,3383,7831,71,220,2744,5953,2815,6173
221090,202307,1678,3596,1302,2992,21,48,1123,2503,1144,2551
221093,202307,2077,4594,1697,3914,174,358,1220,2691,1394,3049
221095,202307,1075,2472,829,2105,32,75,661,1636,693,1711
221097,202307,991,2236,687,1718,25,77,512,1195,537,1272
221100,202307,187876,411010,145081,337566,10639,27065,102847,222631,113486,249696
221110,202307,14145,33110,11955,29906,428,1135,10075,24568,10503,25703
221120,202307,6078,15374,4906,13415,202,624,3868,10249,4070,10873
221130,202307,7324,15597,5227,11823,1387,2731,2730,6080,4117,8811
221135,202307,2433,5082,1973,4448,92,147,1666,3773,1758,3920
221140,202307,1914,3496,1470,2917,74,128,1218,2337,1292,2465
221150,202307,1360,3008,913,2251,31,91,709,1629,740,1720
221160,202307,877,1932,706,1661,41,66,527,1226,568,1292
221170,202307,1333,2979,1166,2686,17,47,1064,2387,1081,2434
230010,202307,3597,8444,2695,6867,173,414,2038,5010,2211,5424
230015,202307,4479,11671,3694,10061,244,706,2495,6565,2739,7271
230020,202307,18773,47515,16460,43612,1206,3051,12693,33008,13899,36059
230030,202307,15557,34222,12054,29021,645,1360,9237,22270,9882,23630
230040,202307,5671,12026,4491,10218,80,261,3531,8125,3611,8386
230050,202307,3007,8644,2029,6282,353,1054,917,2578,1270,3632
230060,202307,2986,6920,2098,5325,55,191,1653,4021,1708,4212
230070,202307,5459,11942,3858,9106,624,1376,2408,5582,3032,6958
230075,202307,12250,32176,10437,28890,789,2181,7875,21021,8664,23202
230080,202307,3661,6764,2660,5492,19,48,2433,4908,2452,4956
230090,202307,5633,11620,4263,9416,126,288,3580,7518,3706,7806
230100,202307,28221,59717,22285,50706,2173,4938,15162,33408,17335,38346
230110,202307,17452,45308,13336,37107,2808,7514,6183,16503,8991,24017
230120,202307,9851,22884,7549,18947,977,2311,4775,11691,5752,14002
230125,202307,3759,8783,2948,7406,104,329,2263,5337,2367,5666
230130,202307,6836,18366,4992,14484,418,1078,3369,9551,3787,10629
230140,202307,4328,11217,3282,9096,102,376,2452,6378,2554,6754
230150,202307,1914,5020,1457,4073,236,609,799,2234,1035,2843
230160,202307,8884,17884,7150,15316,255,531,5961,12352,6216,12883
230170,202307,7435,19103,5498,15226,483,1270,3669,9837,4152,11107
230180,202307,2000,4781,1488,3808,27,100,1221,2967,1248,3067
230185,202307,5727,13278,4336,10971,527,1265,2868,7208,3395,8473
230190,202307,18078,49056,13015,38394,2117,6047,6402,18083,8519,24130
230195,202307,7125,18000,5930,15860,309,818,4504,11783,4813,12601
230200,202307,5896,14644,4547,12052,356,857,3218,8208,3574,9065
230205,202307,5622,13100,4669,11679,496,987,3384,8489,3880,9476
230210,202307,13224,26723,10557,22887,423,933,8594,17873,9017,18806
230220,202307,18986,40836,15596,35823,1107,2538,12014,26612,13121,29150
230230,202307,8735,21731,7409,19161,772,1610,5272,13649,6044,15259
230240,202307,16951,37703,13181,31475,890,1865,9668,22314,10558,24179
230250,202307,11682,28066,9842,24787,1406,3431,5802,13687,7208,17118
230260,202307,18540,46517,14778,39606,2068,5246,8972,23422,11040,28668
230270,202307,8644,20765,5969,15763,784,1927,3474,9216,4258,11143
230280,202307,24548,55581,18918,45881,546,1848,15022,33752,15568,35600
230290,202307,6232,14078,5017,11916,236,561,3978,9072,4214,9633
230300,202307,6168,13746,5162,12314,100,323,4360,10114,4460,10437
230310,202307,5828,14633,4340,11750,182,578,3093,7900,3275,8478
230320,202307,9228,23480,7183,19890,266,973,5327,13993,5593,14966
230330,202307,5871,13849,4082,10465,185,478,3047,7447,3232,7925
230340,202307,4613,12880,3687,10976,339,979,2388,6876,2727,7855
230350,202307,23571,53994,18916,46436,1126,3186,13655,31879,14781,35065
230360,202307,3766,8514,2748,6817,139,323,2026,4966,2165,5289
230365,202307,3702,7770,2942,6643,84,232,2557,5652,2641,5884
230370,202307,103788,217566,84930,188297,5429,13112,65614,137327,71043,150439
230380,202307,7432,18253,5408,14448,145,465,4071,10281,4216,10746
230390,202307,4081,10269,3264,8893,81,346,2562,6668,2643,7014
230393,202307,4195,10217,3101,8105,69,287,2468,6048,2537,6335
230395,202307,6879,16889,5161,13633,514,1374,3318,8262,3832,9636
230400,202307,6962,16362,5635,14096,128,423,4557,10697,4685,11120
230410,202307,16339,43027,12483,35927,1323,3642,8101,22811,9424,26453
230420,202307,38415,90053,28366,71790,3259,8150,17123,40671,20382,48821
230423,202307,5407,14324,4378,12209,326,947,3060,8215,3386,9162
230425,202307,7650,20030,6552,17790,738,1849,4427,11796,5165,13645
230426,202307,3254,7493,2118,5337,64,209,1574,3751,1638,3960
230427,202307,2151,5419,1327,3689,107,316,839,2117,946,2433
230428,202307,12512,30187,9725,25382,1534,3864,5235,12930,6769,16794
230430,202307,5959,15181,4250,12027,188,490,3154,8631,3342,9121
230435,202307,7799,17447,5520,13388,798,1849,3125,7282,3923,9131
230440,202307,624918,1259672,487082,1046002,35626,82898,350310,704201,385936,787099
230445,202307,4913,12139,3663,9837,303,788,2385,6008,2688,6796
230450,202307,4601,11228,3624,9581,186,552,2601,6358,2787,6910
230460,202307,2728,6294,2238,5532,76,244,1813,4321,1889,4565
230465,202307,5040,12245,3900,10098,244,569,2909,7240,3153,7809
230470,202307,14355,39979,12127,35761,1015,2753,8630,24554,9645,27307
230480,202307,1886,4550,1381,3618,82,251,985,2413,1067,2664
230490,202307,3352,8227,2525,6609,217,619,1603,3813,1820,4432
230495,202307,7602,18234,5978,15264,828,2137,3691,8864,4519,11001
230500,202307,11403,32336,9219,28157,670,1906,6686,20288,7356,22194
230510,202307,2175,5190,1576,4010,174,479,989,2330,1163,2809
230520,202307,5870,13797,4701,11735,370,867,3460,8315,3830,9182
230523,202307,20951,54797,13645,38758,3123,8469,3406,9908,6529,18377
230526,202307,4811,11425,3701,9533,265,497,2658,6926,2923,7423
230530,202307,6692,18803,5171,15792,1284,3769,2581,7945,3865,11714
230533,202307,6054,11426,4297,8807,103,301,3553,6775,3656,7076
230535,202307,5824,15056,4429,12503,372,1077,2787,7587,3159,8664
230540,202307,18433,45138,14448,38341,384,1271,11462,29159,11846,30430
230550,202307,28340,63470,20859,50363,2516,5320,13503,31491,16019,36811
230560,202307,9201,19277,6783,15615,603,848,5088,12218,5691,13066
230565,202307,3704,8931,2911,7512,122,334,2242,5518,2364,5852
230570,202307,4026,9226,3131,7824,80,248,2534,6025,2614,6273
230580,202307,15127,32417,11987,27595,582,1254,9890,22093,10472,23347
230590,202307,11760,28538,8955,23499,804,1988,6266,15960,7070,17948
230600,202307,4629,10217,3361,8070,189,409,2321,5514,2510,5923
230610,202307,8312,19937,6813,17390,530,1285,5161,12834,5691,14119
230620,202307,2721,6080,1974,4703,70,208,1444,3098,1514,3306
230625,202307,13035,30548,10181,25289,2029,5179,4978,11585,7007,16764
230630,202307,14251,35190,11407,29870,1567,3711,6915,17938,8482,21649
230640,202307,32572,89157,26985,78776,1769,5477,19518,54382,21287,59859
230650,202307,6315,14944,4932,12560,315,789,3795,9293,4110,10082
230655,202307,12065,33441,10858,31270,793,2057,8596,24585,9389,26642
230660,202307,7210,18723,5454,15549,180,727,4211,11483,4391,12210
230670,202307,7170,15149,4758,11295,225,491,3771,8618,3996,9109
230680,202307,3472,8274,2543,6621,152,348,1753,4479,1905,4827
230690,202307,8493,22304,6344,17921,538,1503,3833,10583,4371,12086
230700,202307,12939,28112,9306,21552,348,928,7236,15836,7584,16764
230710,202307,8067,22740,6296,18743,656,1968,3963,11146,4619,13114
230720,202307,2295,6052,1663,4799,120,363,1046,2840,1166,3203
230725,202307,5856,14946,4949,13316,579,1586,3119,8017,3698,9603
230730,202307,75656,175008,53810,139640,11666,29590,22586,58478,34252,88068
230740,202307,7263,18002,5562,15084,192,607,4231,11185,4423,11792
230750,202307,10196,23885,7281,18626,147,503,5864,14052,6011,14555
230760,202307,14568,33500,11353,27996,522,1556,8321,19122,8843,20678
230763,202307,5806,13762,4375,11247,106,431,3448,8289,3554,8720
230765,202307,58896,136239,45747,113005,4578,11924,29765,68830,34343,80754
230770,202307,35904,70823,27814,59323,1787,3990,20926,42257,22713,46247
230780,202307,8171,24398,6797,21152,959,2706,4097,12688,5056,15394
230790,202307,3901,9334,3320,8386,144,413,2540,6065,2684,6478
230800,202307,10969,29462,8700,24663,1028,2863,5297,14090,6325,16953
230810,202307,13024,35120,10607,30561,802,2014,7473,20945,8275,22959
230820,202307,4334,12398,3150,9703,415,1274,1835,5373,2250,6647
230830,202307,9137,21534,7067,17832,392,912,5188,12511,5580,13423
230835,202307,4917,10402,3510,8186,125,296,2921,6543,3046,6839
230837,202307,4908,10863,4121,9610,79,242,3619,8001,3698,8243
230840,202307,11456,30147,9150,25898,836,2326,6453,17891,7289,20217
230850,202307,12387,29819,9698,24985,561,1353,7194,18092,7755,19445
230860,202307,7919,14685,6178,12174,183,335,5443,10351,5626,10686
230870,202307,22583,44455,17384,35984,839,1605,13993,27697,14832,29302
230880,202307,2360,6390,2019,5713,74,267,1539,4108,1613,4375
230890,202307,5611,15564,4707,13838,249,904,3347,9456,3596,10360
230900,202307,4094,10133,3146,8240,174,587,2220,5417,2394,6004
230910,202307,4231,9253,3108,7521,68,286,2581,5975,2649,6261
230920,202307,5760,14194,4278,11604,165,534,3197,8280,3362,8814
230930,202307,8387,20766,6230,16893,872,1917,3785,10284,4657,12201
230940,202307,10173,22158,8010,18757,200,479,6807,15491,7007,15970
230945,202307,7864,19768,6237,16712,519,1157,4283,11138,4802,12295
230950,202307,7737,16663,6234,14422,190,452,5192,11703,5382,12155
230960,202307,15685,40385,11975,32793,2056,5570,5842,14996,7898,20566
230970,202307,19621,45469,15125,37843,1819,4496,9368,22377,11187,26873
230980,202307,4365,9224,3469,7701,282,581,2588,5553,2870,6134
230990,202307,2040,5045,1549,4111,76,262,1143,2822,1219,3084
231000,202307,3605,7934,2545,6040,72,205,1972,4397,2044,4602
231010,202307,4475,8954,3196,6929,68,202,2717,5603,2785,5805
231020,202307,11324,28347,9380,24658,1711,3999,5521,14570,7232,18569
231025,202307,10580,23948,8836,21109,604,1378,6779,15770,7383,17148
231030,202307,8719,23556,6055,18070,819,2422,3465,10143,4284,12565
231040,202307,3778,8698,3020,7364,110,305,2466,5715,2576,6020
231050,202307,14740,32193,10547,24681,615,1607,8134,18085,8749,19692
231060,202307,3593,8598,2957,7567,135,377,2294,5737,2429,6114
231070,202307,9833,24893,7899,21364,808,1982,5202,13717,6010,15699
231080,202307,4516,11346,3326,9131,238,659,2238,5960,2476,6619
231085,202307,9033,19073,6636,15793,297,756,4992,11300,5289,12056
231090,202307,5184,12132,3597,9120,146,428,2564,6106,2710,6534
231095,202307,2637,7259,1862,5566,174,512,1203,3494,1377,4006
231100,202307,3608,9241,2752,7621,148,440,2043,5425,2191,5865
231110,202307,4498,11835,3716,10309,1021,2825,1747,4463,2768,7288
231120,202307,2970,7270,2335,6188,86,216,1755,4496,1841,4712
231123,202307,2377,5496,1695,4283,99,241,1206,2921,1305,3162
231126,202307,6653,16075,4845,12713,311,718,3612,9292,3923,10010
231130,202307,31098,62470,23858,52288,1200,3208,18449,37296,19649,40504
231135,202307,5007,12549,3785,10166,254,630,2646,6912,2900,7542
231140,202307,21679,51241,16286,41742,1422,3753,11099,26889,12521,30642
231150,202307,7074,17367,4288,11651,786,2118,1666,4215,2452,6333
231160,202307,8634,21870,7029,18710,898,2219,4526,11806,5424,14025
231170,202307,5621,14236,4315,11756,321,876,3056,7889,3377,8765
231180,202307,19362,46923,13972,35970,2080,5154,7496,18316,9576,23470
231190,202307,5064,12217,3574,9479,92,305,2744,6845,2836,7150
231195,202307,5935,16211,4526,13444,298,939,3151,9245,3449,10184
231200,202307,10344,25077,8577,21786,152,605,7184,17189,7336,17794
231210,202307,5876,14964,4544,12619,154,586,3573,9351,3727,9937
231220,202307,16207,34893,11457,26398,615,1307,8559,18563,9174,19870
231230,202307,12094,33909,9930,29727,820,2517,6979,20354,7799,22871
231240,202307,14499,38389,11084,31176,1518,4098,6324,16922,7842,21020
231250,202307,2512,5358,1422,3166,59,132,1064,2186,1123,2318
231260,202307,4065,9616,3152,8052,355,799,2079,5267,2434,6066
231270,202307,7765,17403,5735,13935,159,540,4326,9742,4485,10282
231280,202307,2220,6005,1787,5208,146,419,1199,3440,1345,3859
231290,202307,44604,118890,32342,92747,4568,12170,16360,44299,20928,56469
231300,202307,5076,12282,3501,9146,350,859,2183,5407,2533,6266
231310,202307,10633,22037,7616,16666,489,1240,5648,11475,6137,12715
231320,202307,7952,20478,5792,16405,311,704,4320,12072,4631,12776
231325,202307,2892,6711,2038,5230,115,242,1440,3614,1555,3856
231330,202307,13946,34316,10515,27977,1210,3123,6893,17795,8103,20918
231335,202307,6684,15559,5307,13451,170,502,4393,10818,4563,11320
231340,202307,22685,61387,18405,53335,1646,4773,13005,37301,14651,42074
231350,202307,19729,46982,16441,41797,471,1430,13794,33907,14265,35337
231355,202307,5433,14020,4475,12246,294,813,3401,8928,3695,9741
231360,202307,9734,25815,7671,21985,450,1427,5812,16042,6262,17469
231370,202307,2440,6066,1760,4803,47,158,1338,3498,1385,3656
231375,202307,4910,13314,4140,11926,184,588,3055,8774,3239,9362
231380,202307,7411,16728,6202,15033,203,468,5092,12088,5295,12556
231390,202307,4099,10693,3377,9341,109,411,2552,6661,2661,7072
231395,202307,5347,13296,4138,11145,277,696,2942,7660,3219,8356
231400,202307,12109,29518,9455,24617,328,1102,7195,17597,7523,18699
231410,202307,20109,49969,16872,44516,815,2122,13722,35210,14537,37332
240010,202307,3030,7070,2082,5296,328,856,1006,2385,1334,3241
240020,202307,17709,40635,13403,32686,841,2432,9371,21097,10212,23529
240030,202307,4840,8915,3925,7578,84,242,3424,6179,3508,6421
240040,202307,927,2424,683,1962,23,69,454,1218,477,1287
240050,202307,4172,9880,3009,7754,79,220,2198,5401,2277,5621
240060,202307,1802,4167,1294,3255,43,94,992,2431,1035,2525
240070,202307,3247,8010,2424,6158,182,498,1652,3778,1834,4276
240080,202307,3491,8491,2443,6539,141,435,1622,4040,1763,4475
240090,202307,2785,5764,2080,4600,43,101,1770,3791,1813,3892
240100,202307,13481,27839,9818,21454,268,744,7801,15739,8069,16483
240110,202307,6169,15144,4572,12012,268,802,3221,7793,3489,8595
240120,202307,4089,10322,3118,8694,280,871,2060,5383,2340,6254
240130,202307,4899,8410,3749,6880,41,103,3417,6072,3458,6175
240140,202307,2140,5911,1601,4804,179,605,956,2621,1135,3226
240145,202307,8484,21237,6354,17339,634,1807,4016,10436,4650,12243
240150,202307,1322,3068,996,2451,64,178,706,1623,770,1801
240160,202307,1761,4485,1310,3626,52,209,969,2504,1021,2713
240165,202307,1177,2834,844,2167,20,71,679,1647,699,1718
240170,202307,3450,7938,2612,6435,295,705,1697,3974,1992,4679
240180,202307,3675,9694,2702,7660,531,1464,1272,3602,1803,5066
240185,202307,1742,4649,1456,4103,58,208,1148,3065,1206,3273
240190,202307,1383,3258,1034,2656,37,126,768,1847,805,1973
240200,202307,16324,34256,11800,26423,1567,3436,7013,14720,8580,18156
240210,202307,4242,8518,3225,6846,44,137,2728,5467,2772,5604
240220,202307,8704,23352,7191,20622,546,1871,5165,14074,5711,15945
240230,202307,6927,15542,5063,12389,337,692,3546,8639,3883,9331
240240,202307,2145,5693,1355,3933,223,686,475,1154,698,1840
240250,202307,3713,8193,2837,6723,78,270,2249,4958,2327,5228
240260,202307,19939,50583,16106,43860,4518,11717,6409,18870,10927,30587
240270,202307,3068,7757,2208,6152,140,413,1462,4032,1602,4445
240280,202307,1901,4404,1408,3528,74,184,1025,2447,1099,2631
240290,202307,1329,3447,993,2706,26,82,659,1648,685,1730
240300,202307,2636,6095,1777,4570,112,307,1134,2771,1246,3078
240310,202307,10340,24771,7284,18994,1147,2830,3521,8791,4668,11621
240320,202307,2269,5674,1469,4096,99,286,933,2439,1032,2725
240325,202307,48008,107723,35470,85675,4037,10604,21518,47642,25555,58246
240330,202307,2166,5279,1493,3996,81,266,1007,2512,1088,2778
240340,202307,2491,4858,1801,3755,53,115,1470,2870,1523,2985
240350,202307,3059,6294,2540,5627,83,237,2202,4726,2285,4963
240360,202307,16376,38195,13211,32707,1984,4720,8069,19298,10053,24018
240370,202307,2677,5684,1831,4144,102,258,1330,2753,1432,3011
240375,202307,1150,2460,856,1963,37,99,634,1328,671,1427
240380,202307,2763,6872,1981,5232,246,640,1155,2895,1401,3535
240390,202307,1143,2575,703,1752,32,72,424,963,456,1035
240400,202307,1686,3804,1176,2928,46,155,808,1834,854,1989
240410,202307,709,1902,510,1510,61,201,276,756,337,957
240420,202307,6328,18273,5127,15577,374,1354,3370,9466,3744,10820
240430,202307,4193,9443,3085,7426,127,342,2322,5198,2449,5540
240440,202307,3382,6743,2610,5556,213,458,1969,4003,2182,4461
240450,202307,5351,12992,3678,9707,261,809,2321,5456,2582,6265
240460,202307,4213,9679,3432,8391,263,625,2559,6007,2822,6632
240470,202307,4054,11177,2690,8176,772,2054,986,3193,1758,5247
240480,202307,672,1672,375,1028,25,62,182,481,207,543
240485,202307,2481,6342,1780,4966,154,472,1030,2758,1184,3230
240490,202307,1977,4347,1373,3269,85,170,994,2263,1079,2433
240500,202307,2594,6176,2054,5194,109,279,1604,3887,1713,4166
240510,202307,2031,4860,1592,4075,112,354,1200,2853,1312,3207
240520,202307,1947,3929,1329,3031,108,224,1031,2276,1139,2500
240530,202307,2870,6797,2361,5951,154,323,1815,4450,1969,4773
240540,202307,2747,5877,2253,5099,57,181,1922,4170,1979,4351
240550,202307,1068,2312,887,2003,35,93,759,1651,794,1744
240560,202307,4776,9909,3990,8824,152,303,3311,7148,3463,7451
240570,202307,3301,7985,1888,4904,262,722,738,1594,1000,2316
240580,202307,10719,26377,8725,22701,557,1532,6749,16789,7306,18321
240590,202307,1124,2175,868,1780,38,97,667,1271,705,1368
240600,202307,2115,5068,1405,3652,53,139,977,2368,1030,2507
240610,202307,5504,12436,4373,10358,309,804,3086,6838,3395,7642
240615,202307,1556,3482,1142,2777,77,206,814,1808,891,2014
240620,202307,2382,5654,1861,4726,56,191,1527,3667,1583,3858
240630,202307,2865,6259,2390,5475,225,388,1776,4114,2001,4502
240640,202307,1087,2578,775,2027,33,99,584,1444,617,1543
240650,202307,4806,12817,3607,10318,338,914,2264,6406,2602,7320
240660,202307,5448,9488,4516,8324,156,406,3888,6900,4044,7306
240670,202307,3105,7529,2093,5445,194,493,1308,3151,1502,3644
240680,202307,1932,4460,1420,3566,97,256,1045,2490,1142,2746
240690,202307,1479,3099,1098,2462,25,81,906,1900,931,1981
240700,202307,2819,7436,2080,6051,123,366,1477,4159,1600,4525
240710,202307,25209,51692,19759,42811,1869,4154,14088,28946,15957,33100
240720,202307,6259,14273,4711,11646,652,1684,2853,6719,3505,8403
240725,202307,1276,3342,908,2650,53,153,570,1573,623,1726
240730,202307,2675,6637,1951,5247,83,280,1439,3665,1522,3945
240740,202307,2253,5609,1619,4319,93,298,1120,2728,1213,3026
240750,202307,2648,7620,2125,6479,245,783,1289,3739,1534,4522
240760,202307,2057,4105,1354,3065,123,238,933,2170,1056,2408
240770,202307,4025,9454,3142,8091,116,397,2492,6068,2608,6465
240780,202307,6525,15533,5005,12864,671,1642,3119,7639,3790,9281
240790,202307,1055,2618,754,2043,29,119,504,1238,533,1357
240800,202307,73737,147701,52180,112007,5570,11973,33470,65859,39040,77832
240810,202307,139480,294363,112214,249199,11052,24100,77521,163446,88573,187546
240820,202307,8008,20896,6407,17752,1125,3001,3557,9637,4682,12638
240830,202307,10541,25897,8461,22454,454,1366,6493,16630,6947,17996
240840,202307,1296,2930,919,2255,42,90,637,1485,679,1575
240850,202307,1658,4127,1031,2778,73,203,627,1573,700,1776
240860,202307,1843,3918,1320,3023,42,140,1092,2346,1134,2486
240870,202307,1238,2831,864,2161,171,401,428,1068,599,1469
240880,202307,1543,4400,1233,3750,93,344,839,2410,932,2754
240890,202307,6645,14641,4703,11106,452,1170,3003,6311,3455,7481
240895,202307,3583,9578,3018,8591,394,1119,2067,5799,2461,6918
240910,202307,4153,10033,3216,8382,90,324,2460,6054,2550,6378
240920,202307,1305,2828,912,2188,108,211,584,1394,692,1605
240930,202307,4353,8858,3075,7014,291,502,1981,4800,2272,5302
240933,202307,1898,4316,1476,3666,49,204,1188,2788,1237,2992
240940,202307,8952,18603,6377,14127,711,1495,4205,8770,4916,10265
240950,202307,1319,3532,1019,2910,56,186,717,1901,773,2087
240960,202307,835,2070,686,1743,25,90,508,1194,533,1284
240970,202307,2402,5077,1780,4037,72,203,1460,3166,1532,3369
240980,202307,4855,10972,4098,9718,88,340,3492,7834,3580,8174
240990,202307,3619,8218,2855,6768,241,619,2023,4379,2264,4998
241000,202307,1294,2743,915,2055,11,31,761,1612,772,1643
241010,202307,3895,9933,3213,8565,129,431,2487,6212,2616,6643
241020,202307,2530,5992,1760,4488,95,295,1241,2890,1336,3185
241025,202307,1959,5027,1371,3836,50,177,967,2512,1017,2689
241030,202307,3014,8343,2225,6714,223,716,1501,4294,1724,5010
241040,202307,2682,7354,2091,6275,166,524,1511,4426,1677,4950
241050,202307,1737,4272,1283,3395,54,156,922,2353,976,2509
241060,202307,993,2397,762,1924,36,86,537,1241,573,1327
241070,202307,862,2023,644,1643,19,54,502,1208,521,1262
241080,202307,1300,3310,938,2577,31,93,653,1677,684,1770
241090,202307,2492,6165,1837,5027,66,271,1328,3391,1394,3662
241100,202307,1384,3454,965,2612,96,190,592,1580,688,1770
241105,202307,1429,3684,1069,3008,179,525,512,1301,691,1826
241110,202307,1070,2736,709,1981,45,146,437,1103,482,1249
241120,202307,9164,23348,7169,19682,735,2086,4664,12352,5399,14438
241140,202307,3911,9424,2731,7107,223,540,1803,4577,2026,5117
241142,202307,884,2197,556,1515,48,139,294,700,342,839
241150,202307,7075,16336,5596,13824,245,605,4341,10375,4586,10980
241160,202307,1314,3405,820,2400,126,370,386,1033,512,1403
241170,202307,1582,3554,1221,2891,45,146,979,2168,1024,2314
241180,202307,1227,2776,830,2028,51,157,502,1165,553,1322
241190,202307,1413,3192,1021,2443,35,89,733,1657,768,1746
241200,202307,32692,68785,26155,57788,3003,6789,17548,36148,20551,42937
241210,202307,2005,4451,1306,3152,141,288,810,1915,951,2203
241220,202307,12451,30731,9945,26098,2495,6277,4535,11935,7030,18212
241230,202307,3493,8141,2711,6844,143,383,2089,5034,2232,5417
241240,202307,1460,3735,767,2201,104,323,274,696,378,1019
241250,202307,7764,18026,5650,14181,130,455,4384,10203,4514,10658
241255,202307,3311,8683,2602,7284,229,701,1740,4606,1969,5307
241260,202307,5843,13507,4324,10868,161,488,3198,7461,3359,7949
241270,202307,1875,4958,1420,4036,111,354,932,2489,1043,2843
241280,202307,3181,6220,2540,5111,83,147,2212,4297,2295,4444
241290,202307,3774,8319,2618,6470,94,298,2010,4668,2104,4966
241300,202307,1892,4414,1364,3454,43,131,952,2252,995,2383
241310,202307,2860,5768,2231,4874,59,165,1860,3871,1919,4036
241320,202307,1141,3369,873,2804,118,390,454,1392,572,1782
241330,202307,2071,4672,1544,3907,42,131,1314,3226,1356,3357
241335,202307,4537,11112,3599,9344,138,407,2727,6686,2865,7093
241340,202307,2073,4873,1479,3736,211,610,785,1768,996,2378
241350,202307,2578,6144,2053,5203,103,275,1554,3783,1657,4058
241355,202307,1664,3934,1204,3064,57,140,863,2078,920,2218
241360,202307,2501,5697,1620,3993,66,169,1203,2760,1269,2929
241370,202307,1602,3830,1154,2971,46,143,826,1952,872,2095
241380,202307,858,1996,617,1568,66,145,375,918,441,1063
241390,202307,3352,8558,2659,7397,157,462,1927,5167,2084,5629
241400,202307,4397,10657,3591,9307,276,772,2613,6473,2889,7245
241410,202307,3016,8051,2261,6513,249,741,1436,4005,1685,4746
241415,202307,2285,5389,1756,4377,75,246,1366,3165,1441,3411
241420,202307,3876,9920,3178,8643,556,1512,1758,4652,2314,6164
241430,202307,860,1901,522,1250,16,43,353,763,369,806
241440,202307,10469,27126,8839,24080,276,902,7089,18457,7365,19359
241445,202307,1651,3367,1298,2853,28,78,1132,2399,1160,2477
241450,202307,3764,7559,2780,5988,177,356,2199,4559,2376,4915
241460,202307,4763,11456,3268,8312,308,778,2088,4875,2396,5653
241470,202307,1753,4054,1280,3341,43,160,1000,2457,1043,2617
241475,202307,1423,3439,992,2637,26,82,718,1765,744,1847
241480,202307,3742,10242,2813,8298,831,2420,981,2985,1812,5405
241490,202307,913,1832,594,1334,24,76,463,976,487,1052
241500,202307,972,2374,794,2118,30,95,621,1588,651,1683
250010,202307,3231,8218,2408,6538,78,252,1795,4604,1873,4856
250020,202307,1925,4495,1321,3365,116,246,954,2405,1070,2651
250030,202307,8556,20436,6809,17477,1150,2862,4335,10826,5485,13688
250040,202307,5484,14326,4329,12176,719,2054,2458,6577,3177,8631
250050,202307,4441,10427,3623,9206,184,514,2777,6989,2961,7503
250053,202307,1554,3919,1302,3454,131,293,885,2284,1016,2577
250057,202307,893,2421,796,2278,24,96,704,1986,728,2082
250060,202307,7512,16708,6122,14577,686,1476,4219,9844,4905,11320
250070,202307,4843,11775,3742,9801,73,271,2942,7328,3015,7599
250073,202307,965,2235,720,1808,14,47,568,1361,582,1408
250077,202307,3212,6754,2334,5326,35,109,1998,4362,2033,4471
250080,202307,7408,14194,5784,12124,82,263,5206,10580,5288,10843
250090,202307,4710,8833,3793,7554,60,129,3339,6391,3399,6520
250100,202307,4132,11148,3401,9713,246,621,2474,6830,2720,7451
250110,202307,6027,14802,5118,13371,357,937,3725,9351,4082,10288
250115,202307,926,1901,606,1373,14,48,503,1093,517,1141
250120,202307,2169,5672,1796,5010,33,148,1380,3646,1413,3794
250130,202307,7415,15615,5955,13482,103,347,5195,11297,5298,11644
250135,202307,1666,3923,1367,3395,193,535,967,2280,1160,2815
250140,202307,2827,7207,2317,6421,196,571,1652,4462,1848,5033
250150,202307,5676,15722,4765,14033,202,732,3645,10239,3847,10971
250153,202307,1627,3922,1264,3326,58,118,980,2532,1038,2650
250157,202307,2661,6077,2171,5218,52,130,1816,4209,1868,4339
250160,202307,4424,9767,3395,8185,71,200,2889,6765,2960,6965
250170,202307,2215,5195,1868,4677,44,140,1504,3620,1548,3760
250180,202307,31393,60775,24898,51607,2048,4377,18388,35686,20436,40063
250190,202307,5149,11844,4050,10098,441,1058,2665,6320,3106,7378
250200,202307,3174,5918,2502,4979,39,101,2238,4252,2277,4353
250205,202307,989,2760,757,2324,24,103,552,1619,576,1722
250210,202307,1704,4572,1381,3959,99,291,976,2678,1075,2969
250215,202307,1887,4667,1344,3634,76,218,760,2017,836,2235
250220,202307,810,2003,590,1614,28,98,396,998,424,1096
250230,202307,1921,3913,1229,2859,26,76,975,2177,1001,2253
250240,202307,3803,8210,3143,7092,65,202,2705,5858,2770,6060
250250,202307,5980,13781,4855,12086,398,684,3682,9552,4080,10236
250260,202307,1844,4776,1405,3950,72,202,987,2701,1059,2903
250270,202307,1405,3815,1168,3390,94,278,746,2222,840,2500
250280,202307,4909,10386,4043,9116,297,490,3088,7055,3385,7545
250290,202307,2326,4697,1821,3912,52,133,1472,2988,1524,3121
250300,202307,7381,15705,6009,13736,260,740,4761,10301,5021,11041
250310,202307,1479,3781,1096,3063,62,150,768,2087,830,2237
250320,202307,18525,34054,14859,29510,333,951,12667,23755,13000,24706
250330,202307,3189,7226,2485,6111,71,244,2047,4692,2118,4936
250340,202307,1552,3208,1242,2754,25,63,1085,2333,1110,2396
250350,202307,4548,11802,3566,10042,268,626,2638,7562,2906,8188
250355,202307,2757,6393,2270,5745,35,156,2018,4975,2053,5131
250360,202307,2136,4945,1783,4409,128,382,1362,3165,1490,3547
250370,202307,20919,41479,16896,35436,331,967,14514,28893,14845,29860
250375,202307,1537,3261,1134,2744,33,63,980,2399,1013,2462
250380,202307,2200,4572,1909,4179,69,184,1633,3374,1702,3558
250390,202307,2365,5157,1860,4326,122,305,1456,3294,1578,3599
250400,202307,92654,207447,62451,156546,18827,49457,18217,42229,37044,91686
250403,202307,2955,5989,2373,5255,57,263,1961,3927,2018,4190
250407,202307,1889,3725,1237,2720,136,227,862,2002,998,2229
250410,202307,855,1983,699,1721,25,72,577,1348,602,1420
250415,202307,2446,5665,1986,4921,38,128,1730,4155,1768,4283
250420,202307,1742,3569,1474,3168,24,80,1296,2655,1320,2735
250430,202307,9443,18482,7308,15347,306,670,5897,11573,6203,12243
250435,202307,1970,4929,1376,3847,65,228,1030,2744,1095,2972
250440,202307,5286,12734,4298,11198,115,325,3608,9132,3723,9457
250450,202307,2188,4983,1691,4232,89,169,1318,3300,1407,3469
250460,202307,9733,23419,7745,20196,548,1614,5544,13742,6092,15356
250470,202307,2195,4567,1698,3774,69,170,1375,2899,1444,3069
250480,202307,4679,11284,3676,9875,198,498,2878,7640,3076,8138
250485,202307,851,1752,562,1275,51,77,397,884,448,961
250490,202307,6939,13453,5807,12053,121,326,5070,10138,5191,10464
250500,202307,2444,6004,1984,5189,64,216,1552,3918,1616,4134
250510,202307,7136,14688,5675,12524,283,452,4517,9996,4800,10448
250520,202307,2209,5339,1743,4606,68,223,1335,3357,1403,3580
250523,202307,2688,5673,2167,4889,172,407,1633,3510,1805,3917
250527,202307,2119,4497,1826,4118,24,72,1651,3664,1675,3736
250530,202307,810,1859,648,1599,21,55,492,1131,513,1186
250535,202307,1649,4208,1366,3670,16,54,1124,2882,1140,2936
250540,202307,3984,7327,3109,6264,352,418,2456,5178,2808,5596
250550,202307,934,2727,759,2356,54,182,519,1549,573,1731
250560,202307,2069,5035,1631,4321,104,294,1205,3036,1309,3330
250570,202307,3312,8613,2680,7457,171,538,1949,5254,2120,5792
250580,202307,1250,2934,1025,2575,64,155,794,1909,858,2064
250590,202307,1263,2630,1083,2372,40,112,928,1917,968,2029
250600,202307,9095,22294,6845,18602,337,925,5007,13079,5344,14004
250610,202307,3415,8742,2788,7666,147,475,2134,5696,2281,6171
250620,202307,1140,2383,874,1931,29,63,709,1488,738,1551
250625,202307,2705,7130,2286,6378,61,253,1906,5138,1967,5391
250630,202307,15517,33907,12219,28412,1067,2691,8649,18767,9716,21458
250640,202307,4534,10420,3658,9051,99,359,2949,6839,3048,7198
250650,202307,1292,2720,937,2224,12,59,790,1808,802,1867
250660,202307,1869,4144,1356,3341,55,132,1096,2547,1151,2679
250670,202307,2979,7677,2555,6871,49,163,2137,5454,2186,5617
250680,202307,7518,14389,5966,12411,129,425,5127,10039,5256,10464
250690,202307,8769,17104,6789,14485,164,352,5746,11774,5910,12126
250700,202307,5646,14076,4496,11921,666,1768,2836,7129,3502,8897
250710,202307,5253,13609,4131,11750,395,1112,2777,7728,3172,8840
250720,202307,3425,8180,2794,7182,76,264,2256,5535,2332,5799
250730,202307,5434,12272,4425,10717,221,594,3512,8009,3733,8603
250740,202307,2482,5430,1878,4508,127,270,1353,3150,1480,3420
250750,202307,166504,345638,130532,289552,8350,20888,96413,198251,104763,219139
250760,202307,3682,6858,3077,5968,59,151,2754,5145,2813,5296
250770,202307,4883,13182,3931,11491,496,1257,2507,7284,3003,8541
250780,202307,2267,5150,1741,4199,51,154,1420,3256,1471,3410
250790,202307,3131,7921,2461,6693,102,400,1756,4356,1858,4756
250800,202307,2935,6837,2336,5816,125,290,1821,4425,1946,4715
250810,202307,1767,3834,1294,3069,143,235,881,2139,1024,2374
250820,202307,2563,5864,2224,5400,52,181,1915,4497,1967,4678
250830,202307,7339,19393,5502,15624,245,828,3800,9968,4045,10796
250840,202307,862,2513,686,2123,40,143,492,1516,532,1659
250850,202307,2172,5545,1762,4800,31,120,1433,3741,1464,3861
250855,202307,1412,3358,1152,2916,42,133,957,2315,999,2448
250860,202307,4287,11127,3197,9132,420,1267,1825,4896,2245,6163
250870,202307,1261,2931,969,2410,52,119,709,1708,761,1827
250880,202307,1924,4381,1455,3611,130,328,1046,2484,1176,2812
250890,202307,14792,30059,11912,26075,301,1012,10002,20356,10303,21368
250900,202307,3959,9029,3132,7568,104,315,2594,5922,2698,6237
250905,202307,3079,7521,2665,6933,76,283,2305,5833,2381,6116
250910,202307,9078,17280,7269,14965,100,354,6471,12771,6571,13125
250915,202307,2647,5274,1729,4145,51,121,1445,3336,1496,3457
250920,202307,4806,10108,3883,8590,337,642,2906,6188,3243,6830
250930,202307,2813,6806,2233,5926,143,464,1675,4180,1818,4644
250933,202307,1498,3912,1193,3320,45,162,932,2487,977,2649
250937,202307,960,2242,753,1904,27,74,570,1388,597,1462
250939,202307,2501,5481,1990,4671,30,89,1706,3911,1736,4000
250940,202307,4712,10946,3758,9507,82,267,3132,7693,3214,7960
250950,202307,2020,4751,1525,4017,50,169,1192,2995,1242,3164
250960,202307,1363,3444,1118,2984,37,134,883,2238,920,2372
250970,202307,11297,24710,9004,20799,441,961,7159,15980,7600,16941
250980,202307,2841,6642,2337,5804,38,136,1989,4731,2027,4867
250990,202307,2578,6847,2069,5908,98,360,1498,4054,1596,4414
251000,202307,2297,5898,1776,4950,52,168,1379,3745,1431,3913
251010,202307,2999,7354,2477,6512,62,227,2051,5197,2113,5424
251020,202307,1889,4627,1520,3984,44,169,1224,3023,1268,3192
251030,202307,1216,2918,925,2395,43,128,603,1508,646,1636
251040,202307,2179,5299,1710,4511,34,128,1416,3565,1450,3693
251050,202307,1144,3019,866,2418,54,178,597,1547,651,1725
251060,202307,1367,2716,900,2020,38,74,675,1488,713,1562
251065,202307,554,1405,374,1042,15,41,260,691,275,732
251070,202307,902,1967,685,1631,19,71,540,1180,559,1251
251080,202307,26707,57215,20391,47080,3664,8306,11479,26218,15143,34524
251090,202307,3455,8761,2697,7393,61,215,2199,5803,2260,6018
251100,202307,938,2696,730,2249,42,124,505,1444,547,1568
251110,202307,2230,5129,1712,4147,159,351,1239,2896,1398,3247
251120,202307,9964,22531,7810,19315,372,1076,5936,13899,6308,14975
251130,202307,6063,10250,5064,9038,49,116,4683,8090,4732,8206
251140,202307,4788,12325,3979,10993,168,556,2963,7972,3131,8528
251150,202307,3417,8517,2920,7686,81,364,2313,5742,2394,6106
251160,202307,2927,6860,2427,6061,51,199,2097,5009,2148,5208
251170,202307,2286,4882,1881,4308,36,120,1648,3603,1684,3723
251180,202307,3334,7591,2597,6469,293,629,1694,4295,1987,4924
251190,202307,6966,13576,5922,12207,103,281,5254,10353,5357,10634
251200,202307,5631,13610,4648,12155,203,553,3738,9617,3941,10170
251203,202307,1247,3504,980,2887,73,228,616,1699,689,1927
251207,202307,1331,3192,899,2385,19,62,621,1553,640,1615
251210,202307,9804,21747,7264,17723,644,1302,4872,11994,5516,13296
251220,202307,1630,3370,1124,2642,74,155,846,1944,920,2099
251230,202307,5612,14097,4514,11976,146,428,3414,8663,3560,9091
251240,202307,4417,11421,3258,9138,323,904,2021,5488,2344,6392
251250,202307,14996,34070,11802,28239,1124,2567,8316,19056,9440,21623
251260,202307,646,1478,517,1252,8,23,418,952,426,975
251270,202307,5479,14278,4560,12758,297,753,3414,9530,3711,10283
251272,202307,1738,3881,1502,3538,41,158,1315,2945,1356,3103
251274,202307,1007,2567,726,2025,65,200,387,1012,452,1212
251275,202307,1961,4117,1475,3317,91,221,1160,2441,1251,2662
251276,202307,1611,3937,1315,3492,37,147,1018,2550,1055,2697
251278,202307,813,1890,636,1562,45,110,485,1118,530,1228
251280,202307,3389,6933,2874,6158,61,188,2478,4975,2539,5163
251290,202307,10318,18020,8559,15778,257,556,7491,13185,7748,13741
251300,202307,1013,2575,807,2203,18,66,672,1788,690,1854
251310,202307,3432,8485,2761,7372,47,212,2156,5476,2203,5688
251315,202307,2247,6119,1877,5370,105,281,1433,3985,1538,4266
251320,202307,1918,4538,1403,3610,47,165,1074,2608,1121,2773
251330,202307,2562,5187,1926,4360,39,105,1612,3544,1651,3649
251335,202307,1386,3381,1148,2980,15,50,1020,2558,1035,2608
251340,202307,4581,9645,3332,7768,157,364,2547,5650,2704,6014
251350,202307,1326,3307,1081,2870,43,87,846,2201,889,2288
251360,202307,2244,5370,1608,4330,31,100,1253,3250,1284,3350
251365,202307,937,2221,624,1611,19,50,467,1177,486,1227
251370,202307,35947,81491,27646,68104,5134,12104,14216,34576,19350,46680
251380,202307,1878,3977,1473,3303,52,140,1203,2563,1255,2703
251385,202307,930,2160,639,1606,19,45,464,1079,483,1124
251390,202307,9719,22069,8072,19406,652,1598,5919,13710,6571,15308
251392,202307,1239,2991,972,2556,41,102,737,1916,778,2018
251394,202307,819,2090,612,1701,58,155,393,1049,451,1204
251396,202307,853,2102,621,1643,24,77,439,1064,463,1141
251398,202307,1205,2834,760,2033,23,76,545,1366,568,1442
251400,202307,1766,3415,1299,2711,74,119,1037,2084,1111,2203
251410,202307,1893,3822,1405,3074,29,117,1187,2429,1216,2546
251420,202307,2548,5645,1934,4797,46,148,1536,3626,1582,3774
251430,202307,1804,4745,1475,4116,50,142,1198,3244,1248,3386
251440,202307,1299,3149,1003,2628,65,138,727,1905,792,2043
251445,202307,2069,4860,1725,4325,45,164,1375,3262,1420,3426
251450,202307,5691,14033,4643,12113,110,349,3811,9561,3921,9910
251455,202307,1029,2728,842,2356,30,98,653,1745,683,1843
251460,202307,1175,2895,881,2366,79,214,610,1605,689,1819
251465,202307,613,1511,466,1225,13,47,346,855,359,902
251470,202307,1351,3481,936,2609,154,477,470,1165,624,1642
251480,202307,1274,2944,893,2257,25,83,670,1589,695,1672
251490,202307,2375,5408,1832,4580,139,273,1354,3366,1493,3639
251500,202307,2655,5973,2205,5287,128,298,1709,3921,1837,4219
251510,202307,3110,8512,2323,6883,128,384,1492,4155,1620,4539
251520,202307,1189,2820,836,2172,51,106,564,1402,615,1508
251530,202307,19041,38520,14939,33161,244,904,12839,27135,13083,28039
251540,202307,3626,9253,2912,7885,123,484,2277,5787,2400,6271
251550,202307,5354,9997,4014,8157,143,282,3373,6603,3516,6885
251560,202307,656,1831,527,1588,33,119,380,1044,413,1163
251570,202307,1093,2795,793,2164,25,109,607,1555,632,1664
251580,202307,2830,5436,2259,4571,35,105,1935,3651,1970,3756
251590,202307,1974,4177,1515,3499,59,155,1271,2799,1330,2954
251593,202307,1150,3088,939,2694,94,275,590,1625,684,1900
251597,202307,2805,6346,2403,5771,30,109,2113,4925,2143,5034
251600,202307,7626,18747,6207,16390,292,844,4851,12372,5143,13216
251610,202307,4214,10139,3330,8438,435,1015,2246,5514,2681,6529
251615,202307,1675,3535,1196,2712,37,98,1041,2288,1078,2386
251620,202307,24307,47556,18079,39457,367,958,15231,32453,15598,33411
251630,202307,6408,12566,4910,10357,259,623,3895,7678,4154,8301
251640,202307,2644,6272,2169,5525,49,195,1770,4240,1819,4435
251650,202307,5119,11429,4022,9817,113,309,3267,7590,3380,7899
251660,202307,4437,11187,3543,9455,109,415,2782,7015,2891,7430
251670,202307,5800,12453,4903,11193,86,300,4373,9602,4459,9902
251675,202307,1136,2352,949,2053,33,69,820,1719,853,1788
251680,202307,3139,7118,2384,5933,120,261,1835,4508,1955,4769
251690,202307,3899,9727,2927,7810,150,436,2195,5671,2345,6107
251700,202307,2798,6722,2161,5712,53,216,1742,4335,1795,4551
251710,202307,956,2180,595,1440,38,111,405,887,443,998
251720,202307,1541,3902,1132,3147,39,139,829,2187,868,2326
251740,202307,799,1941,599,1569,25,72,447,1107,472,1179
260005,202307,38620,72754,28884,58797,1728,3635,22453,43298,24181,46933
260010,202307,12667,29443,9450,23664,629,1676,6122,14464,6751,16140
260020,202307,8442,16783,6113,13458,124,443,4950,10168,5074,10611
260030,202307,10179,19776,8074,16746,128,435,6955,13714,7083,14149
260040,202307,8758,19689,6547,16217,340,944,4769,11256,5109,12200
260050,202307,17866,37772,14641,33822,295,846,13168,29839,13463,30685
260060,202307,5212,11017,4042,9117,378,644,2952,6803,3330,7447
260070,202307,14679,29106,11676,24643,233,768,9846,19580,10079,20348
260080,202307,8460,16002,6872,13846,156,331,5831,11244,5987,11575
260090,202307,6789,14451,5539,12556,444,848,4170,9316,4614,10164
260100,202307,4041,8521,3223,7293,57,223,2739,5871,2796,6094
260105,202307,6305,14524,5128,12609,108,398,4207,9772,4315,10170
260110,202307,26135,66349,21289,58368,1164,3565,16219,42737,17383,46302
260120,202307,20001,43388,15910,36946,1852,3885,11115,25467,12967,29352
260130,202307,4037,8786,3244,7593,78,194,2574,5694,2652,5888
260140,202307,16799,31561,13266,26874,413,908,11116,21491,11529,22399
260150,202307,4555,8710,3766,7669,102,237,3305,6555,3407,6792
260160,202307,9175,17636,7513,15503,186,479,6654,13269,6840,13748
260170,202307,27371,55066,21275,46048,1182,2711,16382,33701,17564,36412
260180,202307,4407,9865,3427,8384,92,305,2768,6397,2860,6702
260190,202307,27216,44145,21514,37131,247,518,19552,32584,19799,33102
260200,202307,13492,28791,10950,25265,461,994,9371,21186,9832,22180
260210,202307,13475,33662,10690,28908,444,1235,8370,22078,8814,23313
260220,202307,15199,28509,12871,25404,327,650,11175,21260,11502,21910
260230,202307,16490,30614,13386,26460,331,649,11443,21847,11774,22496
260240,202307,3415,8747,2717,7400,69,268,2097,5436,2166,5704
260250,202307,2945,6382,2328,5368,97,224,1807,3972,1904,4196
260260,202307,17883,39228,14815,34582,1189,2468,10936,25512,12125,27980
260270,202307,6316,11725,5151,10255,86,253,4550,8677,4636,8930
260280,202307,16530,39310,13921,35088,353,1298,11997,28802,12350,30100
260290,202307,56159,123504,43206,101657,3802,9418,29905,65711,33707,75129
260300,202307,13441,28454,10789,24506,342,1037,8882,19129,9224,20166
260310,202307,8226,16372,6901,14531,381,713,5706,11779,6087,12492
260320,202307,8850,23232,6777,19544,147,531,5405,15190,5552,15721
260330,202307,2946,8040,2272,6694,91,324,1714,4828,1805,5152
260340,202307,2685,6038,2170,5205,53,179,1777,4015,1830,4194
260345,202307,39070,83253,30205,68910,2913,6929,20256,42959,23169,49888
260350,202307,8171,14452,6488,12467,41,161,5926,11003,5967,11164
260360,202307,2921,6714,2178,5320,73,213,1632,3781,1705,3994
260370,202307,6951,16441,5427,13772,181,567,4334,10372,4515,10939
260380,202307,6120,15601,4762,13203,249,664,3515,9478,3764,10142
260390,202307,5679,15119,4021,11609,234,654,2661,7367,2895,8021
260392,202307,5063,12186,4329,11143,67,355,3705,9178,3772,9533
260400,202307,28280,52418,22650,44105,461,1300,18923,34351,19384,35651
260410,202307,106053,223218,78572,181319,14886,35011,39430,88820,54316,123831
260415,202307,6033,12769,4739,10804,84,267,4025,8799,4109,9066
260420,202307,16674,28040,13105,23947,168,505,11965,21166,12133,21671
260430,202307,3227,9168,2501,7648,164,552,1611,4747,1775,5299
260440,202307,5318,10729,4178,9104,90,284,3507,7239,3597,7523
260450,202307,6958,15540,5800,13821,326,621,4729,11187,5055,11808
260460,202307,7035,17000,5416,13926,359,1039,3682,8707,4041,9746
260470,202307,6160,12784,4906,11255,139,355,4169,9605,4308,9960
260480,202307,4525,10402,3448,8636,288,821,2415,5751,2703,6572
260490,202307,7111,13307,5663,11341,85,312,4939,9342,5024,9654
260500,202307,7545,16430,5945,13937,630,1333,4047,9419,4677,10752
260510,202307,14298,27690,11509,23630,194,545,10088,19983,10282,20528
260515,202307,5618,12885,4109,10112,99,296,3010,6758,3109,7054
260520,202307,20239,40929,15850,34415,986,2193,12145,24875,13131,27068
260530,202307,12742,29388,10365,25651,157,630,8913,21110,9070,21740
260540,202307,9782,17315,8222,15360,134,343,7484,13571,7618,13914
260545,202307,180,454,109,310,23,64,32,65,55,129
260550,202307,3830,9264,2678,7093,183,557,1734,4126,1917,4683
260560,202307,6859,15599,5235,13007,173,553,4135,9737,4308,10290
260570,202307,11547,23215,9411,20302,209,635,8058,16483,8267,17118
260580,202307,6444,11930,5510,10643,66,168,5000,9393,5066,9561
260590,202307,9556,16673,7521,14195,115,326,6648,12017,6763,12343
260600,202307,44434,94869,34407,78641,1420,3913,26742,56637,28162,60550
260610,202307,9702,22301,7457,18736,328,959,5759,13802,6087,14761
260620,202307,28358,55777,22390,46586,1128,2919,17725,34117,18853,37036
260630,202307,2818,6739,2240,5765,59,159,1803,4479,1862,4638
260640,202307,33426,60557,26318,51375,1292,2352,21529,40706,22821,43058
260650,202307,7617,16958,5693,14325,437,866,4487,11117,4924,11983
260660,202307,9586,19899,7692,17271,248,698,6646,14340,6894,15038
260670,202307,2814,6325,2108,5085,88,296,1580,3549,1668,3845
260680,202307,40003,81400,29839,65124,2144,4827,22058,45365,24202,50192
260690,202307,4231,9510,3127,7708,72,248,2507,5882,2579,6130
260700,202307,9477,18923,8464,17760,129,372,7914,16326,8043,16698
260710,202307,1655,3841,1216,3110,42,152,920,2211,962,2363
260720,202307,40032,77467,30823,64474,1577,3790,24222,47695,25799,51485
260730,202307,10216,25040,8422,22280,234,760,7082,18066,7316,18826
260740,202307,1627,3889,1206,3153,32,127,920,2278,952,2405
260750,202307,9729,21058,7317,17956,214,479,6222,15335,6436,15814
260760,202307,8654,16472,7062,14452,116,348,6172,12078,6288,12426
260765,202307,10693,25834,8542,22212,701,1933,5807,14213,6508,16146
260770,202307,4862,10591,3691,8691,113,347,2989,6754,3102,7101
260775,202307,7773,17065,6367,14684,182,549,5106,10984,5288,11533
260780,202307,4716,11793,3506,9327,280,853,2204,5193,2484,6046
260790,202307,198539,366493,154331,303391,17968,36463,108398,201047,126366,237510
260795,202307,4565,8690,3537,7320,156,444,2745,5260,2901,5704
260800,202307,7975,14312,6865,12764,342,501,5933,10755,6275,11256
260805,202307,4729,10744,3636,8768,121,376,2909,6552,3030,6928
260810,202307,8329,18979,6590,15701,268,711,5063,11212,5331,11923
260820,202307,6102,11397,4890,9847,109,308,4189,8153,4298,8461
260825,202307,3513,9237,2824,7947,144,498,2081,5579,2225,6077
260830,202307,5286,13410,4109,11306,432,1005,2783,7644,3215,8649
260840,202307,5822,11918,4787,10433,215,495,4054,8487,4269,8982
260845,202307,5676,12776,4513,10745,201,628,3429,7587,3630,8215
260850,202307,6074,14195,4477,11075,390,940,2881,6614,3271,7554
260860,202307,4062,10394,3162,8709,203,586,2359,6217,2562,6803
260870,202307,5701,11031,4669,9674,149,278,4010,8140,4159,8418
260875,202307,10856,21178,8016,17090,635,1363,5479,11209,6114,12572
260880,202307,14294,31591,11785,27506,383,987,9706,21691,10089,22678
260890,202307,16808,36459,13227,30517,1448,3282,8398,18755,9846,22037
260900,202307,6899,17112,5284,14518,542,1502,3059,8008,3601,9510
260910,202307,4299,9528,3592,8457,186,390,2781,6404,2967,6794
260915,202307,7290,15018,6340,13789,97,284,5777,12276,5874,12560
260920,202307,4375,8249,3465,7153,146,338,2909,5744,3055,6082
260930,202307,5175,12946,3983,10811,182,620,3072,7842,3254,8462
260940,202307,19851,39319,15620,32829,1219,2629,11773,23612,12992,26241
260950,202307,9587,21140,7003,16479,376,1041,4884,10396,5260,11437
260960,202307,120412,215412,93748,178229,6915,13930,71268,127008,78183,140938
260970,202307,6948,15795,5321,13239,329,609,3899,9536,4228,10145
260980,202307,5959,14140,4920,12700,121,383,4177,10517,4298,10900
260990,202307,20683,50683,16096,43559,818,2339,12192,31615,13010,33954
261000,202307,21440,41305,16232,33952,687,1590,12877,25329,13564,26919
261010,202307,2678,5938,2152,5180,78,198,1799,4213,1877,4411
261020,202307,8536,18664,6902,15909,308,746,5503,11904,5811,12650
261030,202307,5088,12687,4025,10715,117,425,3095,7694,3212,8119
261040,202307,6693,16282,5114,13421,215,717,3813,9379,4028,10096
261050,202307,9969,21754,8106,18820,202,496,6552,14543,6754,15039
261060,202307,18981,40089,15178,34731,433,1221,12297,26718,12730,27939
261070,202307,96650,183947,72350,147915,7352,14919,51218,99513,58570,114432
261080,202307,9056,17976,7633,16069,92,237,7071,14528,7163,14765
261090,202307,26051,49784,21078,42816,885,1713,17382,34034,18267,35747
261100,202307,11179,25809,8999,22338,545,1335,6812,16293,7357,17628
261110,202307,100005,233066,75324,186632,8865,23538,44932,103338,53797,126876
261120,202307,4945,9914,4012,8521,109,264,3473,7070,3582,7334
261130,202307,9780,19535,7958,16902,223,437,6752,13944,6975,14381
261140,202307,4934,9469,3866,7873,260,446,2974,5938,3234,6384
261150,202307,7025,14762,5640,12687,218,485,4474,9693,4692,10178
261153,202307,2337,6173,1720,4910,86,251,1165,3219,1251,3470
261160,202307,319661,634236,239024,514163,64290,137364,95916,207720,160206,345084
261170,202307,10015,18857,8199,16364,274,524,7051,13505,7325,14029
261180,202307,11775,25176,9196,21120,409,927,7079,15452,7488,16379
261190,202307,6702,14881,5333,12532,173,644,4280,9251,4453,9895
261200,202307,4432,8533,3509,7226,151,341,2855,5670,3006,6011
261210,202307,2265,4885,1810,4177,125,180,1437,3299,1562,3479
261220,202307,19124,43673,14727,35699,1170,2991,10300,23024,11470,26015
261230,202307,4708,11598,3631,9943,79,316,2865,7606,2944,7922
261240,202307,7926,15237,6564,13186,218,436,5698,11064,5916,11500
261245,202307,4830,11263,3688,9334,114,418,2871,6764,2985,7182
261247,202307,3794,9874,2849,8094,293,845,1850,5120,2143,5965
261250,202307,38626,71519,31551,62486,3860,7644,23463,45538,27323,53182
261255,202307,4853,12503,3548,9966,145,511,2558,6729,2703,7240
261260,202307,20448,39914,16777,35154,332,998,14825,29624,15157,30622
261270,202307,6725,12407,5500,10773,205,383,4833,9174,5038,9557
261280,202307,3258,7678,2660,6674,113,366,2071,4895,2184,5261
261290,202307,3694,7844,2823,6703,80,214,2240,5150,2320,5364
261300,202307,17503,38801,13661,32320,404,1240,10809,23815,11213,25055
261310,202307,12792,26479,10214,22529,887,1944,7569,15995,8456,17939
261320,202307,7464,18036,6041,15614,148,423,4839,11999,4987,12422
261330,202307,8028,15723,6744,13956,177,448,5858,11647,6035,12095
261340,202307,7716,15236,6342,13337,237,562,5379,10805,5616,11367
261350,202307,10290,26956,8094,22747,360,988,6013,16403,6373,17391
261360,202307,11264,21899,8953,18424,442,902,7173,14110,7615,15012
261370,202307,33328,70261,25427,57997,1954,4620,18271,39155,20225,43775
261380,202307,5570,13236,4553,11525,475,1162,2990,7372,3465,8534
261390,202307,21738,53594,16471,44414,1377,3868,10923,27839,12300,31707
261400,202307,6272,15266,5049,12949,215,767,3872,9173,4087,9940
261410,202307,12608,25984,9564,21346,261,756,7839,16328,8100,17084
261420,202307,10946,25885,8780,22485,549,1532,6645,16045,7194,17577
261430,202307,5536,11140,4526,9634,53,159,4048,8231,4101,8390
261440,202307,1665,4463,1274,3684,56,244,893,2417,949,2661
261450,202307,19029,42337,15391,36541,710,1766,11954,27631,12664,29397
261460,202307,9676,22477,7598,19056,289,790,5915,14419,6204,15209
261470,202307,4629,10247,3591,8597,71,241,2958,6739,3029,6980
261480,202307,6869,17455,5461,14990,261,929,4039,10243,4300,11172
261485,202307,7143,16991,5698,14551,374,1117,4164,10025,4538,11142
261500,202307,8761,18777,7077,16220,690,1288,4976,11624,5666,12912
261510,202307,2191,5799,1731,4927,71,266,1295,3572,1366,3838
261520,202307,2941,7497,2356,6276,131,386,1683,4212,1814,4598
261530,202307,15372,37925,11261,30285,701,2322,6998,16855,7699,19177
261540,202307,12205,30047,10516,27344,2764,6384,5064,14449,7828,20833
261550,202307,4653,10678,3672,8959,238,643,2673,6115,2911,6758
261560,202307,12024,26967,9893,23637,338,939,8049,18305,8387,19244
261570,202307,4538,10869,3227,8478,293,834,2121,5246,2414,6080
261580,202307,9127,19392,7314,16748,95,378,6530,14333,6625,14711
261590,202307,3371,7249,2618,6074,64,209,2107,4609,2171,4818
261600,202307,7725,14627,6341,12632,141,314,5437,10328,5578,10642
261610,202307,2725,6999,2044,5690,236,649,1209,3323,1445,3972
261618,202307,3609,6807,2913,5825,62,181,2483,4715,2545,4896
261620,202307,6126,14186,5348,12982,595,1247,3881,9650,4476,10897
261630,202307,7328,18462,5591,14944,418,1213,3463,8399,3881,9612
261640,202307,49333,93357,37740,77426,1979,3443,28905,58133,30884,61576
261650,202307,5492,11015,4153,9171,274,586,3236,6972,3510,7558
270010,202307,5110,15149,3973,12867,178,815,2810,8571,2988,9386
270020,202307,5141,10544,4076,9067,179,602,3259,6621,3438,7223
270030,202307,45902,109424,36798,94248,2419,6510,27241,66868,29660,73378
270040,202307,12069,28526,9366,24660,672,1927,6858,17218,7530,19145
270050,202307,6699,13654,5321,11978,186,482,4554,9934,4740,10416
270060,202307,2752,6354,2135,5471,137,372,1542,3744,1679,4116
270070,202307,6546,14370,5376,12657,148,460,4642,10466,4790,10926
270080,202307,1766,4175,1300,3397,92,239,950,2393,1042,2632
270090,202307,2249,5758,1892,5118,68,218,1611,4244,1679,4462
270100,202307,8871,16374,7213,14128,184,437,6309,11888,6493,12325
270110,202307,3911,8383,2904,7025,181,340,2296,5599,2477,5939
270120,202307,3012,7448,2469,6618,93,279,1870,4831,1963,5110
270130,202307,6062,13796,4757,11900,144,492,3842,9076,3986,9568
270135,202307,2401,5068,1907,4464,44,165,1631,3640,1675,3805
270140,202307,10260,22832,7184,17902,408,1122,5172,11987,5580,13109
270150,202307,3899,8793,3424,8101,48,174,3154,7281,3202,7455
270160,202307,6100,15399,4944,13762,177,616,4218,11398,4395,12014
270170,202307,3767,10001,2881,8464,184,698,1911,5115,2095,5813
270180,202307,2872,7557,2425,6876,87,367,1991,5449,2078,5816
270190,202307,3043,6065,2619,5532,39,144,2356,4779,2395,4923
270200,202307,3292,8553,2576,7247,467,1129,1514,4377,1981,5506
270210,202307,7056,14255,5734,12606,136,482,4993,10529,5129,11011
270220,202307,2079,4473,1517,3560,113,281,1129,2470,1242,2751
270230,202307,12463,29646,9772,25205,922,2583,7117,17406,8039,19989
270235,202307,7515,20253,6059,17628,303,932,4552,12783,4855,13715
270240,202307,14161,33562,10692,27896,947,2728,7573,18754,8520,21482
270250,202307,4215,8293,3386,7098,177,455,2735,5426,2912,5881
270255,202307,5168,13277,3863,10890,160,506,2936,7937,3096,8443
270260,202307,6496,17813,5477,15969,114,483,4493,12612,4607,13095
270270,202307,1203,2868,900,2430,97,243,643,1705,740,1948
270280,202307,4491,9599,3232,7928,248,534,2276,5589,2524,6123
270290,202307,9642,26631,8254,24226,239,941,6889,19679,7128,20620
270300,202307,4841,11434,3482,9550,218,625,2532,6702,2750,7327
270310,202307,7935,20137,6298,17424,180,633,4908,13066,5088,13699
270320,202307,6579,17392,5056,14336,217,762,3569,9238,3786,10000
270330,202307,5225,14287,4319,12838,192,829,3521,10021,3713,10850
270340,202307,1945,4560,1532,3898,95,176,1253,3178,1348,3354
270350,202307,2257,4578,1683,3827,142,273,1147,2612,1289,2885
270360,202307,4282,8148,3636,7365,66,198,3305,6465,3371,6663
270370,202307,1584,4455,1321,3963,39,173,1065,3084,1104,3257
270375,202307,4840,8709,3857,7608,110,306,3308,6295,3418,6601
270380,202307,6899,15741,5298,13502,583,1349,3794,9626,4377,10975
270390,202307,1504,3241,1120,2774,12,64,954,2317,966,2381
270400,202307,7668,18197,5774,15099,314,852,4089,10178,4403,11030
270410,202307,6235,15378,5060,13498,144,512,4146,10592,4290,11104
270420,202307,8361,19420,7268,17692,177,609,6111,14149,6288,14758
270430,202307,216700,436690,159560,354166,18237,41286,101403,212704,119640,253990
270440,202307,5628,13521,4584,11994,300,1017,3530,8974,3830,9991
270450,202307,11246,23331,9297,20714,510,1023,7428,16282,7938,17305
270460,202307,4695,9310,3638,7945,229,414,3061,6597,3290,7011
270470,202307,14660,35178,11686,30346,673,1996,8800,21701,9473,23697
270480,202307,3729,8427,2840,7093,175,468,2181,5148,2356,5616
270490,202307,1055,2646,848,2329,51,162,635,1657,686,1819
270500,202307,5828,15477,4963,13872,295,794,3906,10705,4201,11499
270510,202307,7677,16853,5875,14211,292,861,4548,10365,4840,11226
270520,202307,4905,12052,3437,9423,661,1825,1667,4458,2328,6283
270530,202307,1614,4165,1236,3481,86,233,835,2307,921,2540
270540,202307,2701,6481,2092,5571,81,250,1745,4493,1826,4743
270550,202307,7794,17974,5698,15282,630,1544,3789,10152,4419,11696
270560,202307,3592,8046,2758,6805,157,514,2106,4801,2263,5315
270570,202307,6858,14390,5531,12348,514,1274,4311,8977,4825,10251
270580,202307,2918,7028,2459,6299,102,280,2044,5061,2146,5341
270590,202307,1699,4633,1479,4270,33,140,1262,3554,1295,3694
270600,202307,3340,8857,2882,8079,104,302,2422,6672,2526,6974
270610,202307,4299,10229,3529,9072,213,554,2626,6496,2839,7050
270620,202307,1405,3850,1199,3461,52,154,966,2701,1018,2855
270630,202307,23973,48771,19555,42433,640,1760,16599,34055,17239,35815
270640,202307,6708,16679,5270,14302,160,627,4045,10408,4205,11035
270642,202307,3111,8643,2535,7548,215,681,1730,4850,1945,5531
270644,202307,4769,10536,3733,9081,297,740,2822,6690,3119,7430
270650,202307,4557,10507,3722,9271,214,610,2892,6747,3106,7357
270660,202307,2339,5168,1923,4565,89,202,1469,3369,1558,3571
270670,202307,23432,45197,18172,38058,898,1930,14676,29249,15574,31179
270680,202307,7755,14458,6623,13100,300,455,5905,11701,6205,12156
270690,202307,12686,27168,9680,22761,267,808,7845,17459,8112,18267
270700,202307,686,1783,552,1541,72,204,368,978,440,1182
270710,202307,7055,18484,5706,16130,402,1217,4251,11630,4653,12847
270720,202307,4441,11090,3648,9706,124,406,2971,7571,3095,7977
270730,202307,9436,18943,7169,16231,722,1152,5289,12410,6011,13562
270740,202307,2760,6722,2174,5828,87,303,1643,4139,1730,4442
270750,202307,6810,15308,5637,13539,105,378,5024,11604,5129,11982
270760,202307,4003,9646,3127,8313,66,283,2535,6470,2601,6753
270770,202307,29390,64551,21625,52612,2901,6911,13707,31768,16608,38679
270780,202307,2502,5380,2143,4881,60,163,1883,4147,1943,4310
270790,202307,2177,4967,1674,4166,108,273,1285,3042,1393,3315
270800,202307,14602,32480,12035,28539,599,1593,9377,21213,9976,22806
270810,202307,4165,9897,3092,8197,291,740,2206,5669,2497,6409
270820,202307,1910,5102,1533,4463,58,225,1200,3356,1258,3581
270830,202307,6116,13288,4524,11065,319,735,3393,8035,3712,8770
270840,202307,9811,26403,7919,23146,552,2251,5899,16242,6451,18493
270850,202307,10848,21947,8535,18958,586,1387,6769,14490,7355,15877
270860,202307,17752,35526,12697,28731,775,1861,9931,21635,10706,23496
270870,202307,2806,7265,2003,5792,190,585,1211,3283,1401,3868
270880,202307,9423,25467,7684,22285,254,996,5922,16377,6176,17373
270890,202307,4226,10216,3225,8467,511,1344,1701,4280,2212,5624
270895,202307,4712,11045,3992,9982,174,520,3307,7967,3481,8487
270900,202307,1862,4339,1356,3546,33,125,1042,2559,1075,2684
270910,202307,5499,13529,4379,11706,289,674,3329,8606,3618,9280
270915,202307,11383,28378,8339,22864,843,2644,5229,13162,6072,15806
270920,202307,7343,18338,6034,16260,112,487,5049,13141,5161,13628
270930,202307,22020,44656,16171,37120,1989,4325,11102,25187,13091,29512
270940,202307,7243,17310,5450,14679,181,689,4165,10468,4346,11157
280010,202307,680,1803,498,1430,18,75,331,854,349,929
280020,202307,6525,13834,5112,11569,409,934,3842,8243,4251,9177
280030,202307,127214,246802,96244,199167,16044,32369,55856,111037,71900,143406
280040,202307,3749,8555,2960,7251,157,461,2288,5299,2445,5760
280050,202307,5171,13129,3809,10518,854,2331,1779,4676,2633,7007
280060,202307,9845,20860,7233,16684,964,2457,4435,9485,5399,11942
280067,202307,8884,18248,6847,14953,625,1040,4960,10630,5585,11670
280070,202307,2176,5833,1856,5286,123,403,1381,3700,1504,4103
280100,202307,5373,11994,4172,9987,593,1244,2479,5983,3072,7227
280110,202307,1986,4158,1600,3606,40,131,1394,3005,1434,3136
280120,202307,9925,23602,8164,20639,1143,2538,5459,13892,6602,16430
280130,202307,10545,22092,8113,18598,706,1705,5868,13008,6574,14713
280140,202307,7574,14670,6278,12721,696,1163,4592,9392,5288,10555
280150,202307,4834,11009,3526,8713,508,1024,2222,5341,2730,6365
280160,202307,1609,3842,1240,3175,110,256,823,1933,933,2189
280170,202307,7227,15051,5865,12996,216,548,4838,10215,5054,10763
280190,202307,2087,3422,1737,2950,30,68,1574,2574,1604,2642
280200,202307,1507,3572,1082,2892,59,219,735,1738,794,1957
280210,202307,22417,46770,17049,38031,2127,4699,11266,23975,13393,28674
280220,202307,2036,4546,1598,3899,86,182,1238,2951,1324,3133
280230,202307,5015,11413,3654,9184,233,522,2450,5957,2683,6479
280240,202307,3867,9159,3193,8072,40,180,2709,6523,2749,6703
280250,202307,1327,2467,891,1764,40,87,713,1313,753,1400
280260,202307,3084,6015,2459,5181,45,114,2179,4411,2224,4525
280270,202307,3075,7099,2531,6258,116,358,2137,5021,2253,5379
280280,202307,4706,12320,3757,10664,500,1176,2562,7349,3062,8525
280290,202307,27793,59310,21540,49235,2409,5940,13110,29357,15519,35297
280300,202307,16609,31848,13675,28356,961,1442,10846,23049,11807,24491
280310,202307,1676,3787,1289,3138,48,141,1010,2320,1058,2461
280320,202307,11562,26021,9126,21960,897,2088,6514,14803,7411,16891
280330,202307,5525,12272,3989,9792,311,789,2755,6335,3066,7124
280340,202307,6398,11876,4704,9782,198,384,3918,7893,4116,8277
280350,202307,40316,74037,32244,62303,1775,3314,26009,48038,27784,51352
280360,202307,7123,17377,5193,13845,568,1587,3188,7874,3756,9461
280370,202307,2865,5932,2154,4733,196,349,1558,3383,1754,3732
280380,202307,1288,2953,985,2444,113,265,673,1622,786,1887
280390,202307,5123,10166,3935,8301,253,444,3133,6423,3386,6867
280400,202307,5145,10608,3931,8792,359,773,2886,6240,3245,7013
280410,202307,3497,8162,2658,6686,318,850,1707,3980,2025,4830
280420,202307,5576,12327,4663,11058,128,318,4074,9514,4202,9832
280430,202307,2958,5860,2387,5056,99,275,1943,3830,2042,4105
280440,202307,5540,12111,4409,10284,285,681,3465,7608,3750,8289
280445,202307,2654,6334,2249,5608,140,236,1678,4095,1818,4331
280450,202307,12042,26796,9487,22725,2291,5426,4709,11273,7000,16699
280460,202307,8665,17757,7157,15583,501,1219,5607,11576,6108,12795
280470,202307,2008,4968,1511,4005,148,392,1069,2685,1217,3077
280480,202307,65137,131159,50631,108501,5443,12051,34422,69572,39865,81623
280490,202307,4102,10753,3166,8968,249,700,2143,5762,2392,6462
280500,202307,1285,2599,925,2088,35,104,726,1581,761,1685
280510,202307,4510,7562,3675,6430,69,164,3304,5500,3373,5664
280520,202307,2336,4782,1879,4101,162,298,1391,2950,1553,3248
280530,202307,2820,6374,2171,5329,102,265,1698,3989,1800,4254
280540,202307,10343,24632,8748,22074,410,1060,7250,17895,7660,18955
280550,202307,8213,16488,6316,13676,172,511,5183,10510,5355,11021
280560,202307,9203,21443,8009,19509,185,567,6895,16283,7080,16850
280570,202307,8657,17616,6582,14637,266,675,5148,10700,5414,11375
280580,202307,7741,16108,6322,13837,458,901,5008,10599,5466,11500
280590,202307,3339,7010,2403,5614,138,370,1744,3776,1882,4146
280600,202307,5261,11213,4226,9406,560,1070,2881,6308,3441,7378
280610,202307,3488,6885,2724,5739,116,270,2241,4485,2357,4755
280620,202307,7735,15772,5970,13199,466,757,4357,9686,4823,10443
280630,202307,5138,11386,4220,9923,373,730,3058,7080,3431,7810
280640,202307,3039,6582,2375,5683,86,238,2030,4702,2116,4940
280650,202307,1412,3369,1032,2698,115,313,627,1478,742,1791
280660,202307,4763,8891,3700,7466,245,486,3021,5896,3266,6382
280670,202307,25776,52795,19639,43584,3367,7219,11613,25157,14980,32376
280680,202307,3553,7467,2751,6199,268,488,1865,4241,2133,4729
280690,202307,1312,2589,998,2126,44,112,808,1637,852,1749
280700,202307,1451,2990,1146,2504,21,52,965,2036,986,2088
280710,202307,18905,36174,14488,30556,872,1589,11802,24195,12674,25784
280720,202307,3132,6226,2249,4979,40,112,1870,4029,1910,4141
280730,202307,1246,2849,942,2311,97,235,632,1494,729,1729
280740,202307,21396,40073,17016,33472,882,1951,13776,25491,14658,27442
280750,202307,4087,10284,3223,8663,302,784,2236,5836,2538,6620
280760,202307,9148,19286,7163,16285,641,1276,5277,11830,5918,13106
290010,202307,3728,6773,2394,4778,27,62,2047,3850,2074,3912
290020,202307,7424,15126,6285,13569,434,725,5098,10901,5532,11626
290030,202307,5454,11032,4175,9386,345,729,3128,7090,3473,7819
290035,202307,6182,11691,4835,9820,196,328,3899,7702,4095,8030
290040,202307,7142,12159,5778,10450,209,325,5010,8866,5219,9191
290050,202307,2510,7122,1894,5739,141,456,1252,3562,1393,4018
290060,202307,1903,3602,1283,2729,147,317,931,1880,1078,2197
290070,202307,52952,99768,40529,81713,3172,6177,30390,58771,33562,64948
290080,202307,8591,19419,6894,16664,776,1915,4767,11158,5543,13073
290090,202307,2737,4336,1919,3444,40,70,1739,3039,1779,3109
290100,202307,12074,27458,8512,21401,1594,3926,4068,10193,5662,14119
290110,202307,6868,15611,5054,12219,828,1811,2774,6568,3602,8379
290115,202307,4865,12893,3806,10884,353,1001,2862,7974,3215,8975
290120,202307,8256,17420,6309,14447,218,582,5273,11481,5491,12063
290130,202307,5551,11507,3907,9128,252,511,2727,6485,2979,6996
290135,202307,5667,11452,4085,8699,257,572,3135,6235,3392,6807
290140,202307,5243,12084,3705,9748,196,490,2889,7378,3085,7868
290150,202307,4233,7826,3195,6466,126,331,2562,4834,2688,5165
290160,202307,4512,8557,3692,7334,215,367,3067,5951,3282,6318
290170,202307,4647,9273,3634,8007,134,327,3074,6529,3208,6856
290180,202307,3596,8447,2832,7172,73,250,2354,5726,2427,5976
290190,202307,6225,12996,5238,11590,116,317,4514,9686,4630,10003
290195,202307,3315,6687,2436,5510,160,309,1921,4271,2081,4580
290200,202307,4952,12304,3477,9593,226,517,2406,6477,2632,6994
290205,202307,4576,9674,3539,7904,173,461,2740,5780,2913,6241
290210,202307,17914,39569,14525,34006,1469,2970,10762,25050,12231,28020
290220,202307,4186,7699,3410,6674,108,266,2920,5486,3028,5752
290225,202307,3753,6572,2695,5392,53,165,2357,4458,2410,4623
290230,202307,3885,7438,3386,6802,188,287,2718,5539,2906,5826
290240,202307,5103,10061,3988,8649,135,350,3361,7057,3496,7407
290250,202307,5098,12080,3752,9937,168,451,2986,7793,3154,8244
290260,202307,6519,13883,5101,11624,249,610,4213,9130,4462,9740
290265,202307,3735,10218,2757,8206,344,1105,1657,4681,2001,5786
290270,202307,13154,39396,11093,35299,861,2778,7921,24706,8782,27484
290280,202307,7350,20236,5633,16422,647,2014,3526,9635,4173,11649
290290,202307,11871,31106,8397,24314,974,2954,4967,13518,5941,16472
290300,202307,4935,12057,3347,8993,213,665,2379,6047,2592,6712
290310,202307,2829,4939,2225,4197,18,50,2039,3714,2057,3764
290320,202307,37987,83876,27534,66510,4820,11942,15357,35062,20177,47004
290323,202307,4620,11182,3582,9354,151,418,2752,7067,2903,7485
290327,202307,5125,12880,3802,10069,378,891,2489,6347,2867,7238
290330,202307,3084,4984,2346,4157,27,71,2114,3648,2141,3719
290340,202307,7876,16036,5813,13255,405,910,4537,10022,4942,10932
290350,202307,5726,14394,4358,11902,276,833,3151,8287,3427,9120
290360,202307,6661,13750,5278,11732,204,574,4456,9474,4660,10048
290370,202307,5639,12337,3652,9406,211,565,2568,6526,2779,7091
290380,202307,7258,15301,5545,12749,184,405,4598,10412,4782,10817
290390,202307,18912,47156,14129,38550,1351,3664,9432,24917,10783,28581
290395,202307,3582,8681,2556,6815,105,367,1941,4890,2046,5257
290400,202307,4491,10997,3166,8576,159,504,2337,6017,2496,6521
290405,202307,5442,13995,4267,11830,533,1411,2680,7454,3213,8865
290410,202307,6750,15828,4722,12459,181,693,3530,8797,3711,9490
290420,202307,3734,9026,2774,7399,143,384,2004,5271,2147,5655
290430,202307,4573,9676,3570,8140,153,417,2857,6163,3010,6580
290440,202307,3470,7664,2333,5785,177,404,1636,4017,1813,4421
290450,202307,5337,10027,3882,7844,81,220,3408,6544,3489,6764
290460,202307,15522,39660,10717,29510,2487,6903,3990,10456,6477,17359
290470,202307,6020,11881,4141,9119,366,795,2869,6104,3235,6899
290475,202307,8052,19785,6129,16408,164,631,4933,12600,5097,13231
290480,202307,2280,4846,1676,3845,58,191,1230,2539,1288,2730
290485,202307,5653,14192,4600,12509,260,792,3480,9208,3740,10000
290490,202307,11935,23324,9885,20286,591,1171,7858,15682,8449,16853
290500,202307,5102,13627,3444,10025,725,2243,1305,3555,2030,5798
290510,202307,4445,9145,3480,7814,109,256,2940,6517,3049,6773
290515,202307,4180,10277,3246,8716,81,325,2569,6532,2650,6857
290520,202307,15137,37208,10464,27807,583,1921,6917,16579,7500,18500
290530,202307,5839,14976,4547,12723,122,444,3713,10125,3835,10569
290540,202307,4999,11144,4209,10105,146,366,3510,8191,3656,8557
290550,202307,5299,11534,4333,10250,130,403,3667,8437,3797,8840
290560,202307,7568,17322,5266,13611,522,1487,3197,7560,3719,9047
290570,202307,75707,158182,61581,136331,5293,12768,46509,97554,51802,110322
290580,202307,11358,25702,9358,22736,830,1854,6882,16753,7712,18607
290590,202307,8326,23073,6566,19904,184,652,5151,15566,5335,16218
290600,202307,23149,57193,18067,48051,1182,3312,13767,35117,14949,38429
290610,202307,2909,8147,2103,6474,104,357,1475,4352,1579,4709
290620,202307,7229,18900,5691,16099,446,1187,4307,11994,4753,13181
290630,202307,13197,24983,10300,21178,671,1432,8194,16361,8865,17793
290640,202307,3300,7084,2266,5410,230,475,1566,3785,1796,4260
290650,202307,24194,45469,20314,40066,727,1870,17697,33270,18424,35140
290660,202307,4517,10557,3215,8206,185,532,2305,5723,2490,6255
290670,202307,10776,21125,8596,17854,192,512,7499,14940,7691,15452
290680,202307,13643,32039,10684,27486,261,961,8711,21524,8972,22485
290682,202307,6743,13600,5486,11855,452,684,3991,9211,4443,9895
290685,202307,4262,8702,2845,6543,429,907,1659,3865,2088,4772
290687,202307,10384,21749,8127,18133,1128,2325,5145,11464,6273,13789
290689,202307,3379,8206,2272,6198,325,836,1393,3701,1718,4537
290690,202307,7023,16004,5157,12906,391,969,3635,8711,4026,9680
290700,202307,3870,7764,3143,6776,110,278,2616,5418,2726,5696
290710,202307,11218,25124,8924,21773,218,670,7713,18284,7931,18954
290720,202307,26071,58570,21186,50773,1583,3527,15680,35951,17263,39478
290730,202307,8811,18412,6818,15687,601,1171,4644,10755,5245,11926
290740,202307,1338,3051,960,2452,59,138,762,1893,821,2031
290750,202307,17799,34191,13391,26492,349,907,11153,20478,11502,21385
290755,202307,2342,6083,1687,4868,159,383,1110,3199,1269,3582
290760,202307,4446,11464,3339,9356,168,399,2365,6638,2533,7037
290770,202307,3921,8843,3362,8023,93,302,2841,6508,2934,6810
290780,202307,9374,21042,6931,17076,506,1102,4907,11940,5413,13042
290790,202307,6265,14768,4997,12774,309,842,3939,9869,4248,10711
290800,202307,8192,14613,5506,11223,431,743,3979,8158,4410,8901
290810,202307,6884,14768,5103,11964,217,559,3945,8996,4162,9555
290820,202307,6694,14788,5060,11943,282,647,3601,8086,3883,8733
290830,202307,5129,11450,3900,9194,159,558,2843,5972,3002,6530
290840,202307,22623,52642,17116,43007,1853,3973,10513,27225,12366,31198
290850,202307,11463,20666,8845,17287,638,1142,6824,12898,7462,14040
290860,202307,8028,18824,6581,16821,358,785,5376,13742,5734,14527
290870,202307,5817,14219,3917,10425,367,875,2551,6513,2918,7388
290880,202307,1685,3690,1204,2989,199,445,658,1735,857,2180
290890,202307,12229,21188,9565,18007,323,673,8165,14755,8488,15428
290900,202307,2742,6697,1820,4881,204,549,1055,2700,1259,3249
290910,202307,6199,12764,4327,9905,68,190,3720,8269,3788,8459
290920,202307,6376,13683,5214,12205,188,365,4263,10375,4451,10740
290930,202307,8565,21928,6280,17702,286,921,4487,12104,4773,13025
290940,202307,4073,10374,3077,8672,207,623,2265,6158,2472,6781
290950,202307,1702,3800,1238,3043,106,258,783,1923,889,2181
290960,202307,7483,16053,6020,13870,290,552,4954,11219,5244,11771
290970,202307,3618,10113,2662,8150,173,587,1883,5535,2056,6122
290980,202307,18456,37182,14038,29823,767,1835,9961,19378,10728,21213
290990,202307,11986,27748,9847,24147,397,1254,7919,18324,8316,19578
291000,202307,3942,8871,2866,7416,191,541,2172,5536,2363,6077
291005,202307,21906,46195,17287,39030,1063,2568,13384,28535,14447,31103
291010,202307,3534,9964,2467,7507,147,455,1592,4626,1739,5081
291020,202307,1527,3408,1109,2664,36,108,773,1666,809,1774
291030,202307,3087,6481,2031,4648,232,483,1226,2682,1458,3165
291040,202307,6418,15401,4824,12965,254,704,3604,9526,3858,10230
291050,202307,14653,28592,11834,24286,1425,2729,8440,16853,9865,19582
291060,202307,11151,23977,8945,20732,1029,2070,6386,14502,7415,16572
291070,202307,22694,48284,18025,40807,375,1097,15419,33370,15794,34467
291072,202307,36212,76832,24073,56240,3531,8261,13432,29708,16963,37969
291075,202307,6396,14231,5334,12421,99,283,4345,9577,4444,9860
291077,202307,2002,4739,1410,3685,105,214,936,2436,1041,2650
291080,202307,172338,358882,122567,279774,23550,54683,62098,134250,85648,188933
291085,202307,6737,15062,5042,12369,238,664,4028,9493,4266,10157
291090,202307,2571,4322,1710,3296,53,132,1416,2599,1469,2731
291100,202307,3878,7188,2622,5572,104,200,2064,4231,2168,4431
291110,202307,7004,19256,5171,15626,321,1105,3623,10256,3944,11361
291120,202307,10266,20477,8026,17335,557,1154,6017,12570,6574,13724
291125,202307,2824,4369,1996,3416,86,133,1733,2899,1819,3032
291130,202307,3824,9611,2546,7065,125,416,1845,4775,1970,5191
291140,202307,5735,13834,3675,9822,698,1558,2003,5477,2701,7035
291150,202307,3415,5843,2502,4788,105,173,2182,4116,2287,4289
291160,202307,6122,15036,4377,11907,559,1506,2558,6470,3117,7976
291165,202307,2405,6109,1510,4256,46,171,1010,2684,1056,2855
291170,202307,27479,62177,19850,47995,1525,3797,13049,29484,14574,33281
291180,202307,9657,16667,6961,13116,328,635,5935,10791,6263,11426
291185,202307,4278,9162,3494,7915,192,371,2790,6220,2982,6591
291190,202307,9339,19886,7228,16951,338,810,5370,12526,5708,13336
291200,202307,3232,8113,2113,5869,95,318,1376,3515,1471,3833
291210,202307,9626,17067,6647,13433,350,665,5207,10224,5557,10889
291220,202307,5953,14040,4712,11813,524,1269,3001,7174,3525,8443
291230,202307,6045,10187,4454,8305,91,174,4010,7276,4101,7450
291240,202307,5009,11591,3903,9691,113,313,3265,7817,3378,8130
291250,202307,3807,10329,2740,8284,197,549,1600,4885,1797,5434
291260,202307,1827,3632,1351,2981,31,71,1100,2362,1131,2433
291270,202307,6852,14923,4996,12270,642,1564,3377,8260,4019,9824
291280,202307,3401,7351,2141,5195,146,399,1493,3324,1639,3723
291290,202307,6607,15610,4481,12025,461,1280,2884,7387,3345,8667
291300,202307,4686,11020,3451,8874,246,530,2431,6121,2677,6651
291310,202307,6325,14562,4897,11995,130,390,4145,9726,4275,10116
291320,202307,7902,18937,5690,15027,1286,3264,2937,7777,4223,11041
291330,202307,2240,5154,1694,4215,66,205,1256,2974,1322,3179
291340,202307,5083,11670,3692,9250,242,556,2448,6000,2690,6556
291345,202307,3580,8759,3002,7808,226,598,2303,5901,2529,6499
291350,202307,8527,17743,6282,14698,268,704,4935,11031,5203,11735
291360,202307,55710,105513,40074,84610,5390,10896,25219,52499,30609,63395
291370,202307,10136,23883,8139,20445,847,2048,5595,13319,6442,15367
291380,202307,5928,11642,4723,10002,134,417,3949,7899,4083,8316
291390,202307,16718,30507,11817,24333,751,1351,9385,18695,10136,20046
291400,202307,20742,41539,15653,33539,1633,3329,10681,22427,12314,25756
291410,202307,3573,8339,2544,6476,66,214,1871,4531,1937,4745
291420,202307,2236,4850,1652,4069,31,106,1403,3356,1434,3462
291430,202307,3097,7631,2392,6363,140,410,1779,4473,1919,4883
291440,202307,8086,19906,6366,16941,496,1240,4491,11989,4987,13229
291450,202307,13917,25086,10801,21290,329,601,9461,18440,9790,19041
291460,202307,23019,49076,18069,40660,1967,4097,12459,26814,14426,30911
291465,202307,10470,22790,7790,19402,350,1161,6149,14622,6499,15783
291470,202307,25998,47010,19261,37860,1119,2026,14493,26915,15612,28941
291480,202307,55125,107748,38976,82783,4459,9801,23605,47018,28064,56819
291490,202307,9380,18080,7848,16192,381,853,6618,13208,6999,14061
291500,202307,6770,12819,5287,10904,138,391,4625,9105,4763,9496
291510,202307,5879,11224,4285,9137,104,293,3678,7579,3782,7872
291520,202307,5567,11237,3699,8546,207,504,2849,6237,3056,6741
291530,202307,2767,5627,1800,4263,171,405,1201,2746,1372,3151
291535,202307,4707,11329,3637,9504,201,523,2839,7322,3040,7845
291540,202307,2655,5019,1761,3867,77,161,1466,3184,1543,3345
291550,202307,8212,14916,5823,11656,410,739,4355,8505,4765,9244
291560,202307,21646,47136,14131,35507,3512,8708,5559,13687,9071,22395
291570,202307,2876,5737,2041,4731,66,179,1735,3922,1801,4101
291580,202307,7687,17142,5375,13593,396,993,3772,9098,4168,10091
291590,202307,3490,6367,2806,5496,67,173,2436,4517,2503,4690
291600,202307,6774,13643,4750,10494,466,1115,3113,6562,3579,7677
291610,202307,8666,16668,7137,14702,651,1009,5466,11397,6117,12406
291620,202307,3547,6978,2473,5609,200,417,1762,4003,1962,4420
291630,202307,4315,7864,3031,6239,516,803,2085,4466,2601,5269
291640,202307,22861,45715,15290,33763,1285,2994,9999,20625,11284,23619
291650,202307,12651,25436,10409,22383,839,1483,8088,17355,8927,18838
291660,202307,2340,5146,1617,4003,122,346,1071,2396,1193,2742
291670,202307,2407,5732,1816,4787,256,615,1113,3009,1369,3624
291680,202307,5002,10778,3640,8691,634,1535,2101,4942,2735,6477
291685,202307,5629,12718,4105,10240,360,787,2920,7220,3280,8007
291690,202307,5525,9736,3736,7240,153,302,3232,6031,3385,6333
291700,202307,11892,27493,9847,24078,292,895,8377,19666,8669,20561
291710,202307,6731,13058,4683,10120,340,764,3430,6941,3770,7705
291720,202307,5300,14366,3989,11668,962,2788,1944,5598,2906,8386
291730,202307,9921,18291,8140,15940,422,896,6804,12926,7226,13822
291733,202307,3555,7924,2643,6548,123,301,1922,4795,2045,5096
291735,202307,3123,7869,2162,6033,73,200,1497,4148,1570,4348
291740,202307,4940,11481,2977,7801,118,268,2063,5259,2181,5527
291750,202307,27367,55891,20471,44670,2806,5390,13472,29038,16278,34428
291760,202307,13695,34251,9567,27104,2994,9723,1957,4763,4951,14486
291770,202307,9432,22027,6873,17098,438,1284,5025,11527,5463,12811
291780,202307,6470,14468,5505,13008,195,498,4609,10564,4804,11062
291790,202307,3761,8115,3238,7386,401,632,2306,5477,2707,6109
291800,202307,45340,93640,32660,74003,4241,9991,19829,41368,24070,51359
291810,202307,13364,27588,10402,23443,520,936,8324,18656,8844,19592
291820,202307,4806,10938,3855,9480,150,384,3046,7305,3196,7689
291830,202307,6042,11405,4579,9413,375,581,3485,7153,3860,7734
291835,202307,7786,20992,5772,17108,921,2664,3345,9885,4266,12549
291840,202307,67284,154636,53765,131978,6646,16474,35640,83901,42286,100375
291845,202307,4226,8138,3212,6792,320,622,2342,4936,2662,5558
291850,202307,5563,12920,4363,10952,130,346,3653,9062,3783,9408
291855,202307,2851,4631,2130,3819,58,126,1911,3355,1969,3481
291860,202307,2554,6256,1579,4309,60,182,1035,2679,1095,2861
291870,202307,1511,3478,886,2362,74,208,544,1375,618,1583
291875,202307,3502,9620,2696,7824,101,390,1874,5172,1975,5562
291880,202307,6806,16448,5303,13859,351,884,3915,10134,4266,11018
291890,202307,2099,3751,1232,2669,183,385,744,1534,927,1919
291900,202307,1646,3425,1161,2662,49,130,910,1940,959,2070
291905,202307,2526,6192,1857,5019,96,286,1367,3475,1463,3761
291910,202307,4547,8440,3556,7149,78,199,3134,6144,3212,6343
291915,202307,8779,22102,6565,18096,324,926,4471,12229,4795,13155
291920,202307,46635,98828,37151,84465,1935,5344,28205,59667,30140,65011
291930,202307,3422,7435,2696,6342,317,659,1864,4399,2181,5058
291940,202307,4468,10318,2681,7160,286,740,1596,4113,1882,4853
291950,202307,10914,30423,8169,24722,547,1624,5272,15570,5819,17194
291955,202307,26664,56545,21234,48381,1421,3439,15729,34117,17150,37556
291960,202307,4717,9393,3648,7904,289,485,2868,6316,3157,6801
291970,202307,6152,12486,4892,10800,225,581,3834,8090,4059,8671
291980,202307,12239,30700,8875,24463,879,2277,5762,15788,6641,18065
291990,202307,2766,6236,2143,5423,76,302,1823,4446,1899,4748
291992,202307,5766,11488,4448,9436,150,362,3688,7455,3838,7817
291995,202307,2850,6295,2107,5059,89,263,1657,3712,1746,3975
292000,202307,3404,6689,2659,5761,91,220,2213,4660,2304,4880
292010,202307,7166,14177,5417,11474,115,341,4651,9435,4766,9776
292020,202307,5796,13759,4514,11453,125,422,3673,8842,3798,9264
292030,202307,2620,6589,1990,5384,192,566,1223,3121,1415,3687
292040,202307,5739,12047,4254,9871,149,338,3495,7934,3644,8272
292045,202307,5554,10901,4162,8944,63,202,3747,7812,3810,8014
292050,202307,7835,19157,5535,14746,280,816,3716,9301,3996,10117
292060,202307,16293,30750,14045,27820,646,1298,11882,22583,12528,23881
292070,202307,8840,17556,7350,15633,575,1216,5952,12330,6527,13546
292080,202307,4726,8778,3752,7526,70,216,3375,6557,3445,6773
292090,202307,5194,9962,3419,7685,157,403,2638,5725,2795,6128
292100,202307,16488,34649,12058,27772,1806,4192,7213,15853,9019,20045
292105,202307,3946,9105,3015,7600,86,278,2358,5718,2444,5996
292110,202307,8302,16280,5654,12510,841,1946,3593,7673,4434,9619
292120,202307,8727,19352,6483,15318,732,1503,4409,10402,5141,11905
292130,202307,4043,8567,2986,7055,217,523,2094,4708,2311,5231
292140,202307,7180,13806,5627,11495,179,396,4918,9732,5097,10128
292145,202307,3232,7681,2419,6233,142,280,1783,4601,1925,4881
292150,202307,20053,43170,16038,36573,393,1064,13408,29096,13801,30160
292160,202307,3505,7379,2433,5917,35,119,1912,4789,1947,4908
292170,202307,10576,25003,7941,20538,566,1603,5661,13857,6227,15460
292180,202307,3402,8573,2267,6300,191,532,1430,3741,1621,4273
292190,202307,3786,8488,2813,6829,313,753,1830,4306,2143,5059
292200,202307,11675,25729,7455,18660,1859,4773,3056,7412,4915,12185
292205,202307,4645,11114,3707,9578,149,424,3017,7615,3166,8039
292210,202307,8264,15619,6545,13364,105,326,5978,11803,6083,12129
292220,202307,2772,5571,2080,4446,164,337,1518,3025,1682,3362
292225,202307,3804,9800,3055,8546,90,323,2451,6618,2541,6941
292230,202307,10826,22417,8428,18863,336,919,6604,13881,6940,14800
292240,202307,6231,15557,4889,12980,352,950,3407,8873,3759,9823
292250,202307,7751,16763,6263,14387,385,874,4877,10768,5262,11642
292260,202307,4166,9657,3354,8492,91,264,2867,7120,2958,7384
292265,202307,4561,10422,3574,8814,70,255,2984,7041,3054,7296
292270,202307,6083,11209,4633,9334,257,482,3692,7243,3949,7725
292273,202307,3415,6577,2480,5316,135,275,1795,3924,1930,4199
292275,202307,2202,4859,1728,4167,49,148,1417,3279,1466,3427
292280,202307,3345,6788,2523,5774,98,218,2111,4809,2209,5027
292285,202307,3133,6385,2316,5249,122,230,1851,4210,1973,4440
292290,202307,9149,20190,6905,16848,498,958,5367,13028,5865,13986
292300,202307,13105,29100,9111,22747,1568,3904,4978,12160,6546,16064
292303,202307,4208,9277,3401,7969,89,221,2896,6548,2985,6769
292305,202307,2785,6513,2358,5849,85,226,2009,4872,2094,5098
292310,202307,8459,17910,6757,15475,193,602,5760,12620,5953,13222
292320,202307,6922,16496,5101,13267,216,556,3904,9830,4120,10386
292330,202307,3955,6660,3089,5610,151,233,2602,4728,2753,4961
292335,202307,6220,14297,5045,12405,343,838,3938,9512,4281,10350
292340,202307,6319,16207,4661,12841,427,1062,3123,8415,3550,9477
292350,202307,3452,7839,2754,6811,150,398,2194,5240,2344,5638
292360,202307,6002,14182,4484,11455,254,655,3217,7936,3471,8591
292370,202307,13499,27037,10762,23251,149,534,9810,20434,9959,20968
292380,202307,8231,20206,6667,17225,452,1212,4973,12277,5425,13489
292390,202307,5872,9322,4279,7415,139,251,3828,6499,3967,6750
292400,202307,29995,70863,23320,59015,2553,6194,15434,37830,17987,44024
292405,202307,5520,11760,4181,9532,153,377,3230,7343,3383,7720
292410,202307,3093,5676,2432,4812,105,215,2078,4001,2183,4216
292420,202307,6251,11974,5232,10552,133,262,4648,9118,4781,9380
292430,202307,6030,15980,4056,12061,347,1033,2595,7356,2942,8389
292440,202307,11538,29162,10062,26902,179,800,8750,22757,8929,23557
292450,202307,4983,12536,3349,9301,202,600,2323,6124,2525,6724
292460,202307,7985,16227,6307,13581,295,868,5191,10514,5486,11382
292465,202307,3111,6892,2336,5636,85,210,1620,4034,1705,4244
292467,202307,2655,6136,2243,5534,301,651,1504,3862,1805,4513
292470,202307,3338,7895,2220,5996,169,463,1555,4162,1724,4625
292480,202307,8165,15025,6456,12853,217,401,5698,11150,5915,11551
292490,202307,3466,6584,2610,5407,59,153,2204,4344,2263,4497
292500,202307,9021,19720,6506,15467,355,796,4896,11169,5251,11965
292510,202307,17489,39234,12384,30595,1338,2945,8423,20582,9761,23527
292520,202307,9300,20421,7272,16896,411,1075,5508,12116,5919,13191
292525,202307,8178,16352,6341,14036,191,522,5484,11801,5675,12323
292530,202307,47464,105395,34126,83032,6452,16683,17311,39059,23763,55742
292540,202307,5192,8585,3847,7089,180,313,3336,6052,3516,6365
292550,202307,10544,25245,7353,20688,711,2007,4583,12993,5294,15000
292560,202307,5577,12290,4135,10027,156,462,3208,7334,3364,7796
292570,202307,4507,10270,3387,8291,88,306,2717,6268,2805,6574
292575,202307,8167,21035,6922,18925,1248,3349,4444,12127,5692,15476
292580,202307,9675,19881,7553,16692,410,640,6145,13414,6555,14054
292590,202307,8895,21031,6867,17292,398,1070,5511,13438,5909,14508
292593,202307,3534,7740,2502,5926,104,271,1933,4350,2037,4621
292595,202307,6875,15552,5608,13712,322,687,4349,10566,4671,11253
292600,202307,13840,32476,10999,27893,705,1611,8523,21423,9228,23034
292610,202307,5618,12115,4243,9762,206,490,3275,7150,3481,7640
292620,202307,8276,18468,6342,15902,167,518,5399,13218,5566,13736
292630,202307,11630,23992,8487,18802,1203,3016,5630,11549,6833,14565
292640,202307,9706,24830,7223,20157,501,1427,4811,13187,5312,14614
292650,202307,5068,11335,4121,9944,117,444,3559,8242,3676,8686
292660,202307,13063,32462,10175,27566,552,1519,7447,19874,7999,21393
292665,202307,2434,6282,1912,5477,126,325,1411,4071,1537,4396
292670,202307,4016,10230,2847,7959,263,813,1810,4747,2073,5560
292680,202307,4634,10927,3406,8703,119,307,2568,6241,2687,6548
292690,202307,2845,6897,1799,5128,227,626,1080,3105,1307,3731
292700,202307,12934,29408,9955,24270,622,1368,7363,17385,7985,18753
292710,202307,4320,9045,3837,8379,71,197,3505,7429,3576,7626
292720,202307,10513,21614,8054,18261,472,989,5985,13629,6457,14618
292730,202307,6940,13142,5733,11352,295,510,4815,9418,5110,9928
292740,202307,550322,1064843,444325,902290,48152,98840,308063,589656,356215,688496
292750,202307,9224,18909,7250,16116,329,790,5928,12791,6257,13581
292760,202307,4718,11820,3741,10016,180,514,2792,7239,2972,7753
292770,202307,9785,20934,7285,17275,947,2379,4770,10912,5717,13291
292780,202307,2548,4346,1764,3380,70,163,1439,2563,1509,2726
292790,202307,4697,8620,3167,6750,275,532,2382,4984,2657,5516
292800,202307,14778,31243,11620,26094,1007,2035,8650,19260,9657,21295
292805,202307,4586,9094,3434,7535,177,468,2760,5768,2937,6236
292810,202307,16980,32704,12780,26273,389,1053,10649,20400,11038,21453
292820,202307,7967,20609,5447,16012,512,1602,3587,10044,4099,11646
292830,202307,3605,7403,2884,6467,141,307,2314,5154,2455,5461
292840,202307,12705,25418,10022,21650,207,595,8795,18158,9002,18753
292850,202307,3191,7239,2447,6031,187,460,1716,4034,1903,4494
292860,202307,22719,42293,17943,35618,474,1310,15033,28006,15507,29316
292870,202307,29510,60060,22316,48270,2181,4291,14807,30157,16988,34448
292880,202307,13754,34331,10034,27328,418,1370,6646,16370,7064,17740
292890,202307,11020,23542,8889,20262,245,673,7312,15745,7557,16418
292895,202307,4130,7458,2957,5680,251,438,2260,4229,2511,4667
292900,202307,3718,8016,3021,6868,59,210,2419,5098,2478,5308
292905,202307,5452,12235,3962,9778,247,664,2888,6724,3135,7388
292910,202307,7124,15443,5831,13503,188,401,4715,10504,4903,10905
292920,202307,12567,28656,10181,24461,408,1279,8056,18216,8464,19495
292925,202307,6210,16139,4449,12508,407,974,2920,8050,3327,9024
292930,202307,8791,22494,6593,17975,973,2596,3360,8647,4333,11243
292935,202307,3349,6065,2526,5069,32,94,2268,4482,2300,4576
292937,202307,3245,7621,2547,6592,322,899,1299,3636,1621,4535
292940,202307,3664,8079,2707,6535,466,1029,1626,3988,2092,5017
292950,202307,11142,25892,8121,20315,554,1387,5695,13327,6249,14714
292960,202307,6850,14191,5214,11701,205,441,4029,8647,4234,9088
292970,202307,4957,12039,4124,10754,124,373,3293,8445,3417,8818
292975,202307,5246,10258,4257,8940,108,284,3744,7550,3852,7834
292980,202307,4811,9057,3722,7446,71,210,3276,6276,3347,6486
292990,202307,13903,34373,10621,28401,501,1564,7842,19651,8343,21215
293000,202307,3235,7036,2369,5558,215,454,1657,3851,1872,4305
293010,202307,23695,51567,17302,40986,2597,6192,10713,24507,13310,30699
293015,202307,10430,27977,7602,22446,703,2068,5018,14585,5721,16653
293020,202307,12718,29939,10812,26980,198,694,9586,23220,9784,23914
293030,202307,6261,14851,4388,11657,354,676,2813,7707,3167,8383
293040,202307,5352,12034,3900,9857,138,354,3124,7688,3262,8042
293050,202307,32380,62790,25387,51572,1792,3501,19428,37587,21220,41088
293060,202307,4626,10862,3365,8470,212,578,2452,5818,2664,6396
293070,202307,43217,81376,34422,68103,1933,4067,26948,50223,28881,54290
293075,202307,4423,11845,3548,10301,96,418,2959,8398,3055,8816
293076,202307,4141,8757,3445,7812,133,257,2957,6725,3090,6982
293077,202307,8241,19147,5935,15088,964,2077,3331,8898,4295,10975
293080,202307,5310,13970,4163,11781,113,438,3282,8878,3395,9316
293090,202307,3771,10095,2534,7696,221,663,1660,4834,1881,5497
293100,202307,7157,16742,5330,13453,382,868,4009,9965,4391,10833
293105,202307,4656,13128,3641,11042,279,841,2475,7357,2754,8198
293110,202307,3193,6462,2454,5318,145,283,1941,4096,2086,4379
293120,202307,6526,13403,5465,11795,485,794,4206,9164,4691,9958
293130,202307,4473,10424,3606,9130,113,351,3067,7532,3180,7883
293135,202307,39901,85881,25110,62049,5104,13809,9456,21728,14560,35537
293140,202307,3614,6000,2813,4977,104,166,2371,4016,2475,4182
293150,202307,6201,16325,4415,12547,468,1263,2856,7702,3324,8965
293160,202307,5096,10273,4314,9311,525,716,3254,7546,3779,8262
293170,202307,6766,10891,4907,8613,119,263,4218,6993,4337,7256
293180,202307,5647,13368,4352,11058,141,456,3457,8348,3598,8804
293190,202307,21304,42331,17848,37308,247,877,15909,31826,16156,32703
293200,202307,11683,22935,8806,18473,617,1148,6980,14411,7597,15559
293210,202307,6833,14846,5218,12224,566,1206,3629,8425,4195,9631
293220,202307,7499,15029,5203,11358,754,1562,3359,7011,4113,8573
293230,202307,5981,11595,4255,9353,420,827,3078,6766,3498,7593
293240,202307,5456,12170,4114,9930,206,452,3009,7398,3215,7850
293245,202307,4848,11301,3965,9811,258,651,3007,7022,3265,7673
293250,202307,6962,14859,4935,11655,493,1188,3331,7428,3824,8616
293260,202307,5999,13198,4243,10195,206,499,3018,7123,3224,7622
293270,202307,9335,17566,6962,14838,477,720,5484,11998,5961,12718
293280,202307,5793,12501,4635,10713,317,716,3633,8104,3950,8820
293290,202307,22220,52926,18029,45779,1698,4378,12657,30932,14355,35310
293300,202307,8462,16956,6517,13759,673,1286,4649,9342,5322,10628
293305,202307,5641,11160,4087,9005,95,280,3534,7467,3629,7747
293310,202307,2742,6046,2091,4968,46,137,1708,3874,1754,4011
293315,202307,5742,10908,4409,8983,430,645,3453,7094,3883,7739
293317,202307,3426,7075,2763,5973,332,585,1936,4203,2268,4788
293320,202307,18300,34278,15012,30203,249,645,13300,25666,13549,26311
293325,202307,2330,4871,1653,3941,179,440,1056,2394,1235,2834
293330,202307,101238,229060,72409,175714,9453,24218,42546,94350,51999,118568
293340,202307,2647,6539,1917,5169,175,429,1303,3476,1478,3905
293345,202307,4791,10879,3332,8462,799,1932,1528,4203,2327,6135
293350,202307,7228,17486,5884,15588,365,940,4653,12218,5018,13158
293360,202307,19447,40434,15480,35094,579,1383,12926,28923,13505,30306
310010,202307,1223,2534,761,1835,124,326,331,668,455,994
310020,202307,4116,9611,2675,6815,437,1229,1207,2697,1644,3926
310030,202307,2431,6087,1770,4824,243,714,1105,2804,1348,3518
310040,202307,1045,2439,714,1798,73,218,374,797,447,1015
310050,202307,2112,5132,1564,4129,151,448,945,2277,1096,2725
310060,202307,3806,9140,2861,7627,215,685,1929,5090,2144,5775
310070,202307,424,939,277,691,16,37,192,468,208,505
310080,202307,892,2260,569,1615,84,271,265,698,349,969
310090,202307,6698,14038,5056,11386,214,616,3992,8417,4206,9033
310100,202307,4732,10524,3534,8546,119,427,2788,6277,2907,6704
310110,202307,6009,14060,4224,10807,541,1531,2510,5936,3051,7467
310120,202307,851,1875,497,1296,75,234,238,511,313,745
310130,202307,520,1190,424,1030,34,114,316,695,350,809
310140,202307,458,1169,323,932,73,229,137,339,210,568
310150,202307,8178,17828,5312,12562,443,1274,3260,6814,3703,8088
310160,202307,13805,29963,9145,21719,1984,4711,4073,8761,6057,13472
310163,202307,1512,4079,965,2846,244,783,260,595,504,1378
310170,202307,12413,26628,9199,21466,943,2155,6363,14209,7306,16364
310180,202307,2535,5399,1651,3916,182,484,1043,2297,1225,2781
310190,202307,3341,8654,2099,6053,481,1466,478,1200,959,2666
310200,202307,2505,6361,1719,4860,458,1425,632,1476,1090,2901
310205,202307,1479,3626,1079,2953,140,381,662,1797,802,2178
310210,202307,2913,7068,2082,5394,110,262,1478,3642,1588,3904
310220,202307,1437,3573,966,2660,93,299,592,1505,685,1804
310230,202307,3023,6960,2216,5383,346,880,1263,2792,1609,3672
310240,202307,1305,3322,956,2623,100,270,553,1413,653,1683
310250,202307,1552,3232,1134,2521,39,120,863,1785,902,1905
310260,202307,4936,11722,2839,7563,621,1925,927,1858,1548,3783
310270,202307,3601,6828,2574,5401,92,217,2065,4113,2157,4330
310280,202307,3671,7047,2448,5143,154,389,1747,3265,1901,3654
310285,202307,2227,6224,1602,4907,200,614,916,2754,1116,3368
310290,202307,2099,4932,1543,3827,202,603,908,1928,1110,2531
310300,202307,2128,5282,1311,3583,138,425,645,1470,783,1895
310310,202307,410,869,245,589,41,105,124,256,165,361
310320,202307,582,1352,340,913,34,94,170,415,204,509
310330,202307,630,1372,312,766,62,153,129,280,191,433
310340,202307,10333,23343,6510,16093,941,2216,3200,7530,4141,9746
310350,202307,17723,39489,10999,27578,1689,4703,5521,12316,7210,17019
310360,202307,802,1540,591,1212,24,65,435,825,459,890
310370,202307,1500,4280,1138,3548,277,910,375,1189,652,2099
310375,202307,1079,2426,651,1711,230,580,188,474,418,1054
310380,202307,433,963,195,521,11,31,110,274,121,305
310390,202307,796,2194,591,1769,95,313,282,737,377,1050
310400,202307,16317,36523,10263,25758,1153,3155,5860,13460,7013,16615
310410,202307,1320,3468,644,1878,83,265,269,635,352,900
310420,202307,6259,15084,3806,9997,473,1311,1894,4299,2367,5610
310430,202307,2222,5513,1346,3716,246,723,609,1409,855,2132
310440,202307,813,1874,461,1190,72,170,207,489,279,659
310445,202307,1636,4135,1102,3008,88,220,770,1997,858,2217
310450,202307,6009,12605,3981,9290,312,905,2760,5891,3072,6796
310460,202307,2184,5315,1333,3582,248,676,326,734,574,1410
310470,202307,4063,8530,2913,6872,660,1411,1565,3757,2225,5168
310480,202307,1241,2923,813,2165,83,259,455,1069,538,1328
310490,202307,3710,8937,2527,6720,388,1070,1220,2895,1608,3965
310500,202307,1903,4423,1392,3524,209,542,821,1938,1030,2480
310510,202307,3078,7044,1924,4781,341,923,826,1835,1167,2758
310520,202307,1503,3528,864,2259,138,401,366,887,504,1288
310530,202307,1069,2561,644,1708,76,227,260,541,336,768
310540,202307,3455,9165,2335,6579,421,1273,895,2132,1316,3405
310550,202307,1561,3401,1020,2444,98,267,613,1320,711,1587
310560,202307,22077,51859,13737,34855,1527,4445,7232,15247,8759,19692
310570,202307,1568,3267,1106,2589,40,131,873,1887,913,2018
310590,202307,5373,12394,3394,8170,199,588,2146,4560,2345,5148
310600,202307,1793,4520,1190,3117,146,383,624,1471,770,1854
310610,202307,607,1555,330,1028,71,237,73,202,144,439
310620,202307,308041,680335,204666,480332,21773,58960,119037,241138,140810,300098
310630,202307,5927,14524,3565,9414,509,1355,1930,4644,2439,5999
310640,202307,2037,4516,1408,3330,101,295,994,2080,1095,2375
310650,202307,2911,7026,1823,4838,117,357,1110,2744,1227,3101
310660,202307,1765,4057,1344,3445,41,161,1100,2706,1141,2867
310665,202307,1741,3729,1277,3020,42,147,1001,2242,1043,2389
310670,202307,87796,194117,61738,144481,6755,17287,38947,82884,45702,100171
310680,202307,982,2027,744,1647,20,66,575,1166,595,1232
310690,202307,3318,6817,2144,4948,270,571,1352,2898,1622,3469
310700,202307,659,1222,462,955,13,34,369,722,382,756
310710,202307,8077,20545,4702,13946,1205,3708,766,1989,1971,5697
310720,202307,1485,2989,1055,2348,50,152,790,1621,840,1773
310730,202307,13047,29649,9525,23317,583,1754,6750,15160,7333,16914
310740,202307,8991,21635,5604,14417,654,1893,2871,6357,3525,8250
310750,202307,1740,3688,1143,2648,172,422,627,1273,799,1695
310760,202307,915,2077,584,1504,75,187,350,874,425,1061
310770,202307,1364,3359,833,2364,107,341,388,931,495,1272
310780,202307,5054,10557,3540,8167,301,717,2375,5214,2676,5931
310790,202307,2347,6702,1773,5345,397,1336,446,1092,843,2428
310800,202307,2871,7938,1642,5143,340,1146,120,293,460,1439
310810,202307,1910,4024,1383,3086,113,259,973,2059,1086,2318
310820,202307,1479,3377,750,2086,145,395,228,584,373,979
310825,202307,3208,7886,2316,6341,67,295,1834,4675,1901,4970
310830,202307,2824,6789,1785,4767,338,959,863,1962,1201,2921
310840,202307,2830,6921,1774,4831,372,1078,590,1314,962,2392
310850,202307,1645,3976,1188,3182,84,295,817,2000,901,2295
310855,202307,4198,9684,2862,7340,281,705,1837,4442,2118,5147
310860,202307,8357,21463,6090,17069,858,2180,3335,9260,4193,11440
310870,202307,1180,2586,850,2060,70,192,607,1354,677,1546
310880,202307,1096,2973,710,2104,99,283,364,1020,463,1303
310890,202307,2696,7178,1485,4517,281,900,204,500,485,1400
310900,202307,5468,13983,3450,9392,659,1941,1455,3376,2114,5317
310910,202307,2774,6211,1561,4028,269,762,413,902,682,1664
310920,202307,2307,5391,1536,4043,219,604,902,2228,1121,2832
310925,202307,1351,3052,919,2290,44,110,644,1489,688,1599
310930,202307,6973,16155,4153,11424,810,2272,1769,4860,2579,7132
310940,202307,8607,17900,5881,13476,282,798,4405,9372,4687,10170
310945,202307,1812,4027,1176,2909,150,407,669,1499,819,1906
310950,202307,2268,6222,1273,3947,217,754,339,800,556,1554
310960,202307,827,2151,414,1199,59,185,123,315,182,500
310970,202307,1435,4030,867,2720,219,696,155,416,374,1112
310980,202307,423,910,201,492,11,31,106,225,117,256
310990,202307,1883,4385,1328,3367,161,480,778,1725,939,2205
311000,202307,5370,13162,3660,9832,766,2119,1768,4272,2534,6391
311010,202307,1220,2936,922,2403,218,586,447,1143,665,1729
311020,202307,1458,3344,821,2142,62,191,462,1090,524,1281
311030,202307,2373,5361,1452,3736,394,1130,519,1155,913,2285
311040,202307,366,1035,247,758,78,265,57,141,135,406
311050,202307,3820,8539,2427,6055,369,1066,1294,2818,1663,3884
311060,202307,4724,10774,2802,6974,338,954,1357,2890,1695,3844
311070,202307,3208,6972,2009,4917,264,770,1087,2290,1351,3060
311080,202307,1439,2812,1029,2204,43,124,785,1529,828,1653
311090,202307,2882,8039,1929,5912,454,1377,556,1621,1010,2998
311100,202307,3139,8024,1925,5635,353,1134,532,1307,885,2441
311110,202307,4603,9239,1939,4819,492,1248,304,689,796,1937
311115,202307,1790,3347,1261,2618,24,82,984,2035,1008,2117
311120,202307,9262,21773,5795,14573,898,2446,2604,5423,3502,7869
311130,202307,2325,5653,1504,4149,169,546,836,2047,1005,2593
311140,202307,1998,4540,1240,3200,226,561,618,1520,844,2081
311150,202307,1759,5059,1242,3925,192,665,569,1619,761,2284
311160,202307,5260,13353,3332,9545,550,1732,1362,3422,1912,5154
311170,202307,1201,2794,831,2204,78,216,511,1369,589,1585
311180,202307,1946,4017,1046,2557,151,361,485,1073,636,1434
311190,202307,1030,2688,654,1881,78,255,296,703,374,958
311200,202307,2950,7026,1864,4797,379,1046,771,1636,1150,2682
311205,202307,1131,2953,830,2368,44,137,499,1313,543,1450
311210,202307,1279,3368,1047,2968,128,322,701,2054,829,2376
311220,202307,1104,2412,868,1928,20,62,702,1430,722,1492
311230,202307,9661,26548,6305,19095,1418,4430,1930,5671,3348,10101
311240,202307,1492,3298,1019,2495,130,372,614,1293,744,1665
311250,202307,1740,4302,1116,3014,216,596,477,1123,693,1719
311260,202307,3229,7305,1652,4247,216,592,753,1607,969,2199
311265,202307,1717,3626,1102,2611,51,135,821,1781,872,1916
311270,202307,3742,9723,2792,7861,195,741,1810,4600,2005,5341
311280,202307,1611,3834,855,2339,209,587,232,524,441,1111
311290,202307,2200,6177,1801,5323,142,432,1131,3240,1273,3672
311300,202307,5349,13036,4132,10942,210,663,3133,7877,3343,8540
311310,202307,649,1643,447,1201,35,93,289,722,324,815
311320,202307,3892,10635,2759,7886,372,1110,1311,3209,1683,4319
311330,202307,7939,17061,5197,12370,782,2052,2319,5399,3101,7451
311340,202307,13744,34259,9289,25289,2055,5790,2950,7241,5005,13031
311350,202307,2815,6355,1671,4136,326,815,675,1424,1001,2239
311360,202307,1435,3185,870,2246,206,551,386,936,592,1487
311370,202307,5646,12617,3602,9072,489,1383,1784,3925,2273,5308
311380,202307,478,1373,337,1054,41,139,179,539,220,678
311390,202307,2094,5778,1460,4537,437,1374,348,931,785,2305
311400,202307,2079,5043,1201,3125,219,612,458,932,677,1544
311410,202307,2381,6485,1656,4958,254,845,672,1722,926,2567
311420,202307,2056,5337,1306,3777,251,748,400,924,651,1672
311430,202307,5734,13707,3295,8679,495,1377,1390,3319,1885,4696
311440,202307,3895,9825,2389,6736,672,2139,415,819,1087,2958
311450,202307,3186,8494,1799,5372,438,1489,453,1012,891,2501
311455,202307,1329,2794,741,1797,68,179,466,1032,534,1211
311460,202307,754,2055,413,1278,73,247,102,246,175,493
311470,202307,594,1662,354,1126,78,271,56,150,134,421
311480,202307,1464,2922,1101,2341,100,205,851,1727,951,1932
311490,202307,350,950,223,662,37,132,95,222,132,354
311500,202307,661,1498,444,1115,47,128,247,549,294,677
311510,202307,4505,9810,2815,6809,387,959,1539,3355,1926,4314
311520,202307,844,2031,625,1588,62,173,397,956,459,1129
311530,202307,11848,24890,6879,16461,1880,5181,2170,4212,4050,9393
311535,202307,1226,2921,706,1824,97,266,343,769,440,1035
311540,202307,670,1759,534,1501,93,265,316,866,409,1131
311545,202307,2494,6304,1948,5349,119,352,1418,3751,1537,4103
311547,202307,2205,4317,1638,3402,55,131,1395,2774,1450,2905
311550,202307,3664,8820,2572,6689,421,1192,1163,2543,1584,3735
311560,202307,366,735,182,419,31,82,69,126,100,208
311570,202307,1613,3459,976,2487,65,182,645,1658,710,1840
311580,202307,2737,4846,1649,3351,153,312,1130,2167,1283,2479
311590,202307,776,1801,568,1460,59,180,344,811,403,991
311600,202307,1774,4068,1369,3465,173,503,930,2259,1103,2762
311610,202307,2860,7466,1882,5405,126,413,1207,3205,1333,3618
311615,202307,4568,10302,3349,8258,145,465,2563,5854,2708,6319
311620,202307,725,1783,471,1325,54,172,241,617,295,789
311630,202307,1580,4024,1097,2983,125,330,607,1600,732,1930
311640,202307,977,2335,607,1621,99,278,319,775,418,1053
311650,202307,2296,5090,1612,3924,251,646,929,2088,1180,2734
311660,202307,4122,10571,2486,6868,355,1123,892,1876,1247,2999
311670,202307,2051,4532,1274,3093,148,359,650,1438,798,1797
311680,202307,2868,6684,1996,5126,131,309,1383,3487,1514,3796
311690,202307,765,1494,485,1089,46,96,299,646,345,742
311700,202307,2474,5305,1741,4202,37,124,1400,3213,1437,3337
311710,202307,1938,5171,1253,3765,339,1114,340,891,679,2005
311720,202307,529,1428,386,1123,56,173,218,620,274,793
311730,202307,5904,13087,3680,8864,725,1985,1874,3990,2599,5975
311740,202307,1196,2939,914,2487,72,199,637,1740,709,1939
311750,202307,4884,12876,3360,9603,301,958,2010,5093,2311,6051
311760,202307,930,2349,638,1698,103,334,276,552,379,886
311770,202307,2749,6955,1800,5026,393,1091,583,1430,976,2521
311780,202307,1924,4888,1134,3214,234,661,408,973,642,1634
311783,202307,2869,6503,2099,5180,62,228,1675,3857,1737,4085
311787,202307,997,2638,607,1722,91,273,206,457,297,730
311790,202307,1918,4907,1092,3116,278,854,284,677,562,1531
311800,202307,6790,18118,3982,11198,997,2906,903,1908,1900,4814
311810,202307,1248,3041,934,2436,57,179,714,1713,771,1892
311820,202307,1291,2716,833,1962,67,175,565,1208,632,1383
311830,202307,11652,29644,7479,20535,2066,5860,1475,3676,3541,9536
311840,202307,4946,10883,3558,8760,327,836,2384,5745,2711,6581
311850,202307,432,987,311,772,14,53,217,471,231,524
311860,202307,101747,220945,69480,161077,7389,19404,42766,88482,50155,107886
311870,202307,2254,5515,1354,3768,224,733,576,1346,800,2079
311880,202307,7564,17676,5563,14396,459,1151,3814,9668,4273,10819
311890,202307,2352,4726,1684,3674,63,184,1293,2561,1356,2745
311900,202307,784,1901,521,1480,89,243,256,714,345,957
311910,202307,5362,12138,3824,9662,686,1829,2050,4807,2736,6636
311920,202307,2671,5894,1987,4787,141,320,1367,3178,1508,3498
311930,202307,6185,12447,4069,9054,688,1720,2248,4405,2936,6125
311940,202307,19623,46165,11226,28756,1712,4646,4735,10658,6447,15304
311950,202307,2947,6800,1946,4912,171,443,1168,2827,1339,3270
311960,202307,587,1358,361,925,51,144,148,318,199,462
311970,202307,488,1469,314,1024,51,182,71,178,122,360
311980,202307,573,1406,264,784,43,141,97,250,140,391
311990,202307,629,1437,331,903,50,152,139,312,189,464
311995,202307,1199,3206,431,1312,49,165,80,150,129,315
312000,202307,986,2055,656,1531,26,62,472,1016,498,1078
312010,202307,1433,3187,981,2346,61,146,666,1497,727,1643
312015,202307,1671,4000,1343,3480,66,239,1016,2458,1082,2697
312020,202307,2383,6494,1435,4214,245,734,358,876,603,1610
312030,202307,2694,5275,1995,4344,51,184,1703,3518,1754,3702
312040,202307,1042,2804,605,1809,110,341,251,643,361,984
312050,202307,1485,4136,1108,3359,209,729,369,922,578,1651
312060,202307,1193,2739,712,1955,178,519,208,499,386,1018
312070,202307,1121,2927,689,1948,25,77,428,1113,453,1190
312080,202307,3713,8091,2545,6032,144,407,1720,3532,1864,3939
312083,202307,1365,2791,1019,2276,50,126,818,1727,868,1853
312087,202307,3069,6766,2232,5371,124,367,1721,3933,1845,4300
312090,202307,15123,34622,10392,26134,1068,3166,5951,13095,7019,16261
312100,202307,2071,5044,1357,3605,88,276,882,2132,970,2408
312110,202307,1231,3472,914,2757,160,589,446,1126,606,1715
312120,202307,1341,3369,789,2283,204,643,224,515,428,1158
312125,202307,2552,5532,1866,4442,109,285,1371,3064,1480,3349
312130,202307,1510,3163,948,2156,60,180,596,1131,656,1311
312140,202307,954,2524,690,1947,188,538,253,635,441,1173
312150,202307,697,1675,523,1331,47,119,337,780,384,899
312160,202307,12346,28597,8246,20623,963,2640,4322,9390,5285,12030
312170,202307,1066,2455,725,1801,55,140,459,1073,514,1213
312180,202307,1730,4053,1170,2965,117,310,675,1517,792,1827
312190,202307,1022,2426,691,1771,85,227,342,764,427,991
312200,202307,5740,13981,3944,10808,908,2991,1956,4509,2864,7500
312210,202307,1777,3279,1214,2469,90,181,935,1794,1025,1975
312220,202307,2007,5453,1542,4530,175,563,968,2753,1143,3316
312230,202307,27545,62111,16953,41639,3226,8651,6431,12742,9657,21393
312235,202307,2760,5655,1984,4436,210,407,1431,3046,1641,3453
312240,202307,983,2803,634,2013,133,421,189,524,322,945
312245,202307,4028,7478,3205,6284,61,170,2864,5385,2925,5555
312247,202307,1238,2601,724,1755,97,227,423,936,520,1163
312250,202307,1128,2759,593,1664,74,232,218,540,292,772
312260,202307,1256,2919,926,2291,61,142,691,1592,752,1734
312270,202307,936,2284,615,1579,22,84,385,846,407,930
312280,202307,525,1448,383,1118,90,302,153,382,243,684
312290,202307,1238,3196,863,2451,167,509,287,689,454,1198
312300,202307,1515,4033,956,2724,208,621,254,565,462,1186
312310,202307,1298,3453,863,2463,107,366,447,1109,554,1475
312320,202307,2675,6052,1524,3825,250,642,557,1164,807,1806
312330,202307,1180,2920,850,2276,143,447,463,1107,606,1554
312340,202307,288,681,188,489,24,75,101,224,125,299
312350,202307,285,564,187,429,8,23,125,243,133,266
312352,202307,1791,5210,1436,4458,276,903,639,2103,915,3006
312360,202307,4560,11432,2851,7869,555,1598,1208,2842,1763,4440
312370,202307,2651,5839,1896,4599,219,617,1147,2520,1366,3137
312380,202307,2610,5256,1855,4095,42,133,1507,3123,1549,3256
312385,202307,1507,3697,1026,2778,351,981,299,808,650,1789
312390,202307,2439,6255,1533,4274,245,764,440,979,685,1743
312400,202307,3876,9979,2823,7972,1030,3168,451,1176,1481,4344
312410,202307,20455,46356,14527,35480,1823,4648,8846,19865,10669,24513
312420,202307,5055,12151,3731,9861,848,2484,1615,3907,2463,6391
312430,202307,11137,24125,8095,18770,385,1117,5934,12569,6319,13686
312440,202307,1355,3820,1031,3124,543,1731,178,494,721,2225
312450,202307,1722,4518,1105,3253,309,966,384,1076,693,2042
312460,202307,617,1325,395,963,23,71,280,629,303,700
312470,202307,578,1310,306,797,46,138,114,227,160,365
312480,202307,1262,2946,828,2154,75,211,436,1046,511,1257
312490,202307,3353,6616,2259,4870,191,456,1418,2785,1609,3241
312500,202307,1348,2817,972,2210,42,117,700,1473,742,1590
312510,202307,6798,16543,3314,9013,566,1511,950,2140,1516,3651
312520,202307,465,1055,312,790,46,129,184,419,230,548
312530,202307,931,1864,687,1532,45,112,510,1089,555,1201
312540,202307,1832,4513,1144,3090,133,353,664,1659,797,2012
312550,202307,997,2281,608,1485,37,98,396,862,433,960
312560,202307,2201,5170,1591,4174,96,283,1107,2796,1203,3079
312570,202307,3444,7182,2248,5416,356,884,1142,2584,1498,3468
312580,202307,809,1986,463,1247,54,168,233,544,287,712
312590,202307,1824,4743,1325,3682,215,683,650,1577,865,2260
312595,202307,2676,6734,2003,5585,341,943,976,2844,1317,3787
312600,202307,1609,3712,866,2109,128,342,297,635,425,977
312610,202307,8987,21117,5067,13220,1027,2846,1523,3286,2550,6132
312620,202307,3070,6771,2057,5187,58,237,1647,3906,1705,4143
312630,202307,409,1043,262,760,52,181,102,237,154,418
312640,202307,617,1571,446,1247,59,185,226,559,285,744
312650,202307,2528,5603,1499,3632,56,171,1123,2449,1179,2620
312660,202307,1646,3499,1108,2562,84,210,750,1574,834,1784
312670,202307,7561,15790,5742,12850,151,549,4624,9491,4775,10040
312675,202307,1416,3250,1075,2700,70,201,784,1855,854,2056
312680,202307,1981,4243,1622,3678,69,220,1352,2869,1421,3089
312690,202307,3673,6838,2457,5183,201,379,1811,3670,2012,4049
312695,202307,1281,2910,986,2383,50,103,813,1901,863,2004
312700,202307,2585,6317,1559,4282,183,579,833,2035,1016,2614
312705,202307,2125,3823,1724,3279,25,61,1592,2939,1617,3000
312707,202307,1661,4209,1026,2962,45,182,673,1737,718,1919
312710,202307,9720,20866,5439,13727,1479,3810,1417,3422,2896,7232
312720,202307,1281,3084,908,2421,94,222,537,1302,631,1524
312730,202307,1945,4205,1237,3100,111,278,794,1904,905,2182
312733,202307,1552,3795,1018,2737,35,138,673,1622,708,1760
312735,202307,993,2298,630,1561,58,156,409,902,467,1058
312737,202307,1008,2040,645,1496,64,179,440,946,504,1125
312738,202307,1040,2319,649,1601,69,195,400,879,469,1074
312740,202307,506,1276,285,823,61,184,81,175,142,359
312750,202307,1747,4441,1083,3091,155,477,474,1177,629,1654
312760,202307,2215,5936,1403,4179,246,728,490,1338,736,2066
312770,202307,57292,126554,32377,81195,5406,14786,13206,29036,18612,43822
312780,202307,3302,8232,2504,6747,411,1080,1375,3550,1786,4630
312790,202307,286,650,116,333,8,22,33,64,41,86
312800,202307,7511,17573,5224,13054,390,1197,3295,7334,3685,8531
312810,202307,1928,4867,1131,3360,349,1079,308,759,657,1838
312820,202307,2105,4980,1476,3804,102,237,982,2429,1084,2666
312825,202307,1926,3681,1397,2916,52,130,1135,2263,1187,2393
312830,202307,3387,8597,1775,5132,450,1210,576,1384,1026,2594
312840,202307,1808,4176,1218,3086,161,442,595,1296,756,1738
312850,202307,1445,2712,909,1838,27,98,675,1177,702,1275
312860,202307,1220,2982,757,2105,199,554,237,590,436,1144
312870,202307,7495,18400,3848,10843,644,1879,1165,2837,1809,4716
312880,202307,1913,4179,1250,2973,199,433,674,1566,873,1999
312890,202307,2875,6240,1783,4258,154,382,1078,2365,1232,2747
312900,202307,1651,3792,1096,2835,311,841,450,1049,761,1890
312910,202307,1763,3109,926,1962,132,257,520,1062,652,1319
312920,202307,1158,2854,692,1952,102,346,226,481,328,827
312930,202307,3064,6653,1940,4720,284,712,1031,2465,1315,3177
312940,202307,1213,2972,823,2268,69,211,433,1062,502,1273
312950,202307,4266,9196,2686,6515,398,1063,1543,3361,1941,4424
312960,202307,2141,5042,1604,4152,137,314,1086,2838,1223,3152
312965,202307,1971,4745,1451,3857,165,398,849,2242,1014,2640
312970,202307,2153,5240,1482,4023,146,491,850,2011,996,2502
312980,202307,33252,81933,22106,58486,4216,11335,8911,21286,13127,32621
312990,202307,643,1462,377,1010,73,213,155,377,228,590
313000,202307,607,1531,417,1180,23,91,248,601,271,692
313005,202307,2940,7586,2179,6175,139,404,1547,4202,1686,4606
313010,202307,7675,18424,5386,14071,801,2366,2926,6891,3727,9257
313020,202307,1272,3496,888,2658,200,640,168,388,368,1028
313030,202307,1477,3052,844,2024,116,282,500,1072,616,1354
313040,202307,1122,3051,785,2298,44,169,457,1180,501,1349
313050,202307,2251,5750,1392,4145,239,774,328,809,567,1583
313055,202307,2234,5499,1709,4580,678,1997,643,1524,1321,3521
313060,202307,1338,3027,834,2079,163,488,223,440,386,928
313065,202307,2106,5082,1688,4288,37,159,1381,3278,1418,3437
313070,202307,1057,2629,726,1987,128,369,307,778,435,1147
313080,202307,484,1210,291,793,59,199,111,229,170,428
313090,202307,6989,15650,4842,11758,230,598,3481,8027,3711,8625
313100,202307,1590,3738,1151,2943,60,203,805,1867,865,2070
313110,202307,1875,4494,1150,3087,139,404,550,1310,689,1714
313115,202307,3537,8691,2371,6228,224,662,1329,3021,1553,3683
313120,202307,4450,9900,2906,7491,448,1235,1693,4149,2141,5384
313130,202307,41520,95050,24903,62082,2995,8160,13629,30056,16624,38216
313140,202307,1010,1955,596,1356,60,137,407,860,467,997
313150,202307,1722,4496,1053,3093,288,948,148,322,436,1270
313160,202307,1829,4045,1179,2943,62,174,816,1915,878,2089
313170,202307,14556,37461,8815,24447,1406,4054,3382,8054,4788,12108
313180,202307,3159,7237,2173,5280,204,464,1418,3258,1622,3722
313190,202307,5844,14808,3526,9756,626,1844,1378,3169,2004,5013
313200,202307,1397,3115,1012,2383,43,130,775,1678,818,1808
313210,202307,5391,12277,3932,9783,347,991,2625,5961,2972,6952
313220,202307,2445,5867,1394,3654,221,610,599,1284,820,1894
313230,202307,3395,8403,2557,7158,67,262,1968,5322,2035,5584
313240,202307,14458,31902,9023,22295,1066,2990,4726,10133,5792,13123
313250,202307,7858,20534,5362,15061,1081,3180,2316,5840,3397,9020
313260,202307,1008,2268,605,1584,62,205,309,648,371,853
313270,202307,8317,16247,6007,12919,541,1162,4450,9058,4991,10220
313280,202307,574,1389,342,931,41,116,158,375,199,491
313290,202307,1300,3846,934,3063,209,756,319,934,528,1690
313300,202307,2356,5830,1511,4076,316,914,587,1379,903,2293
313310,202307,1911,5063,1274,3532,249,722,401,865,650,1587
313320,202307,2404,5774,1538,4250,360,1090,493,1315,853,2405
313330,202307,5213,11824,3393,8791,280,785,2116,5229,2396,6014
313340,202307,2184,4390,1423,3167,97,254,1025,2055,1122,2309
313350,202307,3759,9348,2151,5712,300,861,938,2097,1238,2958
313360,202307,2188,4843,1242,3135,197,588,620,1308,817,1896
313370,202307,2085,5091,1191,3147,238,642,399,817,637,1459
313375,202307,2330,5633,1161,3196,243,725,320,709,563,1434
313380,202307,8507,19531,5438,13398,867,2415,2410,4902,3277,7317
313390,202307,979,2712,748,2214,45,169,488,1327,533,1496
313400,202307,4686,10174,3125,7615,146,386,2307,5344,2453,5730
313410,202307,1802,4097,1182,3026,276,713,626,1461,902,2174
313420,202307,20077,41707,9746,23926,2229,5908,2753,5811,4982,11719
313430,202307,1587,3532,1157,2675,46,150,914,1898,960,2048
313440,202307,9378,17215,6030,12482,228,625,4634,8919,4862,9544
313450,202307,903,2253,530,1456,82,253,193,396,275,649
313460,202307,3025,7628,2233,6207,392,1184,961,2451,1353,3635
313470,202307,3376,7574,2442,6050,155,444,1824,4291,1979,4735
313480,202307,1489,3893,822,2412,128,367,339,879,467,1246
313490,202307,3872,9368,1650,4765,305,918,411,995,716,1913
313500,202307,723,1700,394,1017,81,174,156,384,237,558
313505,202307,13314,30032,9824,24321,554,1448,7210,17035,7764,18483
313507,202307,1617,3691,1115,2835,49,174,808,1889,857,2063
313510,202307,19778,46676,13139,33131,1278,3436,7354,16480,8632,19916
313520,202307,20115,45427,15173,37262,741,2171,11446,26305,12187,28476
313530,202307,728,2001,421,1243,60,198,179,432,239,630
313535,202307,2762,7026,1957,5425,218,554,1133,2989,1351,3543
313540,202307,1116,2841,678,1808,88,274,340,763,428,1037
313545,202307,1374,4054,980,3142,156,541,449,1313,605,1854
313550,202307,2700,6864,2017,5381,225,633,1340,3434,1565,4067
313560,202307,3722,5946,2618,4576,50,98,2294,3874,2344,3972
313570,202307,1205,3096,853,2415,178,535,367,900,545,1435
313580,202307,7757,16016,5655,12544,293,769,4210,8640,4503,9409
313590,202307,1444,3414,945,2531,152,412,478,1199,630,1611
313600,202307,5531,11508,4375,9765,124,380,3720,7832,3844,8212
313610,202307,1215,2741,842,2001,77,211,536,1144,613,1355
313620,202307,7269,17361,5163,13307,544,1622,3013,6927,3557,8549
313630,202307,11033,24543,7105,17844,720,2128,4232,9647,4952,11775
313640,202307,1656,3071,1081,2274,76,183,803,1621,879,1804
313650,202307,1949,5414,1422,4427,156,521,795,2389,951,2910
313652,202307,1101,2777,852,2265,74,210,590,1452,664,1662
313655,202307,1460,3083,1046,2500,71,196,757,1733,828,1929
313657,202307,1297,3090,926,2424,31,136,655,1537,686,1673
313660,202307,1536,3473,1131,2764,92,309,768,1671,860,1980
313665,202307,7399,16849,5089,12374,553,1511,3082,6621,3635,8132
313670,202307,73521,162782,45185,112349,6164,16482,21904,48433,28068,64915
313680,202307,1365,3106,949,2351,47,135,623,1393,670,1528
313690,202307,1268,3470,817,2520,164,550,155,383,319,933
313695,202307,2113,5094,1422,3902,118,313,874,2376,992,2689
313700,202307,3520,9675,2697,8269,195,612,1998,5954,2193,6566
313710,202307,1752,3659,1049,2536,152,463,618,1329,770,1792
313720,202307,8339,20617,5118,13504,724,2006,2475,5716,3199,7722
313730,202307,1665,3255,1080,2359,71,152,751,1614,822,1766
313740,202307,2087,6801,1514,5263,326,1240,402,1187,728,2427
313750,202307,3001,6902,2141,5307,289,824,1283,2827,1572,3651
313753,202307,2518,5800,1437,3818,403,1156,318,738,721,1894
313760,202307,8141,20238,5603,14976,912,2669,2535,5827,3447,8496
313770,202307,5099,13051,3680,10543,795,2248,2113,6030,2908,8278
313780,202307,5133,11991,3096,8194,695,1809,1045,2638,1740,4447
313790,202307,765,1960,561,1530,64,182,332,828,396,1010
313800,202307,1663,3455,1052,2472,110,271,585,1253,695,1524
313810,202307,2342,4843,1641,3703,60,185,1268,2642,1328,2827
313820,202307,21535,51081,11135,28101,1916,4896,3581,7674,5497,12570
313830,202307,496,1319,330,956,62,188,120,302,182,490
313835,202307,1163,2836,712,1962,66,218,358,874,424,1092
313840,202307,10581,24666,6756,17692,1612,4310,1941,4742,3553,9052
313850,202307,1237,2609,847,1955,144,340,448,903,592,1243
313860,202307,3685,8494,2445,6147,344,913,1230,2731,1574,3644
313862,202307,1390,2937,597,1590,55,151,288,698,343,849
313865,202307,3231,7373,2361,5901,92,280,1672,3793,1764,4073
313867,202307,1683,4853,1248,3938,342,1085,477,1505,819,2590
313868,202307,2051,5543,1477,4399,71,270,1088,3024,1159,3294
313870,202307,1338,3158,741,1950,129,343,303,702,432,1045
313880,202307,2900,6706,1877,4673,315,932,936,1900,1251,2832
313890,202307,2927,5192,2121,4126,59,131,1694,3106,1753,3237
313900,202307,7014,17684,4049,11331,1065,3045,1173,2655,2238,5700
313910,202307,957,2529,596,1723,120,361,162,415,282,776
313920,202307,3466,9161,2620,7465,526,1455,1204,3382,1730,4837
313925,202307,1954,4394,1303,3183,207,441,790,1831,997,2272
313930,202307,6444,15340,4620,12162,426,1118,2930,7410,3356,8528
313940,202307,12769,34041,8351,25252,2087,6893,1789,5503,3876,12396
313950,202307,6999,13561,4838,10494,281,730,3563,7239,3844,7969
313960,202307,7137,15568,4256,10513,591,1679,1960,4172,2551,5851
313970,202307,2025,4652,1454,3557,55,147,985,2198,1040,2345
313980,202307,1823,4369,1192,3290,223,652,446,1109,669,1761
313990,202307,2843,7261,1919,5300,315,1025,1054,2520,1369,3545
314000,202307,13585,30288,8929,21481,645,1869,5502,12217,6147,14086
314010,202307,1638,3565,1147,2794,81,206,785,1786,866,1992
314015,202307,3070,7414,2127,5530,259,777,1201,2726,1460,3503
314020,202307,677,1638,356,1057,127,450,18,37,145,487
314030,202307,1070,2714,645,1784,97,285,256,633,353,918
314040,202307,763,1932,570,1559,69,229,358,898,427,1127
314050,202307,2686,6176,1770,4395,128,386,1136,2511,1264,2897
314053,202307,2623,6622,1871,5127,303,803,1082,2992,1385,3795
314055,202307,2906,6338,2248,5344,75,215,1789,4093,1864,4308
314060,202307,1590,3724,1037,2694,41,104,730,1811,771,1915
314070,202307,6301,14837,4431,11147,611,1613,2319,5206,2930,6819
314080,202307,2492,5975,1548,4134,155,436,779,1833,934,2269
314085,202307,2868,7017,2091,5751,238,688,1268,3363,1506,4051
314090,202307,6268,14666,4595,11752,465,1238,2742,6774,3207,8012
314100,202307,3548,7945,2466,6242,115,333,1767,4338,1882,4671
314110,202307,6353,15928,4282,11319,687,1978,2016,4613,2703,6591
314120,202307,829,1808,320,842,56,163,136,308,192,471
314130,202307,882,2056,578,1469,23,76,403,949,426,1025
314140,202307,5662,13615,3913,10213,483,1337,2211,5339,2694,6676
314150,202307,1735,3949,1080,2796,164,427,588,1449,752,1876
314160,202307,2919,6584,1758,4448,193,490,709,1669,902,2159
314170,202307,1170,2845,749,1904,81,254,463,1020,544,1274
314180,202307,6750,16549,4491,12287,669,1881,2082,5372,2751,7253
314190,202307,755,1728,503,1279,61,190,286,608,347,798
314200,202307,3710,9200,2684,7272,257,644,1648,4288,1905,4932
314210,202307,2381,5631,1519,3931,289,809,503,1126,792,1935
314220,202307,2220,5389,1543,4168,271,824,641,1524,912,2348
314225,202307,1234,3251,837,2440,158,471,409,1094,567,1565
314230,202307,1090,2625,681,1849,123,336,303,732,426,1068
314240,202307,1359,3429,928,2639,197,569,361,1002,558,1571
314250,202307,512,1365,294,883,49,159,112,279,161,438
314260,202307,1340,3188,930,2502,340,943,221,503,561,1446
314270,202307,4034,9924,2960,8009,105,304,2103,5470,2208,5774
314280,202307,4416,9542,2679,6672,294,817,1512,3415,1806,4232
314290,202307,5563,12547,4047,9675,217,575,2979,6658,3196,7233
314300,202307,2433,6360,1339,3895,328,1010,359,858,687,1868
314310,202307,4491,11037,2657,7536,730,2366,320,659,1050,3025
314315,202307,1232,3349,911,2675,68,243,617,1692,685,1935
314320,202307,4263,10206,2512,6706,371,1120,1117,2528,1488,3648
314330,202307,72083,184799,47246,135136,11287,32022,12780,33890,24067,65912
314340,202307,3423,7879,2118,5412,373,1138,1001,2072,1374,3210
314345,202307,2018,4818,1436,3733,129,302,953,2298,1082,2600
314350,202307,1244,3208,643,1910,96,274,152,328,248,602
314360,202307,698,1820,401,1191,48,130,132,354,180,484
314370,202307,928,2089,641,1604,57,161,434,980,491,1141
314380,202307,1530,3820,923,2611,222,673,310,790,532,1463
314390,202307,20108,44662,12228,30244,1948,5293,5422,11355,7370,16648
314400,202307,4810,13288,3319,10226,1197,3875,805,2444,2002,6319
314410,202307,3742,9824,2226,6530,565,2010,419,912,984,2922
314420,202307,958,2142,589,1508,30,99,375,885,405,984
314430,202307,9851,20991,6054,14519,924,2318,2785,6102,3709,8420
314435,202307,2309,5590,1431,3877,259,661,658,1643,917,2304
314437,202307,1114,2518,744,1857,59,160,512,1203,571,1363
314440,202307,753,1985,464,1363,97,339,158,359,255,698
314450,202307,1793,4250,1173,2997,176,500,602,1322,778,1822
314460,202307,4333,11625,2912,8455,638,2013,1201,2971,1839,4984
314465,202307,2865,7030,2148,5647,143,322,1507,3755,1650,4077
314467,202307,1195,2817,872,2265,126,392,530,1291,656,1683
314470,202307,2943,7387,1997,5277,412,1177,869,1958,1281,3135
314480,202307,11454,28244,7352,19296,1089,3104,3283,7355,4372,10459
314490,202307,1299,3043,868,2236,88,251,533,1271,621,1522
314500,202307,2451,5430,1431,3724,448,1136,273,684,721,1820
314505,202307,2879,5648,2075,4425,130,223,1534,3182,1664,3405
314510,202307,2757,6737,1901,5387,659,2131,517,1272,1176,3403
314520,202307,10476,28072,7430,21529,1525,4582,1692,4384,3217,8966
314530,202307,6735,17973,5334,15218,448,1357,3611,9654,4059,11011
314535,202307,3560,7437,2596,5924,147,383,2023,4412,2170,4795
314537,202307,1467,3690,1011,2796,84,222,639,1678,723,1900
314540,202307,526,1181,320,827,21,74,174,378,195,452
314545,202307,2293,4814,1663,3895,68,224,1236,2677,1304,2901
314550,202307,913,2018,512,1286,51,144,265,569,316,713
314560,202307,6320,16121,3994,10734,440,1354,1955,4323,2395,5677
314570,202307,416,1081,282,835,46,155,131,364,177,519
314580,202307,626,1637,394,1147,89,254,118,304,207,558
314585,202307,921,2493,556,1631,46,155,263,691,309,846
314587,202307,2820,6739,1982,5270,661,1848,880,2132,1541,3980
314590,202307,5554,13265,3582,9241,483,1340,1679,3841,2162,5181
314600,202307,2291,5804,1266,3755,261,854,150,366,411,1220
314610,202307,12269,28002,7940,19755,939,2625,3740,8612,4679,11237
314620,202307,3080,6062,2293,4979,165,318,1767,3821,1932,4139
314625,202307,2006,4381,1446,3513,65,262,1111,2441,1176,2703
314630,202307,6086,13774,4420,11208,209,646,3306,7953,3515,8599
314640,202307,1075,2057,738,1505,24,80,580,1066,604,1146
314650,202307,1021,2279,576,1460,72,210,286,601,358,811
314655,202307,1806,4448,1115,3147,189,454,567,1595,756,2049
314660,202307,451,871,309,633,13,37,231,421,244,458
314670,202307,1882,3903,1168,2792,46,138,819,1817,865,1955
314675,202307,2025,4674,1564,3876,98,236,1148,2734,1246,2970
314690,202307,2602,6579,1781,5098,443,1273,514,1375,957,2648
314700,202307,15040,36655,9033,24637,1370,4089,4089,9963,5459,14052
314710,202307,10035,25454,6263,16808,1039,2961,2429,5446,3468,8407
314720,202307,2972,8068,1704,5181,359,1192,300,638,659,1830
314730,202307,3222,7691,1719,4533,303,888,628,1315,931,2203
314740,202307,4131,10305,2903,7958,540,1585,1342,3237,1882,4822
314750,202307,368,882,240,610,18,51,143,314,161,365
314760,202307,2394,6366,1343,3946,251,787,338,696,589,1483
314770,202307,1296,3523,639,1930,79,229,119,302,198,531
314780,202307,457,1038,282,731,22,62,176,409,198,471
314790,202307,15647,37749,9562,25666,1796,5227,3856,9121,5652,14348
314795,202307,1836,4148,1375,3357,68,188,986,2216,1054,2404
314800,202307,15107,35473,8960,23428,1425,4074,3675,8119,5100,12193
314810,202307,13798,32782,8804,23164,2033,5486,3354,8011,5387,13497
314820,202307,1547,3409,1004,2490,66,191,620,1374,686,1565
314830,202307,2264,5521,1603,4234,149,421,967,2294,1116,2715
314840,202307,1092,2959,815,2416,82,315,533,1434,615,1749
314850,202307,3462,5795,2634,4775,50,124,2367,4177,2417,4301
314860,202307,4168,10114,3153,8244,120,408,2314,5682,2434,6090
314870,202307,8687,16662,5846,12786,294,710,4300,9155,4594,9865
314875,202307,2185,5998,1748,5222,260,695,1085,3234,1345,3929
314880,202307,942,2137,586,1494,43,125,330,766,373,891
314890,202307,595,1702,372,1156,81,302,111,247,192,549
314900,202307,1149,2486,731,1726,78,182,459,988,537,1170
314910,202307,2011,5321,1269,3860,258,917,504,1328,762,2245
314915,202307,2573,6780,1872,5470,205,563,1043,2980,1248,3543
314920,202307,704,1557,430,1095,28,73,268,652,296,725
314930,202307,8386,20842,5451,14444,953,2736,2408,5387,3361,8123
314940,202307,528,1121,366,844,41,105,218,466,259,571
314950,202307,857,1932,497,1285,46,146,285,652,331,798
314960,202307,1203,2601,829,1953,82,198,526,1179,608,1377
314970,202307,1550,4140,1041,3065,199,637,384,904,583,1541
314980,202307,2816,6420,1950,4874,186,492,1274,2943,1460,3435
314990,202307,3495,9228,2009,5736,346,967,502,1184,848,2151
314995,202307,2126,5182,1440,3819,90,303,893,2104,983,2407
315000,202307,1309,2998,845,2239,93,275,544,1347,637,1622
315010,202307,514,1241,371,1008,33,104,231,572,264,676
315015,202307,3084,7431,2435,6252,230,711,1655,3920,1885,4631
315020,202307,971,2545,543,1558,48,149,283,690,331,839
315030,202307,870,2034,517,1372,161,408,132,301,293,709
315040,202307,1240,2860,945,2321,146,409,597,1358,743,1767
315050,202307,1412,3316,861,2288,90,276,399,968,489,1244
315053,202307,1532,3440,995,2465,129,306,545,1259,674,1565
315057,202307,2268,5627,1598,4451,144,364,965,2774,1109,3138
315060,202307,902,2401,586,1706,110,348,167,420,277,768
315070,202307,1162,2227,795,1675,98,232,541,1056,639,1288
315080,202307,4258,9901,2814,7143,133,367,1985,4653,2118,5020
315090,202307,1013,2711,688,2036,104,319,317,822,421,1141
315100,202307,1792,4770,996,2897,160,492,403,975,563,1467
315110,202307,2878,6069,1806,4308,149,371,1035,2327,1184,2698
315120,202307,15944,33734,10085,24000,1218,2880,5580,12455,6798,15335
315130,202307,2306,5551,1632,4176,187,533,847,1860,1034,2393
315140,202307,4177,10279,3000,7916,469,1324,1688,4065,2157,5389
315150,202307,5771,13607,3507,9395,604,1709,1428,3397,2032,5106
315160,202307,2570,5550,1502,3648,212,552,846,1870,1058,2422
315170,202307,1781,5158,1130,3569,198,675,342,953,540,1628
315180,202307,22175,51078,10805,28375,1674,4622,3811,8286,5485,12908
315190,202307,2689,5484,1866,4300,300,638,1225,2809,1525,3447
315200,202307,5982,14593,4000,10954,1240,3553,1276,2993,2516,6546
315210,202307,10602,25567,6142,15917,710,1967,2820,6144,3530,8111
315213,202307,1263,3055,974,2541,22,70,761,1898,783,1968
315217,202307,3235,8182,2160,6225,817,2419,724,1876,1541,4295
315220,202307,10772,26486,7348,20118,647,1648,3906,10593,4553,12241
315230,202307,3659,7117,2647,5602,154,300,1950,3999,2104,4299
315240,202307,3129,7836,2245,6189,553,1630,890,2286,1443,3916
315250,202307,19833,47900,12207,32108,1845,5273,5510,12283,7355,17556
315260,202307,1163,2900,613,1764,103,278,153,362,256,640
315270,202307,1280,3265,870,2388,106,313,415,918,521,1231
315280,202307,4210,9649,2466,6361,648,1720,791,1824,1439,3544
315290,202307,1506,3401,816,2177,140,410,345,786,485,1196
315300,202307,797,1796,535,1387,39,116,350,855,389,971
315310,202307,1600,3597,1038,2528,57,166,725,1564,782,1730
315320,202307,753,2034,472,1426,79,243,174,450,253,693
315330,202307,873,2573,462,1483,58,206,195,526,253,732
315340,202307,3373,7805,1889,5065,518,1353,588,1531,1106,2884
315350,202307,2401,5269,1862,4388,154,387,1400,3145,1554,3532
315360,202307,2028,5256,1392,3902,194,585,628,1545,822,2130
315370,202307,776,1870,509,1356,69,197,247,558,316,755
315380,202307,286,739,166,483,36,110,20,39,56,149
315390,202307,1604,4039,1131,3040,126,424,608,1369,734,1793
315400,202307,5028,12069,3444,9064,442,1245,1935,4688,2377,5933
315410,202307,2704,5746,1526,3706,352,981,418,862,770,1843
315415,202307,1866,4751,1263,3554,383,1256,222,507,605,1763
315420,202307,1904,4920,1160,3371,290,871,291,701,581,1572
315430,202307,4322,9868,2600,6974,444,1309,1171,2863,1615,4172
315440,202307,1260,2928,819,2100,92,270,501,1151,593,1421
315445,202307,2838,5483,1922,4165,141,287,1450,3055,1591,3342
315450,202307,2653,6584,1829,4994,185,520,1166,2933,1351,3453
315460,202307,62110,145205,45938,114127,4587,13342,28500,63062,33087,76404
315470,202307,842,2140,491,1289,65,198,224,500,289,698
315480,202307,1975,4829,1191,3091,158,424,588,1302,746,1726
315490,202307,3529,8139,1978,5246,324,850,708,1705,1032,2555
315500,202307,654,1581,352,924,17,40,224,526,241,566
315510,202307,1703,3699,1269,3042,25,104,1016,2244,1041,2348
315520,202307,1378,3046,1066,2528,45,95,853,1909,898,2004
315530,202307,1051,2297,794,1811,60,169,582,1196,642,1365
315540,202307,2092,4968,1184,3181,133,402,510,1199,643,1601
315550,202307,2232,5576,1286,3649,197,625,426,1111,623,1736
315560,202307,8171,21106,6253,17256,477,1239,4267,11292,4744,12531
315570,202307,3129,7157,1810,4551,304,898,925,1932,1229,2830
315580,202307,4144,8618,2711,6124,353,925,1265,2507,1618,3432
315590,202307,1635,2992,1291,2467,37,116,1054,1798,1091,1914
315600,202307,3044,8253,1913,5930,526,1552,669,2199,1195,3751
315610,202307,1248,2833,781,1930,83,249,403,811,486,1060
315620,202307,655,1580,421,1172,34,112,221,584,255,696
315630,202307,1546,3704,1033,2654,170,461,479,1054,649,1515
315640,202307,505,1118,350,870,33,91,214,479,247,570
315645,202307,1180,2840,729,2005,142,424,270,660,412,1084
315650,202307,2288,4525,1683,3595,83,192,1316,2668,1399,2860
315660,202307,2540,5987,1765,4595,226,625,937,2288,1163,2913
315670,202307,21318,50361,14446,36695,2605,6863,6674,15091,9279,21954
315680,202307,3872,9626,2556,7064,364,1096,1260,3233,1624,4329
315690,202307,4836,11131,2360,6416,480,1257,661,1880,1141,3137
315700,202307,10920,26086,7416,19033,717,2018,4221,9699,4938,11717
315710,202307,2113,4615,1356,3418,96,261,880,2053,976,2314
315720,202307,5627,13450,3803,9679,186,621,2531,5786,2717,6407
315725,202307,2903,6580,2060,5206,260,617,1269,3239,1529,3856
315727,202307,802,1850,547,1408,62,190,288,663,350,853
315730,202307,762,2069,532,1548,106,316,192,461,298,777
315733,202307,1889,4322,1264,3137,232,588,554,1214,786,1802
315737,202307,1430,3471,914,2451,41,134,636,1583,677,1717
315740,202307,1065,2704,763,2056,57,170,496,1201,553,1371
315750,202307,1595,3616,1118,2884,102,241,688,1785,790,2026
315760,202307,1483,3038,1016,2328,29,88,808,1721,837,1809
315765,202307,2513,5258,1989,4585,34,139,1757,3935,1791,4074
315770,202307,1607,4088,1098,3126,307,890,303,823,610,1713
315780,202307,40754,98169,29354,74917,2459,7178,17967,41396,20426,48574
315790,202307,4271,11999,3394,10291,347,1057,1936,6067,2283,7124
315800,202307,1669,4746,1111,3358,125,445,493,1215,618,1660
315810,202307,1753,3658,1307,2929,60,173,1009,2089,1069,2262
315820,202307,3667,7896,2722,6446,270,571,1845,4266,2115,4837
315830,202307,1545,4135,809,2341,103,294,250,559,353,853
315840,202307,1102,2399,661,1590,64,157,365,741,429,898
315850,202307,1459,3717,1042,2953,181,545,529,1417,710,1962
315860,202307,657,1717,428,1277,79,235,135,323,214,558
315870,202307,569,1403,416,1126,27,76,296,752,323,828
315880,202307,1425,3153,864,2082,112,318,473,949,585,1267
315890,202307,2212,5565,1705,4785,563,1760,562,1453,1125,3213
315895,202307,8041,19874,4690,12652,601,1781,2132,5058,2733,6839
315900,202307,1108,2655,823,2143,128,346,453,1097,581,1443
315910,202307,801,1789,638,1532,35,99,484,1090,519,1189
315920,202307,1608,3758,799,2155,140,494,333,713,473,1207
315930,202307,1410,2830,827,1916,60,145,536,1158,596,1303
315935,202307,1475,3828,1004,2857,174,526,474,1253,648,1779
315940,202307,724,1756,493,1333,64,197,254,619,318,816
315950,202307,1579,3778,1254,3225,142,386,873,2182,1015,2568
315960,202307,6615,17223,3523,10194,781,2387,733,1520,1514,3907
315970,202307,684,1724,506,1439,60,184,299,798,359,982
315980,202307,5223,10649,2592,5979,381,919,1334,2707,1715,3626
315990,202307,4296,10057,2784,7065,456,1187,1371,3135,1827,4322
316000,202307,982,2083,672,1582,63,184,414,866,477,1050
316010,202307,826,2170,548,1545,84,244,220,495,304,739
316020,202307,1154,2815,847,2206,71,211,560,1328,631,1539
316030,202307,3332,8112,2251,6094,345,942,1204,3307,1549,4249
316040,202307,3279,8711,1908,5816,341,1180,521,1228,862,2408
316045,202307,2789,5721,2308,5019,151,283,1899,4039,2050,4322
316050,202307,537,1267,362,949,31,79,229,542,260,621
316060,202307,874,1847,552,1359,32,97,383,849,415,946
316070,202307,7629,18281,5335,13483,907,2224,2494,5784,3401,8008
316080,202307,1047,2817,707,2046,119,362,321,815,440,1177
316090,202307,673,1635,443,1108,41,133,253,542,294,675
316095,202307,1527,4313,1010,3067,240,774,303,806,543,1580
316100,202307,3053,7762,1908,5270,310,967,806,1907,1116,2874
316105,202307,878,2078,611,1611,45,129,371,961,416,1090
316110,202307,18375,42775,13967,35050,874,2725,10255,23888,11129,26613
316120,202307,1519,3787,776,2106,131,406,262,534,393,940
316130,202307,1541,3200,854,1983,86,239,506,1032,592,1271
316140,202307,1286,3162,692,1998,160,484,210,550,370,1034
316150,202307,2728,5718,1643,3752,181,412,939,1928,1120,2340
316160,202307,1207,2836,849,2163,25,77,586,1372,611,1449
316165,202307,1079,2331,720,1742,66,175,471,1037,537,1212
316170,202307,1811,3643,1222,2666,58,162,900,1769,958,1931
316180,202307,2038,5187,1138,3204,201,594,385,906,586,1500
316190,202307,3322,8711,1506,4257,167,526,673,1546,840,2072
316200,202307,4808,11645,3217,8525,449,1313,1650,3830,2099,5143
316210,202307,7318,19316,4148,11680,1287,3823,436,966,1723,4789
316220,202307,924,2592,489,1597,94,327,114,344,208,671
316225,202307,1992,4079,1372,3107,63,234,1024,2031,1087,2265
316230,202307,615,1447,420,1093,94,261,208,502,302,763
316240,202307,6921,17484,5407,14540,397,1156,3879,9831,4276,10987
316245,202307,3886,10759,3190,9503,234,916,2170,5935,2404,6851
316250,202307,14801,32129,9427,22225,1722,4345,3991,8442,5713,12787
316255,202307,3548,9342,2755,7858,265,763,1858,5222,2123,5985
316257,202307,1979,4050,1299,2958,113,256,877,1884,990,2140
316260,202307,3361,6635,2381,5076,245,471,1541,3180,1786,3651
316265,202307,1322,3205,914,2441,29,66,676,1732,705,1798
316270,202307,4726,12693,3585,10178,480,1440,1890,4807,2370,6247
316280,202307,3823,9050,2811,7131,392,1043,1525,3599,1917,4642
316290,202307,5139,12308,3168,8222,373,983,1291,2950,1664,3933
316292,202307,7915,18903,5497,14317,605,1782,3391,7978,3996,9760
316294,202307,1196,3293,747,2361,171,594,247,668,418,1262
316295,202307,4687,11618,3152,8458,276,845,1873,4444,2149,5289
316300,202307,1362,3185,1005,2623,56,166,719,1746,775,1912
316310,202307,903,2372,544,1547,95,296,173,427,268,723
316320,202307,826,2142,497,1420,83,266,122,313,205,579
316330,202307,1300,2979,896,2273,40,112,679,1616,719,1728
316340,202307,1274,3088,892,2321,105,301,514,1178,619,1479
316350,202307,1795,4124,1411,3444,144,348,1007,2322,1151,2670
316360,202307,782,1877,564,1514,87,225,363,969,450,1194
316370,202307,7806,17847,5114,12742,574,1736,2737,5636,3311,7372
316380,202307,2178,4511,1499,3421,80,185,1086,2359,1166,2544
316390,202307,928,2300,606,1694,228,709,138,320,366,1029
316400,202307,1531,3961,769,2309,103,317,247,610,350,927
316410,202307,1542,3449,1171,2801,22,56,929,2090,951,2146
316420,202307,2272,5517,1744,4663,68,228,1265,3155,1333,3383
316430,202307,1155,2753,702,1915,123,388,291,681,414,1069
316440,202307,1069,3079,643,2092,123,419,158,458,281,877
316443,202307,704,1774,419,1192,93,305,147,359,240,664
316447,202307,2737,5899,2149,4966,152,265,1720,3891,1872,4156
316450,202307,2556,6664,1726,4961,220,660,983,2691,1203,3351
316460,202307,1725,4123,1164,3029,93,283,703,1638,796,1921
316470,202307,9451,24211,5935,16456,923,2708,2473,5793,3396,8501
316480,202307,280,634,211,503,30,75,123,259,153,334
316490,202307,416,1068,238,681,49,155,83,194,132,349
316500,202307,1716,4692,1043,3108,219,678,334,839,553,1517
316510,202307,987,2845,699,2197,121,375,302,907,423,1282
316520,202307,1685,3688,1112,2598,189,473,395,756,584,1229
316530,202307,1514,3395,1014,2466,91,260,610,1288,701,1548
316540,202307,1410,3154,965,2380,163,432,396,870,559,1302
316550,202307,1858,4433,1470,3752,48,173,1165,2815,1213,2988
316553,202307,6308,16381,3737,10135,522,1571,1813,4149,2335,5720
316555,202307,3299,8443,2618,7439,115,484,2086,5618,2201,6102
316556,202307,688,1457,447,987,33,73,282,534,315,607
316557,202307,1552,4178,1205,3527,411,1262,426,1169,837,2431
316560,202307,502,1402,296,951,54,187,72,190,126,377
316570,202307,1841,4588,1243,3393,294,709,390,1119,684,1828
316580,202307,450,947,238,574,32,80,96,183,128,263
316590,202307,1594,3592,948,2296,99,202,604,1375,703,1577
316600,202307,1265,3191,999,2634,136,415,646,1517,782,1932
316610,202307,775,2007,551,1590,57,170,323,848,380,1018
316620,202307,2900,6396,2184,5126,169,379,1639,3667,1808,4046
316630,202307,1859,5063,1450,4213,419,1183,550,1747,969,2930
316640,202307,225,551,159,419,36,105,58,129,94,234
316650,202307,1422,3490,1033,2796,88,264,670,1680,758,1944
316660,202307,201,478,91,245,7,19,31,65,38,84
316670,202307,2031,4568,1365,3460,398,1071,403,912,801,1983
316680,202307,2923,6946,1897,4881,185,506,1128,2746,1313,3252
316690,202307,1643,4397,927,2802,163,504,153,325,316,829
316695,202307,1174,3118,823,2408,25,109,536,1465,561,1574
316700,202307,667,1132,509,933,7,15,436,740,443,755
316710,202307,4512,12028,3227,9227,396,1242,1821,4626,2217,5868
316720,202307,29841,71794,19996,51725,2870,8019,10244,23528,13114,31547
316730,202307,694,1496,476,1096,50,109,276,572,326,681
316740,202307,1098,2663,785,2087,103,301,502,1251,605,1552
316750,202307,519,1302,334,946,74,222,141,360,215,582
316760,202307,4960,13597,3818,11309,1274,4256,1408,3897,2682,8153
316770,202307,1916,3868,1328,3022,46,126,1048,2343,1094,2469
316780,202307,758,2025,543,1603,179,571,91,187,270,758
316790,202307,913,2248,566,1556,110,307,162,414,272,721
316800,202307,8442,20892,5893,16029,907,2665,2857,7100,3764,9765
316805,202307,1512,2766,1137,2300,33,92,956,1849,989,1941
316810,202307,971,2354,608,1635,53,163,397,990,450,1153
316820,202307,490,941,270,594,11,25,188,373,199,398
316830,202307,1144,2585,800,2001,94,232,472,1114,566,1346
316840,202307,3761,8162,2693,6410,114,355,2056,4466,2170,4821
316850,202307,2960,6401,1913,4513,162,461,1238,2563,1400,3024
316860,202307,30119,65971,20481,49827,2824,7863,10958,24145,13782,32008
316870,202307,11400,27001,7066,18021,825,2379,3679,7898,4504,10277
316880,202307,1471,3390,1079,2691,142,376,609,1337,751,1713
316890,202307,1420,3032,803,2126,115,351,464,1105,579,1456
316900,202307,3806,8684,2487,6148,414,1126,1196,2571,1610,3697
316905,202307,598,1609,401,1200,218,654,85,262,303,916
316910,202307,1252,3022,742,2038,161,473,176,421,337,894
316920,202307,2537,5163,1725,3872,313,574,1024,2177,1337,2751
316930,202307,12281,30616,8127,22158,1652,4789,3115,7253,4767,12042
316935,202307,5615,13289,3576,9278,608,1677,1649,3764,2257,5441
316940,202307,7734,20342,5363,15149,949,2774,2242,5395,3191,8169
316950,202307,2526,4999,1791,3947,127,294,1381,2871,1508,3165
316960,202307,6945,13488,4300,9536,320,778,2983,6222,3303,7000
316970,202307,5464,12979,3748,9559,667,1775,1701,3733,2368,5508
316980,202307,1144,2885,794,2258,216,674,318,778,534,1452
316990,202307,16878,40409,10474,26971,2604,7007,2681,5803,5285,12810
317000,202307,3378,8037,2639,6873,111,281,2122,5337,2233,5618
317005,202307,3229,8177,2206,6053,393,1160,1059,2616,1452,3776
317010,202307,38766,84455,24066,59616,3512,9620,12947,29040,16459,38660
317020,202307,98237,216479,54213,134798,10533,27849,19885,42893,30418,70742
317030,202307,823,1996,605,1635,15,51,434,1119,449,1170
317040,202307,14668,33987,8106,21868,2069,5939,1794,4635,3863,10574
317043,202307,1186,2250,715,1550,30,71,565,1166,595,1237
317047,202307,1364,2917,844,2026,51,146,574,1262,625,1408
317050,202307,1472,4296,851,2694,120,369,274,679,394,1048
317052,202307,3022,7054,2081,5420,206,594,1326,3174,1532,3768
317057,202307,2868,5263,1931,3829,41,119,1584,2910,1625,3029
317060,202307,593,1491,298,866,61,191,106,262,167,453
317065,202307,1341,3513,938,2595,61,208,580,1385,641,1593
317070,202307,10974,27811,7681,21084,1160,3564,3584,8412,4744,11976
317075,202307,1378,3115,921,2241,160,385,494,1111,654,1496
317080,202307,8512,18094,5669,13109,1098,2736,2701,5828,3799,8564
317090,202307,5840,14744,4622,12609,426,1093,3252,8683,3678,9776
317100,202307,3188,7086,1838,4616,410,1054,764,1715,1174,2769
317103,202307,3113,6509,2277,5154,155,374,1690,3572,1845,3946
317107,202307,1839,4233,1231,3036,53,162,808,1677,861,1839
317110,202307,832,1799,418,1096,82,223,184,433,266,656
317115,202307,1399,3566,1034,2861,150,457,573,1498,723,1955
317120,202307,25764,59291,18230,45147,1607,4635,11330,25076,12937,29711
317130,202307,14433,31037,8639,20533,1249,3118,3446,7461,4695,10579
317140,202307,1190,2579,740,1804,88,215,491,1154,579,1369
317150,202307,1315,2625,922,2067,28,100,750,1549,778,1649
317160,202307,4104,9261,2302,6075,297,715,1066,2981,1363,3696
317170,202307,2596,5823,1838,4382,107,337,1260,2577,1367,2914
317180,202307,2245,6336,1333,4147,269,847,237,668,506,1515
317190,202307,1343,3342,888,2514,161,491,425,1078,586,1569
317200,202307,8294,20127,4823,12634,1021,2775,1254,2752,2275,5527
317210,202307,1536,3257,1015,2422,37,110,700,1546,737,1656
317220,202307,435,1060,326,860,56,189,186,405,242,594
320010,202307,6055,16400,4007,11982,846,2707,1442,4149,2288,6856
320013,202307,2590,6400,1581,4382,323,957,701,1898,1024,2855
320016,202307,3517,8342,2363,6328,232,656,1550,3978,1782,4634
320020,202307,6342,14316,4280,10519,588,1673,2363,5230,2951,6903
320030,202307,2315,5729,1377,3785,219,677,614,1434,833,2111
320035,202307,2456,5863,1775,4613,278,777,1036,2540,1314,3317
320040,202307,5860,14660,4146,11095,596,1661,2129,5060,2725,6721
320050,202307,2496,5054,1772,3903,184,530,1213,2354,1397,2884
320060,202307,19671,48376,12106,32445,2339,6641,5186,12303,7525,18944
320070,202307,2484,5920,1587,4071,177,524,862,1892,1039,2416
320080,202307,7219,16786,4472,11261,732,1972,2045,4555,2777,6527
320090,202307,10397,25663,5912,16242,1258,3728,2007,4696,3265,8424
320100,202307,4489,10201,3275,7990,397,1118,2045,4540,2442,5658
320110,202307,3238,6498,2032,4567,350,808,1154,2309,1504,3117
320115,202307,2779,7972,2188,6828,753,2423,654,2037,1407,4460
320120,202307,35188,79487,21375,53074,2892,7584,10933,24183,13825,31767
320130,202307,79557,184240,55988,139356,7272,19570,32551,73952,39823,93522
320140,202307,5369,13021,3302,8649,617,1807,1549,3562,2166,5369
320150,202307,18524,43413,10849,28290,2817,8082,1786,3483,4603,11565
320160,202307,8561,20798,5659,15233,826,2430,2986,7439,3812,9869
320170,202307,2331,5971,1484,4253,405,1188,451,1354,856,2542
320180,202307,947,2711,676,2143,219,788,124,317,343,1105
320190,202307,4070,11515,2673,8403,576,1993,488,1263,1064,3256
320200,202307,1697,4294,1050,3032,234,720,281,757,515,1477
320210,202307,5763,13266,3970,10005,659,1765,1989,4531,2648,6296
320220,202307,4851,10931,3056,7606,661,1692,1326,3020,1987,4712
320225,202307,1978,5509,1246,3867,358,1222,275,782,633,2004
320230,202307,7295,17339,4745,12568,1268,3451,1238,3304,2506,6755
320240,202307,22760,52727,14741,38531,3921,11158,3939,9182,7860,20340
320245,202307,4147,11316,2691,8074,679,2180,299,785,978,2965
320250,202307,3831,8994,2062,5114,345,937,1012,2146,1357,3083
320255,202307,2780,7387,2169,6189,363,1107,1364,3778,1727,4885
320260,202307,1799,4669,969,2854,264,766,239,591,503,1357
320265,202307,2935,8311,1947,6157,648,2218,202,550,850,2768
320270,202307,2875,7237,1864,5209,499,1559,590,1501,1089,3060
320280,202307,11597,25954,8328,20152,877,2425,5636,12366,6513,14791
320290,202307,1647,4551,963,2915,244,818,252,707,496,1525
320300,202307,5748,15149,4132,11880,1223,3903,1212,3176,2435,7079
320305,202307,7101,17677,4879,13341,844,2536,2321,5831,3165,8367
320310,202307,2724,6621,1679,4400,296,831,775,1799,1071,2630
320313,202307,3278,7330,1761,4290,335,909,660,1308,995,2217
320316,202307,1987,5156,1341,3936,246,727,663,1935,909,2662
320320,202307,27527,67369,17396,48094,4484,12849,4707,12127,9191,24976
320330,202307,3631,8706,2573,6852,410,1090,1419,3709,1829,4799
320332,202307,11182,26137,7892,20002,1675,4375,4089,9615,5764,13990
320334,202307,2616,6596,1495,4290,235,793,350,728,585,1521
320335,202307,2413,6351,1378,4025,296,982,426,1065,722,2047
320340,202307,7471,15423,5305,11873,447,1040,3709,7851,4156,8891
320350,202307,6693,14581,4149,9880,512,1377,2296,4906,2808,6283
320360,202307,1721,4061,1053,2749,140,390,526,1230,666,1620
320370,202307,3771,10145,2660,7729,681,2218,958,2482,1639,4700
320380,202307,4042,8744,2984,6758,213,586,2158,4392,2371,4978
320390,202307,10463,24763,6629,16913,1420,3844,2654,6106,4074,9950
320400,202307,4074,10577,2618,7497,794,2429,881,2309,1675,4738
320405,202307,6786,15705,4342,11096,630,1678,2301,5436,2931,7114
320410,202307,5894,14187,3924,10602,773,2080,1724,4519,2497,6599
320420,202307,5701,12549,3844,9347,890,2327,1566,3542,2456,5869
320425,202307,2720,5738,1839,4214,129,323,1255,2620,1384,2943
320430,202307,3955,9199,2644,6713,360,937,1519,3591,1879,4528
320435,202307,3128,8730,2330,7017,830,2714,625,1832,1455,4546
320440,202307,1925,4802,1221,3380,220,696,526,1224,746,1920
320450,202307,2798,6706,2024,5215,302,988,1159,2556,1461,3544
320455,202307,5899,16471,3555,11030,883,3029,868,2211,1751,5240
320460,202307,2656,7234,1649,4985,477,1562,424,1087,901,2649
320465,202307,2081,5343,1256,3632,317,964,475,1321,792,2285
320470,202307,5687,13757,3655,9690,723,2078,1210,2756,1933,4834
320480,202307,3457,7289,2361,5393,305,695,1479,3082,1784,3777
320490,202307,34769,78198,21488,53352,4150,10087,9414,22572,13564,32659
320495,202307,1824,4548,1176,3224,286,891,174,309,460,1200
320500,202307,93676,216030,65649,163242,8165,22322,37946,84963,46111,107285
320501,202307,6344,16466,3770,11088,983,2980,868,2313,1851,5293
320503,202307,3370,8791,1984,5867,573,1862,527,1314,1100,3176
320506,202307,3758,10081,2327,6685,670,2053,635,1528,1305,3581
320510,202307,16296,38534,10783,27959,1985,5108,4860,11875,6845,16983
320515,202307,2345,5896,1483,4048,444,1282,445,1099,889,2381
320517,202307,2977,7891,2173,6210,624,1939,835,2281,1459,4220
320520,202307,65464,147512,44172,108427,6592,17458,21955,48616,28547,66074
320530,202307,48367,108426,33190,79992,2614,7600,21296,44912,23910,52512
330010,202307,38260,83056,28316,65364,2233,5814,20158,42995,22391,48809
330015,202307,2417,5001,1682,3765,223,572,998,2000,1221,2572
330020,202307,32246,68167,24814,56413,2363,6130,17931,38154,20294,44284
330022,202307,2612,6447,1653,4645,324,958,619,1618,943,2576
330023,202307,10028,20995,7129,16261,975,2507,4325,8886,5300,11393
330025,202307,10527,21149,6660,14774,976,2454,3546,7047,4522,9501
330030,202307,16195,35683,11384,27406,1003,2757,7477,16155,8480,18912
330040,202307,26279,57990,19270,45225,970,2850,14228,30432,15198,33282
330045,202307,148299,278887,116540,235334,5620,12524,96572,186956,102192,199480
330050,202307,4976,10907,3664,8680,535,1551,2281,4715,2816,6266
330060,202307,8713,19012,5572,13494,998,2744,2204,4655,3202,7399
330070,202307,46728,96948,35969,80623,4143,9868,23958,51183,28101,61051
330080,202307,15120,30616,11661,25242,1444,3094,8042,16698,9486,19792
330090,202307,4562,8473,3040,6284,270,439,2046,4217,2316,4656
330093,202307,4216,8656,2780,6375,159,461,2124,4503,2283,4964
330095,202307,2084,4959,1335,3476,118,336,789,1847,907,2183
330100,202307,108414,235239,87801,201683,5170,13075,67520,146374,72690,159449
330110,202307,3347,7749,2565,6352,234,682,1726,3865,1960,4547
330115,202307,4037,8426,2475,5801,412,1050,1365,2783,1777,3833
330120,202307,4830,9196,3307,7056,158,391,2539,5032,2697,5423
330130,202307,8197,18693,6171,15332,788,2031,3851,8937,4639,10968
330140,202307,6262,12236,4842,10193,215,610,3958,7757,4173,8367
330150,202307,3718,8320,2585,6344,403,1036,1367,3096,1770,4132
330160,202307,2326,5325,1719,4242,256,740,979,2098,1235,2838
330170,202307,238149,453885,187213,380196,20272,43254,137793,267623,158065,310877
330180,202307,3200,6200,2336,4878,73,212,1785,3376,1858,3588
330185,202307,17558,33991,13496,28110,474,1314,10996,21209,11470,22523
330187,202307,8714,17968,6219,13890,836,2066,4051,8299,4887,10365
330190,202307,68808,132390,53911,110059,2553,6186,43266,83072,45819,89258
330200,202307,29075,60211,22211,50154,2591,6170,15656,33720,18247,39890
330205,202307,3053,6710,2017,4894,192,534,1314,2860,1506,3394
330210,202307,4658,10010,3133,7399,416,1038,1653,3454,2069,4492
330220,202307,20901,44217,13596,31256,2217,5606,7045,14186,9262,19792
330225,202307,6463,14058,4540,10883,320,875,2980,6514,3300,7389
330227,202307,29256,57857,23344,49470,614,1758,19948,39776,20562,41534
330230,202307,2508,5293,1447,3597,161,405,675,1613,836,2018
330240,202307,42714,91628,32777,74408,3318,8351,22584,47880,25902,56231
330245,202307,2287,5181,1283,3362,268,780,546,1193,814,1973
330250,202307,72987,144687,58535,122680,5769,12872,43476,86893,49245,99765
330260,202307,10031,19845,7589,16417,437,1175,5943,12110,6380,13285
330270,202307,49209,103835,28348,67794,3597,9368,15097,32808,18694,42176
330280,202307,4168,8648,2923,6543,238,597,1992,4026,2230,4623
330285,202307,46513,87962,35768,71966,1589,4105,29236,54718,30825,58823
330290,202307,6971,13240,5176,10733,335,976,4001,7554,4336,8530
330300,202307,8282,16619,5581,12575,416,995,4071,8721,4487,9716
330310,202307,3842,7851,2655,5877,113,289,2019,4164,2132,4453
330320,202307,27738,54481,19854,43298,2528,5427,13843,28572,16371,33999
330330,202307,79103,148961,58842,119395,4523,9870,44821,85799,49344,95669
330340,202307,29320,60519,19834,44877,2620,7008,11635,23105,14255,30113
330350,202307,257545,476907,203142,403411,9145,20147,171552,325892,180697,346039
330360,202307,11292,22179,8791,18332,374,821,7165,13975,7539,14796
330370,202307,8305,19480,5837,14908,968,2707,2986,6929,3954,9636
330380,202307,10791,22902,7807,17697,449,1284,5737,11872,6186,13156
330385,202307,6423,14880,4816,12228,837,2353,2457,5737,3294,8090
330390,202307,54101,116001,37770,87021,3285,9261,25635,52326,28920,61587
330395,202307,5270,10773,3912,8740,155,494,3030,6249,3185,6743
330400,202307,5164,11490,3966,9449,233,712,2807,5965,3040,6677
330410,202307,4856,10374,3362,7829,350,1006,2327,4893,2677,5899
330411,202307,4066,9657,2760,7098,172,538,1794,4163,1966,4701
330412,202307,2516,5749,1889,4629,151,439,1287,2832,1438,3271
330414,202307,37571,80149,28838,66584,2269,5639,21309,46717,23578,52356
330415,202307,6427,15185,4139,10866,436,1247,2422,5824,2858,7071
330420,202307,18781,41246,12449,29929,1375,3671,7325,15765,8700,19436
330430,202307,16214,30491,12599,25124,511,1168,10267,19207,10778,20375
330440,202307,4411,9782,2840,6840,307,860,1872,4011,2179,4871
330450,202307,2110,5005,1484,3812,112,326,933,2184,1045,2510
330452,202307,31018,65924,23502,53448,1905,5229,17039,35692,18944,40921
330455,202307,1111515,2118335,856112,1738070,84331,184682,616971,1181427,701302,1366109
330460,202307,1741,4047,1239,3215,174,448,646,1621,820,2069
330470,202307,8880,18595,5663,13325,1316,3389,2294,4821,3610,8210
330475,202307,13720,29655,10531,25060,1410,3751,6881,15479,8291,19230
330480,202307,8029,17898,6146,14622,533,1379,4131,9015,4664,10394
330490,202307,178765,350000,133613,281710,11073,24640,98464,196365,109537,221005
330500,202307,12322,25664,9256,20919,584,1493,6884,14697,7468,16190
330510,202307,75955,156044,56791,127528,4852,12036,41783,87726,46635,99762
330513,202307,1845,4050,1306,3194,195,513,701,1586,896,2099
330515,202307,3980,9179,2878,7352,477,1347,1339,3043,1816,4390
330520,202307,21832,46685,16951,38790,1557,4126,11623,24647,13180,28773
330530,202307,2263,4899,1464,3575,264,697,701,1637,965,2334
330540,202307,4441,10091,3083,7640,597,1527,1567,3618,2164,5145
330550,202307,30596,59145,20289,43557,2636,6135,12516,25068,15152,31203
330555,202307,32174,55192,25110,46039,909,1968,21258,37613,22167,39581
330560,202307,5830,12725,4348,10308,647,1587,2752,6176,3399,7763
330570,202307,4463,9895,3615,8589,522,1451,2424,5463,2946,6914
330575,202307,9344,19287,7456,16002,330,875,6038,11936,6368,12811
330580,202307,35438,76347,26255,59707,3593,8518,16074,33268,19667,41786
330590,202307,2214,4903,1766,4256,242,565,1036,2484,1278,3049
330600,202307,19430,42237,13831,32212,862,2465,9826,20805,10688,23270
330610,202307,14604,31412,11009,25303,1104,2806,7485,15901,8589,18707
330615,202307,3054,6966,2334,5919,393,848,1477,3863,1870,4711
330620,202307,6599,15395,4773,12150,687,1881,2695,6201,3382,8082
330630,202307,46852,97232,31452,70634,1547,4501,22995,46581,24542,51082
350010,202307,3116,7406,1604,4180,278,776,406,839,684,1615
350020,202307,839,2062,425,1184,62,170,162,377,224,547
350030,202307,5075,12350,3487,9256,723,2079,1746,4111,2469,6190
350040,202307,977,2566,518,1556,80,269,166,368,246,637
350050,202307,2009,4524,1143,2950,191,564,354,673,545,1237
350055,202307,1263,2794,864,2070,110,273,510,1070,620,1343
350060,202307,434,947,183,452,40,101,70,152,110,253
350070,202307,4535,10826,2807,7477,454,1319,1164,2612,1618,3931
350075,202307,873,2242,517,1498,137,375,84,235,221,610
350080,202307,874,2127,484,1310,54,177,249,564,303,741
350090,202307,809,1627,467,1054,57,153,298,593,355,746
350100,202307,3459,7917,2131,5367,122,360,1438,3198,1560,3558
350110,202307,675,1461,433,1005,15,48,316,665,331,713
350115,202307,1410,3842,953,2756,149,456,413,1061,562,1517
350120,202307,709,1569,357,931,43,114,179,425,222,539
350130,202307,4539,10807,3034,7699,364,1020,1759,3942,2123,4962
350140,202307,904,2251,493,1382,38,118,283,703,321,821
350150,202307,591,1643,328,996,78,258,101,234,179,492
350160,202307,16831,39239,10509,26365,1400,3852,6010,13432,7410,17284
350170,202307,3939,9566,2739,6794,484,1259,1459,3130,1943,4389
350180,202307,1260,2780,686,1682,80,208,394,855,474,1063
350190,202307,5176,13126,3285,8547,403,1245,1850,3968,2253,5213
350200,202307,725,1687,484,1208,46,113,292,677,338,790
350210,202307,8879,18523,5537,12708,406,1160,3769,7645,4175,8805
350220,202307,4208,10434,2513,6751,460,1338,1145,2567,1605,3905
350230,202307,1534,3396,1021,2586,129,384,604,1369,733,1753
350240,202307,801,2107,394,1162,88,259,88,216,176,475
350250,202307,4869,11960,3138,8666,797,2229,872,2251,1669,4480
350260,202307,1080,2357,559,1427,80,210,281,651,361,861
350270,202307,5774,13604,3984,10090,550,1481,2199,4992,2749,6473
350275,202307,4148,9534,2991,7396,171,530,2147,4801,2318,5331
350280,202307,25319,53771,14788,35098,2060,5192,7619,15991,9679,21183
350290,202307,4690,11680,2970,7985,566,1616,1262,2903,1828,4519
350300,202307,1037,2238,621,1462,84,234,422,899,506,1133
350310,202307,1276,3239,786,2162,109,327,372,873,481,1200
350315,202307,877,1898,482,1207,24,83,289,623,313,706
350320,202307,23641,55307,15426,38937,2596,7227,7654,16520,10250,23747
350330,202307,18693,41542,11813,28007,1115,3064,7756,16497,8871,19561
350335,202307,467,1223,279,819,34,100,120,336,154,436
350340,202307,1744,4212,958,2549,134,411,461,1037,595,1448
350350,202307,909,2109,650,1704,97,217,358,907,455,1124
350360,202307,1571,3997,1009,2701,158,419,452,1082,610,1501
350370,202307,942,2118,595,1406,167,383,230,481,397,864
350380,202307,6596,16740,3828,10441,823,2372,1378,3263,2201,5635
350390,202307,15850,36633,10571,26411,1423,4003,6321,14198,7744,18201
350395,202307,500,1195,199,582,22,69,74,191,96,260
350400,202307,11679,26741,7209,18311,1873,5052,2310,5260,4183,10312
350410,202307,14786,37490,9362,26363,1870,5612,3452,8772,5322,14384
350420,202307,1604,3795,930,2399,186,482,294,615,480,1097
350430,202307,858,2068,615,1638,102,311,302,701,404,1012
350440,202307,2809,6260,1903,4561,212,579,1246,2714,1458,3293
350450,202307,9979,24914,6859,18800,1443,4306,3102,7439,4545,11745
350460,202307,3259,7680,1837,4899,290,845,873,2022,1163,2867
350470,202307,341,757,225,550,10,31,169,381,179,412
350480,202307,1174,2785,689,1879,180,561,137,292,317,853
350490,202307,2725,6103,1706,4281,240,687,885,1846,1125,2533
350500,202307,807,2006,514,1436,91,281,192,469,283,750
350510,202307,1605,3608,1064,2565,120,304,652,1416,772,1720
350520,202307,3270,8666,2221,6434,326,1024,1051,2725,1377,3749
350530,202307,4174,9545,2670,6438,202,592,1686,3564,1888,4156
350535,202307,1963,4674,1446,3748,200,560,918,2242,1118,2802
350540,202307,2599,5255,1795,3992,234,671,1239,2409,1473,3080
350550,202307,13562,30330,8576,21166,936,2640,4806,10325,5742,12965
350560,202307,6373,14129,4707,11055,183,555,3616,7852,3799,8407
350570,202307,43870,106672,30343,79136,5008,13910,15055,34873,20063,48783
350580,202307,2866,6886,1492,4031,396,1096,351,696,747,1792
350590,202307,7085,17083,4671,11769,666,1929,2768,6128,3434,8057
350600,202307,45181,99467,25344,63141,4302,11686,11212,24154,15514,35840
350610,202307,9847,24046,6219,16390,688,2034,3547,8137,4235,10171
350620,202307,511,1221,268,729,29,72,150,372,179,444
350630,202307,2354,4970,1470,3386,93,258,1021,2132,1114,2390
350635,202307,15936,33594,11087,25403,1091,2741,7747,16438,8838,19179
350640,202307,1134,2864,513,1496,88,266,143,347,231,613
350650,202307,11693,28528,7287,19278,1357,3831,3027,6914,4384,10745
350660,202307,6557,14939,4576,11443,695,1665,2664,6358,3359,8023
350670,202307,2453,6035,1580,4344,268,763,780,1954,1048,2717
350680,202307,1579,3812,968,2598,132,386,494,1169,626,1555
350690,202307,1947,4631,1223,3274,209,597,569,1365,778,1962
350700,202307,7243,16327,4904,12187,1086,2982,2456,5328,3542,8310
350710,202307,4230,9818,2929,7305,511,1444,1548,3394,2059,4838
350715,202307,904,2412,669,1915,127,409,318,742,445,1151
350720,202307,216,500,115,302,17,50,40,86,57,136
350730,202307,828,2237,499,1492,48,158,265,679,313,837
350740,202307,2093,5066,1259,3322,215,612,451,1019,666,1631
350745,202307,790,1917,372,1024,26,86,208,501,234,587
350750,202307,16318,38356,11370,28814,1944,5449,5228,11622,7172,17071
350760,202307,24993,54210,15923,37310,2038,5608,8951,18048,10989,23656
350770,202307,1353,2991,786,1969,81,220,508,1147,589,1367
350775,202307,938,1964,508,1214,69,182,273,600,342,782
350780,202307,3057,6848,2010,5198,539,1340,727,1958,1266,3298
350790,202307,2579,6368,1427,4070,346,1004,334,751,680,1755
350800,202307,4708,11761,3519,9435,483,1310,2067,5092,2550,6402
350810,202307,3762,8234,2450,5972,562,1432,1111,2484,1673,3916
350820,202307,1230,2632,664,1568,58,167,410,849,468,1016
350830,202307,1110,2695,565,1520,105,289,202,435,307,724
350840,202307,4556,12444,2951,8868,578,1895,1126,2900,1704,4795
350850,202307,11474,28075,8022,21231,1324,3736,4184,10082,5508,13818
350860,202307,5381,12167,4136,10080,487,1261,2641,6010,3128,7271
350870,202307,3500,8683,2237,6386,456,1325,941,2493,1397,3818
350880,202307,2188,5322,1534,3947,393,1051,682,1467,1075,2518
350890,202307,646,1580,303,798,66,177,112,247,178,424
350900,202307,13326,31546,8303,20743,1267,3395,4485,9963,5752,13358
350910,202307,1243,2616,901,2029,96,196,620,1333,716,1529
350920,202307,17421,39788,12162,29772,857,2346,8337,18680,9194,21026
350925,202307,5855,13839,3936,10291,611,1788,2118,4722,2729,6510
350930,202307,1878,4480,981,2570,67,173,572,1380,639,1553
350940,202307,3728,8319,2708,6540,278,778,1821,3945,2099,4723
350945,202307,1266,3182,802,2195,161,448,330,793,491,1241
350950,202307,138500,315358,91996,222849,11901,31329,53499,116630,65400,147959
350960,202307,10272,24196,6832,17216,1053,2955,3488,7631,4541,10586
350970,202307,5227,13204,3047,8335,754,2354,1028,2120,1782,4474
350980,202307,1022,2347,773,1880,104,287,479,1055,583,1342
350990,202307,2931,6787,2118,5384,490,1434,1089,2459,1579,3893
350995,202307,1140,3075,871,2427,54,189,577,1455,631,1644
351000,202307,3887,10001,2138,6130,437,1356,537,1332,974,2688
351010,202307,529,1245,283,763,54,156,119,297,173,453
351015,202307,1318,3518,833,2335,147,456,369,881,516,1337
351020,202307,10983,26293,7087,18520,1378,3653,3246,7427,4624,11080
351030,202307,4174,11036,2867,8160,608,1882,1231,3085,1839,4967
351040,202307,7868,16537,5534,12490,381,1025,4038,8206,4419,9231
351050,202307,24233,54573,16296,40689,2850,7578,8443,19139,11293,26717
351060,202307,69202,155149,46197,112693,4436,12250,29946,67123,34382,79373
351070,202307,1974,4522,998,2756,273,786,186,428,459,1214
351080,202307,3780,8228,2524,6267,312,826,1460,3248,1772,4074
351090,202307,447,1095,299,819,55,143,129,318,184,461
351100,202307,3762,9144,2000,5361,325,947,802,1922,1127,2869
351110,202307,7745,18571,5024,13315,907,2598,2323,5450,3230,8048
351120,202307,1027,2427,579,1495,106,316,213,450,319,766
351130,202307,1550,4025,595,1779,112,353,130,331,242,684
351140,202307,2982,7450,1918,5274,408,1210,731,1677,1139,2887
351150,202307,3686,9615,2150,6197,389,1218,604,1475,993,2693
351160,202307,1941,5384,1169,3563,199,624,186,438,385,1062
351170,202307,2207,5143,1672,4103,127,385,1148,2534,1275,2919
351190,202307,1272,3274,735,2090,178,529,194,497,372,1026
351200,202307,1974,4580,1254,3266,156,446,610,1338,766,1784
351210,202307,1920,4279,1105,2723,77,223,733,1635,810,1858
351220,202307,5133,11867,3738,9240,483,1174,2336,5426,2819,6600
351230,202307,3026,6994,1989,5019,348,966,935,1997,1283,2963
351240,202307,3011,7503,1401,3879,283,807,206,398,489,1205
351250,202307,1300,3289,600,1719,97,277,225,579,322,856
351260,202307,1027,2340,633,1606,125,317,246,558,371,875
351270,202307,690,1705,406,1093,50,152,198,415,248,567
351280,202307,5151,12514,3296,8609,767,2111,1153,2709,1920,4820
351290,202307,1987,4263,1149,2725,86,253,829,1814,915,2067
351300,202307,31809,76733,20835,55080,3762,10597,9835,23366,13597,33963
351310,202307,5293,11511,3513,8234,270,696,2376,5014,2646,5710
351320,202307,1033,2787,617,1894,96,290,154,406,250,696
351330,202307,373,918,182,512,16,47,77,179,93,226
351340,202307,11231,24988,8689,20103,1578,4136,5262,10556,6840,14692
351350,202307,18508,41150,12970,30376,1134,3011,9168,19477,10302,22488
351360,202307,5209,11988,3899,9744,732,2035,1978,4315,2710,6350
351370,202307,2625,6781,1456,4209,341,1071,305,662,646,1733
351380,202307,63349,137493,38786,92113,4085,10546,24185,52574,28270,63120
351385,202307,479,1194,160,462,32,90,62,151,94,241
351390,202307,1885,4218,1192,3169,72,226,880,2175,952,2401
351400,202307,1574,3870,1037,2686,232,550,480,1183,712,1733
351410,202307,3505,8703,2230,6033,443,1249,900,2188,1343,3437
351420,202307,627,1413,328,839,68,161,174,416,242,577
351430,202307,1334,3060,880,2145,100,261,558,1212,658,1473
351440,202307,4896,11587,2811,7134,490,1304,1064,2199,1554,3503
351450,202307,2280,5461,1231,3318,231,745,431,904,662,1649
351460,202307,1374,3179,913,2319,166,427,524,1221,690,1648
351470,202307,1576,3642,1000,2517,80,209,635,1460,715,1669
351480,202307,3150,8081,2181,6224,382,1138,993,2533,1375,3671
351490,202307,3015,7423,2165,5689,94,308,1568,3812,1662,4120
351492,202307,489,1142,343,827,17,52,257,565,274,617
351495,202307,295,726,185,493,19,39,107,257,126,296
351500,202307,60983,129843,41229,94763,5638,13947,26217,54899,31855,68846
351510,202307,18721,40363,12286,28623,1383,3660,7857,16869,9240,20529
351512,202307,589,1477,338,910,60,161,106,236,166,397
351515,202307,4132,9204,2155,5426,452,1234,525,1222,977,2456
351518,202307,2562,6271,1523,4198,266,778,582,1326,848,2104
351519,202307,797,2039,372,1116,80,255,83,199,163,454
351520,202307,1362,3159,576,1606,73,224,276,670,349,894
351530,202307,439,1050,225,587,38,106,93,178,131,284
351535,202307,2073,4832,1276,3322,220,618,565,1347,785,1965
351540,202307,3540,7838,2134,5255,251,733,1138,2394,1389,3127
351550,202307,9887,22471,5788,14476,851,2209,2945,6511,3796,8720
351560,202307,706,1868,433,1260,73,216,171,440,244,656
351565,202307,360,863,231,610,33,107,119,262,152,369
351570,202307,32339,75136,22270,54649,1908,5371,14712,33063,16620,38434
351580,202307,287,707,139,407,23,71,59,177,82,248
351590,202307,536,1172,239,635,24,79,119,275,143,354
351600,202307,1665,4130,1052,2786,180,460,456,1041,636,1501
351610,202307,858,1888,440,1080,54,109,252,583,306,692
351620,202307,32789,79458,20828,56723,3054,9326,9432,22294,12486,31620
351630,202307,39708,90387,27284,66909,2355,6494,18387,40932,20742,47426
351640,202307,28000,62661,19532,46637,1511,4251,13447,29124,14958,33375
351650,202307,484,1274,188,589,36,119,41,114,77,233
351660,202307,766,2001,470,1341,88,272,128,307,216,579
351670,202307,8098,20191,4327,11464,898,2403,1866,4249,2764,6652
351680,202307,532,1368,320,933,58,167,114,296,172,463
351685,202307,628,1589,390,1077,70,181,156,361,226,542
351690,202307,1512,3583,778,2134,117,387,308,693,425,1080
351700,202307,1793,3974,1114,2705,163,421,649,1387,812,1808
351710,202307,1027,2433,621,1595,51,158,350,782,401,940
351720,202307,1982,4754,1179,3144,206,550,543,1312,749,1862
351730,202307,1341,3015,894,2211,72,176,556,1240,628,1416
351740,202307,4256,9752,3021,7368,402,1055,1747,3819,2149,4874
351750,202307,2537,6164,1332,3638,176,508,666,1594,842,2102
351760,202307,4285,10554,2881,7702,583,1787,1279,2906,1862,4693
351770,202307,2768,6566,2058,5124,513,1258,1046,2412,1559,3670
351780,202307,1371,3183,693,1826,83,230,319,765,402,995
351790,202307,2031,4353,1375,3269,254,580,748,1690,1002,2270
351800,202307,547,1210,239,611,36,108,87,168,123,276
351810,202307,1478,3480,988,2539,262,755,426,944,688,1699
351820,202307,4183,10026,2679,6866,588,1618,1104,2430,1692,4048
351830,202307,6871,15416,4479,10914,357,1037,2936,6321,3293,7358
351840,202307,13079,31861,9176,24197,833,2502,5791,13727,6624,16229
351850,202307,1854,4895,1025,3099,191,646,306,701,497,1347
351860,202307,3625,9317,2447,6866,779,2252,853,2084,1632,4336
351870,202307,40608,92345,29011,71409,5465,13855,14824,34519,20289,48374
351880,202307,237822,517382,163566,381152,22346,61811,101990,210401,124336,272212
351885,202307,1381,3068,996,2397,49,132,743,1666,792,1798
351890,202307,1039,2512,533,1532,101,326,141,342,242,668
351900,202307,1652,4020,1085,2977,113,327,692,1823,805,2150
351905,202307,811,2120,508,1413,58,166,211,503,269,669
351907,202307,31652,74720,20868,53220,2560,7399,12132,27596,14692,34995
351910,202307,2342,5332,1417,3402,149,427,883,1835,1032,2262
351920,202307,1152,2739,757,1934,141,361,297,662,438,1023
351925,202307,1315,3141,873,2240,89,278,506,1143,595,1421
351930,202307,6096,13365,4851,11054,602,1441,3268,6900,3870,8341
351940,202307,1443,3414,919,2406,178,476,366,915,544,1391
351950,202307,2100,4110,1396,3007,70,190,1045,2086,1115,2276
351960,202307,7429,16990,4765,11915,1097,2873,1920,4208,3017,7081
351970,202307,15026,34726,11317,28199,1306,4002,7522,16796,8828,20798
351980,202307,1418,3140,761,1921,138,372,342,744,480,1116
351990,202307,1823,3984,1060,2561,47,143,643,1336,690,1479
352000,202307,3704,8954,2688,6748,253,774,1810,4074,2063,4848
352010,202307,3138,7477,2154,5637,589,1560,571,1420,1160,2980
352020,202307,2275,5331,1572,3992,263,727,824,1884,1087,2611
352030,202307,8355,18619,6018,14418,761,2122,3900,8426,4661,10548
352040,202307,6159,14163,3865,9638,705,1908,1624,3533,2329,5441
352042,202307,5208,11036,3154,7591,361,962,1990,4437,2351,5399
352044,202307,2680,6575,1358,3842,232,723,299,641,531,1364
352050,202307,18395,45066,10348,27986,2911,8340,2268,4633,5179,12973
352060,202307,1021,2427,663,1719,125,359,322,733,447,1092
352070,202307,1197,2382,653,1502,95,227,347,718,442,945
352080,202307,569,1349,250,652,36,99,101,215,137,314
352090,202307,2074,5333,1427,3890,184,585,739,1694,923,2279
352100,202307,5161,13093,3358,9334,691,2043,1359,3373,2050,5416
352110,202307,993,2491,601,1632,118,321,260,614,378,935
352115,202307,626,1600,484,1378,135,435,198,470,333,905
352120,202307,1093,2815,789,2186,70,195,483,1212,553,1407
352130,202307,2462,6505,1345,3705,227,645,607,1449,834,2094
352140,202307,1864,4522,1161,3022,227,601,462,1075,689,1676
352150,202307,1100,2668,736,1972,118,325,425,1074,543,1399
352160,202307,1235,2810,718,1840,73,206,361,854,434,1060
352170,202307,3820,9490,2531,6717,465,1417,1118,2489,1583,3906
352180,202307,3635,9094,2461,6758,479,1402,990,2411,1469,3813
352190,202307,2210,5036,1590,3952,272,690,826,1933,1098,2623
352200,202307,443,1305,266,872,41,134,91,258,132,392
352210,202307,32440,64479,23751,51605,1351,3428,18564,37696,19915,41124
352215,202307,804,1982,563,1531,112,317,270,683,382,1000
352220,202307,39500,83287,26642,59791,3449,8868,17032,33823,20481,42691
352230,202307,20823,53434,13999,39030,3613,10648,4988,11686,8601,22334
352240,202307,14100,33277,9928,25783,2075,5894,4985,11310,7060,17204
352250,202307,35244,88929,25753,70932,3610,10799,15136,38466,18746,49265
352260,202307,6626,15308,3956,9728,722,1925,1843,3772,2565,5697
352265,202307,1129,3015,932,2672,224,684,424,1136,648,1820
352270,202307,2842,7238,2039,5516,393,1114,897,2172,1290,3286
352280,202307,3171,6933,2255,5452,424,1137,1180,2516,1604,3653
352290,202307,2043,5066,1262,3342,180,494,636,1426,816,1920
352300,202307,1206,2863,619,1613,71,207,304,668,375,875
352310,202307,61981,145860,43142,111205,6914,18120,26091,63319,33005,81439
352320,202307,9140,20615,6533,15682,859,2300,3951,8245,4810,10545
352330,202307,3503,7694,2526,6148,230,747,1675,3607,1905,4354
352340,202307,10981,26143,6996,17884,1044,2963,3670,8140,4714,11103
352350,202307,3378,8149,2282,5799,152,459,1517,3475,1669,3934
352360,202307,2063,4791,1436,3580,170,463,854,1850,1024,2313
352370,202307,1337,3368,990,2689,86,276,671,1690,757,1966
352380,202307,1269,2969,779,2001,163,416,279,649,442,1065
352390,202307,19861,45440,12357,30912,1797,5017,6957,15285,8754,20302
352400,202307,5148,13271,3293,9258,765,2249,1018,2398,1783,4647
352410,202307,5122,11366,3479,8343,479,1213,1934,4224,2413,5437
352420,202307,1071,2542,633,1674,109,285,292,671,401,956
352430,202307,11993,25376,7768,17585,950,2408,4637,9465,5587,11873
352440,202307,26315,64596,17127,45441,3894,10474,5927,14451,9821,24925
352450,202307,1021,2417,475,1362,68,228,209,498,277,726
352460,202307,3492,8724,2289,6374,409,1260,1040,2555,1449,3815
352470,202307,3872,9505,2563,6888,276,857,1468,3514,1744,4371
352480,202307,6041,13060,3429,8218,507,1354,1662,3392,2169,4746
352490,202307,1111,2765,701,1892,135,355,285,703,420,1058
352500,202307,15609,36791,8653,22954,2900,8408,1557,2561,4457,10969
352510,202307,6299,14840,4434,11231,515,1406,2889,6786,3404,8192
352520,202307,3788,9354,2496,6865,445,1308,1218,2899,1663,4207
352530,202307,15896,36739,9537,24042,2170,5995,3323,6707,5493,12702
352540,202307,731,1859,481,1316,61,175,256,631,317,806
352550,202307,1445,3505,907,2535,175,596,322,718,497,1314
352560,202307,890,2094,596,1463,37,111,403,876,440,987
352570,202307,2844,7276,1745,5113,455,1472,267,496,722,1968
352580,202307,997,2237,732,1722,104,287,446,934,550,1221
352585,202307,498,1279,268,777,39,130,99,214,138,344
352590,202307,16576,40666,10230,27833,1773,5319,4823,11167,6596,16486
352600,202307,2582,6172,1824,4638,308,871,1054,2346,1362,3217
352610,202307,3940,9258,2731,7107,414,1201,1383,3221,1797,4422
352620,202307,7959,17528,5364,13247,1303,3220,2417,5723,3720,8943
352630,202307,1051,2354,701,1774,116,335,324,736,440,1071
352640,202307,4474,10305,2877,7111,267,706,1726,3760,1993,4466
352650,202307,704,1846,398,1167,68,213,157,405,225,618
352660,202307,1464,3760,1027,2793,70,218,695,1725,765,1943
352670,202307,14069,33336,9056,22865,1722,4618,4282,9421,6004,14039
352680,202307,4460,11820,2923,8222,571,1846,1302,2851,1873,4697
352690,202307,35156,81065,23474,58392,1315,3970,16402,37244,17717,41214
352700,202307,1068,2509,683,1790,96,275,351,820,447,1095
352710,202307,7294,17175,4615,11990,1340,3688,1603,3467,2943,7155
352720,202307,13713,30774,9810,23213,1261,3352,6002,12888,7263,16240
352725,202307,661,1428,310,797,25,77,174,369,199,446
352730,202307,5332,14656,3454,9716,508,1561,1584,3587,2092,5148
352740,202307,3031,6857,1872,4715,259,723,874,1883,1133,2606
352750,202307,530,1233,262,715,30,81,114,255,144,336
352760,202307,1796,4508,1282,3449,182,520,673,1661,855,2181
352770,202307,1198,2851,738,1928,95,258,408,969,503,1227
352780,202307,819,2166,446,1328,116,306,125,349,241,655
352790,202307,511,1232,299,765,52,128,130,282,182,410
352800,202307,1745,4747,974,2911,191,582,217,480,408,1062
352810,202307,2179,4745,1544,3538,153,382,1109,2398,1262,2780
352820,202307,539,1427,326,975,67,208,79,191,146,399
352830,202307,681,1625,278,771,37,102,94,217,131,319
352840,202307,5087,13056,3509,9736,777,2298,1426,3575,2203,5873
352850,202307,17915,38032,11619,27322,1871,4896,6558,13552,8429,18448
352860,202307,1524,3830,920,2544,180,499,338,860,518,1359
352870,202307,1035,2504,610,1584,71,175,347,832,418,1007
352880,202307,2162,4800,1225,2922,218,540,507,1038,725,1578
352885,202307,458,1143,303,824,32,97,181,442,213,539
352890,202307,889,1904,500,1098,48,115,357,691,405,806
352900,202307,25906,61251,15344,39797,2565,6838,6072,14086,8637,20924
352910,202307,463,1140,216,619,10,29,91,219,101,248
352920,202307,3604,8360,2441,6122,145,438,1755,4017,1900,4455
352930,202307,7751,18314,5473,13536,896,2572,2780,5844,3676,8416
352940,202307,37049,88797,26381,66357,3953,10631,15059,34401,19012,45032
352950,202307,699,1774,390,1166,78,248,122,295,200,543
352960,202307,928,2276,451,1219,68,196,158,342,226,538
352965,202307,290,734,159,464,30,81,48,133,78,214
352970,202307,5186,9579,3900,7591,119,305,3263,5949,3382,6254
352980,202307,2019,4387,1402,3414,378,976,663,1448,1041,2424
352990,202307,5826,13483,3973,10143,706,1868,2078,4932,2784,6800
353000,202307,555,1389,271,767,35,109,92,225,127,334
353010,202307,3568,8005,2091,5138,346,941,1010,2129,1356,3070
353020,202307,4040,9649,2170,5833,348,1078,916,2153,1264,3231
353030,202307,6262,14740,3617,9773,880,2542,977,2335,1857,4877
353040,202307,951,2082,613,1487,60,166,401,882,461,1048
353050,202307,6787,17390,4331,12133,733,2255,2121,5277,2854,7532
353060,202307,68646,154299,50652,122122,3551,10334,36404,80235,39955,90569
353070,202307,15216,38142,9534,25185,1651,4745,4459,10160,6110,14905
353080,202307,6814,16315,4270,11097,820,2342,1772,3743,2592,6085
353090,202307,741,2025,481,1446,50,164,244,633,294,797
353100,202307,395,955,150,441,26,82,47,104,73,186
353110,202307,11074,25306,8044,20514,1733,4426,4000,10188,5733,14614
353120,202307,666,1554,444,1134,68,215,222,465,290,680
353130,202307,4049,8833,2316,5520,511,1315,1021,1974,1532,3289
353140,202307,4136,8971,2738,6455,421,1178,1596,3327,2017,4505
353150,202307,2236,5130,1418,3605,278,748,643,1441,921,2189
353160,202307,801,1926,446,1205,54,169,199,431,253,600
353170,202307,900,2055,606,1556,57,176,374,859,431,1035
353180,202307,12968,30030,8373,21131,1918,5207,3483,7701,5401,12908
353190,202307,4664,11149,2960,7491,362,973,1689,3880,2051,4853
353200,202307,2267,5610,1206,3331,161,495,511,1212,672,1707
353205,202307,621,1607,403,1066,42,122,238,545,280,667
353210,202307,1160,2273,654,1431,27,67,502,1009,529,1076
353215,202307,494,1225,315,832,48,144,141,319,189,463
353220,202307,974,2482,523,1473,103,297,180,432,283,729
353230,202307,1087,2775,771,2222,203,649,164,422,367,1071
353240,202307,3370,7893,2493,6345,357,1046,1468,3378,1825,4424
353250,202307,1777,3563,1055,2323,125,315,668,1325,793,1640
353260,202307,1510,3257,774,2024,175,513,307,687,482,1200
353270,202307,1109,2511,779,1847,101,286,473,982,574,1268
353280,202307,958,2331,588,1628,120,339,209,512,329,851
353282,202307,2116,5495,1526,4246,161,508,840,2060,1001,2568
353284,202307,458,1052,215,578,21,73,92,198,113,271
353286,202307,201,506,101,310,22,61,15,42,37,103
353290,202307,1654,4042,748,2050,168,432,205,504,373,936
353300,202307,2890,7087,1733,4584,353,1028,771,1719,1124,2747
353310,202307,503,1125,317,743,22,60,222,468,244,528
353320,202307,821,2034,521,1399,67,195,275,647,342,842
353325,202307,1031,2643,557,1537,85,250,250,587,335,837
353330,202307,818,1875,425,1092,56,142,205,457,261,599
353340,202307,4207,10413,2955,7762,486,1468,1503,3324,1989,4792
353350,202307,5932,13169,3670,8853,994,2595,1068,2175,2062,4770
353360,202307,903,2304,606,1632,49,148,376,900,425,1048
353370,202307,784,2049,558,1630,79,248,305,822,384,1070
353380,202307,402,1001,272,734,36,114,161,368,197,482
353390,202307,8392,19315,5086,12971,484,1435,2924,6543,3408,7978
353400,202307,749,1821,470,1231,72,201,220,445,292,646
353410,202307,689,1637,440,1133,146,369,151,312,297,681
353420,202307,645,1508,389,997,82,236,110,230,192,466
353430,202307,2984,7521,2014,5527,460,1307,803,1970,1263,3277
353440,202307,108560,257424,71752,181801,9442,26534,41837,93649,51279,120183
353450,202307,499,1178,298,804,33,83,139,338,172,421
353460,202307,4242,10556,2382,6567,479,1450,600,1265,1079,2715
353470,202307,12466,29390,7891,20317,1402,3882,3517,7744,4919,11626
353475,202307,2055,4737,1090,2788,158,452,470,1024,628,1476
353480,202307,2068,4687,1407,3444,91,251,979,2180,1070,2431
353490,202307,1400,3294,883,2252,123,351,484,1071,607,1422
353500,202307,1602,3575,1060,2581,231,596,502,1091,733,1687
353510,202307,1346,3442,782,2081,147,413,326,720,473,1133
353520,202307,1347,3240,760,2109,128,372,279,605,407,977
353530,202307,3295,7606,2334,5667,263,739,1501,3253,1764,3992
353540,202307,2904,6900,2026,5273,303,827,1202,2868,1505,3695
353550,202307,8210,18269,5492,13045,803,2032,3281,6967,4084,8999
353560,202307,3083,7495,2117,5772,585,1684,669,1483,1254,3167
353570,202307,822,2065,428,1231,70,209,155,376,225,585
353580,202307,3225,7663,2183,5545,400,989,1163,2754,1563,3743
353590,202307,939,2192,594,1533,99,252,311,737,410,989
353600,202307,1987,4716,1176,3116,178,471,559,1378,737,1849
353610,202307,1082,2878,657,1961,97,299,268,716,365,1015
353620,202307,3827,8950,2381,6308,572,1567,726,1642,1298,3209
353625,202307,808,1849,393,1050,47,160,211,495,258,655
353630,202307,2092,5480,1524,4194,214,629,817,1979,1031,2608
353640,202307,1811,4262,1197,3072,153,380,746,1782,899,2162
353650,202307,9151,22904,5875,15944,885,2605,3041,7315,3926,9920
353657,202307,466,1155,258,720,24,77,111,259,135,336
353660,202307,1744,3364,1141,2495,146,364,774,1571,920,1935
353670,202307,5820,14366,3635,9586,719,2172,1540,3344,2259,5516
353680,202307,930,2155,602,1621,100,295,303,725,403,1020
353690,202307,524,1348,192,575,27,81,43,101,70,182
353700,202307,2930,6673,2028,5077,226,583,1239,2863,1465,3446
353710,202307,5422,11622,3379,7681,586,1392,1851,3577,2437,4969
353715,202307,529,1319,255,715,23,77,120,278,143,355
353720,202307,2504,5995,1693,4509,363,1026,693,1668,1056,2694
353730,202307,6921,15975,4925,12233,686,1946,2884,6372,3570,8318
353740,202307,2873,6850,1879,4899,364,1058,884,1946,1248,3004
353750,202307,1173,3213,712,2223,178,554,119,330,297,884
353760,202307,19888,39542,13853,30701,2712,6521,7421,15228,10133,21749
353770,202307,816,2178,396,1235,53,201,49,112,102,313
353780,202307,9289,21676,6731,16611,1248,3417,3650,8106,4898,11523
353790,202307,3554,9619,2275,6707,539,1712,497,1126,1036,2838
353800,202307,25207,59020,17833,45273,2412,6564,10775,25120,13187,31684
353810,202307,1660,4022,982,2536,182,464,397,950,579,1414
353820,202307,2416,5833,1449,3917,424,1137,378,879,802,2016
353830,202307,777,1798,472,1255,67,205,241,543,308,748
353850,202307,2065,5048,1399,3696,248,687,652,1571,900,2258
353860,202307,3717,8938,2627,6972,592,1819,1127,2431,1719,4250
353870,202307,40018,96298,24925,65022,4231,11691,10928,25053,15159,36744
353880,202307,3983,9724,2901,7560,231,713,1890,4451,2121,5164
353890,202307,4321,8159,2744,5712,198,495,1929,3556,2127,4051
353900,202307,949,2426,566,1560,89,273,215,499,304,772
353910,202307,4241,9760,3115,7711,268,758,2099,4764,2367,5522
353920,202307,2624,6500,1634,4451,462,1381,371,727,833,2108
353930,202307,7374,17416,4792,12286,902,2476,2066,4572,2968,7048
353940,202307,1735,4555,989,2846,176,510,373,918,549,1428
353950,202307,4588,11031,3089,8006,944,2545,856,1974,1800,4519
353960,202307,943,2299,561,1533,125,341,91,219,216,560
353970,202307,894,1857,591,1357,54,143,442,942,496,1085
353980,202307,23793,52290,16332,38492,789,2382,12150,26134,12939,28516
353990,202307,1284,2768,792,1868,122,333,465,983,587,1316
354000,202307,3286,7487,1506,3823,238,669,673,1442,911,2111
354010,202307,421,1011,268,716,43,121,157,394,200,515
354020,202307,5370,12581,3620,8784,812,2149,1576,3371,2388,5520
354025,202307,886,2269,486,1376,92,281,129,294,221,575
354030,202307,647,1392,289,717,43,115,141,306,184,421
354040,202307,969,2043,538,1326,52,144,346,770,398,914
354050,202307,1371,3529,851,2547,178,566,313,865,491,1431
354060,202307,5549,13702,3536,9171,532,1543,1849,4059,2381,5602
354070,202307,5435,12569,3318,8234,567,1480,1390,2920,1957,4400
354075,202307,3777,9338,2778,7453,554,1591,1497,3561,2051,5152
354080,202307,1982,5009,1231,3428,190,565,589,1416,779,1981
354085,202307,525,976,337,678,5,13,259,474,264,487
354090,202307,2269,5564,1719,4366,113,335,1238,2903,1351,3238
354100,202307,33902,82966,23104,63099,4296,12834,11065,27104,15361,39938
354105,202307,1466,3481,873,2331,125,354,435,1009,560,1363
354110,202307,629,1562,383,1070,55,156,176,434,231,590
354120,202307,1844,4531,1052,2796,224,599,376,859,600,1458
354130,202307,7857,18587,4469,11545,1238,3272,1146,2463,2384,5735
354140,202307,25291,58468,15911,39632,2388,6413,8181,17756,10569,24169
354150,202307,3584,7905,2476,5993,638,1524,724,1728,1362,3252
354160,202307,3588,9284,2619,7257,605,1735,1110,2744,1715,4479
354165,202307,948,2460,662,1847,68,230,419,1017,487,1247
354170,202307,2614,6549,1603,4301,310,926,718,1587,1028,2513
354180,202307,582,1516,349,969,43,130,178,424,221,554
354190,202307,1978,5065,1198,3345,82,276,707,1754,789,2030
354200,202307,1165,2656,748,1870,97,264,421,912,518,1176
354210,202307,1412,3338,892,2235,92,250,556,1260,648,1510
354220,202307,4143,9886,2711,6976,544,1463,1088,2460,1632,3923
354230,202307,1033,2340,767,1940,51,155,522,1215,573,1370
354240,202307,2390,6047,1390,3833,273,769,547,1269,820,2038
354250,202307,842,1991,475,1283,118,322,157,381,275,703
354260,202307,12004,27185,8185,20099,1300,3358,3919,8839,5219,12197
354270,202307,1276,3362,871,2422,137,380,429,1030,566,1410
354280,202307,1040,2317,738,1766,44,140,533,1123,577,1263
354290,202307,1271,3544,911,2719,131,408,483,1314,614,1722
354300,202307,4261,11322,3275,9316,863,2493,1260,3238,2123,5731
354310,202307,1052,2658,746,2024,101,317,457,1099,558,1416
354320,202307,1190,2644,657,1668,114,306,311,658,425,964
354323,202307,563,1250,295,741,39,107,158,357,197,464
354325,202307,1689,4797,833,2646,175,565,134,342,309,907
354330,202307,13484,30476,8221,19638,1121,2953,4727,10081,5848,13034
354340,202307,57094,130133,37192,93625,6203,16362,19103,43791,25306,60153
354350,202307,1505,3411,1117,2701,137,401,703,1494,840,1895
354360,202307,823,1810,447,1151,112,285,153,336,265,621
354370,202307,1262,3149,876,2399,149,450,494,1239,643,1689
354380,202307,673,1690,436,1265,59,210,155,368,214,578
354390,202307,20665,45199,12507,29765,1731,4500,6825,14300,8556,18800
354400,202307,2096,6003,1332,4137,239,781,408,1140,647,1921
354410,202307,9553,21394,6302,14805,976,2556,3626,7596,4602,10152
354420,202307,1849,4429,1125,2991,178,506,540,1258,718,1764
354425,202307,3735,8191,2348,5608,391,955,1317,2913,1708,3868
354430,202307,2303,5303,1517,3813,143,424,952,2138,1095,2562
354440,202307,745,1797,363,937,44,124,193,430,237,554
354450,202307,641,1589,308,886,40,123,111,251,151,374
354460,202307,993,2388,588,1622,167,516,153,326,320,842
354470,202307,503,1267,240,655,23,71,100,223,123,294
354480,202307,1792,3756,1039,2446,72,201,700,1476,772,1677
354490,202307,1054,2829,653,1868,144,384,292,761,436,1145
354500,202307,3125,7643,2162,5823,542,1553,757,1813,1299,3366
354510,202307,946,2406,592,1632,76,219,299,682,375,901
354515,202307,562,1487,316,933,60,186,92,220,152,406
354520,202307,11236,27319,7039,18251,963,2797,3881,8706,4844,11503
354530,202307,6996,17037,4613,11961,1172,2991,1806,4244,2978,7235
354540,202307,1609,3868,1004,2661,178,495,449,1081,627,1576
354550,202307,732,1822,474,1295,74,223,227,519,301,742
354560,202307,2791,6251,1316,3371,155,386,722,1679,877,2065
354570,202307,1104,2590,408,1166,72,219,62,162,134,381
354580,202307,11071,27554,6789,18702,995,3005,3418,8351,4413,11356
354600,202307,2711,6656,1759,4718,304,817,889,2174,1193,2991
354610,202307,588,1474,271,777,33,96,121,301,154,397
354620,202307,626,1636,335,1023,32,115,170,461,202,576
354625,202307,394,1045,196,605,17,62,62,144,79,206
354630,202307,3356,8479,2481,6629,788,2121,694,1660,1482,3781
354640,202307,5182,12859,3482,9284,470,1428,1834,4248,2304,5676
354650,202307,1112,2633,683,1695,198,458,301,709,499,1167
354660,202307,4487,9888,2209,5830,301,885,908,2059,1209,2944
354670,202307,1583,3945,1025,2752,213,609,356,799,569,1408
354680,202307,8611,19236,5969,14503,949,2521,3432,7607,4381,10128
354690,202307,682,1907,392,1205,61,187,153,398,214,585
354700,202307,1207,2836,747,1904,102,293,408,933,510,1226
354710,202307,603,1493,329,911,36,90,157,372,193,462
354720,202307,385,855,163,433,58,141,40,89,98,230
354730,202307,15372,39792,10370,29152,1453,4244,5481,13798,6934,18042
354740,202307,393,1010,145,438,36,105,20,45,56,150
354750,202307,3144,7456,1838,4755,285,791,834,1824,1119,2615
354760,202307,2948,6984,1819,4763,346,950,726,1607,1072,2557
354765,202307,433,1085,153,455,16,64,42,94,58,158
354770,202307,3194,7293,2020,4916,427,1169,979,2090,1406,3259
354780,202307,87224,190526,58780,133862,4114,11439,41618,84605,45732,96044
354790,202307,1169,2965,866,2442,86,257,496,1299,582,1556
354800,202307,3575,8453,2177,5744,476,1287,753,1668,1229,2955
354805,202307,1845,3955,1152,2729,79,213,800,1696,879,1909
354810,202307,672,1888,370,1226,72,268,100,267,172,535
354820,202307,1219,3268,781,2364,158,488,227,560,385,1048
354830,202307,684,1527,342,866,72,200,131,267,203,467
354840,202307,1077,2611,530,1412,44,119,294,674,338,793
354850,202307,31576,70298,20914,50727,1744,5043,14152,30570,15896,35613
354860,202307,2060,5051,1190,3305,146,458,511,1220,657,1678
354870,202307,96176,213363,63377,148259,5345,14450,41624,86061,46969,100511
354880,202307,8406,19474,4088,10216,558,1587,1942,3812,2500,5399
354890,202307,25693,56948,17714,41953,2258,5957,10084,21365,12342,27322
354900,202307,480,1116,267,715,82,229,80,178,162,407
354910,202307,8166,19720,4396,12243,926,2754,1360,3119,2286,5873
354920,202307,594,1523,218,648,29,89,57,131,86,220
354925,202307,334,895,152,489,17,60,32,76,49,136
354930,202307,443,1026,226,560,20,52,132,300,152,352
354940,202307,3672,9650,2463,6916,695,2020,955,2256,1650,4276
354950,202307,2011,4497,1355,3305,69,220,967,2119,1036,2339
354960,202307,1071,2604,686,1922,78,268,332,808,410,1076
354970,202307,5815,14170,4010,10789,295,954,2594,6311,2889,7265
354980,202307,48809,106404,30771,73542,3854,10607,18888,39792,22742,50399
354990,202307,108588,240132,68838,164997,4983,14396,45814,97405,50797,111801
354995,202307,4560,8491,3188,6500,161,387,2518,4768,2679,5155
355000,202307,1945,4451,1257,3263,217,625,577,1303,794,1928
355010,202307,5422,13253,3029,8104,930,2406,816,1974,1746,4380
355020,202307,3947,10624,2929,8721,727,2387,982,2473,1709,4860
355030,202307,1823887,4096698,1138678,2717172,165270,429080,624876,1331092,790146,1760172
355040,202307,4811,10263,3358,8057,438,1163,2233,4898,2671,6061
355050,202307,1475,3166,940,2268,224,542,374,834,598,1376
355060,202307,9317,22641,6120,16217,1002,2887,3109,7218,4111,10105
355070,202307,15146,33916,10812,25885,1254,3386,6827,14629,8081,18015
355080,202307,1263,3301,667,2064,166,508,112,293,278,801
355090,202307,1807,4408,1237,3286,197,529,657,1525,854,2054
355100,202307,45143,101051,34629,82724,3334,8915,24528,54080,27862,62995
355110,202307,1294,3241,784,2310,149,453,52,138,201,591
355120,202307,915,2198,529,1499,76,231,254,624,330,855
355130,202307,1115,2203,517,1081,15,45,397,755,412,800
355140,202307,3026,5551,2341,4566,94,229,1948,3548,2042,3777
355150,202307,6769,15546,4819,11810,604,1607,2932,6585,3536,8192
355160,202307,3215,7919,1925,5369,421,1212,559,1332,980,2544
355170,202307,16653,37620,11240,27408,1772,4734,6367,14066,8139,18800
355180,202307,3763,8555,2538,6529,565,1609,1201,2751,1766,4360
355190,202307,2435,5967,1549,4223,584,1613,343,954,927,2567
355200,202307,1172,3165,875,2607,234,780,313,809,547,1589
355210,202307,4264,10370,2725,7124,754,1929,956,2264,1710,4193
355220,202307,74472,172964,52086,126870,6390,17892,31160,66899,37550,84791
355230,202307,1578,3770,679,1816,125,383,283,598,408,981
355240,202307,33703,80954,21052,54621,2370,6824,12686,29614,15056,36438
355250,202307,56258,133714,37718,95267,8755,22528,17966,41481,26721,64009
355255,202307,826,1909,357,963,40,120,157,342,197,462
355260,202307,2027,4294,1264,2930,106,308,888,1850,994,2158
355270,202307,1648,4331,1130,3203,289,783,428,1118,717,1901
355280,202307,44898,101584,28111,68648,3612,9590,15906,34985,19518,44575
355290,202307,1217,2957,795,2114,177,462,361,854,538,1316
355300,202307,1863,4828,1333,3705,225,658,582,1377,807,2035
355310,202307,1177,2918,757,2070,105,313,397,994,502,1307
355320,202307,709,1751,426,1133,87,253,165,335,252,588
355330,202307,4109,9309,2722,6618,130,389,2027,4502,2157,4891
355340,202307,5302,11089,3312,7772,633,1485,1412,3347,2045,4832
355350,202307,1839,4671,1235,3423,232,720,571,1389,803,2109
355360,202307,1650,3781,1081,2773,166,462,573,1259,739,1721
355365,202307,431,990,185,520,31,85,65,149,96,234
355370,202307,7536,17265,5052,12777,1032,2331,2455,6118,3487,8449
355380,202307,3901,9432,2595,6856,462,1321,973,2136,1435,3457
355385,202307,1782,4225,1186,3018,114,322,689,1548,803,1870
355390,202307,974,2445,614,1638,103,283,290,645,393,928
355395,202307,2249,6035,1227,3631,212,681,486,1199,698,1880
355400,202307,13305,33685,9272,24906,1825,5381,4110,9290,5935,14671
355410,202307,32715,81814,20270,55358,3847,11289,8479,20416,12326,31705
355420,202307,749,2176,535,1687,112,382,157,431,269,813
355430,202307,4717,10964,3069,7647,511,1401,1688,3885,2199,5286
355440,202307,878,2177,465,1286,94,279,134,312,228,591
355450,202307,4864,11373,2712,6879,353,964,1380,2897,1733,3861
355460,202307,598,1377,355,931,41,127,160,365,201,492
355465,202307,573,1344,395,1030,57,151,224,536,281,687
355470,202307,1464,3438,726,1945,210,613,263,624,473,1237
355475,202307,444,959,290,691,15,35,194,421,209,456
355480,202307,5530,14010,3935,11104,592,1828,2230,5799,2822,7627
355490,202307,1118,2833,521,1548,67,224,219,548,286,772
355495,202307,1256,3026,775,2150,98,324,374,840,472,1164
355500,202307,9284,21453,5193,13118,681,1960,2478,5353,3159,7313
355510,202307,1815,4186,1032,2670,169,462,481,1071,650,1533
355520,202307,382,868,172,497,29,83,31,73,60,156
355530,202307,380,814,150,377,14,42,89,194,103,236
355535,202307,684,1698,471,1283,95,305,212,453,307,758
355540,202307,18203,39440,13780,32334,1365,3513,9517,20710,10882,24223
355550,202307,813,2172,598,1740,71,239,344,885,415,1124
355560,202307,1439,3505,685,1964,162,501,35,103,197,604
355570,202307,383,923,176,489,36,83,66,157,102,240
355580,202307,1486,3407,702,1895,124,339,137,332,261,671
355590,202307,202,501,136,380,13,36,73,180,86,216
355600,202307,1720,4068,1007,2696,137,400,293,649,430,1049
355610,202307,2659,6056,1519,3865,304,789,703,1576,1007,2365
355620,202307,6684,16049,4204,10831,501,1569,2374,5246,2875,6815
355630,202307,3431,8365,2162,5749,278,799,1276,3054,1554,3853
355635,202307,1341,3484,771,2190,106,324,301,731,407,1055
355640,202307,4656,11818,2716,7799,757,2166,437,1261,1194,3427
355645,202307,4743,12204,2932,8495,424,1336,1382,3568,1806,4904
355650,202307,11033,26205,7388,18763,1313,3472,3624,8187,4937,11659
355660,202307,1644,4208,813,2487,155,464,133,343,288,807
355670,202307,6108,14636,3634,9130,475,1395,1859,3884,2334,5279
355680,202307,3156,8278,1271,3795,348,1115,116,303,464,1418
355690,202307,934,2549,547,1700,190,592,15,34,205,626
355695,202307,321,820,169,494,16,49,35,71,51,120
355700,202307,12069,29756,8768,22384,1054,3018,5157,11680,6211,14698
355710,202307,13440,29563,7903,18490,1180,3104,4136,8194,5316,11298
355715,202307,609,1543,293,825,74,201,85,205,159,406
355720,202307,1933,4719,1329,3516,235,641,692,1633,927,2274
355730,202307,1404,3428,922,2445,87,263,534,1271,621,1534
410010,202307,1491,3886,940,2642,212,594,218,536,430,1130
410020,202307,1436,3720,933,2612,269,746,236,577,505,1323
410030,202307,2178,5273,1551,4130,242,686,817,2073,1059,2759
410040,202307,19509,48740,12013,33315,2500,7256,3706,9073,6206,16329
410045,202307,886,2252,542,1501,123,350,137,325,260,675
410050,202307,2619,6454,1522,4253,241,747,456,1077,697,1824
410060,202307,2560,6602,1729,4900,444,1404,533,1292,977,2696
410070,202307,2454,5778,1334,3489,240,643,498,1097,738,1740
410080,202307,1694,4217,1054,2968,257,751,241,572,498,1323
410090,202307,1427,3132,947,2267,245,559,313,813,558,1372
410100,202307,2608,6821,1287,3706,213,668,93,244,306,912
410105,202307,713,1615,371,950,32,82,198,422,230,504
410110,202307,3940,8768,2499,6082,356,946,1437,3137,1793,4083
410115,202307,667,1622,400,1080,53,168,148,298,201,466
410120,202307,4227,9702,3283,8017,684,1434,1855,4414,2539,5848
410130,202307,1677,3963,1293,3177,161,427,796,1831,957,2258
410140,202307,22465,50829,12129,30908,2459,6559,4121,9186,6580,15745
410150,202307,19763,44255,9021,22811,1534,4293,3278,6860,4812,11153
410160,202307,3730,9713,2482,6999,558,1718,906,2277,1464,3995
410165,202307,753,1925,533,1415,80,244,247,582,327,826
410170,202307,3688,8871,1705,4488,342,918,406,914,748,1832
410180,202307,22913,57763,14335,38659,2588,7508,6576,15235,9164,22743
410185,202307,578,1536,362,1036,63,197,149,355,212,552
410190,202307,2743,6459,1546,4044,330,860,322,710,652,1570
410200,202307,7212,15351,3316,8355,775,2059,612,1254,1387,3313
410210,202307,3822,9119,2005,5588,333,1035,638,1422,971,2457
410220,202307,779,1893,371,954,79,203,131,290,210,493
410230,202307,2643,6433,1555,4062,242,703,672,1449,914,2152
410240,202307,6280,15558,3449,9567,750,2482,624,1420,1374,3902
410250,202307,2848,6437,1684,4261,225,584,775,1802,1000,2386
410260,202307,2518,5708,1376,3529,281,767,652,1446,933,2213
410270,202307,625,1524,337,914,50,153,160,356,210,509
410275,202307,729,1893,391,1152,80,262,158,409,238,671
410280,202307,2885,7062,1588,4353,226,678,710,1629,936,2307
410290,202307,4045,10369,2384,6808,957,2671,494,1359,1451,4030
410300,202307,837,1922,556,1382,67,206,288,591,355,797
410302,202307,403,946,205,575,34,102,90,225,124,327
410304,202307,1850,4012,1360,3139,175,430,773,1738,948,2168
410305,202307,2138,4741,1335,3408,183,530,820,1913,1003,2443
410310,202307,4091,9290,2799,6784,203,646,1930,4181,2133,4827
410315,202307,860,1864,490,1217,121,312,160,359,281,671
410320,202307,1131,3015,573,1725,73,238,98,251,171,489
410322,202307,754,1932,291,838,33,93,95,209,128,302
410330,202307,1755,4057,997,2575,189,477,325,729,514,1206
410335,202307,1031,2578,612,1689,122,355,183,422,305,777
410337,202307,984,2315,506,1292,73,189,192,416,265,605
410340,202307,555,1439,293,771,23,75,152,301,175,376
410345,202307,3478,8538,1671,4483,426,1133,618,1450,1044,2583
410347,202307,955,2307,538,1454,93,250,132,325,225,575
410350,202307,2029,4628,1183,3056,109,334,669,1487,778,1821
410360,202307,4809,11612,2857,7682,563,1584,797,1921,1360,3505
410370,202307,18405,45881,9470,24448,1244,3616,4252,8940,5496,12556
410380,202307,2198,5031,1136,2899,173,500,371,809,544,1309
410390,202307,3526,7744,2060,5114,395,1170,874,1769,1269,2939
410395,202307,1089,2880,742,2158,157,432,250,729,407,1161
410400,202307,10343,23325,6483,15689,668,1880,4025,8577,4693,10457
410405,202307,1141,2478,661,1683,82,253,329,751,411,1004
410410,202307,2028,4776,1496,3780,131,363,958,2314,1089,2677
410420,202307,16281,39488,10130,26469,1730,4860,4506,10034,6236,14894
410425,202307,4902,12275,2944,8115,532,1532,1036,2492,1568,4024
410430,202307,16991,39037,9567,24118,1499,4127,3913,8616,5412,12743
410440,202307,3042,7761,2336,6314,429,1168,1185,2951,1614,4119
410442,202307,3156,8454,2061,5937,550,1616,482,1253,1032,2869
410445,202307,2757,7227,1593,4807,358,1197,187,561,545,1758
410450,202307,1999,4612,1184,3142,218,592,336,768,554,1360
410460,202307,3262,7296,1943,4765,295,778,962,2027,1257,2805
410465,202307,3778,9924,2206,6342,549,1592,526,1228,1075,2820
410470,202307,3031,7696,1864,5453,641,2103,131,344,772,2447
410480,202307,52839,118494,24658,65514,3928,11350,7884,17549,11812,28899
410490,202307,15031,37529,9114,24439,1601,4632,4367,10189,5968,14821
410500,202307,2257,5429,1181,3237,245,654,201,429,446,1083
410510,202307,2201,5099,1208,3129,283,696,388,957,671,1653
410520,202307,3866,10712,3111,9102,983,3074,1189,3218,2172,6292
410530,202307,1841,4328,659,1754,87,264,191,402,278,666
410540,202307,3548,8694,2057,5560,383,1116,899,2091,1282,3207
410550,202307,9605,23972,5389,14537,906,2672,1717,3638,2623,6310
410560,202307,1863,4507,1062,2793,205,614,271,565,476,1179
410570,202307,3396,8329,2018,5670,740,2341,194,453,934,2794
410580,202307,37467,87892,24259,62283,3904,10825,11710,26696,15614,37521
410590,202307,2125,5467,1224,3350,189,546,341,726,530,1272
410600,202307,2278,5425,1549,4004,314,825,649,1531,963,2356
410610,202307,863,2043,530,1369,50,141,276,627,326,768
410620,202307,3731,9092,2334,6086,575,1575,740,1720,1315,3295
410630,202307,3051,7299,1641,4340,329,1045,344,607,673,1652
410640,202307,6474,14127,3599,8753,870,2260,672,1527,1542,3787
410645,202307,1768,3995,1285,3262,123,351,886,2114,1009,2465
410650,202307,3320,8251,1758,4824,384,1053,677,1607,1061,2660
410655,202307,1056,2415,552,1403,110,302,209,453,319,755
410657,202307,717,1820,387,1069,62,204,186,407,248,611
410660,202307,4680,10769,2310,5778,367,975,892,1883,1259,2858
410670,202307,1209,2877,583,1555,92,266,207,465,299,731
410680,202307,2976,8248,1875,5593,530,1569,476,1372,1006,2941
410685,202307,647,1574,400,1096,103,303,157,377,260,680
410690,202307,184310,416703,106523,261965,17173,46724,45747,94410,62920,141134
410700,202307,3023,7193,2011,5212,492,1308,697,1607,1189,2915
410710,202307,1113,2651,569,1542,144,416,207,458,351,874
410712,202307,811,2042,532,1462,101,285,259,670,360,955
410715,202307,1076,2839,568,1676,71,243,246,644,317,887
410720,202307,4979,11403,3274,8057,497,1503,1266,2755,1763,4258
410725,202307,1443,3321,714,1906,169,473,176,393,345,866
410730,202307,1112,2615,583,1530,104,325,125,287,229,612
410740,202307,1041,2714,578,1687,49,163,318,884,367,1047
410750,202307,2457,5516,1544,3728,249,646,696,1529,945,2175
410752,202307,485,1119,201,547,81,203,27,63,108,266
410753,202307,432,1153,224,677,38,110,69,171,107,281
410754,202307,1425,3233,961,2441,82,233,667,1605,749,1838
410755,202307,664,1613,396,1057,48,149,189,428,237,577
410760,202307,4430,10794,2666,7322,744,2435,642,1501,1386,3936
410765,202307,24610,60344,15940,41997,3254,9420,5605,12233,8859,21653
410770,202307,1235,2798,696,1811,77,189,347,857,424,1046
410773,202307,1632,3898,1173,3022,267,712,584,1321,851,2033
410775,202307,2075,4207,1551,3288,45,120,1210,2359,1255,2479
410780,202307,725,1713,405,1059,68,178,141,340,209,518
410785,202307,1013,2267,616,1580,90,273,279,638,369,911
410790,202307,1435,3858,906,2658,194,644,193,467,387,1111
410800,202307,4288,8488,2586,5469,83,236,1862,3617,1945,3853
410810,202307,566,1405,342,943,40,108,165,402,205,510
410820,202307,1241,3225,543,1496,118,340,122,268,240,608
410830,202307,59652,129097,36563,87147,5901,15631,18547,38985,24448,54616
410832,202307,1367,3332,889,2342,101,310,484,1102,585,1412
410840,202307,11543,27121,5467,14724,1373,3761,1139,2413,2512,6174
410845,202307,1501,3165,1037,2381,111,313,694,1448,805,1761
410850,202307,2636,6751,1924,5273,390,1164,879,2217,1269,3381
410855,202307,865,2036,473,1245,67,209,220,474,287,683
410860,202307,6173,13164,4154,9439,182,544,2977,6039,3159,6583
410865,202307,1765,4520,1299,3604,233,672,660,1851,893,2523
410870,202307,1453,3609,956,2645,133,406,498,1249,631,1655
410880,202307,5989,14711,3339,9479,564,1635,531,1595,1095,3230
410890,202307,1469,3662,984,2613,196,491,463,1120,659,1611
410895,202307,1211,3506,914,2819,265,889,275,741,540,1630
410900,202307,1060,2670,575,1658,101,302,113,236,214,538
410910,202307,543,1187,272,657,18,52,158,330,176,382
410920,202307,1162,2536,631,1511,51,126,403,880,454,1006
410930,202307,2150,5123,1207,3367,275,849,193,431,468,1280
410940,202307,32424,79903,19745,54222,4050,12264,8022,19312,12072,31576
410950,202307,2457,6163,2017,5360,202,479,1460,3723,1662,4202
410960,202307,11128,24637,7100,17733,2092,5718,2339,5002,4431,10720
410965,202307,1365,3308,663,1867,122,368,261,650,383,1018
410970,202307,5398,13469,3102,8546,787,2546,615,1272,1402,3818
410975,202307,1860,4140,1045,2640,206,539,422,971,628,1510
410980,202307,9699,22163,5485,14053,616,1832,2817,6187,3433,8019
410990,202307,1915,4120,1182,2890,210,580,602,1356,812,1936
411000,202307,843,2160,492,1416,89,275,159,389,248,664
411005,202307,569,1326,266,689,34,96,108,224,142,320
411007,202307,3149,7612,1868,5028,382,1150,663,1502,1045,2652
411010,202307,6013,15690,3591,10312,958,2866,787,1828,1745,4694
411020,202307,2870,7375,1996,5640,539,1535,583,1569,1122,3104
411030,202307,855,1989,476,1189,64,169,205,420,269,589
411040,202307,1272,3020,518,1394,98,246,155,338,253,584
411050,202307,2488,7151,1666,5234,353,1190,267,652,620,1842
411060,202307,2896,7060,1495,4064,269,781,543,1156,812,1937
411065,202307,474,1138,228,623,24,68,94,232,118,300
411070,202307,9961,22700,6544,16224,1081,2857,3246,7079,4327,9936
411080,202307,2570,6167,1636,4294,382,1117,575,1255,957,2372
411090,202307,961,2488,444,1319,63,215,133,327,196,542
411095,202307,2953,6679,1245,3292,229,616,208,426,437,1042
411100,202307,1482,3574,808,2203,129,422,313,735,442,1157
411110,202307,770,1930,289,861,34,98,24,40,58,138
411120,202307,2156,5132,1361,3550,221,690,632,1410,853,2100
411125,202307,6882,18017,4835,13597,1449,4111,1556,3990,3005,8101
411130,202307,930,2282,506,1375,147,376,148,396,295,772
411140,202307,2641,7562,1805,5618,467,1482,471,1438,938,2920
411150,202307,5041,11859,2746,7077,595,1626,255,507,850,2133
411155,202307,1370,3113,761,1877,120,344,416,851,536,1195
411160,202307,493,1054,256,656,44,125,70,175,114,300
411170,202307,968,2521,663,1900,136,424,304,796,440,1220
411180,202307,6933,16020,4948,12084,725,1968,2719,5819,3444,7787
411190,202307,2751,6570,1603,4160,218,616,760,1680,978,2296
411200,202307,6350,15586,4101,10894,877,2636,1424,3052,2301,5688
411210,202307,4468,9534,2424,5667,295,821,1188,2330,1483,3151
411220,202307,1226,2836,674,1747,130,364,259,556,389,920
411230,202307,1038,2584,641,1765,142,391,167,399,309,790
411240,202307,1895,4209,1075,2667,225,576,367,792,592,1368
411250,202307,2820,6857,1655,4540,415,1243,443,1016,858,2259
411260,202307,400,955,218,584,35,107,100,214,135,321
411270,202307,2496,6156,1509,4081,218,634,708,1655,926,2289
411275,202307,2037,4175,1225,2759,119,342,703,1323,822,1665
411280,202307,1901,4704,1120,3027,249,703,408,931,657,1634
411290,202307,1015,2447,563,1513,63,199,281,677,344,876
411295,202307,1593,3778,978,2552,194,498,398,893,592,1391
411300,202307,1213,2915,571,1527,65,197,215,435,280,632
411310,202307,1187,2445,735,1682,132,325,395,779,527,1104
411320,202307,7359,16826,4767,11783,713,1976,2302,4761,3015,6737
411325,202307,1891,4665,1352,3616,216,595,748,1939,964,2534
411330,202307,3943,9767,2592,7239,680,2070,706,1778,1386,3848
411340,202307,999,2534,464,1296,76,212,164,397,240,609
411342,202307,1266,2931,575,1518,136,373,199,422,335,795
411345,202307,1492,3459,912,2371,69,206,589,1415,658,1621
411350,202307,3745,9364,1983,5598,471,1412,258,592,729,2004
411360,202307,864,1985,535,1330,88,260,244,520,332,780
411370,202307,75423,173008,45091,114184,4132,12023,25942,57915,30074,69938
411373,202307,1733,3984,1121,2850,196,498,476,1133,672,1631
411375,202307,1343,3148,713,1886,119,309,245,551,364,860
411380,202307,1417,3047,737,1674,37,88,510,1055,547,1143
411390,202307,1913,4714,1182,3030,207,611,507,1032,714,1643
411400,202307,2941,6638,1847,4535,221,611,1013,2184,1234,2795
411410,202307,3811,9978,2201,6290,550,1605,512,1195,1062,2800
411420,202307,5199,12069,2111,5743,326,984,412,747,738,1731
411430,202307,5243,12403,3447,8856,671,1934,1276,2686,1947,4620
411435,202307,537,1351,226,654,39,122,41,84,80,206
411440,202307,3374,8339,2037,5612,541,1497,528,1261,1069,2758
411450,202307,3094,7598,2039,5523,329,850,1109,2928,1438,3778
411460,202307,5648,13675,2756,7662,405,1252,745,1627,1150,2879
411470,202307,1137,2549,753,1859,66,221,468,984,534,1205
411480,202307,7038,17147,3955,10771,793,2440,1207,2797,2000,5237
411490,202307,2110,4851,1382,3516,171,525,750,1670,921,2195
411500,202307,1710,4206,951,2505,194,550,260,519,454,1069
411510,202307,2794,6322,1723,4308,319,945,499,1135,818,2080
411520,202307,46772,106854,22471,56816,2917,8504,10381,22023,13298,30527
411530,202307,1139,2737,524,1495,84,251,118,287,202,538
411535,202307,638,1784,327,1035,37,135,80,212,117,347
411540,202307,3430,7613,1865,4578,193,541,1094,2453,1287,2994
411545,202307,1061,2834,792,2267,69,223,479,1305,548,1528
411550,202307,850,1965,551,1361,97,245,208,449,305,694
411560,202307,2354,6218,961,2891,143,452,72,158,215,610
411570,202307,9746,20976,5922,14541,1314,3464,2120,4648,3434,8112
411573,202307,959,2367,691,1828,100,331,399,927,499,1258
411575,202307,2549,6195,1561,4175,310,889,560,1350,870,2239
411580,202307,5418,12576,2603,7233,372,1175,493,1013,865,2188
411585,202307,723,2046,277,879,35,115,34,81,69,196
411590,202307,600,1477,357,948,48,157,177,388,225,545
411600,202307,424,974,201,537,32,79,80,180,112,259
411605,202307,1968,4215,991,2487,120,369,469,1148,589,1517
411610,202307,3610,7287,2193,4699,69,201,1627,3094,1696,3295
411620,202307,3775,8761,2762,6961,591,1503,1185,2898,1776,4401
411630,202307,1093,2582,587,1568,78,260,275,600,353,860
411640,202307,562,1415,293,775,42,115,108,239,150,354
411650,202307,242,642,131,389,21,62,42,97,63,159
411660,202307,1047,2519,583,1546,97,270,221,482,318,752
411670,202307,1917,4193,1086,2633,118,302,580,1240,698,1542
411680,202307,1709,4165,1050,2835,223,637,384,914,607,1551
411690,202307,5023,11730,2922,7570,597,1544,1039,2426,1636,3970
411695,202307,793,2178,451,1295,34,104,205,538,239,642
411700,202307,2009,4833,1100,2935,252,667,301,684,553,1351
411705,202307,3103,7610,2289,6088,345,952,1393,3604,1738,4556
411710,202307,2652,6226,1452,3739,295,780,515,1104,810,1884
411720,202307,1266,2954,677,1775,96,252,223,512,319,764
411721,202307,1210,2838,750,1932,152,386,216,508,368,894
411722,202307,1217,3211,569,1649,90,248,209,508,299,756
411725,202307,1575,4178,851,2613,219,746,170,422,389,1168
411727,202307,1775,4558,1008,2917,199,608,139,240,338,848
411729,202307,710,1729,336,951,85,290,92,179,177,469
411730,202307,6971,16718,4482,11621,1128,3179,1633,3855,2761,7034
411740,202307,575,1412,267,750,72,180,53,134,125,314
411745,202307,973,2564,508,1479,77,229,111,252,188,481
411750,202307,8483,20175,4982,13034,695,1915,2338,5556,3033,7471
411760,202307,9495,22349,5999,16003,1894,5185,1247,3268,3141,8453
411770,202307,3916,10462,2367,6794,522,1582,562,1381,1084,2963
411780,202307,3188,8290,2332,6653,631,1869,584,1712,1215,3581
411790,202307,4030,8973,2102,5278,300,827,836,1697,1136,2524
411800,202307,1437,3842,847,2327,162,497,250,569,412,1066
411810,202307,1906,4595,1105,2867,202,533,402,910,604,1443
411820,202307,22545,52869,17134,42729,3931,9801,8809,20785,12740,30586
411830,202307,559,1370,324,871,67,180,63,134,130,314
411840,202307,16275,39244,9111,23990,1481,4123,3618,8080,5099,12203
411845,202307,796,2095,381,1142,75,242,90,211,165,453
411850,202307,10181,24274,5512,14910,1536,4401,895,1758,2431,6159
411860,202307,946,2456,569,1612,150,408,112,286,262,694
411870,202307,734,1933,451,1289,126,407,99,204,225,611
411880,202307,2994,6540,1818,4437,347,856,782,1699,1129,2555
411885,202307,1284,3194,679,1891,112,340,186,437,298,777
411890,202307,1837,4563,1098,3053,217,624,147,383,364,1007
411900,202307,1059,2699,507,1497,181,540,39,121,220,661
411910,202307,1434,3892,872,2653,168,562,302,761,470,1323
411915,202307,20983,47798,12059,29961,1808,4886,5291,11116,7099,16002
411920,202307,1491,3839,1044,2916,266,796,389,935,655,1731
411925,202307,610,1484,363,989,92,246,139,336,231,582
411930,202307,6456,17329,4682,13632,2366,7013,520,1622,2886,8635
411940,202307,4121,10818,2742,7716,660,1873,955,2317,1615,4190
411950,202307,20341,48974,14435,37437,1820,5318,8344,19358,10164,24676
411960,202307,7425,17937,4838,12570,1019,2920,1962,4331,2981,7251
411965,202307,644,1626,361,1001,63,179,145,328,208,507
411970,202307,1447,2938,863,1964,160,284,397,1000,557,1284
411980,202307,2122,4551,1259,3064,297,679,439,1011,736,1690
411990,202307,51117,122540,29211,79268,5551,16067,11728,27854,17279,43921
411995,202307,6521,14458,4376,10812,1291,3515,1261,2785,2552,6300
412000,202307,2495,5159,1516,3343,69,202,1127,2203,1196,2405
412010,202307,765,2109,373,1101,40,133,124,282,164,415
412015,202307,611,1600,441,1256,99,296,191,534,290,830
412020,202307,569,1531,296,954,43,150,85,227,128,377
412030,202307,779,2019,534,1527,96,245,243,638,339,883
412033,202307,1128,2759,564,1509,63,170,257,601,320,771
412035,202307,861,2190,443,1323,88,248,168,447,256,695
412040,202307,869,2158,406,1108,70,195,151,343,221,538
412050,202307,1760,4170,1023,2731,289,831,192,474,481,1305
412060,202307,9032,23401,6106,17099,1690,5324,1663,3912,3353,9236
412065,202307,750,1872,418,1155,78,235,120,275,198,510
412070,202307,1680,3898,1076,2674,115,323,550,1102,665,1425
412080,202307,3506,8287,2184,5479,259,688,1188,2507,1447,3195
412085,202307,404,985,128,394,23,86,36,89,59,175
412090,202307,8139,18613,5039,12928,1116,3167,2153,5159,3269,8326
412100,202307,2330,5717,1443,4065,427,1286,274,781,701,2067
412110,202307,1172,2898,587,1646,87,256,163,372,250,628
412120,202307,2923,7409,1953,5486,431,1317,586,1397,1017,2714
412125,202307,984,2582,463,1371,77,226,112,288,189,514
412130,202307,964,2266,499,1332,109,293,128,320,237,613
412135,202307,657,1662,281,809,34,120,126,293,160,413
412140,202307,2495,5682,1421,3595,262,695,333,784,595,1479
412150,202307,3386,7995,2391,6012,570,1498,1103,2389,1673,3887
412160,202307,1160,3390,439,1458,39,140,35,72,74,212
412170,202307,5805,14067,4270,11161,872,2409,2040,4697,2912,7106
412175,202307,1603,4269,1135,3262,251,733,360,993,611,1726
412180,202307,2091,5376,1248,3575,235,750,421,1007,656,1757
412190,202307,3853,9246,2247,6046,322,978,934,2208,1256,3186
412200,202307,2417,6356,1447,4119,389,1194,255,604,644,1798
412210,202307,796,1811,413,1096,61,172,190,443,251,615
412215,202307,4093,10048,2572,7061,526,1545,1078,2855,1604,4400
412217,202307,1252,2874,905,2212,23,70,688,1533,711,1603
412220,202307,7661,20508,4819,14168,1127,3277,1077,2916,2204,6193
412230,202307,3505,9245,2084,6008,366,1190,507,1195,873,2385
412240,202307,10262,25077,5287,14474,996,2953,1655,3608,2651,6561
412250,202307,2336,5708,1392,3787,373,1054,225,490,598,1544
412260,202307,1685,3992,918,2292,162,412,343,736,505,1148
412265,202307,1308,3078,879,2288,110,320,522,1222,632,1542
412270,202307,1385,3537,757,2103,84,248,320,729,404,977
412280,202307,520,1349,323,924,64,163,77,200,141,363
412290,202307,1308,3024,818,2087,144,378,336,764,480,1142
412300,202307,2302,5383,1382,3583,286,790,458,1002,744,1792
412310,202307,779,2140,448,1405,72,237,125,333,197,570
412320,202307,864,2094,470,1287,64,214,166,397,230,611
412330,202307,1973,4815,1105,3080,231,673,293,737,524,1410
412340,202307,1539,3858,873,2437,140,424,93,241,233,665
412350,202307,3811,9587,1944,5562,322,1016,581,1318,903,2334
412360,202307,359,845,219,569,11,38,145,332,156,370
412370,202307,1493,3654,788,2165,154,450,188,458,342,908
412380,202307,1802,4666,1035,2962,247,762,77,206,324,968
412382,202307,618,1431,359,939,39,127,184,394,223,521
412385,202307,2907,6917,1978,5107,614,1564,621,1622,1235,3186
412390,202307,3057,6962,1776,4534,390,993,556,1300,946,2293
412395,202307,928,2308,549,1465,70,188,277,676,347,864
412400,202307,1167,2796,703,1866,117,337,255,550,372,887
412402,202307,3045,6971,1649,4312,362,940,553,1385,915,2325
412405,202307,3772,9550,1978,5839,588,1679,337,888,925,2567
412410,202307,8235,19954,4915,13644,951,2914,1639,4037,2590,6951
412420,202307,642,1514,322,835,38,114,125,283,163,397
412430,202307,639,1552,265,719,52,134,95,249,147,383
412440,202307,3701,8899,2139,5762,477,1284,688,1713,1165,2997
412450,202307,669,1803,352,1022,39,120,47,97,86,217
412460,202307,1465,3321,902,2235,192,502,382,865,574,1367
412470,202307,1959,5514,1470,4409,359,1161,424,1114,783,2275
412480,202307,1774,4062,951,2334,181,472,359,730,540,1202
412490,202307,1614,3644,1007,2470,71,210,605,1276,676,1486
412500,202307,2534,5901,1455,3729,259,708,487,1042,746,1750
412510,202307,2318,6469,1476,4449,370,1214,217,454,587,1668
412520,202307,1709,4068,829,2238,150,404,104,243,254,647
412530,202307,833,2109,451,1273,99,259,106,271,205,530
412535,202307,958,2407,460,1319,85,263,62,119,147,382
412540,202307,1244,3120,758,2170,160,570,138,309,298,879
412545,202307,868,2109,462,1270,77,228,154,384,231,612
412550,202307,48636,117312,28960,75043,4143,11841,13741,30536,17884,42377
412555,202307,355,848,168,427,20,60,64,119,84,179
412560,202307,6852,17526,4161,11407,1135,3416,754,1664,1889,5080
412570,202307,5350,12349,2792,7381,542,1655,726,1548,1268,3203
412575,202307,1435,3243,955,2324,287,672,381,794,668,1466
412580,202307,1962,4509,1097,2765,117,292,622,1396,739,1688
412590,202307,554,1376,249,707,53,149,32,61,85,210
412600,202307,2135,4917,1463,3563,98,310,971,2082,1069,2392
412610,202307,1018,2556,566,1523,93,244,229,510,322,754
412620,202307,1626,3823,1099,2847,213,589,505,1148,718,1737
412625,202307,12358,30595,6742,18767,1376,4064,1357,3067,2733,7131
412627,202307,1366,3561,766,2251,177,547,177,449,354,996
412630,202307,3318,9072,1834,5542,331,1085,415,1046,746,2131
412635,202307,609,1475,304,826,51,154,99,220,150,374
412640,202307,1194,3037,565,1605,83,249,118,249,201,498
412650,202307,2084,5233,1318,3561,232,683,498,1158,730,1841
412660,202307,3580,8300,2142,5389,272,761,877,1872,1149,2633
412665,202307,527,1220,336,864,76,191,116,266,192,457
412667,202307,2074,5147,1279,3501,232,711,504,1258,736,1969
412670,202307,1156,2466,655,1563,109,315,310,617,419,932
412680,202307,2678,6561,1373,3795,194,630,439,953,633,1583
412690,202307,1411,3361,805,2099,157,451,284,587,441,1038
412700,202307,2172,5343,1519,4005,357,1024,671,1596,1028,2620
412710,202307,6699,17763,4000,11515,721,2258,1137,2552,1858,4810
412720,202307,1676,4457,1100,3091,186,552,315,660,501,1212
412730,202307,3419,8131,2080,5327,323,947,1058,2338,1381,3285
412740,202307,2487,6452,1368,4042,252,835,254,690,506,1525
412750,202307,4862,11968,3323,8981,487,1446,1697,4094,2184,5540
412760,202307,3998,9632,2828,7388,546,1566,1418,3314,1964,4880
412770,202307,15762,38549,7049,20264,967,3006,1833,4202,2800,7208
412780,202307,1567,3750,968,2577,255,771,288,601,543,1372
412785,202307,2749,5879,1684,4056,259,721,1006,2168,1265,2889
412788,202307,1735,4499,1207,3450,341,974,417,1061,758,2035
412790,202307,1708,4122,890,2414,143,442,370,786,513,1228
412795,202307,1501,3579,666,1878,136,347,162,425,298,772
412796,202307,2719,7248,1873,5410,447,1282,526,1356,973,2638
412800,202307,5295,11419,3175,7360,303,889,1806,3524,2109,4413
412810,202307,17287,40461,9378,24049,1123,3199,4415,9608,5538,12807
412820,202307,7842,20022,4629,13127,1207,3541,1106,2881,2313,6422
412830,202307,429,1126,246,690,39,115,90,204,129,319
412840,202307,2494,5231,1597,3525,138,368,1058,2021,1196,2389
412850,202307,3394,8124,2264,6054,270,855,1210,2825,1480,3680
412853,202307,2002,4411,1430,3255,180,485,849,1678,1029,2163
412855,202307,1666,4033,701,1929,103,305,167,353,270,658
412860,202307,970,2265,539,1454,108,336,215,490,323,826
412862,202307,792,1922,455,1268,76,220,205,503,281,723
412863,202307,1622,4302,1254,3509,257,815,607,1453,864,2268
412865,202307,781,2026,502,1423,120,361,98,244,218,605
412870,202307,1220,2910,722,1992,234,689,174,429,408,1118
412880,202307,1189,3011,728,2096,153,431,249,642,402,1073
420005,202307,567,1560,275,842,30,97,124,344,154,441
420010,202307,3698,8467,2173,5713,150,441,1461,3656,1611,4097
420020,202307,517,1521,343,1080,65,223,99,249,164,472
420030,202307,173,572,107,392,31,106,23,69,54,175
420040,202307,717,2076,330,1105,55,207,26,62,81,269
420050,202307,973,2305,531,1357,95,266,279,599,374,865
420055,202307,225,615,106,309,17,52,46,113,63,165
420060,202307,282,732,197,538,28,77,98,236,126,313
420070,202307,1105,3013,775,2309,140,461,406,1092,546,1553
420075,202307,95,251,50,143,9,30,17,31,26,61
420080,202307,526,1443,298,856,65,193,74,178,139,371
420090,202307,568,1625,313,1008,69,240,75,184,144,424
420100,202307,1839,4162,1281,3143,146,355,748,1740,894,2095
420110,202307,387,1138,285,892,45,138,136,399,181,537
420120,202307,838,2195,460,1339,72,232,188,437,260,669
420125,202307,479,1398,283,918,56,174,76,190,132,364
420127,202307,391,1027,135,434,10,33,49,142,59,175
420130,202307,6681,17263,4281,12279,843,2676,1639,3819,2482,6495
420140,202307,6314,15610,4081,11186,1074,3236,1090,2480,2164,5716
420150,202307,880,2188,523,1447,60,194,253,618,313,812
420160,202307,262,634,90,258,12,39,31,88,43,127
420165,202307,221,645,95,309,11,45,25,64,36,109
420170,202307,445,1225,316,936,36,127,178,453,214,580
420180,202307,179,555,83,302,15,67,20,66,35,133
420190,202307,262,725,129,393,24,78,32,78,56,156
420195,202307,2730,6580,1825,4851,297,898,975,2294,1272,3192
420200,202307,10924,24160,5947,14423,777,2116,2734,5354,3511,7470
420205,202307,2818,6888,1635,4477,242,712,799,1937,1041,2649
420207,202307,3010,7151,1761,4753,352,1028,695,1615,1047,2643
420208,202307,456,1229,219,688,76,253,52,115,128,368
420209,202307,230,666,117,357,18,65,58,152,76,217
420210,202307,6178,14768,3852,10301,622,1820,1881,4464,2503,6284
420213,202307,995,2752,701,2083,134,425,254,687,388,1112
420215,202307,310,833,177,517,47,145,45,116,92,261
420220,202307,454,1283,246,791,46,180,90,224,136,404
420230,202307,8450,20504,5522,14467,781,2234,2946,6765,3727,8999
420240,202307,21345,55384,11585,32049,1594,4877,4975,11029,6569,15906
420243,202307,648,1515,473,1188,81,231,283,665,364,896
420245,202307,2826,6596,1916,4872,184,517,1159,2629,1343,3146
420250,202307,892,1942,669,1556,54,162,470,980,524,1142
420253,202307,567,1329,340,910,51,131,196,493,247,624
420257,202307,212,515,123,351,15,51,63,167,78,218
420260,202307,1600,3730,1046,2830,77,244,691,1745,768,1989
420270,202307,792,1997,307,823,40,106,142,337,182,443
420280,202307,2118,5548,1394,3883,210,679,606,1455,816,2134
420285,202307,160,439,96,293,18,61,18,31,36,92
420287,202307,574,1264,321,823,48,143,141,319,189,462
420290,202307,7487,19486,4763,13166,723,2226,2413,5687,3136,7913
420300,202307,10539,27817,4921,14246,952,2846,1605,3890,2557,6736
420310,202307,941,2079,481,1222,47,128,202,444,249,572
420315,202307,1172,3029,611,1835,82,260,277,730,359,990
420320,202307,8915,22423,5740,16402,1540,4541,1511,3922,3051,8463
420325,202307,420,1148,245,747,37,128,80,191,117,319
420330,202307,1423,3927,751,2309,159,500,196,522,355,1022
420340,202307,1723,3979,1109,2776,239,646,505,1072,744,1718
420350,202307,1803,3954,1219,2907,144,344,802,1788,946,2132
420360,202307,3823,10050,1697,5177,275,911,161,423,436,1334
420370,202307,1880,4418,1399,3538,105,344,1006,2311,1111,2655
420380,202307,5849,14378,3529,9618,640,1913,1556,3694,2196,5607
420390,202307,1471,3610,839,2227,143,407,283,531,426,938
420395,202307,1765,4580,1002,2896,153,466,209,463,362,929
420400,202307,1569,3890,901,2482,117,358,494,1207,611,1565
420410,202307,751,1867,430,1182,66,198,212,538,278,736
420415,202307,448,1190,276,782,49,160,119,300,168,460
420417,202307,791,2204,504,1531,111,316,209,630,320,946
420419,202307,152,487,95,328,30,110,5,21,35,131
420420,202307,20645,50682,12003,32985,3037,9049,3457,7888,6494,16937
420425,202307,818,2156,476,1366,59,188,223,554,282,742
420430,202307,4501,11279,2381,6619,364,1155,988,2247,1352,3402
420435,202307,461,1155,229,683,49,143,115,331,164,474
420440,202307,1076,2683,592,1614,206,518,159,424,365,942
420445,202307,291,689,157,422,29,86,47,94,76,180
420450,202307,1149,3118,680,1991,132,396,277,676,409,1072
420455,202307,2723,6099,1703,4290,482,1148,575,1455,1057,2603
420460,202307,13544,33009,8793,23375,1294,3862,4479,10230,5773,14092
420470,202307,893,2274,416,1150,65,194,134,277,199,471
420475,202307,90,230,33,104,6,23,10,26,16,49
420480,202307,7338,17241,4036,10879,782,2185,1616,4001,2398,6186
420490,202307,510,1369,286,829,44,133,129,328,173,461
420500,202307,1762,4529,1025,3056,197,692,446,1147,643,1839
420510,202307,162,465,90,268,16,54,31,63,47,117
420515,202307,181,519,97,296,14,55,35,77,49,132
420517,202307,933,2193,656,1611,93,242,372,852,465,1094
420519,202307,375,964,216,636,28,89,102,291,130,380
420520,202307,352,915,157,500,17,72,4,8,21,80
420530,202307,952,2787,478,1541,95,344,148,373,243,717
420535,202307,278,777,81,265,12,42,22,53,34,95
420540,202307,56214,125955,32936,81393,4467,12491,14213,28583,18680,41074
420543,202307,320,872,188,555,29,100,76,189,105,289
420545,202307,2125,5992,1333,4019,242,765,533,1345,775,2110
420550,202307,5693,13703,2922,8059,500,1446,1150,2734,1650,4180
420555,202307,428,1157,243,733,32,108,117,310,149,418
420560,202307,555,1195,332,820,44,95,164,404,208,499
420570,202307,4287,10102,2803,7171,483,1316,1404,3226,1887,4542
420580,202307,2296,6153,1281,4013,283,940,336,897,619,1837
420590,202307,4294,10995,2408,6746,409,1251,701,1528,1110,2779
420600,202307,1864,4681,1277,3434,106,367,834,2029,940,2396
420610,202307,798,2040,450,1288,84,227,212,553,296,780
420620,202307,1104,2706,607,1716,104,305,230,590,334,895
420630,202307,1495,4237,933,2827,166,546,369,982,535,1528
420640,202307,603,1601,236,757,39,124,12,26,51,150
420650,202307,4824,11772,2757,7277,440,1283,1195,2597,1635,3880
420660,202307,586,1435,271,740,54,158,43,78,97,236
420665,202307,919,2238,471,1289,86,242,170,358,256,600
420670,202307,1554,4267,742,2352,77,299,135,297,212,596
420675,202307,279,694,157,470,13,44,95,251,108,295
420680,202307,344,781,160,461,22,82,80,195,102,277
420690,202307,1249,3400,676,1989,110,339,233,526,343,865
420700,202307,4356,10735,2924,7868,254,781,1895,4686,2149,5467
420710,202307,1424,3880,1075,3073,150,479,557,1326,707,1805
420720,202307,1743,4366,1175,3213,180,552,684,1684,864,2236
420730,202307,4971,12062,3368,8922,622,1800,1500,3469,2122,5269
420740,202307,531,1471,271,836,64,212,77,216,141,428
420750,202307,2994,8154,1678,4962,288,956,548,1316,836,2272
420757,202307,154,395,67,217,7,23,25,73,32,96
420760,202307,471,1307,185,554,40,114,59,155,99,269
420765,202307,795,2103,331,985,53,175,149,402,202,577
420768,202307,1833,4593,1300,3518,164,410,804,2081,968,2491
420770,202307,280,821,107,381,13,56,15,34,28,90
420775,202307,383,974,196,593,36,97,65,183,101,280
420780,202307,1290,3422,615,1790,134,388,107,266,241,654
420785,202307,289,707,159,411,5,18,83,169,88,187
420790,202307,1450,3851,1024,2899,211,756,561,1315,772,2071
420800,202307,995,2291,513,1364,127,344,233,559,360,903
420810,202307,1821,5064,1353,4049,311,1031,543,1346,854,2377
420820,202307,19274,45955,12047,32101,1672,4819,5909,13724,7581,18543
420830,202307,6904,16762,4252,11551,854,2579,1654,3964,2508,6543
420840,202307,777,2331,328,1141,56,226,33,82,89,308
420845,202307,4076,9831,2485,6857,474,1510,1042,2586,1516,4096
420850,202307,1313,3778,853,2614,164,543,267,642,431,1185
420860,202307,476,1224,254,778,83,268,63,149,146,417
420870,202307,1026,2729,603,1789,116,373,204,526,320,899
420880,202307,1604,4434,1089,3283,243,809,422,1074,665,1883
420890,202307,10421,26892,5540,16061,925,2872,1893,4498,2818,7370
420895,202307,248,687,119,356,15,41,55,146,70,187
420900,202307,2261,5291,1072,2979,139,468,440,961,579,1429
420910,202307,47658,117858,28037,77105,4589,13918,12172,27938,16761,41856
420915,202307,583,1994,445,1636,71,267,199,696,270,963
420917,202307,611,1495,230,597,38,78,116,288,154,366
420920,202307,120,313,34,107,5,18,6,13,11,31
420930,202307,24701,57212,15546,39580,2140,6117,8353,18543,10493,24660
420940,202307,5027,11600,2878,7542,628,1878,927,1817,1555,3695
420945,202307,267,799,114,360,16,61,40,102,56,163
420950,202307,541,1428,299,873,51,167,99,245,150,412
420960,202307,1410,3303,799,2069,138,398,333,715,471,1113
420970,202307,2886,7324,1701,4950,362,1056,464,1317,826,2373
420980,202307,311,1022,226,809,65,249,28,87,93,336
420985,202307,475,1248,197,627,32,99,45,117,77,216
420990,202307,484,1388,262,828,47,152,51,126,98,278
421000,202307,748,2176,430,1384,112,352,64,139,176,491
421003,202307,534,1288,119,345,15,45,10,22,25,67
421005,202307,137,394,82,256,14,48,24,67,38,115
421010,202307,5125,12571,3218,8741,520,1621,1320,2847,1840,4468
421020,202307,518,1543,345,1114,55,206,176,484,231,690
421030,202307,1362,3559,925,2609,173,533,350,864,523,1397
421040,202307,870,2071,431,1228,47,144,235,602,282,746
421050,202307,1606,4191,839,2347,169,481,245,532,414,1013
421055,202307,182,512,97,290,15,50,46,119,61,169
421060,202307,956,2578,601,1767,99,325,257,629,356,954
421070,202307,867,2370,455,1363,82,257,201,518,283,775
421080,202307,652,1755,425,1247,67,236,173,420,240,656
421085,202307,396,1096,120,403,13,40,18,48,31,88
421090,202307,381,956,175,458,19,68,82,174,101,242
421100,202307,1107,2356,426,1168,57,172,87,180,144,352
421105,202307,2020,5039,1104,3091,241,662,355,889,596,1551
421110,202307,1694,4010,1177,3051,136,424,725,1714,861,2138
421120,202307,1461,4127,867,2688,127,434,287,715,414,1149
421125,202307,519,1253,320,816,62,168,125,267,187,435
421130,202307,9049,23544,6562,18191,1208,3607,3061,7483,4269,11090
421140,202307,441,1154,243,708,55,142,84,225,139,367
421145,202307,446,1199,285,825,97,282,52,129,149,411
421150,202307,1014,2692,587,1692,114,365,223,479,337,844
421160,202307,890,2287,586,1596,67,219,332,768,399,987
421165,202307,300,833,140,406,21,59,43,93,64,152
421170,202307,1580,3882,1104,2912,100,291,693,1688,793,1979
421175,202307,1429,3547,744,2184,165,525,293,769,458,1294
421180,202307,516,1232,248,667,32,103,119,246,151,349
421185,202307,402,975,249,657,38,113,107,222,145,335
421187,202307,307,919,124,404,22,67,50,150,72,217
421189,202307,538,1413,325,958,56,183,118,308,174,491
421190,202307,20327,50579,13321,35696,2293,6720,6106,14149,8399,20869
421200,202307,1061,2650,660,1791,82,260,351,855,433,1115
421205,202307,321,826,201,573,43,117,79,224,122,341
421210,202307,1403,3397,661,1936,197,562,157,418,354,980
421220,202307,1794,4830,1231,3608,296,900,370,941,666,1841
421223,202307,542,1297,307,827,51,155,143,337,194,492
421225,202307,1451,3769,1091,3069,111,382,687,1777,798,2159
421227,202307,901,2399,461,1399,93,295,165,462,258,757
421230,202307,843,2139,522,1484,95,298,217,558,312,856
421240,202307,349,987,133,456,21,91,33,83,54,174
421250,202307,3522,8419,2256,6046,349,961,1266,3137,1615,4098
421260,202307,338,1041,65,183,12,38,12,28,24,66
421265,202307,1296,2869,923,2239,101,234,593,1343,694,1577
421270,202307,484,1253,219,715,53,177,72,213,125,390
421280,202307,3669,8912,2415,6537,386,1219,1185,2771,1571,3990
421290,202307,1444,3764,549,1566,84,244,91,222,175,466
421300,202307,425,1124,138,434,20,57,26,60,46,117
421310,202307,313,834,197,571,64,193,54,130,118,323
421315,202307,432,1114,209,609,43,131,60,147,103,278
421320,202307,809,2444,332,1045,27,88,54,85,81,173
421330,202307,791,2189,430,1335,88,277,109,291,197,568
421335,202307,543,1546,368,1165,46,160,161,459,207,619
421340,202307,1829,4847,979,3082,158,505,383,1057,541,1562
421350,202307,2293,5423,1269,3470,271,731,403,990,674,1721
421360,202307,2735,6922,1463,4261,364,1256,417,796,781,2052
421370,202307,974,2981,531,1787,86,303,123,339,209,642
421380,202307,1094,2547,788,1983,73,250,503,1119,576,1369
421390,202307,198,522,68,228,14,45,19,60,33,105
421400,202307,847,2142,451,1285,82,262,177,406,259,668
421410,202307,244,629,117,358,30,81,19,61,49,142
421415,202307,252,667,152,415,27,76,53,133,80,209
421420,202307,778,2022,437,1235,70,203,198,459,268,662
421430,202307,124,362,65,202,11,39,14,30,25,69
421440,202307,934,2393,455,1360,97,298,162,432,259,730
421450,202307,500,1510,288,973,46,173,20,79,66,252
421460,202307,386,1171,175,633,9,29,12,26,21,55
421470,202307,486,1311,254,784,42,118,78,240,120,358
421480,202307,4335,11018,2637,7254,378,1207,1161,2695,1539,3902
421490,202307,150,454,75,241,10,49,23,60,33,109
421500,202307,3300,8799,1951,5755,371,1178,699,1631,1070,2809
421505,202307,420,1049,304,851,27,78,153,398,180,476
421507,202307,545,1358,269,734,50,128,82,188,132,316
421510,202307,605,1597,326,954,44,152,150,325,194,477
421520,202307,577,1491,276,760,42,113,92,200,134,313
421530,202307,423,1231,210,729,32,133,41,93,73,226
421535,202307,571,1428,299,831,44,124,152,359,196,483
421540,202307,475,1082,220,609,29,79,75,197,104,276
421545,202307,883,2460,565,1733,110,350,206,521,316,871
421550,202307,2893,7273,1849,5129,341,1032,814,1987,1155,3019
421555,202307,287,791,65,209,13,47,9,18,22,65
421560,202307,128,403,74,251,12,42,20,52,32,94
421565,202307,1340,3294,821,2295,207,623,345,852,552,1475
421567,202307,583,1678,389,1161,98,296,112,323,210,619
421568,202307,397,1116,162,517,33,119,49,122,82,241
421569,202307,186,506,67,192,14,46,30,65,44,111
421570,202307,2152,5675,1311,3710,220,686,528,1217,748,1903
421575,202307,411,1182,218,635,25,74,81,198,106,272
421580,202307,6858,17431,3502,9755,526,1612,1424,3217,1950,4829
421590,202307,253,666,179,503,39,119,74,180,113,299
421600,202307,800,1957,421,1105,51,142,204,438,255,580
421605,202307,886,2203,544,1534,121,343,200,511,321,854
421610,202307,1293,3225,726,2031,143,440,284,716,427,1156
421620,202307,5208,12780,3344,9185,686,2135,1374,3217,2060,5352
421625,202307,161,445,80,229,10,28,26,53,36,81
421630,202307,3824,9581,2036,5754,329,994,570,1290,899,2284
421635,202307,583,1490,348,966,30,98,200,476,230,574
421640,202307,963,2355,670,1865,175,491,314,820,489,1311
421650,202307,3669,9081,2180,6163,418,1303,716,1745,1134,3048
421660,202307,17499,44200,11355,31342,1603,5022,5707,13640,7310,18662
421670,202307,1185,3144,679,1892,139,425,265,625,404,1050
421680,202307,2351,4812,1728,3738,151,392,1257,2461,1408,2853
421690,202307,1962,5483,1125,3518,232,779,246,607,478,1386
421700,202307,778,2237,389,1238,61,208,83,195,144,403
421710,202307,269,807,122,391,19,70,49,139,68,209
421715,202307,217,516,143,341,23,69,81,151,104,220
421720,202307,2718,7080,1350,3924,300,906,366,800,666,1706
421725,202307,361,864,162,444,21,61,75,164,96,225
421730,202307,720,2014,333,954,47,136,148,357,195,493
421740,202307,1124,2971,593,1737,129,385,195,450,324,835
421750,202307,1279,2975,615,1682,142,424,201,462,343,886
421755,202307,204,548,80,241,16,48,27,63,43,111
421760,202307,1428,3468,727,1994,121,356,272,621,393,977
421770,202307,3264,7985,1963,5452,343,1022,724,1718,1067,2740
421775,202307,260,688,118,359,13,41,32,67,45,108
421780,202307,1243,3247,740,2117,116,346,305,725,421,1071
421790,202307,1186,3032,467,1402,90,256,139,341,229,597
421795,202307,315,913,139,435,19,69,39,108,58,177
421800,202307,4023,10414,2526,7288,458,1401,955,2395,1413,3796
421810,202307,736,1938,394,1174,51,183,175,477,226,660
421820,202307,1506,4070,762,2194,134,420,252,596,386,1016
421825,202307,2103,4646,1537,3693,115,299,1043,2350,1158,2649
421830,202307,2542,7012,1613,4939,340,1093,377,1101,717,2194
421835,202307,326,758,199,500,28,81,127,297,155,378
421840,202307,495,1488,323,1028,60,211,94,245,154,456
421850,202307,507,1438,238,821,49,161,29,76,78,237
421860,202307,298,769,134,415,17,58,42,86,59,144
421870,202307,7634,17793,4813,11913,670,1949,2647,5456,3317,7405
421875,202307,394,1149,127,407,17,46,19,51,36,97
421880,202307,903,2397,467,1372,89,222,107,274,196,496
421885,202307,375,1020,165,511,26,93,42,110,68,203
421890,202307,1390,3514,927,2596,115,383,548,1326,663,1709
421895,202307,540,1321,383,1035,48,130,241,649,289,779
421900,202307,1450,3619,806,2098,127,376,356,743,483,1119
421910,202307,438,1269,179,619,28,102,29,79,57,181
421915,202307,474,1271,233,692,59,181,51,113,110,294
421917,202307,805,1791,367,1029,96,283,80,200,176,483
421920,202307,535,1511,316,984,81,246,79,231,160,477
421930,202307,4365,10382,2085,5749,392,1141,634,1403,1026,2544
421935,202307,517,1467,372,1161,81,263,150,444,231,707
421940,202307,432,1198,158,455,28,84,57,132,85,216
421950,202307,4198,10408,2121,6042,385,1155,592,1363,977,2518
421960,202307,191,465,93,262,16,39,35,95,51,134
421970,202307,2734,6793,1342,3683,243,718,527,1170,770,1888
421985,202307,405,1082,227,660,24,79,105,281,129,360
422000,202307,2648,6246,1724,4596,136,424,1119,2789,1255,3213
430003,202307,827,2008,502,1403,66,183,264,705,330,888
430005,202307,466,1079,316,801,17,56,211,474,228,530
430010,202307,2300,4878,1501,3556,308,686,682,1568,990,2254
430020,202307,687,1476,449,1081,54,148,254,532,308,680
430030,202307,1251,2705,671,1581,98,249,397,809,495,1058
430040,202307,12310,26825,6783,17094,1837,4951,1971,4308,3808,9259
430045,202307,680,1473,423,1032,27,74,287,626,314,700
430047,202307,292,652,90,223,20,45,32,72,52,117
430050,202307,1061,2515,507,1384,102,255,155,377,257,632
430055,202307,311,703,127,328,18,44,58,129,76,173
430057,202307,115,263,43,120,11,24,11,30,22,54
430060,202307,29076,68100,20538,52897,3532,9665,10805,25620,14337,35285
430063,202307,825,2131,642,1772,135,370,355,940,490,1310
430064,202307,1417,3522,915,2544,216,645,397,1012,613,1657
430066,202307,122,261,81,192,8,20,54,116,62,136
430070,202307,668,1679,139,403,27,87,20,41,47,128
430080,202307,1195,2875,547,1481,95,291,232,496,327,787
430085,202307,1148,2280,617,1441,108,250,261,600,369,850
430087,202307,1161,2728,684,1826,79,228,351,860,430,1088
430090,202307,560,1398,195,603,45,147,38,108,83,255
430100,202307,1441,3238,615,1537,81,221,279,607,360,828
430105,202307,1973,4511,1238,3203,170,518,669,1533,839,2051
430107,202307,210,554,95,272,14,40,29,70,43,110
430110,202307,2710,6200,1767,4492,338,909,874,2031,1212,2940
430120,202307,1490,3854,925,2480,157,412,416,1040,573,1452
430130,202307,4340,8931,2790,6534,1044,2389,544,1471,1588,3860
430140,202307,1300,3092,803,2127,134,374,381,951,515,1325
430150,202307,703,1730,336,994,77,238,87,233,164,471
430155,202307,263,612,90,242,13,34,26,49,39,83
430160,202307,28127,56801,19479,43131,1537,3849,13736,28221,15273,32070
430163,202307,4452,8799,2798,6297,72,250,2210,4588,2282,4838
430165,202307,413,1040,105,325,15,36,8,20,23,56
430170,202307,1141,2794,302,954,76,280,52,103,128,383
430175,202307,1039,2363,820,1942,118,282,512,1169,630,1451
430180,202307,823,1935,487,1270,105,246,188,488,293,734
430185,202307,788,1909,308,888,78,222,58,133,136,355
430187,202307,1081,2103,684,1563,71,162,456,984,527,1146
430190,202307,1871,4263,1248,3170,261,659,564,1309,825,1968
430192,202307,132,332,39,108,8,22,12,28,20,50
430195,202307,531,1444,70,206,8,23,16,35,24,58
430200,202307,1385,3562,976,2746,261,769,176,494,437,1263
430205,202307,701,1345,568,1132,20,55,481,910,501,965
430210,202307,9428,22654,4441,11590,636,1790,1343,2731,1979,4521
430215,202307,451,1011,238,596,28,89,113,237,141,326
430220,202307,700,1660,235,689,47,136,79,180,126,316
430222,202307,308,764,167,464,35,98,58,139,93,237
430223,202307,355,854,234,626,27,68,130,315,157,383
430225,202307,42,92,26,60,3,6,16,33,19,39
430230,202307,2746,6340,1958,4972,152,445,1355,3169,1507,3614
430235,202307,585,1459,299,835,53,159,73,154,126,313
430237,202307,669,1353,402,892,23,68,286,571,309,639
430240,202307,1672,3717,699,1816,104,287,287,599,391,886
430245,202307,902,2182,676,1767,140,347,347,927,487,1274
430250,202307,1343,3004,801,2021,243,640,216,481,459,1121
430258,202307,156,388,85,233,12,27,43,115,55,142
430260,202307,880,2032,497,1291,61,177,269,656,330,833
430265,202307,303,827,190,606,35,112,64,187,99,299
430270,202307,4221,8734,2935,6573,492,1104,1834,3862,2326,4966
430280,202307,6459,13374,4017,9123,638,1542,2155,4517,2793,6059
430290,202307,2773,5633,2019,4576,197,451,1456,3118,1653,3569
430300,202307,13830,29978,9175,21481,1337,3331,5375,11514,6712,14845
430310,202307,18515,41903,11265,27771,1430,3736,6548,14690,7978,18426
430320,202307,1105,2636,550,1537,51,147,305,797,356,944
430330,202307,761,1758,375,971,81,211,131,285,212,496
430340,202307,856,1736,504,1150,63,146,339,725,402,871
430350,202307,11151,24711,7451,17944,1040,2682,4430,9818,5470,12500
430355,202307,410,1090,111,333,32,91,11,22,43,113
430360,202307,1114,2532,574,1547,154,442,152,351,306,793
430367,202307,438,889,238,549,32,87,149,300,181,387
430370,202307,560,1480,178,527,38,106,53,126,91,232
430380,202307,758,1777,308,883,56,161,94,237,150,398
430390,202307,4478,10241,2337,5982,456,1219,293,525,749,1744
430400,202307,1286,2489,809,1755,108,293,493,945,601,1238
430410,202307,695,1462,464,1079,42,116,321,683,363,799
430420,202307,3740,8514,2588,6241,361,1052,1478,3017,1839,4069
430430,202307,579,1396,206,600,42,126,28,74,70,200
430435,202307,2403,5381,1486,3682,259,665,727,1703,986,2368
430440,202307,6382,14558,4249,10388,432,1180,2646,5777,3078,6957
430450,202307,10097,21099,7375,16324,1147,2935,4341,8614,5488,11549
430460,202307,53697,119181,33155,82342,5030,13361,17407,39771,22437,53132
430461,202307,232,585,77,226,14,47,36,90,50,137
430462,202307,383,927,171,480,30,93,57,144,87,237
430463,202307,9572,22732,6320,16478,1152,3338,3073,7249,4225,10587
430465,202307,709,1577,421,1027,65,185,238,534,303,719
430466,202307,6327,13987,4424,10748,685,1775,2614,5735,3299,7510
430467,202307,636,1435,390,969,41,116,230,531,271,647
430468,202307,1888,4118,1311,3119,73,217,924,2003,997,2220
430469,202307,722,1915,103,299,10,28,34,70,44,98
430470,202307,7354,17398,4098,11134,1021,3093,952,2060,1973,5153
430471,202307,1032,2380,786,1921,82,216,524,1147,606,1363
430480,202307,812,2086,419,1185,63,206,129,266,192,472
430485,202307,210,512,86,228,19,44,25,52,44,96
430490,202307,603,1434,258,706,37,120,112,231,149,351
430495,202307,491,1258,271,816,45,139,127,344,172,483
430500,202307,1169,2747,701,1882,216,631,205,453,421,1084
430510,202307,35630,85933,21608,56204,4112,11682,8995,19827,13107,31509
430511,202307,392,1028,117,353,26,74,20,38,46,112
430512,202307,1273,2608,900,2034,204,487,367,766,571,1253
430513,202307,964,2132,437,1069,58,155,250,518,308,673
430515,202307,485,1183,280,758,50,135,131,339,181,474
430517,202307,1780,4429,1228,3247,266,660,633,1645,899,2305
430520,202307,1605,3804,782,2035,144,391,195,453,339,844
430530,202307,1099,2585,396,1103,74,220,124,309,198,529
430535,202307,4592,10575,2746,7000,394,1045,1364,3199,1758,4244
430537,202307,687,1503,546,1240,71,147,382,819,453,966
430540,202307,704,1617,363,987,60,159,169,443,229,602
430543,202307,1342,2286,701,1486,183,394,168,369,351,763
430544,202307,834,2197,501,1460,116,370,144,370,260,740
430545,202307,3098,7171,2051,5431,399,1085,1024,2511,1423,3596
430550,202307,487,1217,273,749,81,200,78,203,159,403
430558,202307,189,412,64,155,2,6,41,91,43,97
430560,202307,353,798,140,405,17,64,43,95,60,159
430570,202307,1010,2279,543,1315,118,340,239,453,357,793
430580,202307,938,2256,655,1768,173,437,201,574,374,1011
430583,202307,212,513,35,90,6,25,11,14,17,39
430585,202307,248,594,111,293,24,72,38,78,62,150
430587,202307,247,630,132,373,22,70,57,144,79,214
430590,202307,1648,3679,1085,2699,122,314,639,1483,761,1797
430593,202307,37,99,22,60,2,7,12,26,14,33
430595,202307,513,1275,95,287,14,32,18,41,32,73
430597,202307,564,1324,187,493,17,43,70,135,87,178
430600,202307,2343,5799,831,2329,144,420,151,382,295,802
430605,202307,1681,3924,1045,2721,154,413,515,1247,669,1660
430607,202307,842,1771,462,1071,56,118,282,622,338,740
430610,202307,7563,16265,4860,11925,1334,3583,1902,4047,3236,7630
430613,202307,304,683,66,178,14,40,17,37,31,77
430620,202307,1041,2264,641,1508,104,277,319,594,423,871
430630,202307,475,1257,141,402,28,84,39,91,67,175
430632,202307,508,1259,155,446,26,74,56,139,82,213
430635,202307,681,1410,438,970,69,134,278,600,347,734
430637,202307,636,1399,407,1001,49,135,256,567,305,702
430640,202307,1358,3535,668,1969,90,274,216,494,306,768
430642,202307,452,1167,212,603,35,101,86,212,121,313
430645,202307,193,442,79,212,16,42,21,44,37,86
430650,202307,2234,5476,1551,4318,451,1187,562,1680,1013,2867
430655,202307,398,911,186,468,22,63,108,225,130,288
430660,202307,6708,15123,4384,10972,722,2006,2289,5205,3011,7211
430670,202307,712,1597,406,1010,80,196,186,434,266,630
430673,202307,596,1284,232,621,57,144,77,176,134,320
430675,202307,286,804,54,181,11,38,11,38,22,76
430676,202307,7671,17185,5407,13301,890,2284,3087,7157,3977,9441
430680,202307,1539,3662,791,2133,226,664,242,450,468,1114
430690,202307,4216,9638,2970,7321,960,2478,1112,2542,2072,5020
430692,202307,243,661,174,540,9,31,117,346,126,377
430693,202307,1119,2785,560,1614,132,384,131,342,263,726
430695,202307,483,1124,261,647,47,132,149,320,196,452
430697,202307,650,1464,430,1095,50,142,273,653,323,795
430700,202307,10378,23738,5335,13753,1190,3301,1364,2802,2554,6103
430705,202307,422,963,175,496,23,72,70,163,93,235
430710,202307,2546,4355,1563,3062,69,198,1274,2310,1343,2508
430720,202307,944,2152,427,1186,58,176,210,515,268,691
430730,202307,1141,2886,663,1881,126,358,251,651,377,1009
430740,202307,854,2159,377,1085,54,151,128,342,182,493
430745,202307,619,1354,398,925,47,161,267,512,314,673
430750,202307,2125,4815,1242,3136,249,645,618,1400,867,2045
430755,202307,568,1290,324,791,31,97,199,421,230,518
430760,202307,3298,7459,2123,5277,432,1100,986,2192,1418,3292
430770,202307,9894,21750,6877,16450,845,2158,4207,9290,5052,11448
430780,202307,2787,6419,1592,4206,199,589,840,1950,1039,2539
430781,202307,843,1968,486,1194,156,403,182,382,338,785
430783,202307,428,925,250,629,61,155,120,270,181,425
430786,202307,43,132,24,88,4,13,3,5,7,18
430790,202307,6183,13847,3695,9058,405,1162,2158,4502,2563,5664
430800,202307,1091,2103,724,1546,47,125,549,1080,596,1205
430805,202307,475,1039,299,686,13,31,227,477,240,508
430807,202307,747,1729,369,996,56,156,142,312,198,468
430810,202307,902,2061,380,983,64,185,148,307,212,492
430820,202307,1750,4531,811,2344,135,390,251,598,386,988
430825,202307,320,722,113,254,15,31,51,101,66,132
430830,202307,2584,5701,1832,4264,110,258,1350,2895,1460,3153
430840,202307,1524,3252,912,2212,146,345,544,1274,690,1619
430843,202307,241,561,90,247,8,19,29,68,37,87
430845,202307,637,1343,361,856,55,143,199,408,254,551
430850,202307,3009,7291,1727,4756,494,1457,388,919,882,2376
430860,202307,1514,3524,675,1797,96,302,285,603,381,905
430865,202307,745,1681,409,1062,116,325,158,349,274,674
430870,202307,617,1587,211,631,43,126,42,110,85,236
430880,202307,1855,3790,1188,2681,135,347,754,1538,889,1885
430885,202307,223,553,120,329,16,46,61,156,77,202
430890,202307,1376,3215,689,1893,182,579,66,114,248,693
430900,202307,4372,8052,2467,5184,124,360,1787,3325,1911,3685
430905,202307,1137,2670,644,1681,117,317,251,603,368,920
430910,202307,2939,7310,1691,4443,240,713,762,1650,1002,2363
430912,202307,656,1711,362,1063,69,197,164,475,233,672
430915,202307,629,1660,357,1061,94,289,81,235,175,524
430920,202307,36373,81402,25077,60815,3140,8162,15425,34681,18565,42843
430925,202307,107,220,45,111,6,15,20,47,26,62
430930,202307,15980,33431,9996,23312,1101,2883,6407,13464,7508,16347
430940,202307,1634,3810,970,2517,184,475,375,847,559,1322
430950,202307,1025,2054,593,1306,64,162,398,754,462,916
430955,202307,544,1353,126,334,19,51,39,70,58,121
430957,202307,250,698,209,607,37,103,106,311,143,414
430960,202307,1720,3824,810,2097,214,561,222,505,436,1066
430965,202307,1969,4097,1380,3166,60,149,1049,2347,1109,2496
430970,202307,465,1083,224,608,25,70,99,249,124,319
430975,202307,603,1547,417,1143,83,256,139,330,222,586
430980,202307,543,1177,271,683,37,94,121,274,158,368
430990,202307,709,1775,464,1257,72,205,197,492,269,697
430995,202307,669,1491,378,961,66,164,196,457,262,621
431000,202307,1787,3983,598,1631,85,246,73,144,158,390
431010,202307,3507,8386,2068,5543,373,1130,819,1779,1192,2909
431020,202307,11447,23569,5849,14188,983,2636,2686,5543,3669,8179
431030,202307,396,1033,175,549,38,144,24,73,62,217
431033,202307,5326,11680,3088,7742,724,1791,1175,2795,1899,4586
431036,202307,347,763,75,220,9,29,21,55,30,84
431040,202307,1072,2455,613,1578,68,230,386,848,454,1078
431041,202307,492,1103,275,706,47,121,111,230,158,351
431043,202307,438,1050,268,683,24,70,164,360,188,430
431046,202307,114,286,37,95,6,15,8,17,14,32
431050,202307,1528,3311,1002,2411,183,448,539,1222,722,1670
431053,202307,879,2072,426,1168,84,236,150,341,234,577
431055,202307,786,1723,506,1236,67,160,324,773,391,933
431057,202307,226,658,117,364,26,86,39,117,65,203
431060,202307,7115,15783,4366,10940,1066,2879,1767,3855,2833,6734
431065,202307,569,1293,302,806,38,107,166,399,204,506
431070,202307,504,1239,237,647,50,139,70,204,120,343
431075,202307,330,802,163,430,25,83,85,180,110,263
431080,202307,836,2149,417,1190,62,190,135,307,197,497
431085,202307,951,2304,415,1116,69,185,173,441,242,626
431087,202307,490,1236,341,913,52,151,198,496,250,647
431090,202307,512,1142,181,492,27,83,77,178,104,261
431100,202307,5607,10709,3751,8131,394,941,2467,4871,2861,5812
431110,202307,1790,3803,1130,2580,158,410,654,1330,812,1740
431112,202307,779,1801,573,1422,74,219,359,808,433,1027
431113,202307,674,1540,485,1181,117,283,269,612,386,895
431115,202307,1383,3299,940,2485,96,323,618,1473,714,1796
431120,202307,3369,7734,2013,5101,471,1336,829,1777,1300,3113
431123,202307,427,1037,249,669,41,92,113,291,154,383
431125,202307,1526,3541,971,2525,224,610,533,1335,757,1945
431127,202307,297,727,54,157,10,34,11,23,21,57
431130,202307,4204,9419,2785,6911,483,1270,1424,3175,1907,4445
431140,202307,7658,17256,3920,9724,536,1435,1816,3631,2352,5066
431142,202307,822,1794,506,1236,60,140,323,742,383,882
431150,202307,1269,3051,850,2269,103,303,495,1225,598,1528
431160,202307,833,2024,475,1292,133,377,143,322,276,699
431162,202307,737,1706,393,1025,40,126,221,513,261,639
431164,202307,199,452,37,108,8,28,10,21,18,49
431170,202307,568,1391,362,975,99,262,79,182,178,444
431171,202307,1195,2348,884,1899,125,277,661,1367,786,1644
431173,202307,577,1370,376,1059,120,370,98,226,218,596
431175,202307,1638,3523,858,2115,127,302,426,980,553,1282
431177,202307,1193,2762,792,2058,166,487,401,948,567,1435
431179,202307,369,794,97,273,25,81,35,82,60,163
431180,202307,3103,7533,1551,4212,392,1016,402,945,794,1961
431190,202307,731,1741,248,692,25,75,64,126,89,201
431198,202307,512,1359,393,1107,89,259,159,433,248,692
431200,202307,348,836,89,230,20,49,14,33,34,82
431205,202307,288,724,146,404,38,108,44,109,82,217
431210,202307,810,1753,555,1316,108,251,270,620,378,871
431213,202307,373,919,222,610,18,54,121,300,139,354
431215,202307,761,1714,284,776,33,91,123,302,156,393
431217,202307,204,479,122,323,25,66,40,95,65,161
431220,202307,792,1792,414,1058,108,284,185,412,293,696
431225,202307,1991,4092,1306,2926,141,334,888,1878,1029,2212
431230,202307,963,2356,559,1460,101,292,270,566,371,858
431235,202307,203,543,29,90,2,4,7,15,9,19
431237,202307,472,1308,295,904,37,120,136,387,173,507
431238,202307,47,144,32,109,5,23,11,24,16,47
431240,202307,6908,15155,4732,11139,497,1344,2917,6109,3414,7453
431242,202307,393,885,266,618,34,94,148,302,182,396
431244,202307,492,1157,200,523,51,116,62,139,113,255
431245,202307,1601,3488,857,2138,109,273,385,842,494,1115
431247,202307,352,801,169,432,20,57,69,141,89,198
431250,202307,2478,5363,1726,4171,350,879,932,2121,1282,3000
431260,202307,410,1004,199,563,22,71,76,171,98,242
431261,202307,354,944,232,682,25,87,137,359,162,446
431262,202307,334,893,156,496,26,101,66,194,92,295
431265,202307,1934,4328,633,1680,144,425,162,312,306,737
431267,202307,278,657,157,413,27,79,82,193,109,272
431270,202307,3676,7434,1723,4135,501,1220,534,1176,1035,2396
431275,202307,194,498,98,260,15,47,56,134,71,181
431280,202307,330,867,122,369,26,79,28,71,54,150
431290,202307,440,1251,221,697,40,134,47,121,87,255
431295,202307,91,230,30,94,7,18,7,22,14,40
431300,202307,373,961,81,238,16,55,25,60,41,115
431301,202307,319,869,72,232,7,22,10,23,17,45
431303,202307,830,1900,417,1073,33,96,219,463,252,559
431306,202307,2907,6529,1340,3499,201,559,563,1209,764,1768
431308,202307,46,124,35,98,14,40,9,22,23,62
431310,202307,680,1591,364,920,65,142,178,421,243,563
431320,202307,834,2152,413,1198,75,230,130,292,205,522
431330,202307,2575,5628,1198,2996,168,478,603,1280,771,1758
431333,202307,242,609,108,311,22,58,28,75,50,133
431335,202307,45,128,25,85,9,29,3,12,12,41
431337,202307,5422,11239,4026,8969,185,528,3146,6516,3331,7044
431339,202307,568,1327,330,875,71,184,137,337,208,521
431340,202307,25016,56304,15127,37904,2192,5971,7835,17453,10027,23424
431342,202307,479,1052,298,737,48,126,186,434,234,560
431344,202307,447,1089,221,637,41,113,107,288,148,401
431346,202307,260,609,84,244,20,64,25,57,45,121
431349,202307,1263,2660,665,1508,106,262,393,800,499,1062
431350,202307,6301,14258,4241,10600,628,1671,2447,5545,3075,7216
431360,202307,686,1569,286,766,83,247,84,175,167,422
431365,202307,3031,5928,2076,4531,139,386,1634,3292,1773,3678
431370,202307,6747,14259,4267,10069,742,1928,2289,4911,3031,6839
431380,202307,1175,2859,821,2196,172,446,408,1056,580,1502
431390,202307,3291,7542,1709,4412,190,563,898,1949,1088,2512
431395,202307,2279,4639,1556,3503,156,366,1097,2303,1253,2669
431400,202307,377,1009,156,475,22,61,33,87,55,148
431402,202307,1095,2258,707,1641,85,198,426,919,511,1117
431403,202307,238,629,157,449,29,89,52,120,81,209
431405,202307,7461,17476,4749,12252,845,2335,2233,5054,3078,7389
431406,202307,709,1799,416,1180,113,298,107,326,220,624
431407,202307,652,1618,357,995,70,184,126,327,196,511
431410,202307,25294,56559,15449,38365,1957,5649,8937,19328,10894,24977
431413,202307,299,815,57,166,8,24,17,34,25,58
431415,202307,916,2125,510,1367,108,324,193,430,301,754
431417,202307,683,1377,380,874,68,169,186,402,254,571
431420,202307,2132,4267,1412,3193,100,257,978,2023,1078,2280
431430,202307,685,1637,280,793,47,139,97,236,144,375
431440,202307,51303,104938,35320,78761,5538,13691,20222,39685,25760,53376
431442,202307,210,556,71,223,9,28,6,13,15,41
431445,202307,583,1548,215,664,18,52,104,307,122,359
431446,202307,336,876,243,687,28,85,135,361,163,446
431447,202307,926,2218,438,1215,79,217,154,388,233,605
431449,202307,981,2267,524,1381,84,234,266,616,350,850
431450,202307,3278,5764,2250,4273,197,323,1692,3064,1889,3387
431454,202307,52,162,32,106,5,20,14,44,19,64
431455,202307,635,1420,279,706,40,87,131,313,171,400
431460,202307,4024,8366,2297,5301,455,1159,1134,2390,1589,3549
431470,202307,1710,4263,1036,2858,260,728,317,827,577,1555
431475,202307,300,792,47,150,4,13,6,10,10,23
431477,202307,594,1385,290,780,86,204,92,228,178,432
431478,202307,288,781,51,152,12,37,9,18,21,55
431480,202307,4136,9896,2595,6907,562,1482,899,2177,1461,3659
431490,202307,181544,371778,123843,276442,7497,21243,88877,179295,96374,200538
431500,202307,574,1331,340,879,58,145,158,379,216,524
431505,202307,290,636,169,426,21,57,106,248,127,305
431507,202307,343,784,116,340,38,116,20,47,58,163
431510,202307,2099,4974,1160,3071,413,1087,246,616,659,1703
431513,202307,254,537,114,280,26,87,37,59,63,146
431514,202307,152,362,91,234,9,19,49,109,58,128
431515,202307,681,1457,452,1041,97,228,223,472,320,700
431517,202307,90,247,58,171,10,35,28,79,38,114
431520,202307,430,993,161,433,30,88,66,135,96,223
431530,202307,6682,13730,3476,8466,739,1910,1516,3339,2255,5249
431531,202307,260,594,114,307,23,67,31,85,54,152
431532,202307,780,1628,400,960,73,178,185,417,258,595
431535,202307,351,879,134,374,28,76,27,65,55,141
431540,202307,2424,6352,1854,5332,135,484,1224,3305,1359,3789
431545,202307,439,1014,95,223,12,26,45,96,57,122
431550,202307,2891,6567,1737,4335,241,638,869,1938,1110,2576
431555,202307,870,1799,451,1062,39,108,260,583,299,691
431560,202307,33644,74820,19263,49387,3306,8685,8301,20029,11607,28714
431570,202307,6991,13671,5080,10663,506,1166,3460,6557,3966,7723
431575,202307,489,1065,320,752,58,143,179,354,237,497
431580,202307,844,2016,462,1186,48,137,242,512,290,649
431590,202307,1073,2732,571,1599,150,463,204,471,354,934
431595,202307,440,1096,227,647,50,152,78,181,128,333
431600,202307,2344,5412,1385,3664,227,675,538,1182,765,1857
431610,202307,1883,4091,987,2438,181,469,364,941,545,1410
431620,202307,577,1339,277,705,55,168,154,313,209,481
431630,202307,1576,3665,646,1794,150,438,181,434,331,872
431640,202307,8923,17913,6335,14008,882,2067,4006,8250,4888,10317
431642,202307,824,1747,402,951,79,186,179,364,258,550
431643,202307,464,1090,156,417,18,40,63,149,81,189
431645,202307,3121,5395,2243,4188,47,114,1887,3341,1934,3455
431647,202307,372,864,94,260,14,40,13,21,27,61
431650,202307,165,438,101,299,15,44,45,117,60,161
431660,202307,1023,2529,446,1302,77,246,102,236,179,482
431670,202307,1571,3444,779,1920,120,318,403,872,523,1190
431673,202307,252,633,87,276,12,48,27,70,39,118
431675,202307,436,1076,95,311,9,30,9,17,18,47
431680,202307,13120,28641,7873,18675,1583,4132,3246,6549,4829,10681
431690,202307,36418,79330,23134,54924,4322,11025,12014,25383,16336,36408
431695,202307,276,649,134,362,15,47,68,139,83,186
431697,202307,552,1180,358,851,61,135,192,442,253,577
431700,202307,1876,4071,1295,3015,215,458,673,1572,888,2030
431710,202307,19709,39790,12913,29534,1418,3710,8489,17995,9907,21705
431720,202307,8910,19780,4211,10654,1174,3087,773,1563,1947,4650
431725,202307,42,107,24,73,7,26,5,8,12,34
431730,202307,5877,12496,3515,8635,659,1782,1778,3861,2437,5643
431740,202307,6517,14585,3624,9340,789,2213,1155,2511,1944,4724
431750,202307,10981,25465,6378,16861,1664,4638,1958,4655,3622,9293
431755,202307,390,1012,64,201,7,21,9,28,16,49
431760,202307,6787,14269,4101,9505,478,1353,2462,4905,2940,6258
431770,202307,2663,5403,1784,4074,355,741,1042,2324,1397,3065
431775,202307,298,694,117,320,21,62,38,84,59,146
431780,202307,2702,6032,1447,3650,285,775,448,990,733,1765
431790,202307,922,2329,512,1455,142,421,164,424,306,845
431795,202307,312,760,132,382,18,57,33,89,51,146
431800,202307,10380,22754,5551,14424,1656,4801,688,1467,2344,6268
431805,202307,316,803,47,170,3,9,0,0,3,9
431810,202307,3980,8344,2396,5496,428,1063,1334,2777,1762,3840
431820,202307,2777,6534,1849,4912,435,1209,794,1936,1229,3145
431830,202307,10888,22720,6655,16104,2076,5474,1180,2756,3256,8230
431840,202307,3655,8049,2574,6200,402,1000,1522,3423,1924,4423
431842,202307,606,1418,178,502,31,87,33,70,64,157
431843,202307,372,950,196,545,50,154,78,192,128,346
431844,202307,212,564,54,180,13,43,18,57,31,100
431845,202307,581,1381,314,824,29,78,178,452,207,530
431846,202307,374,812,278,652,17,51,218,467,235,518
431848,202307,175,441,65,191,8,22,14,29,22,51
431849,202307,420,1032,59,170,11,30,7,18,18,48
431850,202307,5360,13142,3338,8954,926,2590,873,2175,1799,4765
431860,202307,853,1903,412,1016,70,179,239,540,309,719
431861,202307,119,297,60,170,7,24,24,55,31,79
431862,202307,620,1834,437,1456,87,321,187,551,274,872
431870,202307,31916,70551,21584,52066,2557,6604,13385,29589,15942,36193
431880,202307,5144,11918,3353,8655,500,1458,1749,4032,2249,5490
431890,202307,6205,14307,3295,8567,983,2588,839,1975,1822,4563
431900,202307,1304,3037,734,1904,140,403,321,681,461,1084
431910,202307,935,2091,314,815,67,169,89,169,156,338
431912,202307,720,1589,518,1236,80,182,319,729,399,911
431915,202307,1464,3038,1022,2291,61,162,769,1618,830,1780
431920,202307,1701,3231,1223,2552,45,112,1018,2032,1063,2144
431930,202307,951,2243,562,1524,185,511,169,424,354,935
431935,202307,99,239,47,133,8,22,7,12,15,34
431936,202307,364,922,170,468,34,98,84,207,118,305
431937,202307,191,461,97,252,26,59,29,74,55,133
431940,202307,3838,8143,2107,4994,211,505,1274,2819,1485,3324
431950,202307,2923,6652,1822,4619,431,1115,673,1536,1104,2651
431960,202307,3770,8432,2451,5952,742,1900,534,1218,1276,3118
431970,202307,521,1258,187,490,33,96,57,105,90,201
431971,202307,95,232,43,125,10,24,14,35,24,59
431973,202307,722,1981,468,1448,34,95,323,990,357,1085
431975,202307,130,273,33,87,8,25,9,17,17,42
431980,202307,1588,3357,1132,2597,116,332,759,1497,875,1829
431990,202307,8969,19283,5503,13682,368,1124,3571,8057,3939,9181
432000,202307,20878,43144,13843,31354,1697,4400,9022,18568,10719,22968
432010,202307,3622,7795,1854,4586,438,1100,672,1498,1110,2598
432020,202307,1908,4764,1010,2806,342,963,152,391,494,1354
432023,202307,680,1513,264,700,30,84,113,232,143,316
432026,202307,1253,3043,887,2327,265,709,319,866,584,1575
432030,202307,552,1239,239,641,20,61,140,338,160,399
432032,202307,378,911,223,589,23,76,107,234,130,310
432035,202307,865,2163,639,1731,168,442,266,702,434,1144
432040,202307,1188,2808,412,1170,51,170,168,382,219,552
432045,202307,228,544,112,309,15,46,47,117,62,163
432050,202307,697,1583,425,1078,63,185,222,510,285,695
432055,202307,898,2061,538,1379,170,411,163,436,333,847
432057,202307,183,453,134,341,15,36,83,183,98,219
432060,202307,541,1245,122,380,17,51,22,63,39,114
432065,202307,283,692,187,499,38,108,96,224,134,332
432067,202307,996,2483,745,1943,130,331,369,929,499,1260
432070,202307,1998,4564,1290,3211,192,553,648,1385,840,1938
432080,202307,6585,13613,3927,9058,787,2134,1796,3456,2583,5590
432085,202307,487,1237,346,950,64,174,155,387,219,561
432090,202307,3552,8162,1642,4260,295,748,730,1627,1025,2375
432100,202307,1140,2675,464,1347,80,250,64,133,144,383
432110,202307,2678,6209,1716,4383,396,1105,579,1244,975,2349
432120,202307,4784,11567,3222,8625,502,1497,1641,3876,2143,5373
432130,202307,3537,7803,2357,5713,494,1229,1089,2576,1583,3805
432132,202307,341,838,161,425,26,78,82,192,108,270
432135,202307,1232,2577,717,1694,100,228,409,978,509,1206
432140,202307,2470,5925,1785,4600,238,618,1104,2662,1342,3280
432143,202307,2047,4827,1334,3550,130,372,789,1968,919,2340
432145,202307,2322,5671,1095,3003,176,528,362,782,538,1310
432146,202307,168,425,103,294,29,80,25,61,54,141
432147,202307,698,1744,321,922,95,270,45,135,140,405
432149,202307,623,1367,231,588,29,65,109,246,138,311
432150,202307,5463,12172,3649,8935,816,2212,1687,3482,2503,5694
432160,202307,8818,19710,5887,14885,1416,3754,2315,5453,3731,9207
432162,202307,239,520,38,107,5,15,6,6,11,21
432163,202307,202,468,31,87,1,2,8,17,9,19
432166,202307,809,2029,502,1374,103,297,171,397,274,694
432170,202307,1933,4841,1017,2944,210,633,343,853,553,1486
432180,202307,3702,8165,1669,4280,261,734,753,1655,1014,2389
432183,202307,519,1316,342,927,60,194,187,443,247,637
432185,202307,1089,2513,558,1473,109,337,261,595,370,932
432190,202307,2936,6335,1759,4281,141,420,1138,2428,1279,2848
432195,202307,1247,2980,583,1630,107,301,172,451,279,752
432200,202307,4789,10646,3111,7676,300,762,2003,4608,2303,5370
432210,202307,511,1192,301,793,50,152,134,305,184,457
432215,202307,797,2017,564,1557,124,342,218,630,342,972
432218,202307,254,589,89,229,11,32,42,81,53,113
432220,202307,4813,10121,2979,6910,517,1256,1636,3450,2153,4706
432225,202307,203,499,121,334,29,67,29,72,58,139
432230,202307,913,2074,383,1064,77,228,96,217,173,445
432232,202307,584,1350,336,879,55,156,161,368,216,524
432234,202307,320,762,153,413,33,81,46,108,79,189
432235,202307,60,132,29,67,4,10,19,38,23,48
432237,202307,361,839,290,718,24,52,214,511,238,563
432240,202307,22144,47332,14634,36088,1430,3883,9424,21827,10854,25710
432250,202307,9422,22829,5907,15531,944,2701,3025,7058,3969,9759
432252,202307,572,1301,326,802,39,110,155,326,194,436
432253,202307,1175,3034,728,1983,218,616,150,361,368,977
432254,202307,698,1615,149,416,22,72,32,64,54,136
432255,202307,122,306,60,166,4,10,28,60,32,70
432260,202307,7618,17123,4536,11137,804,2141,2063,4389,2867,6530
432270,202307,2992,7049,1921,4953,527,1350,538,1326,1065,2676
432280,202307,1487,3573,581,1662,83,257,155,341,238,598
432285,202307,163,482,22,57,3,5,5,14,8,19
432290,202307,431,1060,236,621,46,139,91,194,137,333
432300,202307,41719,90504,28584,68027,2391,6796,19322,41522,21713,48318
432310,202307,1345,2884,948,2249,133,283,662,1571,795,1854
432320,202307,191,443,89,248,20,59,31,75,51,134
432330,202307,201,451,58,177,20,54,8,30,28,84
432335,202307,204,577,62,210,3,8,12,29,15,37
432340,202307,397,930,141,383,20,53,57,146,77,199
432345,202307,1143,2058,903,1744,29,69,760,1412,789,1481
432350,202307,372,889,161,474,35,115,52,126,87,241
432360,202307,260,755,50,158,8,23,12,30,20,53
432370,202307,474,1069,219,601,21,58,109,272,130,330
432375,202307,613,1394,349,871,130,335,68,166,198,501
432377,202307,206,606,41,145,3,11,9,24,12,35
432380,202307,2444,6300,1442,4247,234,749,599,1598,833,2347
500020,202307,4318,9631,2473,6389,272,823,1483,3517,1755,4340
500025,202307,1449,3276,757,1947,100,258,406,962,506,1220
500060,202307,10796,26588,7127,19047,949,2778,4046,10131,4995,12909
500070,202307,6579,14789,4070,10311,780,2118,1863,4483,2643,6601
500080,202307,1945,4467,1033,2757,191,530,430,1019,621,1549
500085,202307,2679,6088,1494,3851,349,930,562,1251,911,2181
500090,202307,2500,6017,1554,4421,295,891,415,1218,710,2109
500100,202307,5134,11864,3234,8430,537,1504,1362,3182,1899,4686
500110,202307,13909,31054,8469,21736,1900,5063,3845,9239,5745,14302
500124,202307,2844,7086,2092,5826,352,963,1202,3281,1554,4244
500150,202307,1993,4173,1218,2945,182,470,679,1497,861,1967
500190,202307,6456,15352,3432,9079,829,2161,1046,2447,1875,4608
500200,202307,3390,7218,1831,4437,250,662,975,2126,1225,2788
500210,202307,6567,13761,4140,10383,1033,2816,2126,4942,3159,7758
500215,202307,1816,4542,1109,3201,138,397,574,1613,712,2010
500220,202307,4477,10862,2900,7915,401,1177,1529,3746,1930,4923
500230,202307,2679,5941,1688,4230,270,706,921,2159,1191,2865
500240,202307,5307,14107,3436,10124,528,1706,1330,3690,1858,5396
500260,202307,3978,7977,2304,5394,251,680,1383,2961,1634,3641
500270,202307,193526,421021,108636,272031,14832,41834,51113,111611,65945,153445
500280,202307,1748,3985,1018,2800,161,426,544,1455,705,1881
500290,202307,4650,10544,2358,6314,394,1216,854,1907,1248,3123
500295,202307,5441,12041,3091,7708,498,1372,1303,2765,1801,4137
500310,202307,1310,2445,693,1598,112,184,338,761,450,945
500315,202307,6188,13235,4800,11280,305,825,3874,8704,4179,9529
500320,202307,26167,63593,16002,45306,3813,10128,6651,19415,10464,29543
500325,202307,8075,16308,4926,11381,667,1751,3005,6355,3672,8106
500330,202307,8620,18167,4958,12276,646,1713,2619,6196,3265,7909
500345,202307,2793,6428,1533,4091,303,824,510,1210,813,2034
500348,202307,2988,6821,2098,5289,321,855,1340,3161,1661,4016
500350,202307,1488,3791,775,2275,124,377,250,635,374,1012
500370,202307,36018,86745,22804,62745,3418,10372,10404,26153,13822,36525
500375,202307,3174,7916,1650,4648,216,657,598,1422,814,2079
500380,202307,4550,10630,2511,6742,700,1816,362,1007,1062,2823
500390,202307,931,1808,511,1246,70,190,330,760,400,950
500400,202307,2107,5035,1178,3161,193,570,424,983,617,1553
500410,202307,2995,6573,1826,4707,216,552,952,2447,1168,2999
500430,202307,3588,8222,2050,5608,345,928,760,2158,1105,3086
500440,202307,2021,4539,876,2414,151,424,326,866,477,1290
500450,202307,2508,5920,1346,3762,295,839,296,820,591,1659
500460,202307,4848,11867,2548,7188,470,1469,471,1148,941,2617
500470,202307,3735,9271,2141,5945,503,1535,612,1362,1115,2897
500480,202307,2383,6861,1772,5793,200,707,1134,3651,1334,4358
500490,202307,1445,3276,725,2049,152,481,168,430,320,911
500500,202307,5006,12440,2827,8563,889,3111,267,782,1156,3893
500510,202307,878,2095,502,1351,48,125,302,718,350,843
500515,202307,2010,4788,1259,3400,210,577,607,1612,817,2189
500520,202307,4313,11265,2919,8662,560,1657,1468,4288,2028,5945
500525,202307,1265,3392,878,2657,131,376,442,1292,573,1668
500540,202307,6652,16373,3426,10224,970,3224,538,1255,1508,4479
500560,202307,7326,17364,5523,14745,393,1059,4204,11000,4597,12059
500568,202307,5840,11990,3188,7771,767,1909,1267,2744,2034,4653
500570,202307,11509,24662,7008,16831,954,2656,3967,8417,4921,11073
500580,202307,3995,9503,2490,6690,662,1784,922,2380,1584,4164
500600,202307,4730,11050,2800,7503,678,1859,760,1911,1438,3770
500620,202307,10676,25237,6077,16014,902,2484,2958,6974,3860,9458
500625,202307,710,1768,424,1192,63,181,183,453,246,634
500627,202307,974,2509,491,1474,89,290,115,297,204,587
500630,202307,10030,21147,4981,12374,1115,3013,1562,3424,2677,6437
500635,202307,3268,9712,2284,8215,354,1177,1316,5172,1670,6349
500640,202307,2169,4360,1302,3066,73,168,889,1981,962,2149
500660,202307,28243,63864,16528,45198,4429,12696,5493,14540,9922,27236
500690,202307,3493,8233,2185,6044,734,2248,698,1788,1432,4036
500710,202307,4293,10539,2462,6914,531,1589,590,1462,1121,3051
500720,202307,6463,15423,3652,10213,754,2247,1045,2625,1799,4872
500730,202307,1339,3047,648,1764,158,428,183,474,341,902
500740,202307,5688,12766,3151,8462,800,2203,984,2561,1784,4764
500750,202307,1473,3357,819,2152,123,348,366,847,489,1195
500755,202307,1428,3444,741,2051,128,384,222,497,350,881
500769,202307,6583,15323,2937,8085,740,2095,424,940,1164,3035
500770,202307,1704,4325,1114,3282,201,628,339,972,540,1600
500780,202307,1614,3905,820,2307,135,401,210,463,345,864
500790,202307,10106,24868,6022,16874,1094,3291,2146,5467,3240,8758
500793,202307,2745,6457,1603,4162,339,931,604,1391,943,2322
500795,202307,3810,7971,2770,6494,587,1520,1723,3788,2310,5308
500797,202307,1053,2429,572,1487,168,436,184,428,352,864
500800,202307,4492,9742,2341,6139,568,1636,641,1610,1209,3246
500830,202307,27290,62434,14957,38131,3470,9180,5182,11777,8652,20957
500840,202307,1817,4065,972,2413,110,281,496,1073,606,1354
510010,202307,2175,4418,1394,3304,165,363,914,2109,1079,2472
510020,202307,5635,13507,2295,6529,373,1058,681,1753,1054,2811
510025,202307,9755,22109,5553,14780,663,1899,3020,7336,3683,9235
510030,202307,3935,8158,2100,5045,158,412,1063,2466,1221,2878
510035,202307,1328,3408,793,2480,202,652,290,957,492,1609
510040,202307,3035,6220,1915,4521,255,572,1114,2622,1369,3194
510050,202307,2896,5439,1811,3976,199,541,1243,2508,1442,3049
510060,202307,1954,4727,1105,2971,294,840,263,578,557,1418
510080,202307,1935,4626,1138,3259,194,628,395,929,589,1557
510100,202307,858,1785,561,1306,67,176,351,743,418,919
510120,202307,326,562,180,382,8,23,139,265,147,288
510125,202307,2614,6283,1631,4420,248,754,643,1486,891,2240
510130,202307,2092,4747,1293,3369,237,703,612,1384,849,2087
510140,202307,3728,9401,2303,7123,975,3187,563,1733,1538,4920
510160,202307,2603,5554,1850,4507,49,138,1625,3884,1674,4022
510170,202307,6353,14934,4125,10826,687,1950,2099,5048,2786,6998
510180,202307,18977,38750,11334,27147,1531,3917,6113,14284,7644,18201
510185,202307,2128,5254,1272,3848,410,1320,428,1378,838,2698
510190,202307,3169,8182,1724,5515,380,1266,487,1532,867,2798
510250,202307,22764,51765,14614,38233,2123,5972,8134,20172,10257,26144
510260,202307,2301,9211,1852,8395,245,1128,1135,5646,1380,6774
510263,202307,5100,13227,2797,8092,514,1594,685,1570,1199,3164
510267,202307,7246,19548,3490,10529,643,2048,710,1795,1353,3843
510268,202307,1558,3877,884,2542,212,640,168,438,380,1078
510269,202307,1189,3009,695,2041,138,450,299,790,437,1240
510270,202307,3646,9805,2256,7105,374,1267,853,2514,1227,3781
510279,202307,2302,5565,1124,3281,181,549,330,823,511,1372
510285,202307,1325,3238,774,2202,197,616,257,654,454,1270
510300,202307,5288,11520,3590,8978,262,728,2553,6023,2815,6751
510305,202307,1881,4825,1109,3292,248,764,384,1105,632,1869
510310,202307,1373,3127,889,2287,229,568,344,884,573,1452
510320,202307,5238,11932,2918,7673,679,1981,873,1963,1552,3944
510325,202307,5501,14940,3487,10856,846,2887,588,1664,1434,4551
510330,202307,3397,8765,2132,6500,587,1830,891,2658,1478,4488
510335,202307,6341,16471,4340,12939,1054,3318,1868,5268,2922,8586
510336,202307,674,1770,436,1365,52,156,237,783,289,939
510337,202307,1810,4826,1073,3456,385,1299,237,685,622,1984
510340,202307,128726,269730,76032,185169,14235,39658,35000,74581,49235,114239
510343,202307,1563,3475,919,2358,125,341,483,1144,608,1485
510345,202307,1844,4323,1118,2876,218,601,606,1398,824,1999
510350,202307,4023,9692,2106,6088,576,1656,467,1279,1043,2935
510360,202307,2297,4316,1210,2922,47,110,897,2176,944,2286
510370,202307,2258,5878,1574,4720,291,820,877,2693,1168,3513
510380,202307,666,1512,347,963,48,158,153,394,201,552
510385,202307,1615,4829,1103,3813,76,331,770,2620,846,2951
510390,202307,1849,4066,1208,3256,212,621,750,1936,962,2557
510395,202307,845,1732,498,1205,37,80,333,799,370,879
510410,202307,6870,16608,4531,12465,551,1602,2836,7473,3387,9075
510420,202307,3367,6138,2063,4276,62,159,1629,3221,1691,3380
510450,202307,631,1439,324,874,60,154,149,378,209,532
510452,202307,1234,3128,855,2343,142,374,494,1329,636,1703
510454,202307,1489,3606,897,2530,157,397,467,1375,624,1772
510455,202307,1168,2969,655,1915,131,431,236,603,367,1034
510460,202307,2446,5756,1471,3955,514,1569,446,846,960,2415
510480,202307,6241,14079,3453,8646,614,1676,1595,3447,2209,5123
510490,202307,2184,5010,1498,3998,189,472,917,2435,1106,2907
510500,202307,1789,4092,948,2655,226,675,260,700,486,1375
510510,202307,5071,13022,3123,9439,916,2990,911,2584,1827,5574
510515,202307,6827,16630,4085,11410,785,2276,1644,4215,2429,6491
510517,202307,2085,4952,1273,3606,403,1280,419,1059,822,2339
510520,202307,2851,5611,1258,3173,206,566,533,1346,739,1912
510523,202307,1423,3166,884,2228,159,428,470,1083,629,1511
510525,202307,10910,28152,6301,18109,1241,3658,1957,4926,3198,8584
510530,202307,722,1700,502,1373,34,97,355,932,389,1029
510550,202307,3248,8569,2197,6555,405,1227,1114,3130,1519,4357
510558,202307,2831,7178,1863,5518,272,754,931,2832,1203,3586
510560,202307,2530,6775,1369,4305,319,1069,218,655,537,1724
510562,202307,7851,16842,4899,11537,797,2059,2622,5400,3419,7459
510590,202307,4147,9335,2692,7154,324,906,1800,4584,2124,5490
510600,202307,1590,3207,1010,2298,226,651,508,949,734,1600
510610,202307,3547,7752,2206,5717,286,844,1308,3156,1594,4000
510615,202307,3606,8524,2227,6174,443,1288,1086,2862,1529,4150
510617,202307,1347,3662,1021,3131,119,396,715,2233,834,2629
510618,202307,1638,3898,1046,2865,190,596,542,1359,732,1955
510619,202307,899,2196,436,1302,98,292,95,241,193,533
510620,202307,1754,3701,714,1940,256,789,85,185,341,974
510621,202307,1990,5020,1015,3047,249,810,259,628,508,1438
510622,202307,7224,18597,3529,10317,901,2694,440,1003,1341,3697
510623,202307,3536,7975,2046,5252,406,1114,790,1828,1196,2942
510624,202307,1893,4754,871,2657,105,372,172,435,277,807
510625,202307,4633,10444,2488,6510,553,1548,836,2096,1389,3644
510626,202307,1646,3910,998,2787,289,920,237,586,526,1506
510627,202307,822,1964,398,1127,119,371,108,310,227,681
510628,202307,1789,3767,1028,2668,342,991,318,705,660,1696
510629,202307,2258,5806,1270,3833,299,1019,263,709,562,1728
510630,202307,4294,10920,2353,7123,563,1706,643,2088,1206,3794
510631,202307,737,1601,495,1205,30,76,375,892,405,968
510637,202307,4509,9940,2524,6458,708,1973,828,1862,1536,3835
510642,202307,7319,18341,4998,14498,918,2917,2593,7063,3511,9980
510645,202307,1244,2375,667,1585,167,385,290,698,457,1083
510650,202307,9806,21159,6675,17103,788,1424,4603,12485,5391,13909
510665,202307,2092,4305,1135,2708,233,513,453,1105,686,1618
510670,202307,504,1061,288,742,37,89,158,413,195,502
510675,202307,8407,21564,4879,14343,1173,3744,999,2480,2172,6224
510677,202307,2700,6541,1769,4965,318,947,1009,2731,1327,3678
510680,202307,870,2110,399,1178,63,203,107,266,170,469
510682,202307,2212,5727,1497,4436,393,1225,644,1809,1037,3034
510685,202307,659,1669,412,1183,38,106,232,635,270,741
510700,202307,5395,11817,3365,8679,354,1061,2147,5214,2501,6275
510704,202307,14641,32318,8036,20242,1835,4899,2660,5760,4495,10659
510706,202307,3250,8776,2093,6570,405,1279,917,2951,1322,4230
510710,202307,3727,8569,1964,5084,611,1548,460,1060,1071,2608
510715,202307,792,1606,436,1060,36,100,277,617,313,717
510718,202307,2725,6134,1510,4293,282,831,703,2150,985,2981
510719,202307,588,1178,318,765,47,127,149,286,196,413
510720,202307,1112,2370,660,1680,133,381,285,625,418,1006
510724,202307,1085,2899,620,1903,87,297,241,630,328,927
510726,202307,1094,2005,538,1205,53,133,341,712,394,845
510729,202307,783,1701,328,875,47,121,94,246,141,367
510730,202307,3644,8231,2244,5810,482,1407,1084,2456,1566,3863
510735,202307,1684,4313,1234,3544,118,331,939,2669,1057,3000
510740,202307,1199,2671,673,1639,40,110,459,1018,499,1128
510757,202307,643,1935,457,1570,113,419,168,517,281,936
510760,202307,56740,119156,29012,72696,6629,18169,8675,18519,15304,36688
510770,202307,5417,10796,3546,8197,201,500,2548,5722,2749,6222
510774,202307,550,1347,362,1018,64,187,208,576,272,763
510775,202307,841,2006,450,1298,92,281,117,300,209,581
510776,202307,985,2375,567,1505,102,279,271,701,373,980
510777,202307,1730,4345,1139,3465,215,749,628,1764,843,2513
510779,202307,1031,2617,636,1875,72,198,393,1204,465,1402
510780,202307,5474,12359,3453,9159,573,1525,1778,4834,2351,6359
510785,202307,2500,6082,1295,3759,294,887,422,1164,716,2051
510787,202307,4569,11938,2507,7375,897,2695,276,717,1173,3412
510788,202307,592,1327,362,951,59,136,166,473,225,609
510790,202307,25494,62470,13310,38867,2887,9045,1480,3755,4367,12800
510792,202307,14375,37326,7953,23757,1888,5895,1871,4861,3759,10756
510794,202307,1549,4028,976,2922,274,886,139,312,413,1198
510795,202307,14628,34240,9006,23881,1943,5604,3229,7399,5172,13003
510800,202307,1879,4783,1063,3125,317,948,145,327,462,1275
510805,202307,1855,4814,998,3081,204,661,335,929,539,1590
510810,202307,835,1610,501,1140,150,304,262,632,412,936
510820,202307,926,1712,501,1141,29,81,343,710,372,791
510830,202307,979,2299,698,1881,110,335,419,1111,529,1446
510835,202307,745,1617,443,1158,58,175,261,632,319,807
510840,202307,82354,160563,51109,116435,7810,17508,29928,65621,37738,83129
510850,202307,2201,5458,1093,3360,256,852,79,161,335,1013
510860,202307,3420,8317,2083,6084,749,2324,429,1203,1178,3527
510880,202307,909,2440,557,1740,201,639,80,234,281,873
510885,202307,776,1816,415,1151,91,240,117,317,208,557
510890,202307,1041,2719,634,1905,183,590,138,361,321,951
510895,202307,1856,4394,1129,3063,228,695,523,1224,751,1919
520005,202307,4982,12007,3506,9696,1079,2708,1235,3904,2314,6612
520010,202307,3879,9399,2511,6632,541,1544,1020,2325,1561,3869
520013,202307,4577,10716,2555,6822,703,1834,655,1796,1358,3630
520015,202307,613,1458,365,1025,85,222,134,393,219,615
520017,202307,1582,3651,953,2505,164,515,414,966,578,1481
520020,202307,708,1252,471,936,51,92,348,663,399,755
520025,202307,51141,123064,39356,103104,6230,16813,22614,56173,28844,72986
520030,202307,9150,19111,6710,15259,520,1105,4912,10699,5432,11804
520050,202307,519,1182,247,664,46,126,103,265,149,391
520055,202307,2129,4946,969,2455,165,425,420,944,585,1369
520060,202307,2482,5818,1521,4091,294,857,406,1051,700,1908
520080,202307,2372,5444,1596,4238,344,899,677,1759,1021,2658
520082,202307,1013,2432,621,1683,149,443,222,579,371,1022
520085,202307,1276,2910,878,2231,182,433,430,1036,612,1469
520090,202307,1102,1993,739,1554,113,163,543,1194,656,1357
520110,202307,57637,141094,32073,91717,8422,25452,2032,4873,10454,30325
520120,202307,320,707,153,401,26,84,65,147,91,231
520130,202307,5065,11056,3078,7436,619,1506,1297,2860,1916,4366
520140,202307,67184,162908,40882,114514,12676,37366,4350,11662,17026,49028
520145,202307,777,1664,392,1029,77,205,116,260,193,465
520150,202307,895,2031,581,1512,76,175,322,791,398,966
520160,202307,1110,2527,646,1663,122,302,285,731,407,1033
520170,202307,5836,11806,3399,8296,462,1219,2035,4566,2497,5785
520180,202307,3600,8116,2610,6555,331,937,1663,3930,1994,4867
520215,202307,2253,4932,1475,3649,135,394,973,2235,1108,2629
520235,202307,959,1880,541,1260,98,239,298,626,396,865
520250,202307,2258,5202,1412,3785,528,1534,120,361,648,1895
520260,202307,908,2027,472,1241,98,257,158,388,256,645
520280,202307,1049,2162,676,1543,162,365,303,671,465,1036
520310,202307,1133,2312,677,1613,148,400,318,728,466,1128
520320,202307,2695,6363,1619,4277,219,568,786,2031,1005,2599
520330,202307,6521,15199,4478,11452,709,1996,2530,5918,3239,7914
520340,202307,2814,5713,1518,3740,188,431,739,1866,927,2297
520350,202307,4438,10058,2530,6681,790,2091,667,1761,1457,3852
520355,202307,2295,5851,1464,4140,451,1368,214,534,665,1902
520357,202307,1110,2409,746,1860,86,230,515,1247,601,1477
520360,202307,1023,2343,681,1706,95,267,329,710,424,977
520380,202307,1703,4033,864,2361,159,427,231,540,390,967
520390,202307,1449,3248,830,2237,219,676,142,372,361,1048
520393,202307,888,1878,523,1271,66,179,256,547,322,726
520396,202307,1095,2475,775,1882,66,145,518,1180,584,1325
520400,202307,2026,4393,1401,3452,124,313,956,2351,1080,2664
520410,202307,2753,5648,1632,3793,257,659,894,1917,1151,2576
520420,202307,460,952,338,754,20,56,238,479,258,535
520425,202307,1930,4420,899,2309,261,714,186,377,447,1091
520430,202307,3074,6781,1520,3932,314,821,281,603,595,1424
520440,202307,3771,8634,1887,5039,389,1117,397,983,786,2100
520450,202307,18618,41673,10860,28039,2596,6839,2885,6819,5481,13658
520455,202307,1009,2398,583,1667,166,492,160,446,326,938
520460,202307,1304,2820,862,2143,234,498,354,904,588,1402
520465,202307,1102,2359,820,1935,42,119,599,1330,641,1449
520470,202307,3106,6890,2105,5305,632,1719,845,2003,1477,3722
520480,202307,1306,3214,816,2278,174,497,331,849,505,1346
520485,202307,1932,5271,1412,4270,240,757,726,2060,966,2817
520490,202307,5552,12989,3742,9915,592,1662,2112,5263,2704,6925
520495,202307,2009,3840,1407,2997,125,290,1018,2081,1143,2371
520500,202307,2260,5044,1447,3490,253,718,770,1618,1023,2336
520505,202307,1196,2238,861,1786,94,162,624,1272,718,1434
520510,202307,13216,29851,8806,22137,1434,4187,4484,10021,5918,14208
520520,202307,1416,3349,978,2574,265,738,382,925,647,1663
520530,202307,3301,7912,2185,5938,428,1157,984,2802,1412,3959
520540,202307,3843,9221,2066,5589,332,941,710,1636,1042,2577
520545,202307,1878,4224,1211,3074,291,733,466,1140,757,1873
520547,202307,1869,4422,1258,3265,255,647,636,1605,891,2252
520549,202307,22271,51106,16614,41724,2109,5734,10430,24407,12539,30141
520551,202307,6643,14880,4994,12147,426,1303,3623,8103,4049,9406
520552,202307,1288,2972,874,2332,246,647,323,888,569,1535
520570,202307,687,1448,386,949,59,126,183,427,242,553
520580,202307,2991,5843,1847,4330,401,937,928,2126,1329,3063
520590,202307,1715,3977,1020,2733,210,586,398,991,608,1577
520620,202307,12638,29429,8939,23195,1517,4125,4788,11661,6305,15786
520630,202307,1076,2511,699,1855,98,272,326,845,424,1117
520640,202307,2744,6232,1785,4396,453,1140,477,1164,930,2304
520650,202307,1321,2612,841,1887,169,363,452,1000,621,1363
520660,202307,597,1464,299,849,74,220,85,240,159,460
520670,202307,1233,2848,870,2208,81,174,575,1381,656,1555
520680,202307,1061,2263,719,1680,96,178,447,1030,543,1208
520690,202307,431,1039,270,732,70,189,86,209,156,398
520710,202307,552,1250,311,793,18,55,200,467,218,522
520725,202307,1667,3749,1004,2576,223,579,384,944,607,1523
520735,202307,1164,2496,709,1731,221,520,196,470,417,990
520740,202307,3265,6949,1954,4824,375,964,842,2024,1217,2988
520750,202307,934,1929,606,1411,113,254,330,733,443,987
520753,202307,1613,3839,1111,2934,196,565,514,1201,710,1766
520760,202307,1869,3550,1374,2912,49,134,1140,2298,1189,2432
520780,202307,2009,4414,1265,3168,208,525,614,1434,822,1959
520790,202307,3938,8687,2290,5834,370,873,1238,3222,1608,4095
520800,202307,24563,55568,17011,42972,3180,8001,8825,21691,12005,29692
520810,202307,1422,2907,932,2267,263,635,379,936,642,1571
520815,202307,711,2025,429,1360,78,242,129,406,207,648
520830,202307,2158,4340,1427,3333,88,209,1053,2361,1141,2570
520840,202307,3698,9040,2606,7258,671,2021,812,2153,1483,4174
520850,202307,1171,2389,702,1640,138,351,341,713,479,1064
520860,202307,12403,30110,7624,20766,1935,5465,2358,5758,4293,11223
520870,202307,201869,429191,125636,301141,23164,58667,57208,124173,80372,182840
520880,202307,12715,33133,8816,25133,1780,5058,3524,9461,5304,14519
520890,202307,6199,12598,3795,8632,603,1603,2072,4150,2675,5753
520910,202307,5872,13680,3422,9024,808,2213,811,1894,1619,4107
520915,202307,1042,2479,583,1515,104,295,263,599,367,894
520920,202307,5555,11444,3627,8628,718,1572,1957,4664,2675,6236
520929,202307,780,1722,507,1246,93,181,212,554,305,735
520940,202307,1202,2924,832,2294,63,206,550,1394,613,1600
520945,202307,587,1223,368,865,41,101,210,462,251,563
520960,202307,1437,2934,983,2270,371,798,342,844,713,1642
520970,202307,4858,11407,3145,8424,1038,2756,678,1842,1716,4598
520980,202307,941,1999,615,1496,77,182,308,673,385,855
520990,202307,3945,8529,2891,7007,421,891,1964,4749,2385,5640
520993,202307,1496,3440,797,2025,262,654,211,505,473,1159
520995,202307,3218,7478,1944,5117,531,1507,380,1055,911,2562
521000,202307,12184,28897,6805,17947,1158,3120,2277,5343,3435,8463
521010,202307,5097,11844,3340,8524,540,1537,1669,3835,2209,5372
521015,202307,969,2215,566,1431,25,69,396,918,421,987
521020,202307,6116,13842,3336,8648,798,2096,908,2199,1706,4295
521030,202307,1029,1750,672,1254,26,57,554,982,580,1039
521040,202307,10925,24922,6683,17319,1695,4359,1888,4859,3583,9218
521056,202307,1303,3188,804,2269,241,658,128,373,369,1031
521060,202307,1235,2972,767,2079,180,511,242,628,422,1139
521080,202307,1278,2613,604,1538,117,300,171,382,288,682
521090,202307,3847,9703,2114,5902,483,1458,221,528,704,1986
521100,202307,2437,4946,1612,3739,205,505,960,2141,1165,2646
521120,202307,6209,13976,4121,10639,1310,3435,903,2505,2213,5940
521130,202307,1297,2907,612,1624,80,244,306,776,386,1020
521140,202307,2117,4799,1333,3330,153,404,792,1782,945,2186
521150,202307,18351,38633,10459,26073,2692,7203,3770,8480,6462,15683
521160,202307,1050,1978,586,1229,54,104,390,749,444,853
521170,202307,1339,2913,819,2026,144,387,341,754,485,1141
521180,202307,11015,25945,7589,19695,1608,4474,3341,8206,4949,12680
521190,202307,15097,34965,8544,23138,1942,5641,2727,6534,4669,12175
521200,202307,871,1988,513,1353,99,276,204,469,303,745
521205,202307,773,1672,549,1303,33,88,411,910,444,998
521210,202307,1097,2713,554,1551,138,392,131,281,269,673
521220,202307,4826,10604,2875,7227,711,2034,1190,2492,1901,4526
521225,202307,544,1042,353,800,28,68,269,591,297,659
521230,202307,1846,4241,1306,3340,512,1344,354,837,866,2181
521250,202307,47986,109371,34439,87757,6987,19408,17885,41645,24872,61053
521260,202307,665,1378,462,1062,68,172,251,523,319,695
521270,202307,2705,5912,2050,4943,226,516,1411,3389,1637,3905
521280,202307,2267,5561,1461,4067,304,876,520,1362,824,2238
521290,202307,716,1508,398,992,42,120,224,512,266,632
521295,202307,1481,3020,960,2230,150,355,526,1118,676,1473
521300,202307,2299,5187,1524,3867,326,851,743,1830,1069,2681
521305,202307,833,1776,512,1260,45,118,330,772,375,890
521308,202307,6022,14465,3567,9587,345,990,2102,5224,2447,6214
521310,202307,14173,33023,8062,21004,1682,4611,2845,6595,4527,11206
521340,202307,531,1116,303,748,29,79,164,364,193,443
521350,202307,2389,5661,1657,4456,123,380,1168,2977,1291,3357
521370,202307,1610,3918,862,2473,291,868,142,441,433,1309
521375,202307,2140,5177,1210,3339,254,683,312,879,566,1562
521377,202307,1600,3200,1043,2447,130,271,706,1691,836,1962
521380,202307,8320,20544,4252,12237,732,2253,801,2198,1533,4451
521385,202307,872,1925,543,1420,72,178,304,815,376,993
521390,202307,888,2124,511,1448,112,366,102,225,214,591
521400,202307,3821,8272,2438,6014,347,880,1380,3236,1727,4116
521405,202307,1668,4092,923,2573,106,317,450,1143,556,1460
521410,202307,1161,2524,832,1988,212,449,420,1048,632,1497
521440,202307,1753,3991,1150,2947,316,748,481,1228,797,1976
521450,202307,5472,14684,3417,10164,863,2533,750,2127,1613,4660
521460,202307,8427,19486,4863,12801,1275,3410,1392,3482,2667,6892
521470,202307,1081,2462,619,1541,112,245,303,706,415,951
521480,202307,690,1368,396,877,50,113,228,429,278,542
521483,202307,2848,6394,1802,4656,602,1534,549,1415,1151,2949
521486,202307,2143,4797,1419,3582,124,246,908,2208,1032,2454
521487,202307,609,1320,408,996,75,162,234,554,309,716
521490,202307,1032,2487,699,1886,38,131,478,1160,516,1291
521500,202307,2478,6042,1547,4246,202,599,772,1910,974,2509
521520,202307,1061,2231,745,1717,100,214,456,1028,556,1242
521523,202307,19273,50467,13461,39066,3989,11528,4856,13164,8845,24692
521525,202307,1315,2906,880,2210,121,359,513,1178,634,1537
521530,202307,2767,6794,1594,4385,312,853,458,1124,770,1977
521540,202307,902,2181,613,1676,154,463,231,556,385,1019
521550,202307,2197,5141,916,2480,187,546,211,579,398,1125
521560,202307,7466,17247,4843,13183,1347,3780,1744,4729,3091,8509
521565,202307,844,1945,519,1370,96,272,223,543,319,815
521570,202307,5666,13993,3296,9207,780,2324,507,1387,1287,3711
521580,202307,691,1523,367,930,66,164,147,322,213,486
521590,202307,1113,2267,719,1677,107,271,406,871,513,1142
521600,202307,549,1311,289,797,52,152,129,311,181,463
521630,202307,2144,4312,1112,2658,356,892,266,558,622,1450
521640,202307,2434,5413,1355,3566,276,824,371,871,647,1695
521645,202307,646,1565,308,907,141,388,21,49,162,437
521680,202307,1780,4365,1252,3404,316,860,511,1322,827,2182
521690,202307,646,1500,457,1183,68,198,244,576,312,774
521710,202307,4348,9801,2564,6586,499,1386,795,1787,1294,3173
521720,202307,3081,6462,1681,4149,200,519,885,2066,1085,2585
521730,202307,5532,13527,3401,9489,922,2819,701,1538,1623,4357
521740,202307,6060,13930,3841,9836,1117,3050,1256,2619,2373,5669
521760,202307,24515,55737,18012,45277,3650,10115,9933,22729,13583,32844
521770,202307,4040,8829,2213,5681,452,1195,499,1249,951,2444
521800,202307,9127,21507,5556,15124,1802,4930,1272,3687,3074,8617
521805,202307,1431,2803,768,1795,154,335,340,800,494,1135
521810,202307,934,1994,597,1471,96,245,353,859,449,1104
521830,202307,7742,18775,5637,15042,630,1832,3635,9000,4265,10832
521839,202307,1099,2330,725,1672,58,151,492,1017,550,1168
521850,202307,9163,19761,4976,12644,1636,4214,637,1520,2273,5734
521860,202307,2086,5319,1197,3455,242,742,318,790,560,1532
521870,202307,927,2327,583,1623,111,338,237,559,348,897
521878,202307,1095,2630,598,1595,62,175,318,762,380,937
521880,202307,32873,74444,20643,53003,4024,11072,8909,20377,12933,31449
521890,202307,4228,9917,2340,6243,638,1680,598,1450,1236,3130
521900,202307,1766,3908,867,2301,295,721,55,147,350,868
521910,202307,1707,3589,1116,2690,286,668,403,916,689,1584
521920,202307,699,1621,468,1203,50,164,269,616,319,780
521925,202307,1074,2453,639,1681,127,320,297,738,424,1058
521930,202307,6985,15773,3977,10734,1228,2869,1392,4034,2620,6903
521935,202307,1246,2807,748,1900,93,249,434,1024,527,1273
521940,202307,1627,3392,933,2293,150,404,515,1180,665,1584
521945,202307,850,1951,472,1242,91,212,228,589,319,801
521950,202307,933,2032,562,1391,112,248,249,614,361,862
521960,202307,823,1971,528,1402,63,191,289,669,352,860
521970,202307,3486,7271,2411,5759,277,624,1585,3711,1862,4335
521971,202307,980,2238,474,1279,113,292,115,276,228,568
521973,202307,2129,5095,1290,3494,208,572,591,1494,799,2066
521975,202307,18071,41246,13069,32931,2137,5739,7672,17879,9809,23618
521980,202307,2770,6045,1878,4721,147,414,1348,3244,1495,3658
521990,202307,1792,4002,1294,3164,225,564,722,1686,947,2250
522000,202307,3256,7745,2216,6129,830,2395,638,1775,1468,4170
522005,202307,526,1073,271,679,45,131,99,229,144,360
522010,202307,6085,14086,3697,9681,841,2306,1184,2805,2025,5111
522015,202307,1337,3188,880,2372,231,621,342,880,573,1501
522020,202307,6879,14841,3997,9975,869,2306,1757,4179,2626,6485
522026,202307,955,2331,568,1588,90,277,188,460,278,737
522028,202307,668,1499,385,950,52,150,211,465,263,615
522040,202307,4823,9682,2800,6505,508,1207,1439,2982,1947,4189
522045,202307,27408,68873,17431,49371,3910,11450,4446,11654,8356,23104
522050,202307,1529,3605,940,2470,178,534,427,960,605,1494
522060,202307,4084,9827,2495,6903,512,1361,985,2665,1497,4026
522068,202307,2274,4885,1601,3925,173,373,1081,2548,1254,2921
522070,202307,1078,2098,814,1719,28,66,670,1337,698,1403
522100,202307,1117,2589,653,1763,107,291,260,660,367,951
522108,202307,1488,2980,1039,2333,57,160,798,1665,855,1825
522119,202307,2506,5311,1833,4343,261,555,1117,2601,1378,3156
522130,202307,685,1514,458,1137,33,82,332,786,365,868
522140,202307,32375,76064,19335,50793,4282,11733,5794,13545,10076,25278
522145,202307,931,2086,598,1543,135,386,298,714,433,1100
522150,202307,1380,3010,781,1957,173,408,234,591,407,999
522155,202307,1212,2887,737,1971,133,357,397,1016,530,1373
522157,202307,938,1843,684,1494,48,110,512,1110,560,1220
522160,202307,7933,18612,4382,11774,1121,3203,467,1283,1588,4486
522170,202307,3440,8129,2404,6362,381,949,1366,3541,1747,4490
522180,202307,949,2003,511,1170,104,236,146,329,250,565
522185,202307,32720,73557,20784,55033,8544,24066,3142,8458,11686,32524
522190,202307,1022,2151,612,1487,91,244,306,623,397,867
522200,202307,2720,6779,1749,4878,430,1180,615,1641,1045,2821
522205,202307,2015,4590,1235,3183,490,1363,255,555,745,1918
522220,202307,1518,3252,960,2437,132,333,526,1329,658,1662
522230,202307,1689,3705,1080,2664,127,348,643,1475,770,1823
530010,202307,372113,859215,282225,702316,42394,110792,159818,368254,202212,479046
110001,202306,4795,12387,2860,8583,704,2275,796,2178,1500,4453
110002,202306,17954,42132,11167,29634,2709,7594,3123,7703,5832,15297
110003,202306,911,2491,578,1765,142,443,112,308,254,751
110004,202306,17830,41622,10043,26999,2212,6176,3336,8235,5548,14411
110005,202306,3059,7526,1841,5229,482,1399,566,1573,1048,2972
110006,202306,1815,4751,995,3017,191,626,185,489,376,1115
110007,202306,1492,3549,781,2248,219,649,142,420,361,1069
110008,202306,4312,10016,2936,7952,584,1382,1569,4681,2153,6063
110009,202306,5549,14398,3117,9660,678,2241,947,2680,1625,4921
110010,202306,10131,27744,7137,22294,1817,5057,3070,10841,4887,15898
110011,202306,9590,23220,5802,16039,1591,4581,1227,3086,2818,7667
110012,202306,22397,51589,12603,33738,3099,8273,3373,8319,6472,16592
110013,202306,7347,19186,4620,13739,1688,5256,746,2164,2434,7420
110014,202306,4685,11311,2708,7478,494,1435,1122,2936,1616,4371
110015,202306,7598,17797,4253,11407,1007,3010,1272,2720,2279,5730
110018,202306,5762,13491,2988,8054,659,1876,721,1664,1380,3540
110020,202306,120085,250761,81319,191588,16827,41134,41651,94670,58478,135804
110025,202306,5846,13277,3499,8948,550,1564,1767,4096,2317,5660
110026,202306,707,1761,414,1211,96,282,111,334,207,616
110028,202306,9258,21845,4807,13366,1197,3667,474,1186,1671,4853
110029,202306,1926,4464,981,2738,193,544,397,1052,590,1596
110030,202306,18057,39746,9419,25067,2735,7668,1310,3333,4045,11001
110032,202306,4582,11652,2406,7130,764,2278,379,1131,1143,3409
110033,202306,5832,15798,4101,12488,1209,3723,1380,4307,2589,8030
110034,202306,3838,8609,2267,6154,841,2431,477,1339,1318,3770
110037,202306,1823,5109,1126,3680,313,1070,280,869,593,1939
110040,202306,3561,9162,2267,6693,627,1997,503,1324,1130,3321
110045,202306,5585,14781,3572,10845,996,3218,1051,2997,2047,6215
110050,202306,2057,5192,1112,3367,377,1260,109,239,486,1499
110060,202306,1152,3172,631,1940,171,518,126,357,297,875
110070,202306,1802,5111,1166,3708,329,1118,260,688,589,1806
110080,202306,8000,17856,5361,13856,1252,3308,2467,6330,3719,9638
110090,202306,728,1862,426,1263,99,330,122,340,221,670
110092,202306,1709,4562,1044,3213,249,792,483,1420,732,2212
110094,202306,3549,9502,2391,7245,764,2395,425,1342,1189,3737
110100,202306,2099,5552,1484,4381,540,1644,421,1214,961,2858
110110,202306,2256,5614,1400,4076,402,1258,230,712,632,1970
110120,202306,1650,4311,987,2948,263,808,252,709,515,1517
110130,202306,3256,7550,1676,4604,398,1134,184,489,582,1623
110140,202306,3056,7898,2052,5897,459,1447,924,2442,1383,3889
110143,202306,1720,4352,1108,3172,297,932,354,932,651,1864
110145,202306,1124,2744,592,1701,172,480,201,590,373,1070
110146,202306,639,1579,380,1086,136,359,106,345,242,704
110147,202306,957,2263,497,1331,60,166,247,572,307,738
110148,202306,1178,2984,490,1480,114,370,55,112,169,482
110149,202306,4316,10286,2621,7284,868,2467,580,1638,1448,4105
110150,202306,2970,7320,1662,5004,555,1830,210,643,765,2473
110155,202306,1054,2824,648,1849,124,396,252,635,376,1031
110160,202306,1803,4942,1120,3447,387,1225,160,480,547,1705
110170,202306,2458,5828,1451,3937,254,758,777,1876,1031,2634
110175,202306,2732,7002,1641,4756,284,906,713,1901,997,2807
110180,202306,1615,4023,1005,2841,257,778,304,788,561,1566
120001,202306,4396,11000,3267,9193,470,1513,2061,5503,2531,7016
120005,202306,2497,8399,2165,7835,253,959,1531,5606,1784,6565
120010,202306,7701,18244,6410,16245,607,1487,4822,12036,5429,13523
120013,202306,3161,8897,2562,7952,924,2842,874,2966,1798,5808
120017,202306,3763,9028,2915,7727,423,1095,1843,5029,2266,6124
120020,202306,19730,60039,17273,55270,1285,4442,12876,40515,14161,44957
120025,202306,4643,10438,3581,9059,536,1353,2256,5892,2792,7245
120030,202306,7676,27345,6758,25555,542,2316,4710,18006,5252,20322
120032,202306,2140,8400,1970,8046,110,655,1617,6421,1727,7076
120033,202306,5465,16068,4960,15169,136,598,4189,12453,4325,13051
120034,202306,3653,10890,3065,9903,159,666,2469,7735,2628,8401
120035,202306,5208,16112,4697,15230,243,930,3978,12592,4221,13522
120038,202306,4119,10456,3344,9193,553,1551,1944,5390,2497,6941
120039,202306,2504,9425,2229,8823,154,805,1696,6541,1850,7346
120040,202306,78773,188807,61920,160420,7973,21293,37722,93201,45695,114494
120042,202306,4427,13248,3864,12179,165,655,3160,9719,3325,10374
120043,202306,1823,6372,1508,5889,80,531,1172,4362,1252,4893
120045,202306,7321,16602,5667,14335,641,1670,3855,9608,4496,11278
120050,202306,12332,36291,10858,33868,491,1947,8716,26687,9207,28634
120060,202306,12332,40600,10852,38151,557,2687,8811,30215,9368,32902
120070,202306,4378,11977,3559,10678,658,1836,2032,6409,2690,8245
120080,202306,7013,16089,6012,14541,703,1638,4453,10634,5156,12272
130002,202306,4298,13516,3671,12636,400,1071,2896,10418,3296,11489
130006,202306,3204,9894,2520,8735,467,1454,1507,5612,1974,7066
130008,202306,3309,9874,2762,9042,206,671,2160,7198,2366,7869
130010,202306,5395,12726,4515,11615,165,442,3936,9956,4101,10398
130014,202306,4948,12370,3394,9842,726,2140,1727,5178,2453,7318
130020,202306,3386,12006,2796,10979,208,1141,2019,7638,2227,8779
130030,202306,19908,40773,17701,38144,222,577,16609,35243,16831,35820
130040,202306,4999,13468,3917,12022,602,1707,2656,8438,3258,10145
130050,202306,8765,29011,7152,26548,587,2292,5354,19807,5941,22099
130060,202306,8846,32014,7375,29874,327,1874,5997,23730,6324,25604
130063,202306,7932,22792,6823,21408,224,931,6071,18750,6295,19681
130068,202306,4770,13351,3874,12091,243,950,3089,9519,3332,10469
130070,202306,9030,23381,7074,20933,781,1999,5122,15558,5903,17557
130080,202306,9492,27743,7887,25728,340,1164,6656,21722,6996,22886
130083,202306,3679,10184,3054,9352,248,760,2417,7592,2665,8352
130090,202306,5027,12316,4312,11422,92,283,3718,10003,3810,10286
130100,202306,9025,25342,7346,23446,186,707,6384,20340,6570,21047
130110,202306,10954,26164,8482,22876,1724,4116,5082,15000,6806,19116
130115,202306,6268,17077,5068,15450,146,476,4270,13042,4416,13518
130120,202306,20983,57264,17739,52671,1770,5599,13684,40270,15454,45869
130130,202306,7252,19274,5429,16775,715,2084,3695,12035,4410,14119
130140,202306,9062,27438,7665,25640,367,1572,6442,21317,6809,22889
130150,202306,4909,14535,4419,13862,251,1055,3664,11323,3915,12378
130160,202306,8098,21559,6795,19837,336,906,5904,17263,6240,18169
130165,202306,4236,13561,3828,12964,139,581,3268,10968,3407,11549
130170,202306,17842,40245,14220,35744,426,1328,12446,30370,12872,31698
130180,202306,5373,15229,5000,14763,55,327,4739,13824,4794,14151
130185,202306,25380,53083,19823,46545,1551,2483,16175,39108,17726,41591
130190,202306,26288,73179,20646,64527,2242,6753,14832,46480,17074,53233
130195,202306,3026,9924,2487,9206,116,535,2046,7594,2162,8129
130200,202306,3774,8912,2911,7697,216,693,2186,5562,2402,6255
130210,202306,1994,6589,1765,6300,172,699,1380,4892,1552,5591
130220,202306,3300,8903,2660,8112,121,360,2285,7023,2406,7383
130230,202306,6300,21995,5418,20738,198,1097,4726,17983,4924,19080
130240,202306,18035,40134,14644,35821,217,994,13380,31788,13597,32782
130250,202306,32389,85429,26316,77488,1620,4267,20870,62182,22490,66449
130255,202306,6133,16243,4918,14120,260,719,3877,10935,4137,11654
130260,202306,489305,1070173,381238,909460,65165,166760,242818,549898,307983,716658
130270,202306,12475,37648,9898,33543,1977,5995,6098,21600,8075,27595
130280,202306,4651,15126,4134,14483,152,669,3651,12663,3803,13332
130290,202306,21859,52135,18839,48360,584,1803,16999,42805,17583,44608
130300,202306,6173,17555,5225,16178,209,820,4250,12882,4459,13702
130310,202306,10745,24997,9081,22829,552,1425,7446,18408,7998,19833
130320,202306,4254,12637,3334,11201,515,1707,2072,7017,2587,8724
130330,202306,5600,15523,4330,13878,243,851,3473,11186,3716,12037
130340,202306,31374,79730,25901,72948,1748,4320,21042,60540,22790,64860
130350,202306,4612,15040,4045,14257,158,795,3445,11946,3603,12741
130353,202306,9633,23211,7285,19877,1309,3317,4392,12366,5701,15683
130356,202306,7011,18895,5535,16518,1211,3440,2993,9201,4204,12641
130360,202306,3637,10803,2756,9582,141,636,2266,7695,2407,8331
130370,202306,6241,24745,5058,22775,677,3671,2954,13236,3631,16907
130380,202306,9946,38402,8997,36656,757,3513,6788,27253,7545,30766
130390,202306,9119,30702,7612,28264,547,2570,6202,22476,6749,25046
130395,202306,3129,8538,2473,7462,160,573,1975,5785,2135,6358
130400,202306,3649,9634,2935,8620,98,314,2536,7344,2634,7658
130406,202306,14675,45176,12030,41588,2853,8599,7102,25974,9955,34573
130410,202306,5561,16888,4617,15377,1221,4095,2485,8565,3706,12660
130420,202306,19474,56498,16044,51915,2266,6899,10922,36213,13188,43112
130423,202306,5398,15478,4544,14367,212,838,3922,12154,4134,12992
130426,202306,3904,12080,3431,11504,84,296,2962,10370,3046,10666
130430,202306,6256,13717,5166,12281,223,564,4428,10222,4651,10786
130440,202306,7270,17201,6011,15615,129,435,5484,14018,5613,14453
140002,202306,3086,8131,2504,7367,295,757,1803,5508,2098,6265
140005,202306,4174,11004,3375,9932,1704,5162,1076,3149,2780,8311
140010,202306,70254,180709,51501,148989,13067,39209,17436,50006,30503,89215
140015,202306,7464,15148,6083,13606,276,591,5342,11853,5618,12444
140017,202306,7221,16431,5711,14402,387,967,4449,11158,4836,12125
140020,202306,7025,17134,5658,15275,731,1902,3789,10488,4520,12390
140023,202306,3520,8916,2646,7612,322,972,1884,5349,2206,6321
140028,202306,2531,5971,1998,5252,143,379,1518,3997,1661,4376
140030,202306,7763,16040,6306,14206,363,692,5308,11863,5671,12555
140040,202306,3624,12651,3263,12157,150,834,2766,10061,2916,10895
140045,202306,4908,15382,4000,13999,1042,3002,2103,8308,3145,11310
140047,202306,7654,19630,6001,16948,929,2657,3579,10176,4508,12833
140050,202306,2197,5573,1686,4736,300,705,976,2836,1276,3541
140060,202306,2832,6050,2340,5354,226,449,1820,4122,2046,4571
140070,202306,2506,11756,2358,11429,166,1133,1834,8662,2000,9795
150010,202306,65810,134676,54473,118828,1359,2827,47681,101208,49040,104035
150013,202306,2743,5603,2165,4916,84,176,1837,4111,1921,4287
150020,202306,19254,48285,16799,44714,1665,3613,13100,35515,14765,39128
150030,202306,11598,36151,10078,34095,800,2149,7835,28110,8635,30259
150034,202306,5292,11368,3794,9223,252,592,2916,6929,3168,7521
150040,202306,20154,47153,16449,42472,1013,1742,14111,37379,15124,39121
150050,202306,9962,26457,8655,24586,267,871,7657,21719,7924,22590
150060,202306,30396,73088,22440,60211,3439,9127,13325,35668,16764,44795
150070,202306,10920,30674,9183,28358,284,1171,8139,24702,8423,25873
150080,202306,115051,243382,82266,192795,22134,50606,28448,72174,50582,122780
150085,202306,12313,28078,10446,25674,177,472,9676,23446,9853,23918
150090,202306,15948,40172,14271,37357,553,1437,12418,31839,12971,33276
150095,202306,9218,19591,7474,17278,850,1406,5808,13719,6658,15125
150100,202306,3661,11124,3050,10087,193,662,2482,8129,2675,8791
150110,202306,5728,19109,5174,18410,160,668,4632,16443,4792,17111
150120,202306,10089,26637,8770,24639,386,888,7550,21208,7936,22096
150125,202306,1101,2577,742,2039,91,299,453,1184,544,1483
150130,202306,31632,78937,24709,67200,4803,11642,14447,40640,19250,52282
150140,202306,385415,731091,293368,597138,23878,49796,215615,416764,239493,466560
150145,202306,5102,14633,3836,12433,1505,4859,979,3759,2484,8618
150150,202306,23137,49879,17912,42611,1675,3845,12529,29117,14204,32962
150157,202306,4469,10974,3255,9132,455,1336,1903,5320,2358,6656
150160,202306,5150,10707,4362,9490,308,731,3451,7046,3759,7777
150170,202306,36011,90202,30466,80476,5483,12717,19019,52826,24502,65543
150172,202306,7277,16020,5497,13379,367,956,4242,10110,4609,11066
150175,202306,2563,6215,2050,5340,157,548,1596,3866,1753,4414
150178,202306,15943,33300,11453,27784,1074,1552,8790,22678,9864,24230
150180,202306,36364,91348,31434,85265,2678,4733,25029,72591,27707,77324
150190,202306,9838,23852,8599,22264,146,487,7725,19569,7871,20056
150195,202306,6490,17365,5732,16208,179,576,5101,14211,5280,14787
150200,202306,7359,18460,6342,17166,83,271,5676,15242,5759,15513
150210,202306,41834,106489,37627,100457,1271,3332,33017,87716,34288,91048
150215,202306,14325,36436,10743,29311,1795,5142,6036,15712,7831,20854
150220,202306,17941,42239,14237,36259,693,1697,10846,26781,11539,28478
150230,202306,17989,42018,15121,37666,1194,2637,11485,28467,12679,31104
150240,202306,45535,110235,34458,89912,7263,19025,15381,37758,22644,56783
150250,202306,5423,17668,4922,17057,349,1241,4237,14707,4586,15948
150260,202306,3713,9718,3056,8671,109,357,2515,6911,2624,7268
150270,202306,10996,28129,6835,20112,1906,5765,1836,5405,3742,11170
150275,202306,9732,24305,8531,22557,211,805,7416,18848,7627,19653
150276,202306,2932,7234,2326,6370,258,678,1571,4473,1829,5151
150277,202306,7049,15309,4860,12231,656,1607,3136,7697,3792,9304
150280,202306,9456,30013,8739,28833,759,2071,6938,23687,7697,25758
150285,202306,4404,12788,3680,11537,237,709,2819,8725,3056,9434
150290,202306,13999,32310,11685,29322,434,968,10171,25487,10605,26455
150293,202306,11854,26198,8497,21268,893,2342,5627,13414,6520,15756
150295,202306,9167,22064,5594,16486,1822,5164,1825,5913,3647,11077
150300,202306,4260,8679,3700,7979,49,130,3441,7320,3490,7450
150304,202306,5398,13979,4210,12044,744,1998,2592,7543,3336,9541
150307,202306,7120,19689,6050,17838,273,789,4715,13729,4988,14518
150309,202306,7992,20355,5839,16496,933,2566,3319,9406,4252,11972
150310,202306,9113,30848,8357,29772,371,1632,7110,25416,7481,27048
150320,202306,11847,27413,9824,24123,1174,2616,6821,16714,7995,19330
150330,202306,19326,50471,16894,46880,2487,5449,11272,34038,13759,39487
150340,202306,2998,7953,2420,6997,259,675,1706,4879,1965,5554
150345,202306,11512,27222,9638,24643,436,1249,8100,20205,8536,21454
150350,202306,12876,26042,10792,23199,1006,1661,8739,18878,9745,20539
150360,202306,31750,78055,23282,65779,2042,4581,16981,48665,19023,53246
150370,202306,14309,36492,10860,31356,1453,3564,7453,22506,8906,26070
150375,202306,4949,17890,4313,16794,270,1161,3454,13196,3724,14357
150380,202306,12784,28423,9501,23713,411,1168,7535,18205,7946,19373
150390,202306,9803,34728,8217,31838,1909,6221,4568,19513,6477,25734
150400,202306,8181,25360,7444,24037,185,605,6226,20510,6411,21115
150405,202306,11148,25354,8757,21927,787,1357,6675,17234,7462,18591
150410,202306,2370,6377,1893,5558,175,481,1299,3772,1474,4253
150420,202306,59857,143047,42556,115247,9295,26372,20705,55052,30000,81424
150430,202306,10152,25581,8397,22881,663,1476,6390,17127,7053,18603
150440,202306,8601,19949,7262,17987,448,1111,6023,14588,6471,15699
150442,202306,39378,78690,29575,65148,1607,3775,22650,47300,24257,51075
150445,202306,10096,23736,8461,21341,177,536,7467,18452,7644,18988
150450,202306,8149,24211,7473,23259,256,1257,6791,20430,7047,21687
150460,202306,10864,29273,9493,27383,520,1241,7752,22879,8272,24120
150470,202306,25636,61200,21236,55155,565,2202,18260,45466,18825,47668
150475,202306,6941,18690,5423,16076,947,2568,3324,10178,4271,12746
150480,202306,17880,47559,15275,43510,3949,9856,8806,27084,12755,36940
150490,202306,10171,31222,8768,28983,794,2316,6578,22381,7372,24697
150495,202306,6834,18576,6060,17377,211,844,5201,14429,5412,15273
150497,202306,3337,9366,2358,7549,432,1406,1204,3888,1636,5294
150500,202306,3822,9009,3103,7828,195,502,2383,5751,2578,6253
150503,202306,7347,17277,4872,13849,1546,3868,1811,5677,3357,9545
150506,202306,17001,41695,13915,37293,2228,5584,9387,26145,11615,31729
150510,202306,16368,42141,13238,36656,1101,2829,10296,28281,11397,31110
150520,202306,10518,31068,9782,30013,137,737,9113,27439,9250,28176
150530,202306,15696,46775,12916,42467,1177,3404,9707,32166,10884,35570
150540,202306,6548,14697,5365,12892,340,780,4347,10242,4687,11022
150543,202306,9129,23196,6790,19591,650,1995,4691,13409,5341,15404
150548,202306,13093,34712,11038,31539,584,1583,9168,26137,9752,27720
150549,202306,2342,5812,1839,5025,107,347,1414,3782,1521,4129
150550,202306,25396,66783,17978,52664,5130,15088,6082,17711,11212,32799
150553,202306,51502,126525,34391,94653,9672,26548,13310,36033,22982,62581
150555,202306,2553,6018,1800,4833,149,380,1211,3275,1360,3655
150560,202306,2452,5993,1961,5091,209,546,1278,3201,1487,3747
150563,202306,3371,8772,2498,7198,578,1731,1250,3518,1828,5249
150565,202306,5633,16086,4545,14090,182,590,3501,10827,3683,11417
150570,202306,9947,23372,8641,21488,227,739,7658,18506,7885,19245
150580,202306,14704,49344,12114,46207,1660,5176,8919,35888,10579,41064
150590,202306,10584,30406,8783,28168,356,1225,7579,24335,7935,25560
150600,202306,13218,34460,11687,32297,489,1384,10138,27897,10627,29281
150610,202306,4058,9043,3376,7991,137,386,2810,6400,2947,6786
150611,202306,4085,9632,3295,8420,108,386,2741,6631,2849,7017
150613,202306,18341,45854,12364,35079,2587,7873,5495,14631,8082,22504
150616,202306,4721,11942,3038,8722,584,1746,1412,3870,1996,5616
150618,202306,9093,22682,6825,18852,1030,3069,4132,11100,5162,14169
150619,202306,8045,20514,6161,17672,1058,2691,3841,11360,4899,14051
150620,202306,9633,27778,7833,24316,1799,5169,3916,12474,5715,17643
150630,202306,9226,18908,8031,17304,141,350,7269,15207,7410,15557
150635,202306,6910,16214,5230,13273,604,1419,3332,8341,3936,9760
150640,202306,2559,6748,2219,6289,67,220,1934,5442,2001,5662
150650,202306,15271,36492,12118,31156,3565,8944,4756,12728,8321,21672
150655,202306,6924,17155,5838,15455,195,780,4811,12195,5006,12975
150658,202306,5440,14476,3552,11068,997,3263,1379,4205,2376,7468
150660,202306,6983,17737,5632,15483,1309,3428,2930,7956,4239,11384
150670,202306,12748,24715,9190,20220,1122,2687,6399,13718,7521,16405
150680,202306,99130,245376,72636,201833,16049,41100,37216,108217,53265,149317
150690,202306,3285,7068,2549,6046,149,323,2065,4835,2214,5158
150700,202306,8743,21739,7142,19288,953,1975,4944,13807,5897,15782
150710,202306,4732,13385,3954,12057,728,2247,2380,7250,3108,9497
150715,202306,6659,15590,5031,13139,376,1048,3889,9861,4265,10909
150720,202306,10638,25943,9157,23668,361,1211,7770,19227,8131,20438
150730,202306,16779,44246,13134,38381,2092,6315,8431,24726,10523,31041
150740,202306,5064,12347,3999,10578,456,959,2768,7409,3224,8368
150745,202306,7000,17064,5191,14279,701,2072,3420,9202,4121,11274
150746,202306,2167,5406,1817,4862,71,205,1464,3807,1535,4012
150747,202306,6814,16423,5718,14715,402,933,4536,11547,4938,12480
150750,202306,4798,12569,3583,10678,385,1143,2425,7340,2810,8483
150760,202306,14582,37335,12154,33385,2382,6012,7128,20195,9510,26207
150770,202306,8965,26189,7951,24877,262,615,7043,22525,7305,23140
150775,202306,1496,3469,1089,2908,106,331,741,1908,847,2239
150780,202306,6313,16656,5311,15323,252,756,4523,13102,4775,13858
150790,202306,7876,18245,6211,16206,533,1098,4127,12370,4660,13468
150795,202306,21317,54151,17312,47813,3245,8787,10171,28073,13416,36860
150796,202306,5126,10405,4035,9002,250,615,3274,7083,3524,7698
150797,202306,5652,14457,4537,12664,496,1329,3446,9505,3942,10834
150800,202306,18691,50195,15628,45622,2968,8180,9390,28220,12358,36400
150803,202306,11003,25053,9336,22555,306,862,8012,18522,8318,19384
150805,202306,4494,12143,3424,10375,416,1191,2355,7176,2771,8367
150808,202306,8245,22112,5554,17255,1885,6505,770,2420,2655,8925
150810,202306,27071,60024,19108,49087,4429,11008,9609,26355,14038,37363
150812,202306,8316,18843,6772,16224,450,1307,5119,11354,5569,12661
150815,202306,11706,31075,9275,27766,1537,4527,6343,19200,7880,23727
150820,202306,19060,38592,15489,33787,1543,2424,12010,27068,13553,29492
150830,202306,16415,45434,14581,42741,610,1649,12580,36837,13190,38486
150835,202306,4568,11954,3733,10630,420,1212,2592,7303,3012,8515
150840,202306,10811,26756,7770,21390,1060,3178,4501,11573,5561,14751
160005,202306,1857,3865,1520,3449,56,146,1294,2842,1350,2988
160010,202306,2769,6732,2404,6281,44,191,2171,5499,2215,5690
160015,202306,5113,10551,4390,9696,442,787,3695,8277,4137,9064
160020,202306,3222,8278,2672,7509,344,869,1893,5501,2237,6370
160021,202306,1602,5103,1313,4724,74,372,894,3256,968,3628
160023,202306,1764,5265,1467,4740,284,889,837,2806,1121,3695
160025,202306,2356,6112,2106,5807,149,301,1846,5170,1995,5471
160027,202306,14648,29728,12414,26687,915,1920,10145,21578,11060,23498
160030,202306,115684,268644,89065,230319,15941,39128,51400,135930,67341,175058
160040,202306,7898,22396,6729,20706,551,1523,5385,16700,5936,18223
160050,202306,8298,19790,6677,17678,2240,5180,3335,9835,5575,15015
160053,202306,5583,14189,4618,12693,257,630,3742,10413,3999,11043
160055,202306,2215,4234,2015,3993,29,68,1884,3657,1913,3725
160060,202306,39489,83196,30928,72457,3473,6749,22926,54567,26399,61316
160070,202306,4032,11882,3340,10802,436,1198,2357,8046,2793,9244
160080,202306,4066,10461,3402,9675,84,278,2994,8499,3078,8777
170025,202306,774,1929,409,1224,100,279,89,264,189,543
170030,202306,1365,3758,880,2739,187,552,297,944,484,1496
170035,202306,1694,4013,1076,2869,109,313,616,1533,725,1846
170040,202306,2204,5389,1499,4228,248,691,730,2111,978,2802
170070,202306,2349,4972,1441,3612,112,324,856,2057,968,2381
170100,202306,3011,7424,2143,5849,301,725,1331,3612,1632,4337
170105,202306,781,2059,453,1379,102,308,140,372,242,680
170110,202306,1307,3373,842,2503,73,261,470,1280,543,1541
170130,202306,1766,4353,1167,3285,100,337,742,1971,842,2308
170190,202306,1856,4328,1285,3354,152,484,794,1886,946,2370
170200,202306,2341,5195,1273,3286,262,656,472,1135,734,1791
170210,202306,33813,84052,21336,60361,5677,16720,3925,10976,9602,27696
170215,202306,1508,3639,1035,2867,98,336,682,1776,780,2112
170220,202306,6833,19379,5109,16108,2337,7381,972,3500,3309,10881
170230,202306,1492,3870,983,2834,183,546,428,1135,611,1681
170240,202306,3580,8157,2560,6444,228,648,1748,4133,1976,4781
170255,202306,4381,11659,2923,8871,506,1592,1402,4115,1908,5707
170270,202306,983,2282,613,1639,79,206,344,866,423,1072
170290,202306,3753,9188,3020,8040,301,578,2232,6134,2533,6712
170300,202306,2577,5829,1824,4613,134,374,1311,3097,1445,3471
170305,202306,803,2007,544,1476,90,244,251,671,341,915
170307,202306,1343,3672,992,2963,122,404,616,1686,738,2090
170310,202306,1913,4293,1189,3084,168,461,600,1457,768,1918
170320,202306,1248,3027,801,2239,100,307,450,1203,550,1510
170330,202306,1185,3189,984,2817,47,196,736,1953,783,2149
170360,202306,708,1625,462,1223,38,104,272,628,310,732
170370,202306,1596,3636,953,2507,133,395,511,1191,644,1586
170380,202306,2114,5538,1470,4431,116,372,842,2529,958,2901
170382,202306,585,1568,428,1277,18,77,265,705,283,782
170384,202306,2071,6262,1534,5120,295,958,737,2325,1032,3283
170386,202306,1131,2913,539,1657,69,235,187,512,256,747
170388,202306,840,2042,545,1512,88,251,293,756,381,1007
170389,202306,984,2850,692,2298,111,398,365,1211,476,1609
170390,202306,2160,4282,1438,3337,64,170,1122,2561,1186,2731
170410,202306,721,1646,473,1205,34,93,307,715,341,808
170460,202306,502,1254,328,937,40,121,181,483,221,604
170510,202306,1059,2689,643,1886,40,152,409,1080,449,1232
170550,202306,8153,19491,5402,14652,1364,3967,1865,4714,3229,8681
170555,202306,1630,3936,1083,2932,142,351,526,1406,668,1757
170560,202306,1132,2912,758,2281,102,284,406,1241,508,1525
170600,202306,1624,3969,1090,3064,161,417,603,1668,764,2085
170610,202306,1979,4554,1276,3327,96,309,832,1984,928,2293
170625,202306,517,1247,308,833,43,106,126,297,169,403
170650,202306,1800,4403,1339,3608,128,415,877,2185,1005,2600
170700,202306,4282,11388,2827,8296,563,1705,1154,3091,1717,4796
170710,202306,2064,4438,1362,3336,143,361,899,2103,1042,2464
170720,202306,2252,4918,1494,3704,145,340,1000,2361,1145,2701
170730,202306,1314,3151,832,2310,109,258,497,1364,606,1622
170740,202306,2398,6997,1865,5953,160,602,1317,4010,1477,4612
170755,202306,1028,2482,618,1737,114,336,273,678,387,1014
170765,202306,1331,3152,823,2228,138,367,411,1053,549,1420
170770,202306,2221,5670,1628,4650,129,412,1176,3202,1305,3614
170820,202306,4685,12182,3096,9167,631,1862,1366,3851,1997,5713
170825,202306,1274,2649,888,2066,82,184,653,1457,735,1641
170830,202306,1596,3775,1070,2869,312,881,388,889,700,1770
170900,202306,3720,9962,3004,8874,452,1220,2065,6154,2517,7374
170930,202306,4844,11869,3229,8737,723,2042,1122,2757,1845,4799
170950,202306,13987,35918,8089,24115,2355,7344,1053,2973,3408,10317
170980,202306,623,1428,341,914,45,123,155,389,200,512
171050,202306,1992,5535,1559,4740,129,402,1106,3330,1235,3732
171070,202306,1584,3946,1225,3368,257,610,621,1899,878,2509
171090,202306,1167,2872,834,2325,139,413,429,1134,568,1547
171110,202306,665,1696,385,1124,64,187,173,459,237,646
171150,202306,1135,2596,620,1709,121,393,292,676,413,1069
171180,202306,815,2147,432,1365,84,262,148,466,232,728
171190,202306,2393,6797,1858,5795,302,979,1004,3082,1306,4061
171195,202306,1005,2787,691,2141,94,324,388,1090,482,1414
171200,202306,726,1896,444,1359,107,354,116,313,223,667
171215,202306,484,1155,349,899,51,152,162,368,213,520
171240,202306,903,2626,620,2077,15,81,422,1323,437,1404
171245,202306,901,2399,592,1753,61,215,281,721,342,936
171250,202306,1100,2841,644,1952,93,286,243,713,336,999
171270,202306,578,1831,393,1401,73,298,183,606,256,904
171280,202306,1030,2775,735,2237,57,177,440,1302,497,1479
171320,202306,4747,12133,3069,8834,635,1828,1121,3136,1756,4964
171330,202306,3604,8888,2335,6542,594,1683,957,2531,1551,4214
171360,202306,1890,4625,1209,3527,126,334,715,2204,841,2538
171370,202306,816,1925,553,1517,71,218,321,807,392,1025
171380,202306,1639,4075,1172,3308,151,395,711,2012,862,2407
171395,202306,1180,2788,747,2061,112,314,411,1096,523,1410
171420,202306,2386,5853,1561,4255,267,714,803,2054,1070,2768
171430,202306,1289,3369,898,2579,82,251,537,1403,619,1654
171488,202306,2991,7460,2024,5706,359,1051,977,2594,1336,3645
171500,202306,1041,2441,616,1640,87,253,333,843,420,1096
171510,202306,1008,2813,762,2319,67,267,487,1354,554,1621
171515,202306,573,1280,371,949,37,116,233,524,270,640
171525,202306,851,2067,524,1462,61,182,308,774,369,956
171550,202306,407,1060,264,820,37,156,116,301,153,457
171570,202306,1301,3416,950,2723,143,410,541,1479,684,1889
171575,202306,1849,4473,1111,3116,126,349,613,1623,739,1972
171610,202306,7191,18712,4505,13567,1171,3804,804,2389,1975,6193
171620,202306,3608,7974,2849,6806,167,407,2243,5183,2410,5590
171630,202306,1321,3164,890,2479,136,381,511,1432,647,1813
171650,202306,2707,7140,1751,5243,456,1454,361,1007,817,2461
171660,202306,2746,6298,1689,4452,127,369,1156,2893,1283,3262
171665,202306,1472,3793,1002,2929,231,744,369,1011,600,1755
171670,202306,2167,5252,1446,3932,254,734,636,1577,890,2311
171700,202306,1356,3439,891,2515,136,371,504,1352,640,1723
171720,202306,870,2026,546,1456,62,164,332,857,394,1021
171750,202306,1607,4472,993,3206,206,661,293,1067,499,1728
171780,202306,1506,3434,960,2504,91,278,592,1421,683,1699
171790,202306,1615,4804,1194,3924,178,612,609,1897,787,2509
171800,202306,855,2067,555,1526,68,186,308,770,376,956
171820,202306,14360,36699,8856,26193,2014,6267,2201,6364,4215,12631
171830,202306,1856,5191,1465,4440,363,1002,653,2179,1016,3181
171840,202306,848,2011,537,1447,27,83,326,809,353,892
171845,202306,811,1795,524,1329,40,108,342,792,382,900
171850,202306,1231,3206,934,2598,45,178,720,1843,765,2021
171855,202306,1189,3331,821,2555,104,336,452,1315,556,1651
171865,202306,588,1510,417,1171,66,211,217,534,283,745
171870,202306,940,2368,560,1659,120,386,232,644,352,1030
171875,202306,1760,4196,1313,3460,56,234,1019,2502,1075,2736
171880,202306,1813,4180,1424,3588,62,187,1111,2695,1173,2882
171884,202306,1371,3155,918,2348,147,374,536,1318,683,1692
171886,202306,1744,4344,1103,3252,309,966,271,810,580,1776
171888,202306,677,1798,419,1257,37,130,242,659,279,789
171889,202306,508,1447,295,986,78,261,88,272,166,533
171890,202306,1567,4046,973,2920,110,356,545,1522,655,1878
171900,202306,680,2040,459,1552,63,191,225,752,288,943
172000,202306,663,1851,437,1355,77,246,149,434,226,680
172010,202306,1563,4233,1157,3453,110,292,733,2153,843,2445
172015,202306,435,1366,290,1039,58,223,123,401,181,624
172020,202306,3456,8695,2670,7411,283,786,1765,4856,2048,5642
172025,202306,857,2099,521,1474,38,121,344,896,382,1017
172030,202306,1463,3938,1082,3243,100,346,723,2056,823,2402
172049,202306,1389,3276,818,2373,109,300,425,1254,534,1554
172065,202306,1766,4021,1227,3234,155,365,650,1847,805,2212
172080,202306,2733,7267,1992,5820,123,394,1320,3735,1443,4129
172085,202306,490,1246,272,793,44,123,86,223,130,346
172090,202306,4922,10581,3570,8557,154,489,2759,6156,2913,6645
172093,202306,528,1456,344,1073,23,122,194,534,217,656
172097,202306,766,1849,418,1183,63,197,157,410,220,607
172100,202306,63938,145058,39391,101490,7158,19923,16681,39908,23839,59831
172110,202306,2076,6376,1610,5549,113,511,1192,3947,1305,4458
172120,202306,6257,16243,4258,12593,544,1602,2402,6899,2946,8501
172125,202306,480,1176,297,824,22,74,155,360,177,434
172130,202306,643,1534,416,1120,22,76,248,587,270,663
172208,202306,2975,6501,2078,5187,164,392,1458,3519,1622,3911
172210,202306,3139,6982,2145,5476,232,542,1410,3636,1642,4178
210005,202306,23787,60757,15765,46277,4308,13080,5909,16897,10217,29977
210010,202306,2648,6594,2326,6152,51,212,2075,5353,2126,5565
210015,202306,3763,10046,3052,8962,136,429,2478,7157,2614,7586
210020,202306,9570,18622,7750,16367,436,734,6560,13749,6996,14483
210030,202306,5392,16099,4605,14777,464,1566,3423,10720,3887,12286
210040,202306,2538,5017,2091,4443,67,183,1813,3713,1880,3896
210043,202306,6797,17480,5329,15215,362,1142,3979,11126,4341,12268
210047,202306,8295,21695,6204,18732,184,751,5082,15096,5266,15847
210050,202306,2981,8041,2230,6593,188,742,1602,4424,1790,5166
210055,202306,2562,6549,2113,5834,55,155,1796,4992,1851,5147
210060,202306,8697,28766,7302,26054,931,3364,4721,17065,5652,20429
210070,202306,8020,18602,6973,17144,149,419,6232,15054,6381,15473
210080,202306,5356,14573,4841,13899,84,386,4260,11989,4344,12375
210083,202306,7211,16500,5883,14932,124,479,5350,13250,5474,13729
210087,202306,3129,8052,2516,7168,125,393,2046,5737,2171,6130
210090,202306,10812,29603,9442,27216,552,1305,7765,22257,8317,23562
210095,202306,7309,22607,6276,20947,703,2292,4506,15495,5209,17787
210100,202306,7605,20859,6028,17823,881,2448,3682,10850,4563,13298
210110,202306,3719,9210,3253,8581,62,273,2861,7338,2923,7611
210120,202306,35162,75019,27093,63576,1227,2580,21549,48861,22776,51441
210125,202306,5458,12908,4460,11605,908,1834,2935,8203,3843,10037
210130,202306,4908,11293,3756,9745,64,193,3292,8406,3356,8599
210135,202306,2152,4709,1681,3991,55,148,1445,3338,1500,3486
210140,202306,25528,61047,17614,48482,2446,6561,10100,26909,12546,33470
210150,202306,5554,11857,4484,10291,101,283,3779,8348,3880,8631
210160,202306,26463,59354,21171,52030,1827,3877,15855,38746,17682,42623
210170,202306,21292,53601,18280,49189,2034,4763,13278,36270,15312,41033
210173,202306,2558,8305,2327,7891,81,363,2024,6705,2105,7068
210177,202306,3820,9556,3105,8555,435,1100,2192,6151,2627,7251
210180,202306,1839,4084,1490,3591,44,122,1272,3033,1316,3155
210190,202306,6851,15001,5317,12701,110,251,4626,10787,4736,11038
210193,202306,1577,3982,1264,3469,56,189,968,2608,1024,2797
210197,202306,2340,6521,1958,5913,160,437,1490,4546,1650,4983
210200,202306,9630,26288,7990,23637,713,2188,5914,17163,6627,19351
210203,202306,8167,21716,6421,19218,609,1745,4729,14306,5338,16051
210207,202306,4526,10079,3395,8580,197,542,2586,6431,2783,6973
210210,202306,8804,24572,7564,22732,221,1027,6162,18031,6383,19058
210215,202306,2883,8127,2402,7372,157,639,1888,5636,2045,6275
210220,202306,8498,23298,7580,21805,338,1491,6366,17425,6704,18916
210230,202306,6859,17224,5894,15614,187,524,5194,13517,5381,14041
210232,202306,14536,38742,11321,33633,1488,4273,7540,22578,9028,26851
210235,202306,3965,10675,3220,9444,151,513,2578,7418,2729,7931
210237,202306,5026,10759,4113,9659,56,159,3772,8638,3828,8797
210240,202306,3023,8127,2548,7326,115,307,2017,5745,2132,6052
210250,202306,7180,17574,6251,16324,137,493,5535,14129,5672,14622
210255,202306,3142,8569,2348,6955,273,844,1405,3943,1678,4787
210260,202306,6317,16587,5218,14868,477,1447,4040,11241,4517,12688
210270,202306,5680,13665,4725,12360,177,661,3981,10092,4158,10753
210275,202306,3939,9038,3131,7976,175,399,2483,6296,2658,6695
210280,202306,7606,17147,5916,14508,152,637,4702,10703,4854,11340
210290,202306,9903,21529,8423,19663,142,398,7718,17629,7860,18027
210300,202306,37733,95949,28363,80817,7524,21381,10923,34171,18447,55552
210310,202306,3575,7946,2940,7031,39,109,2649,6223,2688,6332
210312,202306,3461,7198,2919,6559,39,152,2610,5645,2649,5797
210315,202306,4352,9519,3746,8813,125,325,3422,7953,3547,8278
210317,202306,5157,14234,4523,13361,133,536,3977,11583,4110,12119
210320,202306,33479,70589,29563,65437,395,1461,26929,57881,27324,59342
210325,202306,4113,10693,3098,9165,521,1677,1976,5640,2497,7317
210330,202306,31685,74769,23669,63867,3282,7086,15645,45252,18927,52338
210340,202306,15160,33188,12552,29477,661,1331,10146,23792,10807,25123
210350,202306,11615,27837,9679,25079,180,579,8404,21252,8584,21831
210355,202306,4378,13343,3670,12103,101,526,2978,9610,3079,10136
210360,202306,14811,42406,12183,37632,680,2761,8667,25537,9347,28298
210370,202306,14548,27177,10444,22739,294,509,9507,20720,9801,21229
210375,202306,3794,9677,2467,7434,906,2761,468,1445,1374,4206
210380,202306,6620,15209,5255,13324,225,646,4305,10584,4530,11230
210390,202306,3845,9645,3404,8945,100,377,2962,7596,3062,7973
210400,202306,5428,13695,4387,12226,261,582,3648,10191,3909,10773
210405,202306,8808,20310,6458,16698,960,2275,3852,9881,4812,12156
210407,202306,2445,6909,1918,5887,165,462,1394,4248,1559,4710
210408,202306,3256,10436,2899,9874,171,722,2268,7671,2439,8393
210409,202306,4543,13707,3795,12421,266,1068,2754,8947,3020,10015
210410,202306,4332,11255,3324,9291,89,331,2617,6973,2706,7304
210420,202306,4523,12999,3683,11410,226,706,2909,8854,3135,9560
210430,202306,2681,6981,2200,6232,182,516,1758,4914,1940,5430
210440,202306,4967,12179,3957,10696,199,438,3331,8910,3530,9348
210450,202306,2659,7012,2131,6145,272,622,1474,4363,1746,4985
210455,202306,5876,13541,4117,10993,979,2712,1787,4567,2766,7279
210460,202306,3926,10341,3048,9026,128,439,2404,6952,2532,7391
210462,202306,1970,5334,1514,4574,58,184,1156,3463,1214,3647
210465,202306,3124,8014,2563,7171,122,432,2115,5752,2237,6184
210467,202306,7279,18977,5941,17015,841,2282,4180,12086,5021,14368
210470,202306,2003,5269,1436,4340,179,502,956,2889,1135,3391
210480,202306,19905,53183,15513,46988,2129,4802,10265,33646,12394,38448
210490,202306,3851,8718,2837,7296,106,302,2343,5917,2449,6219
210500,202306,7544,24841,6632,23115,379,1490,5348,18255,5727,19745
210510,202306,8075,20719,6770,19009,183,698,6038,16619,6221,17317
210515,202306,4362,11582,3519,10407,226,713,2810,8291,3036,9004
210520,202306,3027,7964,2497,7131,160,466,1983,5509,2143,5975
210530,202306,67360,151723,45672,116160,8784,23218,21055,53275,29839,76493
210535,202306,4464,12161,3815,11144,154,497,3237,9314,3391,9811
210540,202306,18021,46454,13910,39911,2235,5850,8310,24776,10545,30626
210542,202306,7501,16327,5230,13431,568,1456,3735,9468,4303,10924
210545,202306,2470,7047,2108,6361,70,289,1688,4924,1758,5213
210547,202306,4337,13840,3673,12605,281,894,2745,9630,3026,10524
210550,202306,6757,18938,4764,15400,656,2154,2635,8540,3291,10694
210560,202306,4304,12155,3547,10805,122,380,2917,8691,3039,9071
210565,202306,1775,4615,1379,4020,106,343,983,2837,1089,3180
210570,202306,12709,31808,10585,28762,313,845,8919,23934,9232,24779
210580,202306,3391,7915,2450,6561,209,535,1736,4786,1945,5321
210590,202306,4752,12905,3780,11476,90,409,3152,9321,3242,9730
210592,202306,3350,8217,2903,7415,44,169,2465,6039,2509,6208
210594,202306,2836,7417,1996,5965,231,658,1347,4054,1578,4712
210596,202306,3462,10302,2904,9315,348,1118,2093,6803,2441,7921
210598,202306,2399,5828,2049,5332,118,337,1710,4370,1828,4707
210600,202306,3523,8895,2629,7468,358,967,1657,4665,2015,5632
210610,202306,3699,8490,2840,7241,72,265,2344,5728,2416,5993
210620,202306,3543,7764,2736,6708,142,312,2284,5489,2426,5801
210630,202306,3729,10542,3098,9343,247,803,2287,6697,2534,7500
210632,202306,7264,16500,6211,15030,176,555,5421,12692,5597,13247
210635,202306,1831,6068,1639,5675,191,577,1194,4236,1385,4813
210637,202306,3145,8773,2491,7732,159,565,1882,5829,2041,6394
210640,202306,5893,16720,5316,15990,84,415,4730,13960,4814,14375
210650,202306,8136,20469,6829,18578,135,449,5882,15764,6017,16213
210660,202306,9337,24301,7801,21680,177,756,6610,17604,6787,18360
210663,202306,3607,8155,3037,7379,324,601,2221,5706,2545,6307
210667,202306,2236,6429,1887,5858,88,331,1517,4644,1605,4975
210670,202306,6867,17154,5894,15590,162,620,5089,12992,5251,13612
210675,202306,6528,14423,5208,12649,633,1378,3873,9438,4506,10816
210680,202306,5803,11717,4672,10325,90,214,4300,9350,4390,9564
210690,202306,11289,25298,8893,22144,241,689,7845,18856,8086,19545
210700,202306,3213,7857,2414,6637,171,407,1799,4894,1970,5301
210710,202306,6344,16334,5329,14885,115,435,4642,12714,4757,13149
210720,202306,3561,10031,2939,9173,111,448,2481,7635,2592,8083
210725,202306,1535,4372,1156,3636,44,120,839,2687,883,2807
210730,202306,1729,3567,1341,3021,51,98,1163,2607,1214,2705
210735,202306,5254,13262,4143,11681,376,938,3173,9172,3549,10110
210740,202306,6211,13958,4915,12291,123,279,4085,9968,4208,10247
210745,202306,4926,11990,4096,10761,131,479,3440,8753,3571,9232
210750,202306,31768,75322,25020,64589,4152,9254,14815,39367,18967,48621
210760,202306,7625,15667,6151,13981,138,310,5584,12674,5722,12984
210770,202306,7376,16244,5871,14304,86,328,5235,12403,5321,12731
210780,202306,8639,23864,6839,20653,521,1639,5014,14713,5535,16352
210790,202306,5192,14143,4325,12820,305,856,3291,9867,3596,10723
210800,202306,5756,13686,4676,12126,88,353,4048,10130,4136,10483
210805,202306,4990,15351,4337,14220,245,912,3376,10859,3621,11771
210810,202306,5844,15168,4905,13761,465,1129,3782,10789,4247,11918
210820,202306,8375,21698,6440,18329,1027,2741,3557,10210,4584,12951
210825,202306,10329,23442,8983,21577,238,726,8079,18803,8317,19529
210830,202306,10579,24408,9063,22316,916,1626,7122,18121,8038,19747
210840,202306,6004,10316,5211,9303,37,130,4916,8499,4953,8629
210845,202306,7272,17274,5847,15457,132,365,5205,13601,5337,13966
210850,202306,8454,21866,6701,19116,488,1451,5150,14367,5638,15818
210860,202306,25574,55938,19625,48086,1475,3048,15321,38100,16796,41148
210870,202306,8795,19171,6614,16456,201,449,5708,13999,5909,14448
210880,202306,4871,12999,3942,11502,279,960,2904,8240,3183,9200
210890,202306,5948,13007,5106,11769,169,448,4486,9988,4655,10436
210900,202306,5747,15037,3981,11658,1432,4176,825,2660,2257,6836
210905,202306,2715,5587,2220,4942,45,100,2072,4572,2117,4672
210910,202306,8671,24370,6462,20245,1150,3490,3484,10702,4634,14192
210920,202306,3671,10186,3104,9354,91,382,2687,7890,2778,8272
210923,202306,2319,5172,1878,4482,88,195,1500,3457,1588,3652
210927,202306,5412,16269,4411,14706,766,2380,2619,9012,3385,11392
210930,202306,3443,8886,2866,7880,90,341,2433,6391,2523,6732
210940,202306,4049,10868,3435,10035,272,1183,2702,7233,2974,8416
210945,202306,10058,22779,8534,20808,690,1248,6677,16649,7367,17897
210950,202306,6376,15736,4618,13105,589,1361,2979,8848,3568,10209
210955,202306,1774,4865,1360,4141,188,537,828,2486,1016,3023
210960,202306,10927,29297,8514,25005,3340,9620,2468,8064,5808,17684
210970,202306,2076,4791,1589,3941,88,238,1268,2959,1356,3197
210975,202306,1987,5528,1665,4963,219,661,1150,3358,1369,4019
210980,202306,12650,24524,10800,22385,214,406,9912,20267,10126,20673
210990,202306,21338,52168,15455,43479,1656,4149,10328,29401,11984,33550
211000,202306,17089,43633,13176,38083,2960,7494,7889,24105,10849,31599
211003,202306,7505,17379,6016,15471,153,625,5044,12605,5197,13230
211010,202306,8269,23444,7242,22039,160,736,6244,18735,6404,19471
211020,202306,11138,25893,9304,23602,237,694,8066,20317,8303,21011
211023,202306,2451,6987,2092,6386,132,369,1635,4890,1767,5259
211027,202306,4723,11501,4237,10737,97,337,3819,9417,3916,9754
211030,202306,4474,11214,3730,10056,381,996,2715,7330,3096,8326
211040,202306,5226,16495,4569,15331,148,725,3918,12866,4066,13591
211050,202306,10781,24237,9067,21924,173,541,7871,18613,8044,19154
211060,202306,9197,22386,7947,20535,246,818,6837,17095,7083,17913
211065,202306,2941,6752,2273,5827,123,276,1903,4856,2026,5132
211070,202306,10085,26901,8070,23634,369,1191,6574,18845,6943,20036
211080,202306,1552,3730,1141,3040,27,114,860,2092,887,2206
211085,202306,2582,6391,1989,5553,215,485,1456,4213,1671,4698
211090,202306,3675,9036,3144,8308,49,174,2788,7199,2837,7373
211100,202306,9052,18347,7968,17000,80,199,7317,15337,7397,15536
211102,202306,3900,10972,3347,10071,481,1441,2362,7034,2843,8475
211105,202306,2723,7605,2198,6660,127,373,1686,4980,1813,5353
211107,202306,5438,15442,4279,13496,168,561,3317,10571,3485,11132
211110,202306,7638,17648,5726,14584,295,903,4586,11206,4881,12109
211120,202306,61527,133624,46055,112168,7616,16873,27960,68957,35576,85830
211125,202306,2142,5820,1650,5010,36,148,1347,3989,1383,4137
211130,202306,227957,488585,179619,414281,23303,48514,117487,269737,140790,318251
211140,202306,5484,14574,4389,12876,166,506,3540,10221,3706,10727
211150,202306,11492,26917,8971,23352,560,1139,6891,18333,7451,19472
211153,202306,3573,8641,2266,6823,422,1104,1274,4054,1696,5158
211157,202306,1503,4137,1206,3573,104,332,801,2303,905,2635
211160,202306,6502,14099,4846,11572,183,654,3789,8360,3972,9014
211163,202306,1718,4955,1463,4534,80,265,1161,3611,1241,3876
211167,202306,2050,5202,1796,4813,42,133,1567,4123,1609,4256
211170,202306,8751,16977,7576,15461,108,283,6990,13874,7098,14157
211172,202306,3000,7563,2328,6463,95,317,1854,4896,1949,5213
211174,202306,3399,8565,2919,7960,53,225,2643,7070,2696,7295
211176,202306,4895,12526,3564,10427,238,748,2710,7712,2948,8460
211178,202306,6443,12150,5348,10942,48,194,5060,10112,5108,10306
211180,202306,4902,14282,4204,13113,177,692,3370,10257,3547,10949
211190,202306,3809,9372,3093,8263,49,214,2686,6953,2735,7167
211195,202306,1902,4375,1527,3776,71,170,1282,3104,1353,3274
211200,202306,2449,6713,1701,5276,174,573,1137,3383,1311,3956
211210,202306,7110,19831,5907,17871,581,1763,4314,12916,4895,14679
211220,202306,53027,112895,40545,95490,3874,8549,29293,67348,33167,75897
211223,202306,6227,15118,4563,12567,617,1720,2667,7179,3284,8899
211227,202306,1985,5529,1633,4984,61,242,1296,3929,1357,4171
211230,202306,10278,24876,8242,21769,313,756,6885,17923,7198,18679
211240,202306,12580,28077,11488,26683,161,588,10753,24408,10914,24996
211245,202306,9029,18912,7466,17148,196,472,6851,15412,7047,15884
211250,202306,18300,46722,15684,42396,1356,3728,11978,31652,13334,35380
211260,202306,9868,26906,8097,24641,285,1021,6928,20948,7213,21969
211270,202306,11931,33064,9766,30014,418,1516,7671,23427,8089,24943
211280,202306,19364,40625,16275,36400,351,900,14596,31703,14947,32603
211285,202306,2412,6725,2009,6086,193,634,1396,4134,1589,4768
211290,202306,8457,22549,6965,20060,407,1272,5275,14833,5682,16105
211300,202306,8315,22312,6698,19436,470,1469,4811,13503,5281,14972
211400,202306,13844,33962,10520,28924,1486,3802,6715,18948,8201,22750
220005,202306,2353,5268,1944,4608,72,178,1620,3668,1692,3846
220010,202306,1773,4414,1314,3567,87,183,968,2590,1055,2773
220020,202306,5612,11750,4481,10076,269,525,3753,8219,4022,8744
220025,202306,2720,5310,2135,4409,55,101,1799,3567,1854,3668
220027,202306,1645,3486,1291,2936,33,92,1084,2358,1117,2450
220030,202306,4654,9680,3915,8547,117,250,3437,7285,3554,7535
220040,202306,9952,26291,7910,22292,1504,3887,4360,12489,5864,16376
220045,202306,1937,4836,1472,4040,50,219,1165,2977,1215,3196
220050,202306,6807,14261,5475,12421,84,289,4839,10423,4923,10712
220060,202306,3454,5842,2719,4950,82,127,2470,4402,2552,4529
220070,202306,2797,6423,2123,5417,87,247,1669,4098,1756,4345
220080,202306,875,2239,674,1891,20,81,526,1391,546,1472
220090,202306,2024,4278,1485,3428,58,142,1176,2629,1234,2771
220095,202306,1219,2158,1025,1893,28,66,927,1633,955,1699
220100,202306,1666,3955,1185,3142,37,122,917,2247,954,2369
220105,202306,2364,6422,1872,5554,173,563,1303,3785,1476,4348
220110,202306,4230,9868,3338,8397,79,309,2779,6750,2858,7059
220115,202306,3455,8699,2858,7719,175,530,2190,5681,2365,6211
220117,202306,1583,3386,1135,2690,24,73,912,2059,936,2132
220120,202306,20801,39425,17973,35775,209,581,16435,31776,16644,32357
220130,202306,1323,3086,1038,2677,37,140,885,2165,922,2305
220140,202306,2835,5085,2144,4233,82,145,1795,3521,1877,3666
220150,202306,7884,19543,6559,17128,183,596,5305,13215,5488,13811
220155,202306,1402,3650,1029,2940,29,98,739,2019,768,2117
220157,202306,1312,2771,1020,2331,47,111,793,1742,840,1853
220160,202306,3455,8246,2632,6723,74,237,2081,5069,2155,5306
220170,202306,1802,4371,1366,3689,39,145,1089,2842,1128,2987
220173,202306,2492,6288,1765,4938,55,165,1384,3709,1439,3874
220177,202306,2862,6134,2542,5728,36,131,2333,5037,2369,5168
220180,202306,1380,2822,1036,2224,7,28,889,1778,896,1806
220190,202306,10200,20145,7896,16972,627,1167,5733,12313,6360,13480
220191,202306,1973,5156,1660,4585,139,413,1206,3200,1345,3613
220192,202306,2399,5681,1620,4308,57,185,1267,3283,1324,3468
220194,202306,2259,5292,1760,4340,39,160,1456,3357,1495,3517
220196,202306,2557,5768,2147,5072,26,108,1799,4066,1825,4174
220198,202306,1556,3424,1258,3031,19,58,1123,2696,1142,2754
220200,202306,5959,15552,4936,13982,187,670,3958,10900,4145,11570
220202,202306,2537,6148,1994,5229,32,128,1654,4140,1686,4268
220205,202306,3260,7486,2687,6437,64,194,2227,5124,2291,5318
220207,202306,928,2434,731,2084,80,201,431,1225,511,1426
220208,202306,2130,5883,1608,4855,455,1420,611,1788,1066,3208
220209,202306,1852,4897,1393,3964,25,100,1059,2888,1084,2988
220210,202306,2273,4595,1785,3841,37,84,1528,3150,1565,3234
220211,202306,2001,4146,1680,3689,38,121,1425,3016,1463,3137
220213,202306,2137,4950,1633,4012,43,121,1263,2882,1306,3003
220217,202306,2928,6975,2542,6487,161,307,2182,5675,2343,5982
220220,202306,16615,32828,13206,27644,392,930,11205,22467,11597,23397
220225,202306,1206,2644,932,2272,17,70,821,1925,838,1995
220230,202306,6912,15032,5299,12537,346,672,4229,9776,4575,10448
220240,202306,3946,9659,3012,7993,92,322,2382,6009,2474,6331
220245,202306,2505,4336,1769,3441,25,73,1594,3003,1619,3076
220250,202306,3657,8718,3010,7859,53,182,2654,6773,2707,6955
220253,202306,1992,4802,1536,4059,34,106,1255,3199,1289,3305
220255,202306,2402,4958,1915,4253,53,169,1628,3420,1681,3589
220260,202306,6253,15048,4982,12793,275,733,3873,9679,4148,10412
220265,202306,1890,4820,1582,4323,72,240,1265,3281,1337,3521
220270,202306,7328,21036,6416,19206,193,765,5239,14831,5432,15596
220271,202306,1789,3934,1445,3379,59,136,1205,2738,1264,2874
220272,202306,2063,5336,1632,4494,56,174,1225,3194,1281,3368
220273,202306,1499,3935,1127,3233,64,202,811,2280,875,2482
220275,202306,3109,5894,2285,4763,83,142,1959,3988,2042,4130
220277,202306,2815,5841,2126,4775,99,194,1746,3751,1845,3945
220280,202306,2398,4336,1901,3697,20,43,1709,3244,1729,3287
220285,202306,2027,4017,1630,3515,25,77,1457,3037,1482,3114
220290,202306,8375,20446,6082,16870,576,1408,4043,11297,4619,12705
220300,202306,2277,5912,1638,4958,61,268,1221,3544,1282,3812
220310,202306,3875,8947,2822,7518,109,338,2292,5977,2401,6315
220320,202306,3681,9286,2663,7470,62,279,2068,5514,2130,5793
220323,202306,2039,5015,1452,4014,55,198,1159,3017,1214,3215
220325,202306,1442,3932,1086,3254,34,128,807,2325,841,2453
220327,202306,2003,4850,1584,4130,58,222,1244,3022,1302,3244
220330,202306,6607,12975,5281,11297,130,355,4569,9375,4699,9730
220335,202306,2232,5486,1915,4996,134,294,1524,3953,1658,4247
220340,202306,2083,5191,1418,3984,133,408,817,2189,950,2597
220342,202306,1495,3659,1224,3203,121,234,906,2428,1027,2662
220345,202306,3568,7207,2474,5635,33,93,2117,4623,2150,4716
220350,202306,3859,8920,2737,7019,222,572,1843,4545,2065,5117
220360,202306,1593,3542,1140,2784,28,89,899,2068,927,2157
220370,202306,10971,27054,9185,24010,480,1265,7384,18691,7864,19956
220375,202306,2060,4791,1719,4337,29,101,1579,3911,1608,4012
220380,202306,1865,3719,1353,2993,25,52,1158,2520,1183,2572
220385,202306,1126,2205,818,1680,8,25,727,1440,735,1465
220390,202306,16053,33549,11584,26546,1968,4510,6419,14144,8387,18654
220400,202306,1818,3887,1227,2908,28,92,955,2094,983,2186
220410,202306,1410,3443,1030,2758,31,115,815,2064,846,2179
220415,202306,988,2326,729,1856,24,51,542,1333,566,1384
220420,202306,2179,5678,1552,4423,136,421,990,2668,1126,3089
220430,202306,3545,7491,2890,6562,57,123,2512,5546,2569,5669
220435,202306,2489,5259,1974,4409,41,114,1629,3466,1670,3580
220440,202306,3961,8959,3196,7815,73,313,2726,6222,2799,6535
220450,202306,3326,7282,2582,6224,56,206,2176,5031,2232,5237
220455,202306,1735,4202,1525,3899,32,101,1278,3176,1310,3277
220460,202306,1392,2783,1180,2460,28,54,1011,2022,1039,2076
220465,202306,2922,7788,2400,6897,171,455,1816,5107,1987,5562
220470,202306,4653,11053,3633,9195,206,452,2736,6727,2942,7179
220480,202306,3141,7435,2179,5747,257,520,1393,3659,1650,4179
220490,202306,2866,6321,2218,5370,41,126,1907,4467,1948,4593
220500,202306,3984,8547,2978,6888,147,308,2311,5105,2458,5413
220510,202306,3242,7521,2419,6051,141,352,1841,4571,1982,4923
220515,202306,2191,4451,1850,3922,73,120,1570,3277,1643,3397
220520,202306,6271,13843,5174,12058,134,342,4326,9763,4460,10105
220525,202306,1658,3529,1292,3047,45,111,1117,2617,1162,2728
220527,202306,1994,4190,1552,3488,78,160,1358,3019,1436,3179
220530,202306,2023,4046,1542,3423,157,334,1098,2443,1255,2777
220535,202306,950,2340,819,2104,15,47,637,1524,652,1571
220540,202306,3834,10622,3251,9457,231,668,2451,6996,2682,7664
220545,202306,1818,4672,1493,4123,78,266,1232,3288,1310,3554
220550,202306,10414,29425,8434,25419,605,1943,5677,16226,6282,18169
220551,202306,1743,4136,1401,3526,22,62,1171,2839,1193,2901
220552,202306,1897,4952,1411,4031,28,113,1113,2988,1141,3101
220553,202306,2576,5055,1980,4219,25,53,1801,3771,1826,3824
220554,202306,1160,2521,836,2006,63,122,611,1422,674,1544
220555,202306,4755,8538,3925,7488,57,161,3434,6433,3491,6594
220556,202306,1545,3846,1110,2970,48,200,733,1725,781,1925
220557,202306,2289,5949,1541,4391,98,341,1112,2993,1210,3334
220558,202306,1756,4023,1315,3367,32,118,1083,2643,1115,2761
220559,202306,2209,4694,1697,3836,71,106,1386,3111,1457,3217
220560,202306,2354,4414,1863,3804,38,107,1682,3326,1720,3433
220570,202306,9884,25222,8343,22644,779,1962,6028,16028,6807,17990
220580,202306,8093,19311,6827,17295,141,427,5903,14622,6044,15049
220585,202306,2505,6856,1864,5524,77,225,1435,4148,1512,4373
220590,202306,2007,4188,1539,3459,105,220,1234,2692,1339,2912
220595,202306,3350,7959,2747,7020,77,274,2239,5453,2316,5727
220600,202306,2225,3754,1773,3216,22,32,1653,2941,1675,2973
220605,202306,1696,4566,1330,3828,30,126,1014,2794,1044,2920
220610,202306,3534,8316,3065,7604,40,105,2812,6861,2852,6966
220620,202306,10829,25862,9196,23363,161,670,8113,19855,8274,20525
220630,202306,429,1128,302,899,29,93,178,473,207,566
220635,202306,2137,5595,1705,4706,59,188,1370,3636,1429,3824
220640,202306,2835,7003,2282,6094,78,266,1779,4570,1857,4836
220650,202306,2965,6577,2372,5634,67,152,1981,4628,2048,4780
220660,202306,3079,8389,2345,7041,79,331,1893,5485,1972,5816
220665,202306,1686,4155,1324,3531,33,146,1136,2872,1169,3018
220667,202306,1901,4970,1609,4446,74,214,1265,3405,1339,3619
220669,202306,1968,5166,1702,4694,34,121,1484,3947,1518,4068
220670,202306,2823,5920,2087,4841,42,131,1791,4008,1833,4139
220672,202306,4106,8976,3173,7736,112,373,2633,6130,2745,6503
220675,202306,1528,3742,1259,3235,101,277,922,2281,1023,2558
220680,202306,3760,7822,3369,7321,172,280,2952,6392,3124,6672
220690,202306,1864,4360,1361,3478,109,304,937,2249,1046,2553
220695,202306,1106,2736,925,2414,27,76,766,1957,793,2033
220700,202306,15325,29301,11619,23987,433,962,9461,18523,9894,19485
220710,202306,1051,2541,699,1933,29,100,528,1385,557,1485
220720,202306,2690,5349,2196,4654,34,86,1900,3870,1934,3956
220730,202306,1695,3858,1316,3207,19,71,1100,2524,1119,2595
220735,202306,1206,2425,840,1828,53,117,631,1316,684,1433
220740,202306,1613,3718,1170,3063,78,191,906,2337,984,2528
220750,202306,5279,10893,4285,9487,238,382,3693,8157,3931,8539
220755,202306,1825,3669,1339,2920,45,89,1099,2327,1144,2416
220760,202306,4205,8950,3451,7960,63,210,3097,6916,3160,7126
220770,202306,34838,86267,27211,72303,7622,20882,10646,27357,18268,48239
220775,202306,1767,3623,1477,3261,18,50,1381,3003,1399,3053
220777,202306,1824,4122,1339,3337,36,73,928,2411,964,2484
220779,202306,1422,3452,1133,2988,59,137,909,2350,968,2487
220780,202306,7283,15557,6108,13773,433,916,4641,10316,5074,11232
220785,202306,1741,3463,1433,3057,25,56,1331,2789,1356,2845
220790,202306,12613,30362,10577,27147,306,1008,8667,21627,8973,22635
220793,202306,1183,2628,892,2134,25,76,756,1760,781,1836
220795,202306,1636,3751,1309,3259,51,138,1105,2667,1156,2805
220800,202306,26461,49688,20612,41225,2136,4411,15201,28735,17337,33146
220810,202306,3727,8944,2878,7523,80,198,2204,5755,2284,5953
220820,202306,7377,15248,6022,13168,308,544,5029,10884,5337,11428
220830,202306,9343,20790,7676,18125,441,977,5922,13415,6363,14392
220840,202306,16553,40888,12858,33655,1567,3980,8447,21087,10014,25067
220850,202306,3531,9623,2965,8774,78,316,2505,7261,2583,7577
220855,202306,1053,1963,864,1719,22,45,785,1541,807,1586
220860,202306,1497,2892,1190,2461,23,63,1074,2144,1097,2207
220865,202306,2667,6644,1846,5097,50,212,1320,3401,1370,3613
220870,202306,3971,8784,2989,7394,64,217,2542,6033,2606,6250
220880,202306,8175,14469,6636,12576,180,376,5894,10904,6074,11280
220885,202306,1827,4356,1448,3770,109,304,1121,2852,1230,3156
220887,202306,1978,3600,1521,2978,49,71,1391,2681,1440,2752
220890,202306,1669,4453,1281,3763,52,184,975,2767,1027,2951
220900,202306,2602,5184,2031,4386,40,114,1750,3603,1790,3717
220910,202306,2180,4653,1693,3882,262,424,1207,2881,1469,3305
220915,202306,1078,2677,744,2047,35,101,522,1341,557,1442
220920,202306,1948,4922,1570,4347,117,334,1194,3237,1311,3571
220930,202306,2385,5015,1849,4292,43,123,1575,3632,1618,3755
220935,202306,1253,3285,909,2560,23,98,603,1575,626,1673
220937,202306,1755,4056,1313,3269,40,134,1043,2443,1083,2577
220940,202306,2284,4745,1736,3853,54,138,1413,2967,1467,3105
220945,202306,585,1796,413,1432,38,166,249,818,287,984
220950,202306,1625,3333,1044,2440,14,35,846,1843,860,1878
220955,202306,2033,4344,1497,3449,45,139,1252,2752,1297,2891
220960,202306,877,2066,578,1541,43,143,361,872,404,1015
220965,202306,2255,5087,1809,4367,33,141,1575,3636,1608,3777
220970,202306,2596,4996,1816,3867,26,90,1572,3197,1598,3287
220975,202306,915,2095,677,1733,21,72,574,1388,595,1460
220980,202306,1593,3600,1326,3188,33,95,1116,2564,1149,2659
220985,202306,1770,3721,1380,3049,100,180,1056,2267,1156,2447
220987,202306,1801,4539,1491,3996,52,187,1224,3176,1276,3363
220990,202306,1956,4819,1581,4189,35,129,1270,3263,1305,3392
220995,202306,1712,3783,1319,3132,23,61,1125,2587,1148,2648
220997,202306,2891,7364,2500,6689,63,241,2096,5343,2159,5584
221000,202306,5866,13468,4622,11489,226,633,3587,8517,3813,9150
221005,202306,1986,4335,1703,3850,32,106,1416,3009,1448,3115
221010,202306,1539,2928,1124,2391,33,84,944,1912,977,1996
221020,202306,1803,4924,1441,4211,32,116,1104,3130,1136,3246
221030,202306,2057,4072,1598,3436,25,77,1418,2987,1443,3064
221035,202306,1893,4119,1424,3422,54,110,1172,2755,1226,2865
221037,202306,841,2007,612,1568,15,56,459,1074,474,1130
221038,202306,611,1518,435,1199,34,84,296,789,330,873
221039,202306,984,2414,759,2043,32,102,586,1508,618,1610
221040,202306,5395,13546,4046,11094,274,774,2967,7822,3241,8596
221050,202306,5636,11010,4624,9541,95,225,4179,8423,4274,8648
221060,202306,11870,28059,8878,22820,473,1133,6726,16677,7199,17810
221062,202306,1633,4074,1283,3499,116,271,929,2518,1045,2789
221063,202306,1515,3520,1137,2825,44,121,902,2127,946,2248
221065,202306,3576,7503,2871,6367,29,76,2558,5510,2587,5586
221070,202306,3973,10927,2967,8866,482,1373,1699,5120,2181,6493
221080,202306,4373,9323,3367,7817,66,204,2722,5910,2788,6114
221090,202306,1669,3584,1292,2977,20,47,1114,2484,1134,2531
221093,202306,2063,4569,1687,3893,173,364,1213,2666,1386,3030
221095,202306,1075,2471,832,2109,32,75,663,1641,695,1716
221097,202306,985,2240,683,1720,25,68,505,1189,530,1257
221100,202306,186348,408454,143821,335272,10403,26584,101582,219973,111985,246557
221110,202306,14072,33010,11906,29828,443,1172,10009,24450,10452,25622
221120,202306,6045,15321,4870,13350,199,625,3834,10183,4033,10808
221130,202306,7297,15542,5204,11758,1320,2595,2754,6105,4074,8700
221135,202306,2425,5059,1967,4425,92,146,1656,3742,1748,3888
221140,202306,1910,3486,1469,2912,79,133,1208,2328,1287,2461
221150,202306,1362,3008,912,2246,30,90,712,1635,742,1725
221160,202306,863,1914,698,1649,39,61,516,1195,555,1256
221170,202306,1311,2960,1147,2672,16,46,1042,2362,1058,2408
230010,202306,3595,8450,2692,6865,164,401,2035,4991,2199,5392
230015,202306,4460,11640,3675,10025,240,684,2475,6514,2715,7198
230020,202306,18740,47431,16431,43536,1161,2985,12691,32936,13852,35921
230030,202306,15511,34174,12017,28984,639,1351,9193,22189,9832,23540
230040,202306,5651,12006,4472,10195,82,268,3502,8081,3584,8349
230050,202306,2994,8613,2016,6253,343,1029,909,2551,1252,3580
230060,202306,2969,6913,2083,5315,60,201,1619,3962,1679,4163
230070,202306,5424,11902,3823,9062,593,1331,2394,5539,2987,6870
230075,202306,12140,31976,10330,28695,724,2069,7837,20900,8561,22969
230080,202306,3652,6749,2649,5471,18,44,2425,4898,2443,4942
230090,202306,5630,11608,4259,9400,126,281,3567,7470,3693,7751
230100,202306,28052,59460,22120,50442,2090,4795,15026,33073,17116,37868
230110,202306,17372,45143,13242,36882,2650,7129,6273,16696,8923,23825
230120,202306,9845,22878,7541,18932,939,2231,4788,11721,5727,13952
230125,202306,3744,8744,2938,7377,99,326,2262,5311,2361,5637
230130,202306,6808,18352,4971,14485,389,1034,3353,9500,3742,10534
230140,202306,4310,11180,3265,9055,102,377,2439,6351,2541,6728
230150,202306,1907,5003,1449,4055,228,585,803,2244,1031,2829
230160,202306,8852,17838,7130,15283,250,518,5938,12292,6188,12810
230170,202306,7424,19093,5494,15224,471,1243,3662,9813,4133,11056
230180,202306,1995,4773,1487,3806,26,98,1220,2964,1246,3062
230185,202306,5693,13234,4313,10942,507,1224,2859,7185,3366,8409
230190,202306,17974,48810,12953,38221,2026,5805,6422,18128,8448,23933
230195,202306,7101,17953,5904,15805,311,820,4458,11664,4769,12484
230200,202306,5879,14642,4534,12053,348,839,3190,8151,3538,8990
230205,202306,5618,13116,4659,11686,481,966,3389,8514,3870,9480
230210,202306,13162,26685,10496,22845,426,936,8518,17783,8944,18719
230220,202306,18948,40741,15555,35719,1087,2487,11985,26530,13072,29017
230230,202306,8730,21705,7400,19130,737,1567,5290,13625,6027,15192
230240,202306,16942,37688,13179,31462,884,1868,9673,22290,10557,24158
230250,202306,11647,28001,9803,24709,1261,3051,5874,13884,7135,16935
230260,202306,18484,46459,14725,39536,2031,5163,8916,23291,10947,28454
230270,202306,8630,20739,5949,15728,743,1860,3469,9202,4212,11062
230280,202306,24416,55407,18785,45685,546,1861,14877,33492,15423,35353
230290,202306,6286,14190,5008,11905,234,549,3968,9058,4202,9607
230300,202306,6131,13708,5129,12282,104,340,4317,10044,4421,10384
230310,202306,5801,14605,4346,11798,208,677,3101,7949,3309,8626
230320,202306,9151,23359,7139,19831,269,997,5272,13879,5541,14876
230330,202306,5849,13826,4063,10441,169,460,3040,7413,3209,7873
230340,202306,4574,12775,3659,10898,316,922,2388,6866,2704,7788
230350,202306,23496,53846,18841,46289,1075,3076,13618,31786,14693,34862
230360,202306,3761,8507,2746,6813,139,326,2018,4940,2157,5266
230365,202306,3680,7756,2922,6634,82,228,2536,5631,2618,5859
230370,202306,102824,215987,83994,186654,5227,12908,64789,135528,70016,148436
230380,202306,7438,18276,5411,14462,142,461,4073,10275,4215,10736
230390,202306,4050,10227,3235,8839,85,366,2532,6608,2617,6974
230393,202306,4179,10195,3085,8083,71,287,2454,6018,2525,6305
230395,202306,6867,16858,5151,13598,498,1330,3297,8208,3795,9538
230400,202306,6930,16329,5615,14071,123,408,4528,10635,4651,11043
230410,202306,16243,42882,12397,35791,1243,3460,8073,22771,9316,26231
230420,202306,38101,89628,28152,71513,3145,7914,16956,40374,20101,48288
230423,202306,5393,14302,4362,12177,315,924,3043,8166,3358,9090
230425,202306,7620,19943,6515,17688,723,1800,4404,11723,5127,13523
230426,202306,3240,7473,2114,5333,59,203,1568,3727,1627,3930
230427,202306,2145,5426,1324,3697,108,316,811,2047,919,2363
230428,202306,12443,30071,9656,25257,1492,3779,5214,12860,6706,16639
230430,202306,5944,15168,4233,12003,183,475,3140,8612,3323,9087
230435,202306,7761,17404,5491,13349,797,1852,3079,7176,3876,9028
230440,202306,620564,1253489,482776,1039270,34966,81864,345929,695855,380895,777719
230445,202306,4889,12094,3631,9774,280,745,2387,6012,2667,6757
230450,202306,4590,11200,3612,9545,185,565,2593,6317,2778,6882
230460,202306,2726,6300,2241,5544,76,245,1814,4323,1890,4568
230465,202306,5030,12227,3892,10079,223,525,2922,7246,3145,7771
230470,202306,14216,39705,11997,35490,908,2570,8578,24339,9486,26909
230480,202306,1859,4539,1358,3602,74,240,968,2385,1042,2625
230490,202306,3344,8227,2524,6620,218,628,1599,3803,1817,4431
230495,202306,7585,18241,5965,15265,782,2076,3700,8869,4482,10945
230500,202306,11359,32259,9180,28070,621,1787,6700,20325,7321,22112
230510,202306,2171,5193,1573,4014,177,479,971,2295,1148,2774
230520,202306,5841,13754,4675,11690,363,856,3435,8264,3798,9120
230523,202306,20777,54505,13518,38517,3050,8278,3373,9822,6423,18100
230526,202306,4810,11429,3697,9527,274,510,2644,6905,2918,7415
230530,202306,6668,18790,5149,15774,1237,3661,2582,7950,3819,11611
230533,202306,6043,11428,4289,8804,106,306,3523,6696,3629,7002
230535,202306,5809,15036,4412,12471,348,1022,2788,7577,3136,8599
230540,202306,18355,45054,14381,38264,389,1309,11360,28948,11749,30257
230550,202306,28219,63244,20753,50142,2335,5031,13550,31464,15885,36495
230560,202306,9192,19300,6780,15642,589,830,5091,12238,5680,13068
230565,202306,3694,8924,2902,7501,116,322,2238,5514,2354,5836
230570,202306,4008,9199,3118,7798,81,254,2514,5975,2595,6229
230580,202306,15033,32304,11918,27500,578,1258,9809,21939,10387,23197
230590,202306,11692,28514,8885,23457,791,1983,6191,15836,6982,17819
230600,202306,4608,10184,3346,8040,150,342,2343,5553,2493,5895
230610,202306,8261,19837,6776,17308,511,1247,5122,12717,5633,13964
230620,202306,2696,6067,1951,4688,74,218,1406,3030,1480,3248
230625,202306,12840,30205,9992,24939,1966,5060,4829,11246,6795,16306
230630,202306,14204,35096,11355,29754,1515,3601,6903,17877,8418,21478
230640,202306,32332,88754,26742,78351,1731,5477,19295,53847,21026,59324
230650,202306,6288,14891,4901,12493,276,740,3808,9287,4084,10027
230655,202306,12014,33380,10806,31206,783,2021,8531,24477,9314,26498
230660,202306,7198,18718,5440,15538,182,737,4186,11409,4368,12146
230670,202306,7163,15133,4753,11278,221,487,3770,8615,3991,9102
230680,202306,3458,8242,2535,6593,151,329,1745,4451,1896,4780
230690,202306,8466,22300,6325,17921,526,1489,3794,10531,4320,12020
230700,202306,12904,28070,9273,21513,354,951,7183,15720,7537,16671
230710,202306,8050,22726,6274,18710,627,1895,3911,10988,4538,12883
230720,202306,2299,6064,1669,4809,127,390,1042,2816,1169,3206
230725,202306,5785,14784,4890,13171,491,1373,3157,8103,3648,9476
230730,202306,75254,174454,53481,139137,11348,29086,22528,58162,33876,87248
230740,202306,7250,17987,5555,15079,196,614,4218,11162,4414,11776
230750,202306,10141,23828,7235,18572,149,513,5824,13995,5973,14508
230760,202306,14497,33382,11274,27851,510,1557,8250,18942,8760,20499
230763,202306,5799,13774,4365,11243,105,433,3429,8247,3534,8680
230765,202306,58446,135543,45296,112255,4450,11725,29328,67838,33778,79563
230770,202306,35763,70663,27666,59089,1748,3914,20752,41893,22500,45807
230780,202306,8146,24387,6784,21162,933,2640,4080,12633,5013,15273
230790,202306,3892,9330,3310,8381,139,403,2536,6058,2675,6461
230800,202306,10885,29339,8601,24480,1003,2825,5219,13882,6222,16707
230810,202306,12958,35021,10540,30454,737,1883,7442,20870,8179,22753
230820,202306,4312,12360,3132,9670,394,1228,1833,5357,2227,6585
230830,202306,9139,21531,7069,17817,403,931,5161,12428,5564,13359
230835,202306,4910,10383,3509,8174,126,297,2911,6508,3037,6805
230837,202306,4849,10793,4103,9582,78,250,3599,7955,3677,8205
230840,202306,11388,30033,9106,25815,802,2272,6436,17812,7238,20084
230850,202306,12348,29783,9669,24953,552,1330,7167,18039,7719,19369
230860,202306,7901,14671,6165,12160,183,335,5428,10333,5611,10668
230870,202306,22482,44322,17296,35856,814,1570,13914,27543,14728,29113
230880,202306,2345,6390,2004,5710,70,257,1521,4091,1591,4348
230890,202306,5598,15539,4693,13803,240,874,3348,9449,3588,10323
230900,202306,4075,10093,3127,8203,158,573,2220,5404,2378,5977
230910,202306,4230,9246,3106,7511,73,301,2571,5938,2644,6239
230920,202306,5735,14156,4262,11579,154,500,3174,8227,3328,8727
230930,202306,8360,20737,6218,16874,801,1785,3834,10376,4635,12161
230940,202306,10153,22140,7985,18725,201,487,6774,15414,6975,15901
230945,202306,7872,19794,6234,16707,494,1098,4294,11132,4788,12230
230950,202306,7695,16640,6207,14415,179,422,5175,11709,5354,12131
230960,202306,15647,40316,11917,32658,2013,5482,5804,14872,7817,20354
230970,202306,19544,45265,15058,37654,1739,4383,9388,22293,11127,26676
230980,202306,4328,9176,3445,7661,278,577,2565,5509,2843,6086
230990,202306,2042,5042,1556,4118,74,260,1148,2823,1222,3083
231000,202306,3530,7839,2511,6001,75,210,1937,4345,2012,4555
231010,202306,4499,8937,3227,6940,63,193,2760,5646,2823,5839
231020,202306,11256,28262,9314,24570,1664,3912,5460,14438,7124,18350
231025,202306,10523,23819,8781,20982,599,1365,6727,15645,7326,17010
231030,202306,8695,23486,6044,18017,812,2380,3451,10100,4263,12480
231040,202306,3769,8701,3011,7364,112,318,2461,5720,2573,6038
231050,202306,14670,32122,10489,24619,602,1587,8070,17955,8672,19542
231060,202306,3576,8585,2941,7551,131,375,2279,5710,2410,6085
231070,202306,9809,24877,7877,21344,791,1944,5187,13679,5978,15623
231080,202306,4510,11350,3318,9124,232,645,2231,5964,2463,6609
231085,202306,9027,19076,6629,15793,291,744,4969,11237,5260,11981
231090,202306,5175,12127,3597,9134,148,443,2563,6112,2711,6555
231095,202306,2622,7215,1851,5529,172,502,1186,3444,1358,3946
231100,202306,3629,9274,2767,7642,149,444,2059,5459,2208,5903
231110,202306,4494,11828,3703,10282,934,2575,1807,4628,2741,7203
231120,202306,2958,7264,2326,6182,87,219,1746,4476,1833,4695
231123,202306,2340,5443,1655,4223,89,227,1183,2884,1272,3111
231126,202306,6631,16054,4836,12718,302,695,3599,9281,3901,9976
231130,202306,30960,62347,23732,52157,1150,3144,18300,37000,19450,40144
231135,202306,4977,12510,3750,10105,242,599,2620,6852,2862,7451
231140,202306,21599,51116,16197,41578,1328,3609,11099,26855,12427,30464
231150,202306,7064,17334,4272,11594,764,2077,1645,4141,2409,6218
231160,202306,8581,21795,6961,18585,853,2140,4503,11745,5356,13885
231170,202306,5598,14194,4294,11714,303,844,3054,7880,3357,8724
231180,202306,19236,46743,13882,35843,2034,5090,7444,18179,9478,23269
231190,202306,5035,12191,3554,9463,90,295,2716,6790,2806,7085
231195,202306,5918,16169,4514,13405,289,925,3149,9211,3438,10136
231200,202306,10305,25028,8547,21747,153,617,7141,17108,7294,17725
231210,202306,5830,14959,4503,12614,153,584,3519,9291,3672,9875
231220,202306,16183,34887,11439,26376,588,1260,8549,18529,9137,19789
231230,202306,12048,33797,9896,29641,796,2472,6969,20283,7765,22755
231240,202306,14404,38159,10980,30901,1492,4033,6240,16670,7732,20703
231250,202306,2508,5363,1415,3157,52,120,1060,2171,1112,2291
231260,202306,4048,9595,3136,8034,337,768,2080,5279,2417,6047
231270,202306,7726,17374,5700,13893,158,531,4282,9674,4440,10205
231280,202306,2198,5989,1769,5192,146,424,1185,3417,1331,3841
231290,202306,44366,118584,32073,92243,4363,11775,16268,43914,20631,55689
231300,202306,5051,12242,3478,9103,324,799,2189,5413,2513,6212
231310,202306,10519,21865,7519,16508,484,1237,5569,11343,6053,12580
231320,202306,8216,20918,5859,16552,307,710,4351,12113,4658,12823
231325,202306,2884,6703,2032,5228,110,234,1436,3605,1546,3839
231330,202306,13870,34235,10471,27950,1193,3093,6851,17740,8044,20833
231335,202306,6658,15543,5283,13431,169,507,4363,10758,4532,11265
231340,202306,22613,61234,18354,53212,1620,4701,13005,37275,14625,41976
231350,202306,19658,46875,16359,41656,424,1344,13726,33728,14150,35072
231355,202306,5394,13947,4436,12174,281,786,3356,8821,3637,9607
231360,202306,9672,25713,7618,21886,436,1387,5766,15937,6202,17324
231370,202306,2432,6057,1752,4791,45,148,1332,3493,1377,3641
231375,202306,4875,13260,4129,11916,195,609,3060,8784,3255,9393
231380,202306,7399,16726,6192,15018,200,466,5084,12057,5284,12523
231390,202306,4092,10696,3374,9354,108,421,2542,6638,2650,7059
231395,202306,5323,13253,4119,11108,281,709,2917,7594,3198,8303
231400,202306,12043,29434,9411,24561,303,1065,7163,17539,7466,18604
231410,202306,20061,49876,16832,44432,822,2131,13648,35018,14470,37149
240010,202306,3031,7081,2078,5296,327,857,995,2361,1322,3218
240020,202306,17601,40496,13313,32575,830,2416,9293,20963,10123,23379
240030,202306,4825,8890,3895,7532,82,234,3387,6111,3469,6345
240040,202306,926,2428,685,1971,23,72,452,1206,475,1278
240050,202306,4169,9882,3012,7773,79,220,2194,5398,2273,5618
240060,202306,1796,4153,1288,3234,41,89,990,2421,1031,2510
240070,202306,3214,7904,2410,6106,178,489,1643,3751,1821,4240
240080,202306,3487,8485,2440,6529,142,434,1618,4037,1760,4471
240090,202306,2785,5768,2077,4595,42,99,1770,3795,1812,3894
240100,202306,13453,27810,9796,21427,256,719,7787,15730,8043,16449
240110,202306,6127,15084,4538,11958,241,751,3193,7723,3434,8474
240120,202306,4076,10299,3103,8665,271,855,2046,5334,2317,6189
240130,202306,4888,8397,3738,6866,43,112,3398,6043,3441,6155
240140,202306,2126,5892,1588,4784,173,595,953,2621,1126,3216
240145,202306,8408,21149,6318,17308,635,1812,3946,10281,4581,12093
240150,202306,1311,3042,988,2432,64,178,696,1601,760,1779
240160,202306,1743,4463,1297,3607,50,201,963,2501,1013,2702
240165,202306,1183,2835,851,2172,20,71,687,1655,707,1726
240170,202306,3452,7951,2613,6444,291,695,1688,3947,1979,4642
240180,202306,3657,9662,2681,7623,515,1424,1252,3554,1767,4978
240185,202306,1732,4627,1449,4086,59,208,1137,3030,1196,3238
240190,202306,1386,3257,1041,2665,38,135,769,1830,807,1965
240200,202306,16224,34124,11723,26322,1526,3374,6958,14610,8484,17984
240210,202306,4240,8522,3218,6845,43,134,2719,5454,2762,5588
240220,202306,8666,23309,7156,20577,540,1857,5117,13973,5657,15830
240230,202306,6921,15560,5062,12411,328,680,3536,8628,3864,9308
240240,202306,2153,5713,1367,3956,221,665,483,1172,704,1837
240250,202306,3704,8189,2829,6716,78,274,2234,4923,2312,5197
240260,202306,19915,50542,16085,43812,4491,11622,6398,18825,10889,30447
240270,202306,3055,7753,2198,6152,130,391,1456,4025,1586,4416
240280,202306,1895,4381,1401,3502,77,190,1007,2395,1084,2585
240290,202306,1328,3451,988,2698,24,74,658,1652,682,1726
240300,202306,2627,6081,1772,4557,109,299,1125,2743,1234,3042
240310,202306,10302,24704,7258,18929,1087,2728,3567,8833,4654,11561
240320,202306,2265,5671,1465,4087,99,284,932,2435,1031,2719
240325,202306,47628,106970,35191,85059,3907,10336,21349,47184,25256,57520
240330,202306,2161,5288,1490,4003,81,269,1002,2505,1083,2774
240340,202306,2487,4852,1798,3745,52,109,1468,2859,1520,2968
240350,202306,3043,6260,2523,5593,86,257,2178,4664,2264,4921
240360,202306,16252,37966,13098,32477,1962,4677,7972,19089,9934,23766
240370,202306,2676,5687,1826,4131,97,245,1328,2744,1425,2989
240375,202306,1135,2448,838,1939,37,100,613,1291,650,1391
240380,202306,2748,6853,1966,5209,253,673,1136,2847,1389,3520
240390,202306,1143,2580,706,1765,29,69,429,974,458,1043
240400,202306,1689,3818,1177,2939,48,167,808,1837,856,2004
240410,202306,707,1894,517,1521,58,188,288,781,346,969
240420,202306,6291,18212,5093,15512,368,1317,3329,9363,3697,10680
240430,202306,4186,9446,3079,7429,117,327,2315,5181,2432,5508
240440,202306,3378,6743,2606,5555,207,448,1969,4000,2176,4448
240450,202306,5339,12991,3666,9697,257,801,2307,5426,2564,6227
240460,202306,4211,9671,3427,8375,261,619,2551,5976,2812,6595
240470,202306,4044,11178,2679,8179,719,1937,1025,3288,1744,5225
240480,202306,671,1670,375,1029,27,61,180,474,207,535
240485,202306,2483,6369,1780,4984,153,477,1029,2759,1182,3236
240490,202306,1968,4340,1372,3275,92,190,981,2247,1073,2437
240500,202306,2590,6194,2055,5212,109,283,1598,3880,1707,4163
240510,202306,2025,4845,1586,4061,117,369,1186,2815,1303,3184
240520,202306,1933,3910,1320,3016,106,217,1022,2261,1128,2478
240530,202306,2863,6796,2354,5948,150,318,1808,4429,1958,4747
240540,202306,2739,5874,2244,5095,57,184,1914,4161,1971,4345
240550,202306,1067,2308,886,1999,21,75,774,1670,795,1745
240560,202306,4767,9888,3987,8811,150,297,3312,7137,3462,7434
240570,202306,3289,7979,1889,4927,260,714,747,1625,1007,2339
240580,202306,10689,26356,8696,22674,533,1468,6723,16736,7256,18204
240590,202306,1124,2168,869,1776,36,92,668,1267,704,1359
240600,202306,2114,5067,1405,3651,49,134,979,2371,1028,2505
240610,202306,5483,12390,4358,10320,299,780,3067,6788,3366,7568
240615,202306,1548,3474,1135,2769,72,198,813,1805,885,2003
240620,202306,2369,5638,1852,4713,59,199,1516,3651,1575,3850
240630,202306,2849,6239,2373,5452,218,383,1758,4070,1976,4453
240640,202306,1088,2580,773,2023,34,100,581,1442,615,1542
240650,202306,4799,12803,3591,10271,331,898,2246,6331,2577,7229
240660,202306,5417,9452,4487,8292,154,395,3858,6867,4012,7262
240670,202306,3092,7515,2086,5438,196,500,1298,3140,1494,3640
240680,202306,1916,4436,1410,3552,97,265,1036,2462,1133,2727
240690,202306,1474,3089,1095,2455,25,81,898,1875,923,1956
240700,202306,2824,7453,2082,6059,124,370,1474,4154,1598,4524
240710,202306,25039,51429,19608,42548,1817,4035,14018,28802,15835,32837
240720,202306,6216,14202,4679,11597,614,1582,2859,6752,3473,8334
240725,202306,1272,3335,905,2646,50,149,566,1563,616,1712
240730,202306,2672,6638,1950,5249,88,289,1426,3638,1514,3927
240740,202306,2249,5595,1618,4311,89,287,1120,2722,1209,3009
240750,202306,2634,7610,2116,6464,235,761,1273,3688,1508,4449
240760,202306,2051,4107,1354,3074,122,239,929,2161,1051,2400
240770,202306,4015,9452,3134,8094,113,387,2480,6042,2593,6429
240780,202306,6486,15494,4980,12829,663,1634,3089,7573,3752,9207
240790,202306,1059,2634,757,2055,30,125,504,1238,534,1363
240800,202306,73237,146994,51692,111214,5434,11779,33055,64993,38489,76772
240810,202306,138072,292158,110851,246959,10776,23645,76362,161258,87138,184903
240820,202306,7932,20767,6330,17602,1072,2890,3498,9460,4570,12350
240830,202306,10505,25880,8427,22430,432,1333,6467,16586,6899,17919
240840,202306,1293,2922,917,2247,43,92,637,1484,680,1576
240850,202306,1658,4125,1030,2777,71,197,629,1573,700,1770
240860,202306,1818,3898,1295,3002,41,139,1065,2315,1106,2454
240870,202306,1229,2816,855,2142,165,385,422,1053,587,1438
240880,202306,1534,4372,1223,3720,94,345,826,2367,920,2712
240890,202306,6615,14590,4677,11052,436,1120,2989,6265,3425,7385
240895,202306,3565,9543,3002,8556,378,1066,2063,5799,2441,6865
240910,202306,4148,10041,3210,8388,89,321,2449,6044,2538,6365
240920,202306,1305,2835,911,2192,108,206,578,1380,686,1586
240930,202306,4340,8872,3062,7019,273,488,1974,4795,2247,5283
240933,202306,1898,4317,1476,3668,49,204,1184,2775,1233,2979
240940,202306,8932,18557,6353,14064,685,1450,4206,8726,4891,10176
240950,202306,1314,3528,1017,2907,54,181,718,1905,772,2086
240960,202306,836,2075,686,1745,24,88,505,1193,529,1281
240970,202306,2392,5067,1774,4033,70,199,1453,3156,1523,3355
240980,202306,4837,10941,4078,9674,85,328,3475,7795,3560,8123
240990,202306,3606,8196,2840,6736,234,615,2005,4315,2239,4930
241000,202306,1277,2728,902,2044,10,26,741,1580,751,1606
241010,202306,3881,9935,3200,8563,129,429,2471,6185,2600,6614
241020,202306,2526,6001,1759,4500,92,286,1238,2896,1330,3182
241025,202306,1945,5012,1356,3812,49,175,947,2471,996,2646
241030,202306,3003,8330,2217,6706,221,704,1489,4256,1710,4960
241040,202306,2674,7355,2092,6289,161,515,1510,4427,1671,4942
241050,202306,1731,4266,1278,3390,47,138,930,2371,977,2509
241060,202306,987,2383,755,1906,33,80,536,1238,569,1318
241070,202306,857,2012,641,1634,20,55,498,1197,518,1252
241080,202306,1301,3314,940,2587,33,97,653,1680,686,1777
241090,202306,2487,6176,1834,5037,64,266,1317,3368,1381,3634
241100,202306,1387,3458,966,2614,93,181,597,1590,690,1771
241105,202306,1408,3634,1045,2946,173,511,494,1241,667,1752
241110,202306,1066,2732,705,1970,45,150,439,1109,484,1259
241120,202306,9104,23262,7107,19583,724,2068,4608,12240,5332,14308
241140,202306,3909,9409,2731,7094,213,509,1815,4597,2028,5106
241142,202306,885,2192,556,1508,50,141,295,702,345,843
241150,202306,7048,16296,5565,13775,242,613,4313,10313,4555,10926
241160,202306,1315,3408,819,2398,122,354,385,1031,507,1385
241170,202306,1580,3558,1218,2893,47,150,972,2159,1019,2309
241180,202306,1223,2777,830,2038,50,155,498,1159,548,1314
241190,202306,1421,3214,1017,2432,30,82,733,1660,763,1742
241200,202306,32509,68448,25942,57394,2907,6613,17397,35796,20304,42409
241210,202306,1995,4455,1300,3157,129,265,810,1924,939,2189
241220,202306,12412,30686,9920,26068,2429,6149,4552,11952,6981,18101
241230,202306,3476,8122,2690,6813,142,387,2069,5000,2211,5387
241240,202306,1456,3734,770,2210,103,324,276,696,379,1020
241250,202306,7729,17968,5616,14118,133,461,4343,10120,4476,10581
241255,202306,3276,8630,2572,7246,217,679,1720,4574,1937,5253
241260,202306,5817,13495,4300,10852,156,479,3170,7427,3326,7906
241270,202306,1873,4961,1417,4038,109,354,927,2484,1036,2838
241280,202306,3168,6212,2527,5104,84,148,2192,4271,2276,4419
241290,202306,3766,8319,2613,6473,97,319,2004,4652,2101,4971
241300,202306,1887,4399,1357,3434,36,112,952,2246,988,2358
241310,202306,2851,5747,2227,4864,60,166,1854,3857,1914,4023
241320,202306,1137,3357,873,2802,107,362,463,1413,570,1775
241330,202306,2065,4670,1535,3899,42,132,1302,3203,1344,3335
241335,202306,4496,11044,3558,9261,138,411,2678,6578,2816,6989
241340,202306,2068,4862,1474,3720,197,576,790,1779,987,2355
241350,202306,2586,6173,2056,5220,99,264,1557,3793,1656,4057
241355,202306,1658,3924,1199,3056,56,137,859,2074,915,2211
241360,202306,2493,5690,1610,3983,62,159,1193,2740,1255,2899
241370,202306,1591,3815,1144,2956,44,137,818,1940,862,2077
241380,202306,854,1995,610,1567,50,109,382,936,432,1045
241390,202306,3324,8525,2642,7378,148,446,1911,5129,2059,5575
241400,202306,4382,10667,3574,9304,274,769,2582,6419,2856,7188
241410,202306,3007,8043,2259,6512,239,718,1430,3979,1669,4697
241415,202306,2287,5392,1752,4365,76,242,1360,3143,1436,3385
241420,202306,3846,9844,3145,8559,536,1474,1749,4596,2285,6070
241430,202306,856,1893,519,1244,17,44,351,757,368,801
241440,202306,10433,27083,8795,24009,273,886,7053,18391,7326,19277
241445,202306,1653,3365,1302,2853,26,72,1138,2405,1164,2477
241450,202306,3727,7527,2752,5967,173,342,2169,4527,2342,4869
241460,202306,4747,11441,3256,8300,278,729,2091,4878,2369,5607
241470,202306,1740,4046,1275,3341,44,163,987,2429,1031,2592
241475,202306,1425,3447,996,2647,26,82,720,1768,746,1850
241480,202306,3738,10245,2815,8313,791,2288,1003,3073,1794,5361
241490,202306,913,1832,593,1331,21,68,465,980,486,1048
241500,202306,972,2369,790,2106,30,98,622,1587,652,1685
250010,202306,3227,8216,2401,6526,77,248,1782,4561,1859,4809
250020,202306,1926,4507,1321,3374,93,179,977,2474,1070,2653
250030,202306,8523,20390,6775,17426,1078,2696,4345,10817,5423,13513
250040,202306,5590,14394,4422,12222,724,1955,2495,6621,3219,8576
250050,202306,4464,10415,3648,9201,186,511,2796,6981,2982,7492
250053,202306,1551,3904,1299,3435,127,275,884,2274,1011,2549
250057,202306,898,2433,801,2290,23,90,706,1985,729,2075
250060,202306,7493,16663,6105,14540,639,1403,4242,9859,4881,11262
250070,202306,4841,11767,3738,9791,76,284,2934,7302,3010,7586
250073,202306,965,2234,721,1811,14,47,570,1365,584,1412
250077,202306,3211,6746,2337,5324,36,115,1995,4344,2031,4459
250080,202306,7401,14186,5768,12101,82,262,5186,10544,5268,10806
250090,202306,4711,8837,3793,7552,58,124,3337,6373,3395,6497
250100,202306,4093,11084,3364,9649,248,617,2432,6756,2680,7373
250110,202306,5998,14755,5098,13333,342,913,3724,9342,4066,10255
250115,202306,930,1900,614,1375,14,48,511,1092,525,1140
250120,202306,2159,5674,1786,5010,34,152,1365,3625,1399,3777
250130,202306,7414,15602,5955,13467,102,343,5193,11278,5295,11621
250135,202306,1657,3903,1357,3373,184,513,961,2259,1145,2772
250140,202306,2798,7167,2296,6392,190,564,1639,4444,1829,5008
250150,202306,5665,15703,4758,14019,203,731,3642,10234,3845,10965
250153,202306,1619,3904,1260,3310,63,124,973,2509,1036,2633
250157,202306,2651,6056,2162,5194,57,143,1799,4163,1856,4306
250160,202306,4406,9736,3386,8172,73,205,2881,6750,2954,6955
250170,202306,2216,5194,1871,4680,41,129,1511,3632,1552,3761
250180,202306,31290,60599,24807,51433,1961,4254,18375,35577,20336,39831
250190,202306,5153,11850,4051,10095,434,1035,2670,6325,3104,7360
250200,202306,3164,5914,2494,4976,31,92,2240,4261,2271,4353
250205,202306,984,2760,753,2325,24,105,548,1616,572,1721
250210,202306,1707,4583,1384,3971,99,294,973,2668,1072,2962
250215,202306,1877,4651,1332,3613,73,202,756,2009,829,2211
250220,202306,805,1997,584,1605,28,100,389,983,417,1083
250230,202306,1911,3903,1222,2852,27,77,960,2147,987,2224
250240,202306,3794,8193,3136,7078,63,198,2699,5836,2762,6034
250250,202306,5953,13753,4839,12071,399,688,3666,9530,4065,10218
250260,202306,1842,4768,1402,3935,68,191,989,2703,1057,2894
250270,202306,1394,3799,1158,3375,93,281,747,2233,840,2514
250280,202306,4895,10357,4034,9086,263,447,3134,7100,3397,7547
250290,202306,2314,4705,1812,3919,50,129,1460,2972,1510,3101
250300,202306,7379,15711,6007,13741,262,751,4762,10305,5024,11056
250310,202306,1477,3775,1094,3056,58,138,772,2093,830,2231
250320,202306,18390,33849,14736,29324,335,955,12531,23533,12866,24488
250330,202306,3182,7212,2484,6106,73,254,2044,4677,2117,4931
250340,202306,1541,3195,1233,2745,23,56,1077,2329,1100,2385
250350,202306,4535,11782,3557,10031,269,635,2629,7534,2898,8169
250355,202306,2750,6388,2260,5737,38,177,2004,4947,2042,5124
250360,202306,2136,4947,1784,4412,123,374,1362,3155,1485,3529
250370,202306,20796,41317,16787,35287,330,970,14389,28671,14719,29641
250375,202306,1535,3261,1137,2753,33,66,977,2395,1010,2461
250380,202306,2196,4562,1907,4175,65,180,1636,3374,1701,3554
250390,202306,2355,5151,1854,4323,124,311,1443,3268,1567,3579
250400,202306,92017,206318,61932,155505,18455,48449,18083,42074,36538,90523
250403,202306,2942,5970,2358,5232,58,266,1942,3891,2000,4157
250407,202306,1885,3718,1233,2713,138,234,855,1994,993,2228
250410,202306,855,1983,698,1720,25,72,576,1346,601,1418
250415,202306,2441,5657,1980,4910,37,120,1724,4144,1761,4264
250420,202306,1735,3558,1470,3159,25,87,1292,2644,1317,2731
250430,202306,9413,18429,7279,15293,301,659,5870,11517,6171,12176
250435,202306,1959,4920,1364,3832,66,225,1016,2729,1082,2954
250440,202306,5256,12702,4271,11162,114,321,3574,9074,3688,9395
250450,202306,2186,4979,1688,4227,92,172,1312,3291,1404,3463
250460,202306,9723,23387,7741,20173,546,1609,5529,13682,6075,15291
250470,202306,2188,4559,1692,3767,71,179,1370,2889,1441,3068
250480,202306,4649,11250,3654,9849,184,469,2858,7598,3042,8067
250485,202306,848,1744,560,1269,48,71,396,877,444,948
250490,202306,6940,13455,5809,12056,120,326,5065,10112,5185,10438
250500,202306,2446,6006,1988,5196,66,220,1544,3887,1610,4107
250510,202306,7100,14629,5648,12476,278,441,4498,9954,4776,10395
250520,202306,2209,5345,1746,4614,67,221,1336,3363,1403,3584
250523,202306,2685,5656,2169,4879,169,399,1632,3491,1801,3890
250527,202306,2112,4495,1816,4111,25,73,1634,3645,1659,3718
250530,202306,808,1857,649,1601,22,58,492,1130,514,1188
250535,202306,1637,4191,1354,3652,15,46,1108,2849,1123,2895
250540,202306,3972,7318,3099,6257,352,418,2451,5172,2803,5590
250550,202306,929,2714,756,2349,50,172,519,1546,569,1718
250560,202306,2054,5019,1615,4295,94,274,1201,3030,1295,3304
250570,202306,3307,8609,2673,7445,170,536,1939,5241,2109,5777
250580,202306,1245,2934,1020,2575,62,152,789,1904,851,2056
250590,202306,1264,2630,1085,2373,41,110,928,1915,969,2025
250600,202306,9067,22221,6826,18537,330,908,4995,13029,5325,13937
250610,202306,3395,8706,2779,7646,145,478,2123,5655,2268,6133
250620,202306,1126,2359,862,1911,30,64,696,1467,726,1531
250625,202306,2702,7124,2284,6377,60,250,1903,5132,1963,5382
250630,202306,15427,33779,12139,28291,1064,2697,8534,18541,9598,21238
250640,202306,4530,10417,3652,9042,101,365,2937,6800,3038,7165
250650,202306,1294,2718,938,2218,12,59,789,1800,801,1859
250660,202306,1867,4139,1355,3337,54,130,1097,2549,1151,2679
250670,202306,2967,7680,2543,6873,49,170,2118,5426,2167,5596
250680,202306,7527,14410,5969,12420,109,390,5145,10043,5254,10433
250690,202306,8744,17074,6766,14451,160,350,5721,11720,5881,12070
250700,202306,5609,14014,4462,11863,632,1711,2826,7098,3458,8809
250710,202306,5210,13543,4095,11688,368,1060,2763,7672,3131,8732
250720,202306,3424,8168,2794,7170,73,255,2253,5516,2326,5771
250730,202306,5422,12251,4407,10682,217,585,3489,7952,3706,8537
250740,202306,2469,5408,1866,4486,131,282,1332,3112,1463,3394
250750,202306,165293,343426,129365,287329,8320,20813,95089,195646,103409,216459
250760,202306,3668,6856,3062,5955,60,153,2731,5099,2791,5252
250770,202306,4866,13142,3916,11451,498,1258,2490,7246,2988,8504
250780,202306,2268,5142,1741,4189,53,161,1413,3224,1466,3385
250790,202306,3120,7929,2438,6654,91,374,1729,4301,1820,4675
250800,202306,2930,6824,2330,5800,124,288,1818,4416,1942,4704
250810,202306,1759,3819,1289,3059,143,235,878,2133,1021,2368
250820,202306,2567,5866,2227,5401,52,181,1917,4494,1969,4675
250830,202306,7344,19414,5501,15634,243,823,3800,9961,4043,10784
250840,202306,860,2516,684,2126,39,141,491,1522,530,1663
250850,202306,2168,5536,1762,4797,31,120,1429,3725,1460,3845
250855,202306,1413,3366,1153,2924,43,135,950,2299,993,2434
250860,202306,4279,11106,3175,9080,418,1258,1811,4855,2229,6113
250870,202306,1257,2929,965,2406,52,120,703,1695,755,1815
250880,202306,1920,4374,1451,3604,129,329,1037,2462,1166,2791
250890,202306,14753,29994,11873,26003,304,1006,9941,20210,10245,21216
250900,202306,3951,9006,3126,7546,101,302,2591,5910,2692,6212
250905,202306,3071,7501,2658,6912,75,290,2295,5796,2370,6086
250910,202306,9070,17267,7257,14934,98,334,6454,12733,6552,13067
250915,202306,2629,5257,1709,4122,45,116,1432,3318,1477,3434
250920,202306,4789,10074,3866,8555,320,608,2914,6180,3234,6788
250930,202306,2802,6785,2227,5910,141,463,1669,4154,1810,4617
250933,202306,1497,3912,1194,3323,45,163,933,2487,978,2650
250937,202306,957,2239,749,1897,27,73,566,1382,593,1455
250939,202306,2496,5465,1982,4644,31,90,1702,3898,1733,3988
250940,202306,4707,10933,3750,9490,80,262,3113,7636,3193,7898
250950,202306,2017,4761,1522,4024,51,171,1182,2981,1233,3152
250960,202306,1359,3432,1114,2970,37,136,879,2223,916,2359
250970,202306,11264,24655,8984,20751,429,930,7158,15959,7587,16889
250980,202306,2839,6647,2336,5809,38,136,1985,4725,2023,4861
250990,202306,2577,6850,2067,5908,100,362,1496,4055,1596,4417
251000,202306,2290,5889,1771,4945,54,172,1369,3727,1423,3899
251010,202306,2999,7368,2477,6527,61,228,2045,5187,2106,5415
251020,202306,1879,4622,1506,3972,41,161,1207,2995,1248,3156
251030,202306,1210,2911,921,2388,41,121,604,1511,645,1632
251040,202306,2171,5296,1702,4507,35,130,1405,3551,1440,3681
251050,202306,1143,3015,868,2421,54,178,596,1541,650,1719
251060,202306,1364,2709,901,2020,38,74,675,1487,713,1561
251065,202306,550,1397,371,1037,15,41,255,679,270,720
251070,202306,897,1960,681,1625,18,69,538,1179,556,1248
251080,202306,26588,57031,20289,46901,3530,8062,11414,26040,14944,34102
251090,202306,3449,8750,2691,7377,58,202,2200,5799,2258,6001
251100,202306,936,2694,728,2247,41,123,501,1429,542,1552
251110,202306,2224,5122,1707,4140,143,321,1251,2912,1394,3233
251120,202306,9906,22482,7755,19255,388,1116,5833,13714,6221,14830
251130,202306,6021,10196,5022,8979,49,119,4636,8017,4685,8136
251140,202306,4786,12307,3984,10989,166,559,2979,7991,3145,8550
251150,202306,3410,8510,2916,7680,80,359,2308,5727,2388,6086
251160,202306,2929,6857,2430,6055,51,196,2093,4971,2144,5167
251170,202306,2269,4859,1872,4292,39,132,1630,3557,1669,3689
251180,202306,3339,7578,2598,6444,292,630,1699,4275,1991,4905
251190,202306,6934,13551,5896,12184,100,279,5222,10303,5322,10582
251200,202306,5596,13553,4610,12082,198,543,3697,9530,3895,10073
251203,202306,1244,3508,974,2882,69,215,608,1683,677,1898
251207,202306,1324,3186,893,2382,21,74,611,1540,632,1614
251210,202306,9786,21693,7255,17697,633,1272,4870,11983,5503,13255
251220,202306,1631,3368,1126,2641,75,164,843,1934,918,2098
251230,202306,5609,14117,4510,11989,148,430,3397,8644,3545,9074
251240,202306,4420,11435,3267,9161,320,889,2020,5476,2340,6365
251250,202306,14928,33949,11768,28153,1078,2494,8336,19030,9414,21524
251260,202306,648,1484,519,1258,9,29,420,958,429,987
251270,202306,5468,14260,4550,12735,288,737,3410,9511,3698,10248
251272,202306,1733,3873,1497,3528,41,158,1306,2919,1347,3077
251274,202306,1005,2568,720,2014,63,198,382,997,445,1195
251275,202306,1956,4101,1469,3297,84,194,1156,2426,1240,2620
251276,202306,1605,3926,1310,3486,36,140,1011,2536,1047,2676
251278,202306,807,1873,634,1554,44,109,484,1116,528,1225
251280,202306,3383,6919,2868,6146,60,188,2470,4951,2530,5139
251290,202306,10294,17982,8533,15736,257,560,7450,13106,7707,13666
251300,202306,1010,2577,809,2217,17,63,674,1802,691,1865
251310,202306,3421,8467,2753,7355,49,217,2148,5454,2197,5671
251315,202306,2236,6099,1869,5353,103,269,1427,3972,1530,4241
251320,202306,1916,4529,1401,3601,47,163,1074,2604,1121,2767
251330,202306,2557,5175,1929,4365,37,96,1620,3561,1657,3657
251335,202306,1381,3373,1145,2973,16,53,1014,2541,1030,2594
251340,202306,4573,9628,3324,7750,149,351,2546,5632,2695,5983
251350,202306,1315,3288,1069,2846,42,87,836,2181,878,2268
251360,202306,2239,5369,1605,4327,30,95,1251,3252,1281,3347
251365,202306,938,2222,624,1611,19,50,466,1174,485,1224
251370,202306,35755,81050,27440,67617,4849,11506,14270,34586,19119,46092
251380,202306,1878,3983,1474,3309,52,140,1203,2566,1255,2706
251385,202306,927,2161,637,1606,20,51,462,1077,482,1128
251390,202306,9689,22017,8048,19358,663,1623,5874,13611,6537,15234
251392,202306,1235,2990,969,2554,41,102,733,1908,774,2010
251394,202306,818,2085,611,1696,56,148,392,1043,448,1191
251396,202306,853,2100,622,1645,23,77,440,1064,463,1141
251398,202306,1203,2835,761,2037,23,76,543,1359,566,1435
251400,202306,1764,3415,1296,2709,72,119,1031,2073,1103,2192
251410,202306,1897,3836,1407,3083,28,114,1187,2434,1215,2548
251420,202306,2534,5623,1926,4780,45,146,1519,3579,1564,3725
251430,202306,1801,4756,1472,4129,55,164,1184,3219,1239,3383
251440,202306,1297,3149,1005,2631,61,129,729,1910,790,2039
251445,202306,2068,4860,1722,4317,47,167,1370,3245,1417,3412
251450,202306,5657,13995,4616,12082,110,352,3789,9518,3899,9870
251455,202306,1023,2714,838,2347,28,91,650,1740,678,1831
251460,202306,1170,2880,877,2351,83,228,593,1553,676,1781
251465,202306,612,1509,465,1223,13,47,345,853,358,900
251470,202306,1343,3468,934,2609,149,464,461,1134,610,1598
251480,202306,1270,2936,889,2245,27,88,668,1582,695,1670
251490,202306,2372,5398,1830,4573,140,274,1352,3357,1492,3631
251500,202306,2652,5962,2206,5283,122,287,1704,3896,1826,4183
251510,202306,3112,8530,2326,6904,126,386,1493,4158,1619,4544
251520,202306,1185,2813,834,2167,50,103,560,1395,610,1498
251530,202306,18984,38427,14880,33077,243,903,12770,27020,13013,27923
251540,202306,3619,9249,2899,7860,123,486,2239,5678,2362,6164
251550,202306,5336,9980,4001,8143,141,278,3354,6568,3495,6846
251560,202306,656,1825,527,1582,31,111,380,1041,411,1152
251570,202306,1091,2789,795,2166,21,101,612,1558,633,1659
251580,202306,2828,5439,2262,4579,35,105,1934,3643,1969,3748
251590,202306,1971,4172,1514,3498,60,159,1266,2782,1326,2941
251593,202306,1147,3079,936,2685,92,271,588,1619,680,1890
251597,202306,2799,6337,2396,5761,29,103,2100,4898,2129,5001
251600,202306,7606,18681,6190,16330,283,812,4847,12349,5130,13161
251610,202306,4203,10123,3320,8417,425,980,2237,5497,2662,6477
251615,202306,1677,3536,1197,2712,35,92,1044,2292,1079,2384
251620,202306,24227,47415,18023,39331,376,991,15141,32241,15517,33232
251630,202306,6393,12539,4898,10337,256,608,3881,7655,4137,8263
251640,202306,2640,6263,2163,5513,50,199,1766,4231,1816,4430
251650,202306,5102,11381,4006,9772,117,318,3252,7547,3369,7865
251660,202306,4410,11153,3517,9418,113,432,2734,6893,2847,7325
251670,202306,5796,12439,4901,11182,88,309,4369,9581,4457,9890
251675,202306,1135,2355,950,2060,32,66,820,1721,852,1787
251680,202306,3132,7108,2377,5917,124,269,1825,4485,1949,4754
251690,202306,3883,9717,2914,7803,153,434,2178,5658,2331,6092
251700,202306,2790,6714,2151,5697,54,220,1727,4296,1781,4516
251710,202306,955,2182,593,1440,37,109,404,891,441,1000
251720,202306,1537,3890,1128,3135,37,136,829,2182,866,2318
251740,202306,798,1937,599,1566,24,69,449,1111,473,1180
260005,202306,38505,72538,28761,58549,1695,3553,22331,43053,24026,46606
260010,202306,12610,29358,9406,23581,630,1677,6082,14372,6712,16049
260020,202306,8413,16743,6096,13429,125,453,4937,10133,5062,10586
260030,202306,10123,19722,8025,16700,127,433,6899,13642,7026,14075
260040,202306,8725,19650,6522,16185,346,947,4718,11123,5064,12070
260050,202306,17815,37745,14592,33790,300,857,13108,29753,13408,30610
260060,202306,5204,11011,4030,9099,373,633,2950,6797,3323,7430
260070,202306,14614,29053,11601,24551,237,782,9745,19411,9982,20193
260080,202306,8448,15986,6858,13828,166,348,5803,11199,5969,11547
260090,202306,6769,14428,5526,12540,427,819,4169,9308,4596,10127
260100,202306,4026,8514,3199,7273,57,223,2714,5832,2771,6055
260105,202306,6274,14505,5092,12577,109,401,4165,9713,4274,10114
260110,202306,26037,66162,21213,58213,1137,3507,16143,42528,17280,46035
260120,202306,19801,43078,15711,36630,1797,3784,10946,25195,12743,28979
260130,202306,4024,8749,3235,7562,78,197,2557,5637,2635,5834
260140,202306,16795,31559,13263,26866,414,906,11103,21461,11517,22367
260150,202306,4537,8688,3750,7648,101,236,3284,6511,3385,6747
260160,202306,9152,17614,7494,15489,189,486,6611,13195,6800,13681
260170,202306,27353,55027,21258,46013,1183,2720,16348,33612,17531,36332
260180,202306,4358,9807,3386,8335,94,306,2706,6295,2800,6601
260190,202306,27009,43922,21358,36950,242,518,19392,32354,19634,32872
260200,202306,13468,28734,10927,25209,463,998,9348,21128,9811,22126
260210,202306,13404,33538,10623,28779,407,1157,8329,21968,8736,23125
260220,202306,15173,28461,12844,25342,326,636,11142,21177,11468,21813
260230,202306,16362,30471,13332,26382,330,657,11376,21713,11706,22370
260240,202306,3406,8741,2715,7402,69,269,2090,5423,2159,5692
260250,202306,2937,6364,2323,5354,92,221,1804,3955,1896,4176
260260,202306,17791,39077,14724,34415,1174,2449,10856,25348,12030,27797
260270,202306,6346,11739,5180,10267,86,250,4576,8680,4662,8930
260280,202306,16433,39136,13856,34940,350,1307,11929,28616,12279,29923
260290,202306,55744,122854,42808,100998,3717,9254,29556,65039,33273,74293
260300,202306,13393,28403,10748,24462,340,1040,8823,19022,9163,20062
260310,202306,8206,16342,6870,14483,366,690,5692,11741,6058,12431
260320,202306,8799,23141,6734,19454,148,529,5366,15102,5514,15631
260330,202306,2948,8064,2275,6717,88,318,1714,4836,1802,5154
260340,202306,2681,6026,2166,5197,53,178,1770,4003,1823,4181
260345,202306,38703,82754,29849,68392,2800,6723,20000,42502,22800,49225
260350,202306,8075,14349,6449,12424,41,160,5884,10947,5925,11107
260360,202306,2917,6718,2171,5307,71,207,1613,3735,1684,3942
260370,202306,6920,16415,5390,13720,184,583,4291,10297,4475,10880
260380,202306,6101,15591,4749,13201,247,654,3492,9433,3739,10087
260390,202306,5627,15049,3986,11550,226,638,2643,7341,2869,7979
260392,202306,5041,12164,4310,11122,67,359,3678,9128,3745,9487
260400,202306,28121,52181,22486,43818,454,1275,18754,34035,19208,35310
260410,202306,105349,222144,77888,180187,14525,34499,38840,87513,53365,122012
260415,202306,6016,12731,4719,10764,84,266,4001,8745,4085,9011
260420,202306,16661,28018,13084,23918,169,506,11935,21108,12104,21614
260430,202306,3208,9126,2477,7589,189,638,1554,4576,1743,5214
260440,202306,5300,10699,4164,9074,89,283,3497,7219,3586,7502
260450,202306,6919,15481,5772,13768,326,615,4705,11134,5031,11749
260460,202306,6999,16971,5380,13878,355,1037,3645,8628,4000,9665
260470,202306,6152,12791,4897,11262,133,346,4158,9608,4291,9954
260480,202306,4518,10423,3438,8643,282,797,2395,5732,2677,6529
260490,202306,7084,13277,5640,11314,86,313,4905,9277,4991,9590
260500,202306,7505,16390,5907,13892,589,1250,4047,9427,4636,10677
260510,202306,14213,27578,11478,23614,185,537,10091,20028,10276,20565
260515,202306,5608,12860,4095,10078,97,294,2990,6705,3087,6999
260520,202306,20155,40808,15728,34228,974,2167,12013,24648,12987,26815
260530,202306,12706,29348,10337,25608,163,663,8874,21028,9037,21691
260540,202306,9781,17332,8217,15371,139,356,7464,13537,7603,13893
260545,202306,180,454,109,310,23,64,32,65,55,129
260550,202306,3815,9236,2649,7023,176,542,1696,4025,1872,4567
260560,202306,6850,15578,5228,12981,175,564,4123,9690,4298,10254
260570,202306,11508,23139,9357,20196,208,636,7990,16331,8198,16967
260580,202306,6413,11906,5469,10604,67,169,4945,9320,5012,9489
260590,202306,9576,16671,7532,14172,117,336,6659,11989,6776,12325
260600,202306,44207,94592,34192,78336,1384,3857,26539,56286,27923,60143
260610,202306,9631,22169,7390,18589,326,931,5659,13552,5985,14483
260620,202306,28275,55668,22298,46453,1113,2882,17610,33906,18723,36788
260630,202306,2806,6718,2229,5742,61,162,1789,4451,1850,4613
260640,202306,33252,60356,26189,51201,1240,2295,21446,40550,22686,42845
260650,202306,7621,16958,5689,14311,439,875,4484,11101,4923,11976
260660,202306,9537,19817,7649,17198,244,686,6608,14262,6852,14948
260670,202306,2787,6303,2101,5093,90,294,1563,3528,1653,3822
260680,202306,39864,81100,29680,64754,2075,4695,21954,45052,24029,49747
260690,202306,4213,9496,3115,7701,74,253,2496,5867,2570,6120
260700,202306,9423,18871,8372,17659,132,387,7802,16151,7934,16538
260710,202306,1650,3837,1210,3099,42,150,912,2197,954,2347
260720,202306,39653,76913,30447,63880,1567,3790,23803,46934,25370,50724
260730,202306,10185,24956,8392,22192,234,750,7059,18005,7293,18755
260740,202306,1628,3888,1210,3160,35,138,920,2279,955,2417
260750,202306,9698,21013,7284,17908,214,483,6194,15292,6408,15775
260760,202306,8654,16477,7050,14437,115,349,6155,12051,6270,12400
260765,202306,10646,25782,8491,22137,679,1884,5774,14140,6453,16024
260770,202306,4835,10567,3679,8678,108,335,2973,6725,3081,7060
260775,202306,7690,16922,6290,14553,182,551,5029,10849,5211,11400
260780,202306,4696,11765,3484,9280,274,819,2186,5153,2460,5972
260790,202306,196479,363474,152373,300357,17702,36032,106449,197611,124151,233643
260795,202306,4558,8670,3524,7289,152,426,2734,5233,2886,5659
260800,202306,7955,14286,6843,12735,376,534,5864,10660,6240,11194
260805,202306,4705,10734,3616,8750,121,379,2880,6500,3001,6879
260810,202306,8236,18853,6508,15581,250,674,4989,11058,5239,11732
260820,202306,6085,11364,4853,9785,110,308,4141,8076,4251,8384
260825,202306,3502,9219,2817,7938,140,481,2073,5578,2213,6059
260830,202306,5290,13389,4110,11278,434,988,2774,7601,3208,8589
260840,202306,5814,11909,4777,10418,218,502,4044,8469,4262,8971
260845,202306,5647,12751,4499,10733,200,627,3404,7547,3604,8174
260850,202306,6073,14195,4463,11044,381,927,2875,6589,3256,7516
260860,202306,4050,10352,3155,8675,197,577,2359,6194,2556,6771
260870,202306,5669,11021,4641,9666,145,283,3980,8105,4125,8388
260875,202306,10812,21110,7987,17029,637,1372,5433,11098,6070,12470
260880,202306,14247,31454,11746,27372,380,992,9680,21566,10060,22558
260890,202306,16767,36367,13205,30452,1394,3176,8425,18777,9819,21953
260900,202306,6868,17046,5252,14446,536,1497,3013,7878,3549,9375
260910,202306,4296,9527,3590,8459,179,381,2784,6415,2963,6796
260915,202306,7263,15031,6314,13803,99,300,5739,12247,5838,12547
260920,202306,4372,8278,3470,7188,146,336,2901,5747,3047,6083
260930,202306,5151,12931,3965,10799,179,620,3046,7784,3225,8404
260940,202306,19752,39240,15515,32717,1186,2573,11689,23498,12875,26071
260950,202306,9547,21092,6955,16405,374,1041,4825,10264,5199,11305
260960,202306,119471,214058,92838,176851,6725,13631,70473,125631,77198,139262
260970,202306,6909,15736,5285,13169,326,609,3866,9456,4192,10065
260980,202306,5933,14116,4892,12672,122,380,4133,10432,4255,10812
260990,202306,20585,50517,16002,43381,767,2225,12135,31466,12902,33691
261000,202306,21390,41282,16180,33904,669,1562,12797,25197,13466,26759
261010,202306,2674,5939,2148,5179,78,201,1790,4195,1868,4396
261020,202306,8492,18604,6869,15853,315,765,5462,11820,5777,12585
261030,202306,5052,12640,3988,10661,120,439,3057,7627,3177,8066
261040,202306,6673,16263,5099,13401,214,713,3804,9364,4018,10077
261050,202306,9935,21698,8072,18758,199,489,6510,14461,6709,14950
261060,202306,18904,39992,15096,34614,439,1238,12198,26540,12637,27778
261070,202306,95919,182663,71631,146585,7141,14569,50697,98441,57838,113010
261080,202306,9010,17898,7585,15994,93,238,7019,14442,7112,14680
261090,202306,26018,49706,21048,42747,879,1707,17345,33918,18224,35625
261100,202306,11152,25771,8972,22292,551,1363,6754,16138,7305,17501
261110,202306,98976,231257,74407,184814,8611,23056,44097,101318,52708,124374
261120,202306,4924,9921,3990,8518,111,266,3432,7008,3543,7274
261130,202306,9756,19501,7939,16880,217,424,6735,13917,6952,14341
261140,202306,4927,9454,3859,7849,243,427,2979,5918,3222,6345
261150,202306,7025,14750,5637,12658,225,500,4466,9645,4691,10145
261153,202306,2327,6173,1713,4917,88,259,1152,3193,1240,3452
261160,202306,317466,630929,237030,510940,62338,133544,95923,207536,158261,341080
261170,202306,9927,18749,8140,16283,244,467,7017,13453,7261,13920
261180,202306,11730,25115,9140,21028,408,936,7021,15331,7429,16267
261190,202306,6666,14844,5290,12482,174,652,4222,9137,4396,9789
261200,202306,4427,8532,3511,7240,152,342,2856,5675,3008,6017
261210,202306,2253,4869,1798,4155,126,187,1426,3274,1552,3461
261220,202306,19004,43533,14614,35552,1165,2987,10168,22778,11333,25765
261230,202306,4696,11566,3616,9908,78,311,2848,7572,2926,7883
261240,202306,7926,15225,6561,13161,216,434,5696,11037,5912,11471
261245,202306,4813,11241,3677,9318,114,425,2851,6713,2965,7138
261247,202306,3776,9841,2832,8059,290,841,1827,5068,2117,5909
261250,202306,38490,71201,31469,62225,3521,7039,23872,46034,27393,53073
261255,202306,4850,12515,3537,9956,146,527,2561,6739,2707,7266
261260,202306,20397,39853,16732,35092,315,963,14795,29570,15110,30533
261270,202306,6711,12394,5483,10754,200,383,4816,9144,5016,9527
261280,202306,3243,7644,2647,6643,113,360,2050,4848,2163,5208
261290,202306,3682,7840,2812,6693,79,215,2220,5122,2299,5337
261300,202306,17419,38679,13584,32207,410,1263,10715,23642,11125,24905
261310,202306,12730,26413,10156,22458,874,1908,7494,15886,8368,17794
261320,202306,7444,17999,6028,15595,150,433,4821,11964,4971,12397
261330,202306,8003,15675,6725,13913,172,440,5837,11594,6009,12034
261340,202306,7676,15175,6289,13246,238,558,5318,10702,5556,11260
261350,202306,10241,26919,8027,22634,348,964,5948,16275,6296,17239
261360,202306,11204,21814,8908,18356,428,878,7143,14051,7571,14929
261370,202306,33106,69986,25203,57694,1931,4588,18013,38690,19944,43278
261380,202306,5576,13276,4556,11559,462,1135,2977,7341,3439,8476
261390,202306,21531,53252,16305,44106,1315,3721,10822,27642,12137,31363
261400,202306,6264,15253,5043,12942,214,760,3848,9102,4062,9862
261410,202306,12539,25909,9514,21283,258,750,7772,16206,8030,16956
261420,202306,10848,25744,8651,22252,544,1539,6455,15604,6999,17143
261430,202306,5533,11140,4517,9625,53,159,4031,8205,4084,8364
261440,202306,1656,4442,1267,3663,54,232,888,2402,942,2634
261450,202306,18965,42235,15322,36410,705,1743,11871,27449,12576,29192
261460,202306,9635,22400,7573,19008,290,789,5880,14338,6170,15127
261470,202306,4615,10232,3577,8573,71,254,2943,6694,3014,6948
261480,202306,6828,17405,5421,14929,256,914,4006,10192,4262,11106
261485,202306,7108,16933,5674,14502,365,1083,4135,9958,4500,11041
261500,202306,8719,18680,7043,16140,680,1273,4943,11547,5623,12820
261510,202306,2180,5787,1719,4912,70,263,1277,3539,1347,3802
261520,202306,2942,7519,2354,6287,127,374,1665,4161,1792,4535
261530,202306,15304,37815,11183,30137,685,2309,6929,16656,7614,18965
261540,202306,12153,29888,10469,27189,2711,6265,5057,14384,7768,20649
261550,202306,4641,10673,3662,8959,230,631,2663,6095,2893,6726
261560,202306,11980,26919,9832,23542,333,916,7971,18146,8304,19062
261570,202306,4506,10812,3208,8441,285,809,2112,5219,2397,6028
261580,202306,9129,19398,7310,16744,95,373,6516,14300,6611,14673
261590,202306,3369,7244,2613,6065,64,208,2101,4592,2165,4800
261600,202306,7691,14584,6323,12601,137,305,5424,10302,5561,10607
261610,202306,2707,6983,2026,5669,228,632,1184,3271,1412,3903
261618,202306,3581,6777,2887,5790,64,188,2450,4657,2514,4845
261620,202306,6116,14180,5339,12969,589,1225,3868,9640,4457,10865
261630,202306,7290,18388,5544,14840,413,1207,3403,8236,3816,9443
261640,202306,49172,93185,37606,77259,1955,3407,28760,57887,30715,61294
261650,202306,5464,10976,4111,9102,263,565,3187,6883,3450,7448
270010,202306,5089,15107,3952,12816,181,822,2759,8408,2940,9230
270020,202306,5122,10538,4043,9044,174,589,3216,6566,3390,7155
270030,202306,45444,108490,36446,93433,2399,6469,26916,66067,29315,72536
270040,202306,12042,28479,9325,24578,652,1886,6848,17201,7500,19087
270050,202306,6654,13577,5279,11900,180,481,4506,9810,4686,10291
270060,202306,2753,6361,2134,5475,138,369,1535,3731,1673,4100
270070,202306,6525,14314,5359,12597,155,473,4611,10371,4766,10844
270080,202306,1752,4161,1294,3395,93,242,939,2370,1032,2612
270090,202306,2235,5724,1877,5080,67,217,1596,4202,1663,4419
270100,202306,8826,16323,7153,14060,182,438,6235,11759,6417,12197
270110,202306,3915,8383,2906,7014,186,350,2293,5580,2479,5930
270120,202306,3004,7443,2461,6613,88,270,1865,4821,1953,5091
270130,202306,6037,13766,4731,11849,148,500,3795,8954,3943,9454
270135,202306,2393,5046,1900,4442,43,159,1622,3612,1665,3771
270140,202306,10243,22793,7158,17842,382,1080,5147,11889,5529,12969
270150,202306,3893,8771,3416,8072,50,189,3141,7223,3191,7412
270160,202306,6103,15434,4945,13796,177,626,4210,11383,4387,12009
270170,202306,3744,9973,2861,8434,182,702,1880,5027,2062,5729
270180,202306,2852,7537,2407,6861,87,377,1966,5403,2053,5780
270190,202306,3039,6034,2605,5492,43,150,2332,4714,2375,4864
270200,202306,3238,8473,2545,7191,434,1055,1490,4312,1924,5367
270210,202306,7049,14234,5725,12581,130,463,4984,10505,5114,10968
270220,202306,2076,4468,1509,3543,110,268,1119,2447,1229,2715
270230,202306,12321,29454,9643,25009,894,2533,6993,17191,7887,19724
270235,202306,7410,20080,5991,17498,299,920,4490,12652,4789,13572
270240,202306,14108,33448,10628,27736,929,2660,7498,18557,8427,21217
270250,202306,4171,8236,3344,7033,179,465,2689,5339,2868,5804
270255,202306,5152,13238,3852,10858,159,502,2917,7880,3076,8382
270260,202306,6452,17742,5459,15944,117,493,4474,12577,4591,13070
270270,202306,1194,2858,895,2426,93,232,640,1701,733,1933
270280,202306,4487,9616,3269,8001,258,559,2327,5722,2585,6281
270290,202306,9591,26592,8197,24165,234,919,6823,19571,7057,20490
270300,202306,4831,11409,3458,9497,214,614,2494,6589,2708,7203
270310,202306,7915,20091,6275,17369,183,637,4865,12946,5048,13583
270320,202306,6535,17319,5012,14259,207,723,3512,9094,3719,9817
270330,202306,5212,14268,4310,12823,192,843,3505,9967,3697,10810
270340,202306,1949,4580,1535,3914,92,175,1260,3198,1352,3373
270350,202306,2256,4571,1678,3814,139,269,1149,2608,1288,2877
270360,202306,4253,8082,3599,7289,67,202,3262,6372,3329,6574
270370,202306,1585,4454,1322,3962,39,173,1064,3076,1103,3249
270375,202306,4829,8671,3838,7562,109,300,3284,6236,3393,6536
270380,202306,6876,15751,5282,13512,563,1332,3778,9604,4341,10936
270390,202306,1480,3207,1098,2741,16,86,926,2261,942,2347
270400,202306,7665,18170,5774,15083,311,852,4094,10159,4405,11011
270410,202306,6140,15213,4986,13356,146,524,4075,10438,4221,10962
270420,202306,8293,19278,7203,17551,182,635,6026,13914,6208,14549
270430,202306,214701,433450,157734,350997,17909,40698,99771,209536,117680,250234
270440,202306,5611,13489,4568,11964,301,1016,3517,8950,3818,9966
270450,202306,11189,23264,9234,20629,502,1015,7356,16147,7858,17162
270460,202306,4676,9260,3623,7899,227,405,3050,6566,3277,6971
270470,202306,14588,35045,11619,30218,667,1993,8718,21512,9385,23505
270480,202306,3712,8407,2834,7087,174,471,2175,5131,2349,5602
270490,202306,1054,2648,847,2331,51,164,634,1657,685,1821
270500,202306,5801,15456,4928,13833,300,800,3855,10625,4155,11425
270510,202306,7673,16807,5863,14143,294,864,4515,10228,4809,11092
270520,202306,4887,12039,3429,9411,648,1801,1642,4385,2290,6186
270530,202306,1610,4167,1231,3478,90,249,821,2271,911,2520
270540,202306,2695,6466,2091,5560,80,257,1744,4471,1824,4728
270550,202306,7761,17938,5669,15241,609,1510,3764,10091,4373,11601
270560,202306,3575,8024,2736,6769,157,510,2078,4744,2235,5254
270570,202306,6843,14347,5514,12295,522,1286,4284,8894,4806,10180
270580,202306,2899,6986,2438,6254,100,271,2029,5034,2129,5305
270590,202306,1694,4652,1471,4278,33,140,1255,3556,1288,3696
270600,202306,3333,8849,2875,8065,103,295,2408,6642,2511,6937
270610,202306,4291,10205,3522,9045,211,549,2617,6466,2828,7015
270620,202306,1404,3857,1197,3465,51,152,966,2708,1017,2860
270630,202306,23857,48615,19446,42275,646,1766,16468,33835,17114,35601
270640,202306,6698,16664,5259,14278,162,632,4028,10367,4190,10999
270642,202306,3096,8623,2519,7525,212,679,1703,4773,1915,5452
270644,202306,4772,10526,3736,9064,288,714,2829,6672,3117,7386
270650,202306,4532,10475,3697,9232,215,620,2858,6668,3073,7288
270660,202306,2332,5163,1915,4558,84,193,1463,3357,1547,3550
270670,202306,23374,45042,18109,37913,885,1907,14644,29150,15529,31057
270680,202306,7763,14428,6631,13065,294,442,5910,11660,6204,12102
270690,202306,12622,27055,9604,22612,268,824,7765,17284,8033,18108
270700,202306,683,1783,551,1544,70,203,370,986,440,1189
270710,202306,7012,18390,5675,16055,399,1204,4226,11559,4625,12763
270720,202306,4444,11069,3652,9689,121,402,2970,7531,3091,7933
270730,202306,9426,18940,7160,16214,725,1164,5267,12339,5992,13503
270740,202306,2745,6701,2158,5799,84,294,1624,4098,1708,4392
270750,202306,6795,15316,5616,13536,103,362,5001,11597,5104,11959
270760,202306,4003,9655,3126,8317,67,288,2529,6458,2596,6746
270770,202306,29228,64313,21478,52349,2861,6865,13544,31406,16405,38271
270780,202306,2489,5343,2127,4841,55,152,1868,4100,1923,4252
270790,202306,2159,4942,1657,4140,109,277,1256,2978,1365,3255
270800,202306,14597,32439,12018,28474,598,1592,9361,21135,9959,22727
270810,202306,4142,9866,3077,8176,255,695,2231,5700,2486,6395
270820,202306,1903,5093,1529,4459,55,216,1200,3365,1255,3581
270830,202306,6115,13303,4517,11062,291,709,3399,7999,3690,8708
270840,202306,9789,26381,7888,23096,562,2299,5833,16058,6395,18357
270850,202306,10846,21946,8513,18913,577,1371,6742,14420,7319,15791
270860,202306,17722,35449,12673,28654,749,1810,9931,21582,10680,23392
270870,202306,2774,7206,1992,5780,187,576,1198,3258,1385,3834
270880,202306,9293,25278,7626,22183,259,1024,5825,16098,6084,17122
270890,202306,4220,10218,3214,8461,493,1302,1705,4299,2198,5601
270895,202306,4711,11039,3989,9972,173,519,3300,7939,3473,8458
270900,202306,1860,4340,1353,3545,35,136,1042,2563,1077,2699
270910,202306,5408,13351,4330,11596,274,639,3306,8548,3580,9187
270915,202306,11355,28325,8308,22783,828,2589,5167,12958,5995,15547
270920,202306,7311,18307,6004,16225,110,477,5018,13078,5128,13555
270930,202306,21974,44510,16119,36957,1944,4187,11077,25107,13021,29294
270940,202306,7223,17280,5400,14571,175,678,4131,10374,4306,11052
280010,202306,684,1813,503,1444,19,79,335,864,354,943
280020,202306,6506,13789,5103,11540,395,899,3842,8229,4237,9128
280030,202306,126442,245458,95553,197899,15608,31674,55607,110342,71215,142016
280040,202306,3732,8531,2949,7234,156,458,2271,5264,2427,5722
280050,202306,5145,13077,3781,10449,833,2285,1765,4640,2598,6925
280060,202306,9780,20762,7177,16595,941,2421,4370,9346,5311,11767
280067,202306,8882,18234,6844,14929,626,1028,4946,10618,5572,11646
280070,202306,2148,5787,1823,5229,129,431,1345,3622,1474,4053
280100,202306,5366,11981,4165,9976,575,1209,2469,5965,3044,7174
280110,202306,1981,4148,1596,3598,40,129,1386,2991,1426,3120
280120,202306,9869,23538,8120,20582,1113,2458,5451,13905,6564,16363
280130,202306,10512,22025,8066,18511,684,1662,5810,12852,6494,14514
280140,202306,7579,14652,6282,12705,688,1147,4589,9364,5277,10511
280150,202306,4818,10985,3511,8687,495,1001,2214,5311,2709,6312
280160,202306,1606,3841,1239,3178,109,255,819,1916,928,2171
280170,202306,7239,15051,5871,12988,215,546,4842,10204,5057,10750
280190,202306,2083,3413,1734,2942,29,65,1571,2566,1600,2631
280200,202306,1505,3569,1081,2889,59,221,726,1708,785,1929
280210,202306,22329,46644,16960,37881,2064,4576,11213,23831,13277,28407
280220,202306,2035,4563,1598,3916,89,198,1236,2957,1325,3155
280230,202306,5008,11401,3641,9160,229,506,2434,5915,2663,6421
280240,202306,3860,9146,3189,8061,41,184,2698,6490,2739,6674
280250,202306,1305,2444,874,1742,37,73,696,1286,733,1359
280260,202306,3080,6009,2458,5178,48,120,2174,4397,2222,4517
280270,202306,3068,7083,2525,6242,116,359,2129,4998,2245,5357
280280,202306,4695,12320,3738,10641,499,1170,2537,7301,3036,8471
280290,202306,27732,59124,21506,49081,2395,5842,13120,29370,15515,35212
280300,202306,16563,31751,13639,28260,963,1447,10800,22940,11763,24387
280310,202306,1673,3787,1286,3138,48,138,1002,2303,1050,2441
280320,202306,11503,25949,9073,21892,891,2066,6452,14688,7343,16754
280330,202306,5512,12247,3974,9751,312,790,2726,6266,3038,7056
280340,202306,6399,11884,4704,9786,196,386,3916,7879,4112,8265
280350,202306,40207,73824,32160,62113,1500,2966,26245,48207,27745,51173
280360,202306,7073,17287,5143,13750,530,1541,3167,7798,3697,9339
280370,202306,2863,5923,2152,4722,189,341,1561,3371,1750,3712
280380,202306,1286,2943,985,2439,108,254,676,1624,784,1878
280390,202306,5119,10153,3933,8296,248,425,3135,6428,3383,6853
280400,202306,5137,10592,3922,8773,358,763,2859,6170,3217,6933
280410,202306,3483,8118,2645,6641,308,824,1702,3958,2010,4782
280420,202306,5549,12289,4639,11013,128,314,4048,9461,4176,9775
280430,202306,2957,5855,2386,5051,99,275,1937,3818,2036,4093
280440,202306,5531,12096,4403,10270,277,675,3462,7589,3739,8264
280445,202306,2657,6325,2251,5599,108,200,1706,4098,1814,4298
280450,202306,12025,26738,9468,22660,2199,5185,4684,11179,6883,16364
280460,202306,8665,17745,7151,15556,469,1174,5635,11596,6104,12770
280470,202306,1996,4956,1502,3995,130,357,1072,2688,1202,3045
280480,202306,64814,130612,50305,107907,5333,11860,34099,68862,39432,80722
280490,202306,4097,10756,3162,8973,238,672,2139,5749,2377,6421
280500,202306,1284,2599,924,2085,34,99,726,1583,760,1682
280510,202306,4493,7549,3660,6418,67,165,3283,5461,3350,5626
280520,202306,2326,4775,1869,4093,160,299,1383,2934,1543,3233
280530,202306,2811,6369,2162,5322,99,259,1692,3985,1791,4244
280540,202306,10291,24574,8700,22027,409,1059,7192,17795,7601,18854
280550,202306,8172,16448,6275,13633,166,508,5138,10438,5304,10946
280560,202306,9162,21378,7971,19441,183,554,6847,16183,7030,16737
280570,202306,8635,17540,6562,14564,258,658,5129,10626,5387,11284
280580,202306,7702,16074,6282,13788,456,894,4947,10486,5403,11380
280590,202306,3335,7016,2398,5613,135,367,1734,3748,1869,4115
280600,202306,5239,11171,4217,9385,511,956,2933,6427,3444,7383
280610,202306,3477,6874,2705,5716,117,282,2219,4444,2336,4726
280620,202306,7722,15743,5963,13186,467,756,4344,9654,4811,10410
280630,202306,5135,11387,4216,9915,379,736,3043,7063,3422,7799
280640,202306,3029,6573,2366,5675,85,237,2019,4684,2104,4921
280650,202306,1413,3370,1032,2693,113,305,635,1490,748,1795
280660,202306,4768,8906,3699,7471,239,474,3023,5898,3262,6372
280670,202306,25696,52653,19568,43451,3311,7107,11582,25039,14893,32146
280680,202306,3544,7447,2745,6186,265,484,1861,4232,2126,4716
280690,202306,1299,2567,987,2106,47,122,790,1600,837,1722
280700,202306,1448,2989,1139,2492,21,48,960,2025,981,2073
280710,202306,18846,36139,14431,30511,879,1597,11704,24020,12583,25617
280720,202306,3128,6200,2247,4957,40,112,1867,4008,1907,4120
280730,202306,1246,2854,937,2301,94,229,626,1478,720,1707
280740,202306,21362,40034,16975,33411,875,1938,13731,25395,14606,27333
280750,202306,4078,10262,3212,8633,291,766,2234,5823,2525,6589
280760,202306,9133,19258,7147,16251,632,1259,5262,11774,5894,13033
290010,202306,3720,6761,2383,4759,27,62,2036,3833,2063,3895
290020,202306,7434,15116,6294,13556,438,730,5100,10862,5538,11592
290030,202306,5493,11083,4180,9392,349,736,3129,7093,3478,7829
290035,202306,6182,11692,4915,9927,206,352,4042,8012,4248,8364
290040,202306,7137,12164,5775,10448,215,335,4996,8838,5211,9173
290050,202306,2498,7106,1884,5723,136,444,1237,3529,1373,3973
290060,202306,1895,3596,1279,2725,145,314,926,1872,1071,2186
290070,202306,52777,99439,40363,81394,3092,6074,30271,58465,33363,64539
290080,202306,8545,19361,6853,16596,750,1854,4754,11126,5504,12980
290090,202306,2728,4335,1919,3450,34,63,1745,3050,1779,3113
290100,202306,12053,27439,8486,21369,1569,3849,4065,10176,5634,14025
290110,202306,6850,15550,5037,12166,801,1758,2775,6554,3576,8312
290115,202306,4841,12857,3788,10861,351,1004,2839,7924,3190,8928
290120,202306,8226,17387,6283,14420,211,571,5242,11431,5453,12002
290130,202306,5545,11509,3905,9137,267,537,2711,6449,2978,6986
290135,202306,5671,11440,4090,8692,243,552,3154,6244,3397,6796
290140,202306,5228,12063,3697,9743,194,485,2874,7340,3068,7825
290150,202306,4209,7802,3195,6465,128,337,2556,4812,2684,5149
290160,202306,4492,8528,3674,7307,210,362,3051,5928,3261,6290
290170,202306,4634,9236,3621,7965,134,319,3054,6469,3188,6788
290180,202306,3592,8441,2832,7171,72,247,2355,5726,2427,5973
290190,202306,6202,12960,5220,11556,118,331,4496,9634,4614,9965
290195,202306,3317,6679,2437,5503,162,310,1918,4262,2080,4572
290200,202306,4949,12297,3476,9588,222,500,2404,6470,2626,6970
290205,202306,4551,9659,3512,7872,168,455,2707,5716,2875,6171
290210,202306,17890,39549,14499,33971,1444,2896,10738,25003,12182,27899
290220,202306,4179,7699,3396,6661,106,269,2908,5469,3014,5738
290225,202306,3755,6586,2700,5409,54,169,2362,4474,2416,4643
290230,202306,3881,7445,3379,6799,185,281,2709,5524,2894,5805
290240,202306,5108,10077,3996,8667,131,346,3366,7066,3497,7412
290250,202306,5066,12055,3728,9918,172,459,2953,7748,3125,8207
290260,202306,6513,13875,5099,11624,248,610,4205,9115,4453,9725
290265,202306,3743,10221,2766,8218,335,1085,1667,4687,2002,5772
290270,202306,13113,39311,11052,35193,842,2737,7879,24561,8721,27298
290280,202306,7333,20204,5616,16384,630,1979,3524,9615,4154,11594
290290,202306,11775,30964,8352,24254,958,2906,4907,13384,5865,16290
290300,202306,4923,12039,3339,8980,212,665,2367,6011,2579,6676
290310,202306,2822,4933,2220,4194,20,56,2031,3699,2051,3755
290320,202306,37712,83349,27289,65985,4666,11539,15247,34816,19913,46355
290323,202306,4606,11152,3570,9331,159,442,2735,7032,2894,7474
290327,202306,5116,12846,3791,10037,366,861,2472,6287,2838,7148
290330,202306,3065,4958,2337,4142,27,71,2106,3634,2133,3705
290340,202306,7839,15975,5780,13185,400,904,4513,9975,4913,10879
290350,202306,5711,14368,4349,11888,274,831,3139,8255,3413,9086
290360,202306,6641,13724,5260,11702,208,588,4433,9424,4641,10012
290370,202306,5631,12324,3650,9399,212,567,2567,6512,2779,7079
290380,202306,7246,15312,5529,12755,186,411,4566,10364,4752,10775
290390,202306,18887,47104,14099,38483,1333,3586,9398,24829,10731,28415
290395,202306,3555,8650,2531,6779,100,359,1919,4849,2019,5208
290400,202306,4484,10979,3157,8555,164,518,2326,5985,2490,6503
290405,202306,5440,13999,4262,11825,520,1381,2678,7452,3198,8833
290410,202306,6713,15787,4690,12410,186,717,3488,8693,3674,9410
290420,202306,3721,9014,2765,7386,142,381,2001,5266,2143,5647
290430,202306,4563,9662,3562,8125,154,428,2846,6127,3000,6555
290440,202306,3456,7638,2318,5757,174,399,1625,3991,1799,4390
290450,202306,5355,10028,3902,7847,82,222,3421,6535,3503,6757
290460,202306,15462,39533,10681,29421,2431,6750,4003,10493,6434,17243
290470,202306,5977,11805,4115,9067,359,797,2858,6050,3217,6847
290475,202306,8012,19773,6074,16372,161,629,4869,12510,5030,13139
290480,202306,2275,4844,1672,3844,57,187,1226,2531,1283,2718
290485,202306,5639,14160,4584,12471,261,790,3449,9114,3710,9904
290490,202306,11911,23291,9845,20208,588,1160,7814,15602,8402,16762
290500,202306,5072,13577,3416,9970,709,2199,1309,3575,2018,5774
290510,202306,4431,9123,3469,7794,105,239,2928,6502,3033,6741
290515,202306,4168,10257,3232,8690,81,334,2558,6510,2639,6844
290520,202306,15071,37132,10378,27672,579,1908,6818,16355,7397,18263
290530,202306,5839,14973,4555,12729,120,440,3717,10118,3837,10558
290540,202306,4948,11043,4158,10002,141,356,3455,8075,3596,8431
290550,202306,5253,11513,4290,10229,129,406,3619,8376,3748,8782
290560,202306,7536,17283,5234,13560,519,1483,3164,7493,3683,8976
290570,202306,75129,157156,61074,135364,5179,12430,46007,96589,51186,109019
290580,202306,11352,25713,9358,22757,828,1850,6862,16717,7690,18567
290590,202306,8306,23034,6552,19877,190,658,5127,15514,5317,16172
290600,202306,23045,57012,17957,47841,1166,3282,13665,34889,14831,38171
290610,202306,2903,8146,2096,6468,99,343,1464,4323,1563,4666
290620,202306,7202,18852,5675,16071,440,1163,4282,11949,4722,13112
290630,202306,13132,24920,10240,21117,680,1458,8106,16221,8786,17679
290640,202306,3299,7094,2267,5419,225,463,1562,3784,1787,4247
290650,202306,24064,45302,20153,39823,742,1899,17504,32938,18246,34837
290660,202306,4498,10514,3204,8186,187,530,2285,5690,2472,6220
290670,202306,10731,21056,8549,17775,193,515,7450,14851,7643,15366
290680,202306,13597,31973,10644,27421,263,985,8666,21423,8929,22408
290682,202306,6727,13558,5469,11809,459,703,3964,9150,4423,9853
290685,202306,4221,8635,2833,6520,427,896,1642,3830,2069,4726
290687,202306,10339,21705,8083,18074,1108,2285,5103,11390,6211,13675
290689,202306,3369,8196,2264,6194,320,816,1384,3690,1704,4506
290690,202306,6981,15928,5120,12826,384,946,3599,8628,3983,9574
290700,202306,3866,7741,3139,6748,105,266,2608,5387,2713,5653
290710,202306,11193,25088,8902,21735,221,682,7676,18187,7897,18869
290720,202306,25847,58192,21102,50582,1579,3520,15588,35703,17167,39223
290730,202306,8783,18367,6793,15644,596,1159,4611,10700,5207,11859
290740,202306,1337,3045,957,2443,55,124,760,1887,815,2011
290750,202306,17753,34150,13336,26421,355,922,11068,20317,11423,21239
290755,202306,2335,6068,1679,4851,152,371,1109,3193,1261,3564
290760,202306,4434,11445,3334,9354,173,425,2362,6623,2535,7048
290770,202306,3920,8841,3361,8022,91,294,2837,6494,2928,6788
290780,202306,9325,20968,6875,16983,459,1036,4903,11910,5362,12946
290790,202306,6272,14788,5000,12783,313,837,3930,9856,4243,10693
290800,202306,8159,14556,5488,11190,413,715,3965,8107,4378,8822
290810,202306,6872,14742,5092,11938,211,546,3940,8978,4151,9524
290820,202306,6670,14778,5035,11926,277,638,3559,8015,3836,8653
290830,202306,5132,11463,3903,9201,154,546,2844,5956,2998,6502
290840,202306,22499,52453,17008,42846,1797,3838,10501,27205,12298,31043
290850,202306,11443,20622,8817,17230,642,1147,6756,12743,7398,13890
290860,202306,7990,18751,6544,16746,350,768,5346,13676,5696,14444
290870,202306,5800,14186,3902,10399,359,864,2529,6444,2888,7308
290880,202306,1684,3686,1203,2985,199,445,660,1736,859,2181
290890,202306,12176,21140,9515,17958,328,672,8081,14623,8409,15295
290900,202306,2727,6674,1804,4857,203,546,1043,2679,1246,3225
290910,202306,6179,12741,4308,9876,67,186,3700,8236,3767,8422
290920,202306,6381,13669,5218,12188,189,364,4265,10357,4454,10721
290930,202306,8554,21897,6270,17661,281,906,4467,12021,4748,12927
290940,202306,4058,10370,3067,8670,203,627,2252,6129,2455,6756
290950,202306,1697,3794,1234,3036,108,268,778,1906,886,2174
290960,202306,7448,15999,5983,13794,277,532,4935,11158,5212,11690
290970,202306,3610,10111,2653,8145,160,555,1881,5542,2041,6097
290980,202306,18333,37023,13898,29623,768,1846,9784,19089,10552,20935
290990,202306,11969,27709,9825,24104,393,1246,7889,18254,8282,19500
291000,202306,3935,8866,2857,7403,189,539,2161,5518,2350,6057
291005,202306,21786,46001,17135,38756,1039,2500,13208,28175,14247,30675
291010,202306,3525,9935,2459,7479,144,445,1580,4583,1724,5028
291020,202306,1529,3416,1110,2668,36,108,774,1671,810,1779
291030,202306,3081,6472,2027,4639,231,480,1225,2681,1456,3161
291040,202306,6392,15368,4804,12937,250,697,3584,9479,3834,10176
291050,202306,14607,28508,11777,24177,1415,2702,8378,16752,9793,19454
291060,202306,11107,23929,8905,20675,999,2013,6367,14460,7366,16473
291070,202306,22614,48217,17948,40737,360,1092,15339,33226,15699,34318
291072,202306,36010,76556,23903,55951,3459,8105,13334,29519,16793,37624
291075,202306,6392,14235,5329,12422,98,279,4339,9569,4437,9848
291077,202306,1992,4716,1403,3669,104,212,936,2435,1040,2647
291080,202306,171589,357618,121776,278174,23300,54059,61392,132574,84692,186633
291085,202306,6717,15029,5027,12338,234,649,4006,9442,4240,10091
291090,202306,2566,4315,1707,3290,52,132,1411,2582,1463,2714
291100,202306,3885,7195,2632,5580,104,202,2071,4232,2175,4434
291110,202306,6968,19187,5131,15546,310,1078,3555,10059,3865,11137
291120,202306,10253,20440,8009,17295,542,1121,5996,12514,6538,13635
291125,202306,2817,4352,1986,3397,83,131,1726,2877,1809,3008
291130,202306,3809,9604,2533,7055,125,419,1837,4782,1962,5201
291140,202306,5722,13783,3659,9754,707,1573,1975,5366,2682,6939
291150,202306,3399,5819,2485,4763,102,171,2162,4085,2264,4256
291160,202306,6105,15006,4362,11890,556,1500,2536,6419,3092,7919
291165,202306,2402,6102,1505,4244,46,171,999,2658,1045,2829
291170,202306,27369,61932,19738,47721,1514,3779,12913,29117,14427,32896
291180,202306,9624,16611,6923,13060,327,638,5872,10684,6199,11322
291185,202306,4278,9161,3494,7915,187,352,2788,6222,2975,6574
291190,202306,9315,19851,7211,16919,334,803,5364,12519,5698,13322
291200,202306,3215,8093,2102,5863,94,319,1361,3486,1455,3805
291210,202306,9580,17002,6601,13362,335,647,5174,10161,5509,10808
291220,202306,5980,14052,4737,11823,520,1253,3002,7139,3522,8392
291230,202306,6043,10198,4453,8317,91,177,4003,7269,4094,7446
291240,202306,4994,11564,3893,9671,113,313,3252,7788,3365,8101
291250,202306,3794,10294,2730,8257,197,545,1593,4862,1790,5407
291260,202306,1820,3627,1343,2973,31,70,1087,2337,1118,2407
291270,202306,6823,14883,4973,12247,647,1542,3338,8210,3985,9752
291280,202306,3398,7343,2129,5165,145,397,1479,3285,1624,3682
291290,202306,6588,15586,4469,12005,458,1271,2866,7329,3324,8600
291300,202306,4676,10996,3444,8846,238,520,2437,6114,2675,6634
291310,202306,6295,14523,4873,11965,127,384,4119,9680,4246,10064
291320,202306,7887,18942,5683,15042,1258,3207,2933,7766,4191,10973
291330,202306,2237,5163,1692,4222,66,201,1252,2976,1318,3177
291340,202306,5077,11666,3691,9244,229,514,2471,6030,2700,6544
291345,202306,3566,8755,2990,7802,223,600,2291,5883,2514,6483
291350,202306,8521,17746,6268,14684,273,723,4907,10963,5180,11686
291360,202306,55483,105119,39878,84220,5250,10635,25179,52314,30429,62949
291370,202306,10124,23867,8127,20422,786,1920,5612,13328,6398,15248
291380,202306,5905,11596,4702,9956,138,429,3925,7838,4063,8267
291390,202306,16680,30464,11782,24279,734,1327,9350,18610,10084,19937
291400,202306,20673,41461,15617,33505,1600,3258,10695,22441,12295,25699
291410,202306,3548,8323,2528,6469,66,217,1848,4494,1914,4711
291420,202306,2228,4844,1646,4060,30,105,1398,3348,1428,3453
291430,202306,3083,7613,2382,6350,135,394,1766,4438,1901,4832
291440,202306,8051,19828,6338,16860,499,1247,4458,11884,4957,13131
291450,202306,13899,25077,10791,21281,334,610,9442,18402,9776,19012
291460,202306,22910,48936,17972,40516,1924,4020,12375,26637,14299,30657
291465,202306,10467,22772,7792,19390,346,1155,6148,14597,6494,15752
291470,202306,25919,46890,19172,37709,1110,2022,14386,26697,15496,28719
291480,202306,54938,107407,38841,82512,4398,9678,23486,46720,27884,56398
291490,202306,9291,17964,7749,16052,360,831,6528,13055,6888,13886
291500,202306,6756,12807,5268,10884,139,387,4593,9051,4732,9438
291510,202306,5870,11234,4280,9149,107,300,3659,7547,3766,7847
291520,202306,5553,11205,3685,8513,203,499,2836,6203,3039,6702
291530,202306,2771,5629,1794,4239,168,398,1200,2742,1368,3140
291535,202306,4698,11315,3630,9490,203,529,2826,7278,3029,7807
291540,202306,2639,5012,1747,3863,74,154,1449,3170,1523,3324
291550,202306,8169,14850,5818,11639,410,735,4343,8464,4753,9199
291560,202306,21545,46938,14050,35337,3440,8540,5558,13702,8998,22242
291570,202306,2873,5723,2037,4716,68,185,1723,3888,1791,4073
291580,202306,7685,17155,5374,13595,346,941,3827,9124,4173,10065
291590,202306,3482,6350,2795,5477,67,176,2412,4464,2479,4640
291600,202306,6750,13605,4731,10466,462,1108,3104,6546,3566,7654
291610,202306,8662,16644,7131,14660,667,1019,5435,11328,6102,12347
291620,202306,3531,6972,2468,5615,206,428,1742,3962,1948,4390
291630,202306,4308,7852,3021,6222,514,790,2061,4413,2575,5203
291640,202306,22749,45568,15162,33537,1284,2980,9822,20259,11106,23239
291650,202306,12668,25444,10433,22392,843,1488,8107,17363,8950,18851
291660,202306,2338,5127,1616,3982,119,343,1072,2383,1191,2726
291670,202306,2403,5725,1815,4782,248,589,1118,3018,1366,3607
291680,202306,4970,10735,3605,8637,594,1436,2099,4940,2693,6376
291685,202306,5609,12670,4084,10189,337,744,2912,7183,3249,7927
291690,202306,5507,9709,3714,7200,146,292,3201,5959,3347,6251
291700,202306,11822,27427,9782,24019,287,883,8305,19551,8592,20434
291710,202306,6707,13054,4667,10120,338,752,3399,6896,3737,7648
291720,202306,5283,14340,3977,11647,929,2687,1965,5672,2894,8359
291730,202306,9912,18300,8134,15954,417,884,6793,12917,7210,13801
291733,202306,3544,7910,2631,6531,124,300,1899,4745,2023,5045
291735,202306,3111,7850,2155,6019,67,183,1499,4154,1566,4337
291740,202306,4914,11433,2952,7754,117,277,2039,5194,2156,5471
291750,202306,27297,55789,20395,44522,2784,5337,13375,28814,16159,34151
291760,202306,13653,34153,9538,27025,2968,9661,1988,4825,4956,14486
291770,202306,9411,21999,6855,17074,434,1272,5006,11494,5440,12766
291780,202306,6447,14424,5480,12956,198,501,4578,10507,4776,11008
291790,202306,3749,8098,3227,7368,392,615,2302,5461,2694,6076
291800,202306,45170,93361,32484,73666,4081,9704,19804,41245,23885,50949
291810,202306,13308,27509,10345,23349,519,936,8268,18566,8787,19502
291820,202306,4799,10919,3853,9471,149,378,3040,7279,3189,7657
291830,202306,6043,11411,4582,9416,370,575,3490,7152,3860,7727
291835,202306,7760,20943,5766,17102,866,2517,3447,10196,4313,12713
291840,202306,66774,153852,53253,131109,6445,16109,35236,83016,41681,99125
291845,202306,4220,8143,3210,6797,309,617,2378,4979,2687,5596
291850,202306,5545,12896,4349,10936,130,348,3645,9056,3775,9404
291855,202306,2845,4625,2121,3809,55,126,1905,3347,1960,3473
291860,202306,2548,6246,1574,4298,68,215,1031,2668,1099,2883
291870,202306,1504,3463,884,2355,72,204,544,1370,616,1574
291875,202306,3481,9583,2684,7795,100,383,1851,5100,1951,5483
291880,202306,6788,16431,5287,13842,346,877,3909,10135,4255,11012
291890,202306,2098,3758,1233,2672,185,388,744,1536,929,1924
291900,202306,1644,3421,1160,2656,49,130,910,1936,959,2066
291905,202306,2526,6199,1860,5032,95,291,1369,3474,1464,3765
291910,202306,4531,8416,3542,7125,73,185,3110,6086,3183,6271
291915,202306,8739,22042,6534,18046,318,903,4438,12166,4756,13069
291920,202306,46284,98199,36813,83827,1931,5320,27816,58856,29747,64176
291930,202306,3406,7408,2681,6318,311,653,1848,4353,2159,5006
291940,202306,4477,10322,2687,7156,276,714,1606,4118,1882,4832
291950,202306,10861,30337,8118,24619,518,1555,5245,15511,5763,17066
291955,202306,26407,56064,20927,47798,1385,3367,15374,33374,16759,36741
291960,202306,4716,9397,3647,7906,291,494,2862,6304,3153,6798
291970,202306,6145,12467,4890,10786,231,591,3819,8048,4050,8639
291980,202306,12191,30607,8831,24361,865,2247,5730,15698,6595,17945
291990,202306,2762,6228,2142,5423,76,302,1817,4424,1893,4726
291992,202306,5758,11479,4441,9421,151,364,3677,7425,3828,7789
291995,202306,2840,6273,2102,5047,88,263,1654,3702,1742,3965
292000,202306,3397,6668,2652,5738,89,216,2204,4629,2293,4845
292010,202306,7156,14146,5400,11422,113,339,4644,9409,4757,9748
292020,202306,5766,13745,4480,11428,124,427,3640,8799,3764,9226
292030,202306,2610,6574,1980,5371,191,564,1211,3095,1402,3659
292040,202306,5716,12020,4234,9840,148,338,3471,7880,3619,8218
292045,202306,5553,10871,4159,8906,64,203,3738,7763,3802,7966
292050,202306,7794,19097,5498,14694,275,801,3687,9248,3962,10049
292060,202306,16264,30703,14014,27766,644,1306,11845,22492,12489,23798
292070,202306,8792,17492,7314,15571,570,1216,5906,12203,6476,13419
292080,202306,4724,8779,3752,7527,71,221,3373,6549,3444,6770
292090,202306,5180,9952,3408,7675,161,413,2624,5700,2785,6113
292100,202306,16452,34598,12028,27726,1803,4197,7152,15738,8955,19935
292105,202306,3941,9093,3008,7583,87,281,2353,5704,2440,5985
292110,202306,8278,16229,5633,12458,815,1880,3585,7642,4400,9522
292120,202306,8717,19334,6482,15308,750,1496,4429,10451,5179,11947
292130,202306,4042,8569,2992,7068,208,515,2106,4718,2314,5233
292140,202306,7160,13786,5604,11468,182,410,4884,9669,5066,10079
292145,202306,3224,7662,2415,6220,146,283,1776,4588,1922,4871
292150,202306,19974,43092,15963,36501,410,1104,13300,28930,13710,30034
292160,202306,3490,7352,2419,5889,35,119,1901,4768,1936,4887
292170,202306,10576,25014,7940,20541,552,1565,5656,13843,6208,15408
292180,202306,3379,8533,2248,6262,186,527,1415,3704,1601,4231
292190,202306,3770,8469,2790,6794,298,720,1818,4275,2116,4995
292200,202306,11634,25617,7424,18559,1799,4605,3107,7512,4906,12117
292205,202306,4625,11096,3702,9576,147,420,3012,7603,3159,8023
292210,202306,8248,15610,6525,13345,102,325,5954,11765,6056,12090
292220,202306,2769,5567,2076,4438,167,337,1499,2991,1666,3328
292225,202306,3771,9764,3035,8526,89,334,2432,6576,2521,6910
292230,202306,10796,22394,8398,18833,331,895,6567,13834,6898,14729
292240,202306,6204,15523,4862,12942,346,930,3382,8839,3728,9769
292250,202306,7726,16763,6236,14366,364,841,4868,10763,5232,11604
292260,202306,4153,9637,3348,8481,89,259,2861,7100,2950,7359
292265,202306,4546,10381,3565,8784,67,249,2981,7022,3048,7271
292270,202306,6087,11207,4632,9327,252,470,3688,7229,3940,7699
292273,202306,3405,6557,2473,5297,132,268,1779,3886,1911,4154
292275,202306,2199,4861,1724,4170,48,146,1412,3274,1460,3420
292280,202306,3335,6781,2515,5767,94,203,2100,4792,2194,4995
292285,202306,3115,6363,2310,5238,119,220,1845,4201,1964,4421
292290,202306,9141,20183,6900,16847,379,845,5487,13149,5866,13994
292300,202306,13071,29054,9066,22673,1529,3814,4941,12074,6470,15888
292303,202306,4198,9266,3394,7963,95,238,2880,6514,2975,6752
292305,202306,2780,6511,2356,5852,82,214,2009,4883,2091,5097
292310,202306,8441,17869,6734,15424,191,590,5737,12572,5928,13162
292320,202306,6903,16462,5084,13237,211,549,3896,9801,4107,10350
292330,202306,3959,6660,3094,5610,149,227,2609,4734,2758,4961
292335,202306,6188,14240,5022,12360,332,809,3917,9465,4249,10274
292340,202306,6282,16162,4636,12814,405,1031,3107,8381,3512,9412
292350,202306,3433,7819,2734,6789,152,408,2170,5199,2322,5607
292360,202306,5983,14156,4460,11413,247,638,3202,7907,3449,8545
292370,202306,13488,27013,10743,23202,150,541,9795,20394,9945,20935
292380,202306,8236,20208,6670,17216,444,1199,4971,12248,5415,13447
292390,202306,5855,9309,4259,7395,133,244,3808,6470,3941,6714
292400,202306,29836,70668,23162,58774,2453,6006,15388,37753,17841,43759
292405,202306,5517,11755,4183,9533,155,371,3230,7348,3385,7719
292410,202306,3092,5677,2432,4814,107,220,2070,3981,2177,4201
292420,202306,6235,11947,5217,10527,131,257,4628,9084,4759,9341
292430,202306,6005,15943,4037,12032,325,974,2589,7356,2914,8330
292440,202306,11501,29121,10027,26858,182,812,8700,22649,8882,23461
292450,202306,4956,12478,3323,9241,199,602,2298,6061,2497,6663
292460,202306,7962,16203,6287,13559,288,859,5172,10481,5460,11340
292465,202306,3102,6899,2325,5638,86,211,1615,4039,1701,4250
292467,202306,2649,6124,2237,5520,300,648,1499,3850,1799,4498
292470,202306,3331,7900,2217,6005,167,463,1555,4168,1722,4631
292480,202306,8152,15003,6445,12825,213,397,5682,11096,5895,11493
292490,202306,3453,6563,2599,5387,60,154,2197,4331,2257,4485
292500,202306,9006,19711,6488,15441,357,795,4878,11138,5235,11933
292510,202306,17437,39153,12344,30520,1285,2837,8414,20547,9699,23384
292520,202306,9257,20338,7244,16837,398,1059,5500,12058,5898,13117
292525,202306,8158,16310,6319,13987,191,525,5463,11740,5654,12265
292530,202306,46911,104554,33710,82312,6264,16242,17002,38464,23266,54706
292540,202306,5197,8584,3851,7088,174,302,3346,6064,3520,6366
292550,202306,10475,25115,7293,20563,698,1986,4553,12896,5251,14882
292560,202306,5562,12278,4126,10030,153,451,3184,7280,3337,7731
292570,202306,4501,10277,3380,8295,86,303,2711,6266,2797,6569
292575,202306,8164,21023,6915,18901,1222,3283,4442,12108,5664,15391
292580,202306,9663,19867,7549,16689,426,665,6122,13376,6548,14041
292590,202306,8868,20993,6842,17249,351,988,5511,13400,5862,14388
292593,202306,3515,7712,2480,5893,103,270,1914,4319,2017,4589
292595,202306,6872,15541,5605,13699,321,684,4339,10531,4660,11215
292600,202306,13809,32424,10970,27837,696,1588,8490,21339,9186,22927
292610,202306,5598,12080,4229,9734,200,486,3261,7108,3461,7594
292620,202306,8286,18491,6348,15915,170,533,5403,13214,5573,13747
292630,202306,11590,23913,8468,18742,1147,2883,5646,11553,6793,14436
292640,202306,9671,24776,7210,20143,490,1392,4782,13084,5272,14476
292650,202306,5060,11321,4119,9944,120,456,3549,8224,3669,8680
292660,202306,12987,32308,10098,27392,548,1507,7381,19706,7929,21213
292665,202306,2426,6282,1910,5487,127,332,1404,4061,1531,4393
292670,202306,4001,10213,2835,7934,251,782,1809,4755,2060,5537
292680,202306,4620,10900,3390,8673,119,309,2543,6183,2662,6492
292690,202306,2834,6874,1791,5108,218,604,1076,3091,1294,3695
292700,202306,12937,29427,9961,24295,605,1340,7387,17434,7992,18774
292710,202306,4319,9043,3824,8355,68,188,3487,7393,3555,7581
292720,202306,10506,21614,8053,18266,476,1000,5971,13610,6447,14610
292730,202306,6932,13130,5725,11334,303,522,4797,9375,5100,9897
292740,202306,540118,1049584,434464,886847,45818,95442,301036,577062,346854,672504
292750,202306,9177,18847,7220,16069,325,777,5897,12734,6222,13511
292760,202306,4713,11814,3743,10015,179,514,2795,7242,2974,7756
292770,202306,9670,20741,7198,17110,919,2299,4705,10800,5624,13099
292780,202306,2543,4340,1761,3375,72,168,1431,2540,1503,2708
292790,202306,4680,8603,3152,6735,271,522,2364,4958,2635,5480
292800,202306,14749,31204,11585,26028,970,1957,8635,19213,9605,21170
292805,202306,4573,9082,3425,7525,175,471,2752,5749,2927,6220
292810,202306,16933,32645,12728,26200,388,1041,10585,20286,10973,21327
292820,202306,7951,20574,5435,15984,503,1579,3567,9983,4070,11562
292830,202306,3595,7384,2872,6443,138,303,2298,5116,2436,5419
292840,202306,12652,25337,9970,21570,205,595,8739,18052,8944,18647
292850,202306,3174,7211,2433,6008,187,455,1704,4018,1891,4473
292860,202306,22700,42253,17929,35574,474,1313,15010,27911,15484,29224
292870,202306,29321,59779,22157,47987,2074,4121,14756,30008,16830,34129
292880,202306,13668,34174,9964,27189,415,1367,6563,16161,6978,17528
292890,202306,10965,23468,8832,20174,244,675,7238,15591,7482,16266
292895,202306,4124,7446,2950,5667,254,444,2245,4203,2499,4647
292900,202306,3711,8009,3010,6848,59,209,2403,5064,2462,5273
292905,202306,5425,12205,3946,9766,230,624,2876,6704,3106,7328
292910,202306,7056,15358,5759,13409,184,391,4638,10384,4822,10775
292920,202306,12500,28606,10116,24393,411,1284,7968,18068,8379,19352
292925,202306,6196,16132,4440,12504,403,964,2909,8029,3312,8993
292930,202306,8764,22422,6564,17891,960,2581,3337,8569,4297,11150
292935,202306,3361,6054,2541,5060,34,101,2289,4484,2323,4585
292937,202306,3257,7628,2555,6591,291,777,1327,3764,1618,4541
292940,202306,3641,8049,2696,6511,458,998,1613,3967,2071,4965
292950,202306,11115,25855,8098,20271,547,1369,5674,13279,6221,14648
292960,202306,6830,14156,5196,11662,203,432,4015,8618,4218,9050
292970,202306,4944,12022,4118,10749,124,373,3287,8438,3411,8811
292975,202306,5237,10242,4244,8916,108,281,3730,7527,3838,7808
292980,202306,4800,9047,3719,7445,71,211,3271,6265,3342,6476
292990,202306,13872,34304,10595,28349,480,1504,7841,19635,8321,21139
293000,202306,3230,7017,2366,5551,206,426,1658,3848,1864,4274
293010,202306,23625,51466,17228,40852,2497,6003,10713,24479,13210,30482
293015,202306,10398,27950,7582,22437,690,2030,4987,14507,5677,16537
293020,202306,12681,29882,10774,26911,195,694,9541,23107,9736,23801
293030,202306,6258,14828,4384,11636,360,685,2803,7670,3163,8355
293040,202306,5332,12007,3900,9854,136,347,3122,7672,3258,8019
293050,202306,32255,62622,25258,51393,1775,3495,19279,37312,21054,40807
293060,202306,4608,10824,3350,8431,212,577,2422,5736,2634,6313
293070,202306,43039,81115,34217,67773,1922,4037,26721,49794,28643,53831
293075,202306,4408,11808,3533,10259,96,416,2938,8328,3034,8744
293076,202306,4130,8781,3435,7835,122,236,2939,6706,3061,6942
293077,202306,8165,19059,5887,15027,940,2042,3300,8826,4240,10868
293080,202306,5305,13973,4159,11782,111,432,3272,8859,3383,9291
293090,202306,3734,10017,2510,7645,208,617,1637,4778,1845,5395
293100,202306,7146,16733,5324,13447,375,848,4000,9950,4375,10798
293105,202306,4639,13107,3627,11024,262,793,2468,7345,2730,8138
293110,202306,3180,6456,2457,5334,141,275,1944,4104,2085,4379
293120,202306,6514,13380,5455,11777,492,810,4182,9114,4674,9924
293130,202306,4452,10397,3586,9099,118,368,3032,7454,3150,7822
293135,202306,39680,85422,24957,61686,4952,13386,9439,21706,14391,35092
293140,202306,3614,6016,2810,4983,106,169,2366,4019,2472,4188
293150,202306,6189,16299,4402,12515,443,1216,2869,7708,3312,8924
293160,202306,5102,10295,4322,9333,525,713,3258,7559,3783,8272
293170,202306,6760,10873,4898,8590,118,257,4208,6966,4326,7223
293180,202306,5646,13387,4356,11082,142,460,3456,8359,3598,8819
293190,202306,21178,42164,17736,37159,249,892,15788,31642,16037,32534
293200,202306,11674,22927,8792,18452,612,1134,6983,14411,7595,15545
293210,202306,6795,14769,5180,12143,557,1181,3595,8355,4152,9536
293220,202306,7467,15007,5168,11308,725,1525,3349,6978,4074,8503
293230,202306,5971,11568,4248,9328,418,824,3063,6739,3481,7563
293240,202306,5439,12149,4101,9912,207,453,2990,7366,3197,7819
293245,202306,4839,11278,3951,9770,256,641,2998,6996,3254,7637
293250,202306,6943,14803,4918,11609,463,1124,3342,7428,3805,8552
293260,202306,5983,13173,4221,10149,192,455,3001,7074,3193,7529
293270,202306,9290,17521,6939,14813,480,729,5440,11908,5920,12637
293280,202306,5732,12452,4594,10683,317,714,3585,8046,3902,8760
293290,202306,22100,52722,17916,45574,1669,4324,12551,30704,14220,35028
293300,202306,8443,16914,6505,13721,657,1256,4652,9329,5309,10585
293305,202306,5609,11113,4077,8980,92,269,3524,7437,3616,7706
293310,202306,2728,6018,2082,4948,42,129,1706,3872,1748,4001
293315,202306,5720,10887,4391,8965,430,638,3428,7064,3858,7702
293317,202306,3419,7060,2760,5966,334,593,1928,4184,2262,4777
293320,202306,18129,34106,14846,30006,248,645,13099,25369,13347,26014
293325,202306,2323,4868,1645,3933,178,439,1050,2387,1228,2826
293330,202306,100485,227953,71827,174786,9196,23769,42125,93443,51321,117212
293340,202306,2638,6538,1915,5175,172,419,1298,3473,1470,3892
293345,202306,4767,10851,3315,8438,781,1889,1546,4244,2327,6133
293350,202306,7216,17499,5873,15597,356,916,4633,12181,4989,13097
293360,202306,19444,40449,15470,35085,582,1393,12878,28817,13460,30210
310010,202306,1203,2485,745,1791,107,286,336,673,443,959
310020,202306,4078,9543,2643,6745,432,1214,1176,2626,1608,3840
310030,202306,2417,6068,1756,4800,238,702,1091,2770,1329,3472
310040,202306,1038,2425,708,1788,72,215,373,794,445,1009
310050,202306,2086,5100,1541,4096,151,451,922,2240,1073,2691
310060,202306,3798,9129,2869,7636,194,614,1949,5131,2143,5745
310070,202306,422,934,274,684,15,35,192,465,207,500
310080,202306,887,2250,566,1611,85,275,259,685,344,960
310090,202306,6657,13976,5020,11333,205,597,3953,8343,4158,8940
310100,202306,4717,10503,3519,8517,117,424,2766,6221,2883,6645
310110,202306,5981,14016,4199,10753,543,1539,2465,5824,3008,7363
310120,202306,840,1861,494,1295,73,227,239,510,312,737
310130,202306,543,1233,438,1056,32,108,326,713,358,821
310140,202306,458,1170,324,934,71,223,140,348,211,571
310150,202306,8140,17794,5287,12540,443,1285,3233,6753,3676,8038
310160,202306,13618,29650,8993,21414,1861,4509,4073,8707,5934,13216
310163,202306,1506,4064,958,2826,232,752,263,602,495,1354
310170,202306,12375,26599,9165,21435,918,2099,6342,14187,7260,16286
310180,202306,2514,5377,1638,3901,183,489,1024,2262,1207,2751
310190,202306,3329,8654,2090,6051,472,1438,472,1201,944,2639
310200,202306,2499,6358,1712,4851,444,1398,641,1490,1085,2888
310205,202306,1463,3606,1068,2941,141,384,654,1784,795,2168
310210,202306,2905,7064,2070,5379,109,257,1471,3631,1580,3888
310220,202306,1436,3576,962,2655,90,288,592,1514,682,1802
310230,202306,3003,6935,2194,5351,333,847,1247,2758,1580,3605
310240,202306,1301,3309,952,2613,100,275,547,1391,647,1666
310250,202306,1548,3236,1131,2524,39,120,859,1780,898,1900
310260,202306,4874,11581,2790,7447,607,1885,903,1801,1510,3686
310270,202306,3587,6821,2558,5384,87,209,2049,4080,2136,4289
310280,202306,3653,7027,2433,5123,144,357,1742,3266,1886,3623
310285,202306,2222,6217,1595,4898,191,590,910,2737,1101,3327
310290,202306,2081,4896,1531,3800,199,592,898,1897,1097,2489
310300,202306,2117,5266,1303,3570,135,417,642,1464,777,1881
310310,202306,407,864,241,581,42,106,118,243,160,349
310320,202306,583,1355,342,918,34,95,171,416,205,511
310330,202306,629,1374,310,769,59,144,128,284,187,428
310340,202306,10278,23286,6451,15992,896,2090,3168,7442,4064,9532
310350,202306,17542,39172,10860,27314,1617,4520,5440,12187,7057,16707
310360,202306,804,1546,588,1203,23,61,425,797,448,858
310370,202306,1482,4249,1124,3513,273,887,378,1202,651,2089
310375,202306,1071,2419,645,1704,218,554,187,463,405,1017
310380,202306,432,959,195,520,11,31,110,273,121,304
310390,202306,783,2143,580,1723,91,298,269,701,360,999
310400,202306,16248,36363,10207,25606,1107,3048,5835,13353,6942,16401
310410,202306,1305,3439,638,1869,80,256,266,630,346,886
310420,202306,6234,15045,3783,9953,461,1283,1878,4257,2339,5540
310430,202306,2192,5449,1320,3656,236,691,591,1362,827,2053
310440,202306,809,1867,455,1179,70,166,207,493,277,659
310445,202306,1632,4133,1099,3007,84,215,766,1992,850,2207
310450,202306,5993,12561,3972,9259,293,853,2769,5890,3062,6743
310460,202306,2164,5274,1306,3524,229,627,324,718,553,1345
310470,202306,4038,8493,2892,6844,617,1330,1568,3768,2185,5098
310480,202306,1243,2906,820,2157,83,267,461,1054,544,1321
310490,202306,3693,8909,2521,6709,382,1064,1220,2898,1602,3962
310500,202306,1891,4405,1376,3494,212,549,805,1905,1017,2454
310510,202306,3067,7024,1909,4746,339,915,816,1820,1155,2735
310520,202306,1482,3485,859,2241,140,406,364,879,504,1285
310530,202306,1064,2548,646,1709,78,235,263,544,341,779
310540,202306,3464,9169,2340,6577,418,1255,894,2116,1312,3371
310550,202306,1546,3374,1007,2424,99,265,607,1316,706,1581
310560,202306,21905,51559,13587,34562,1476,4323,7107,14953,8583,19276
310570,202306,1559,3254,1095,2573,41,133,866,1878,907,2011
310590,202306,5363,12379,3370,8114,205,608,2112,4466,2317,5074
310600,202306,1781,4513,1176,3095,139,368,613,1448,752,1816
310610,202306,604,1549,326,1019,70,237,74,200,144,437
310620,202306,304566,674529,201623,474781,21096,57586,116531,236224,137627,293810
310630,202306,5893,14461,3526,9321,482,1289,1910,4572,2392,5861
310640,202306,2027,4498,1398,3307,97,277,990,2076,1087,2353
310650,202306,2898,7009,1812,4813,116,348,1095,2708,1211,3056
310660,202306,1765,4066,1344,3451,41,163,1100,2709,1141,2872
310665,202306,1739,3730,1271,3015,36,125,988,2213,1024,2338
310670,202306,87197,193104,61173,143389,6528,16769,38635,82241,45163,99010
310680,202306,974,2023,736,1639,20,66,568,1161,588,1227
310690,202306,3273,6753,2114,4903,244,522,1341,2878,1585,3400
310700,202306,661,1224,461,954,11,32,371,723,382,755
310710,202306,8003,20404,4633,13797,1158,3567,750,1950,1908,5517
310720,202306,1479,2992,1050,2351,52,161,783,1615,835,1776
310730,202306,12996,29580,9477,23243,566,1714,6711,15090,7277,16804
310740,202306,8928,21547,5530,14291,647,1882,2819,6247,3466,8129
310750,202306,1724,3656,1130,2620,162,397,623,1255,785,1652
310760,202306,897,2024,582,1490,79,197,348,863,427,1060
310770,202306,1353,3344,821,2331,107,343,381,908,488,1251
310780,202306,5047,10555,3528,8158,296,706,2360,5184,2656,5890
310790,202306,2320,6660,1752,5312,384,1319,434,1064,818,2383
310800,202306,2846,7905,1627,5113,327,1114,122,296,449,1410
310810,202306,1902,4006,1375,3070,114,259,958,2023,1072,2282
310820,202306,1478,3381,746,2081,135,364,229,591,364,955
310825,202306,3216,7906,2323,6360,68,297,1839,4689,1907,4986
310830,202306,2777,6689,1755,4694,333,934,833,1899,1166,2833
310840,202306,2810,6904,1756,4812,368,1060,576,1298,944,2358
310850,202306,1623,3947,1169,3158,73,268,806,1976,879,2244
310855,202306,4166,9625,2829,7275,263,660,1818,4400,2081,5060
310860,202306,8326,21389,6061,16999,834,2128,3324,9214,4158,11342
310870,202306,1166,2565,831,2023,63,171,586,1312,649,1483
310880,202306,1100,2985,714,2109,90,248,372,1038,462,1286
310890,202306,2678,7149,1470,4489,273,868,200,486,473,1354
310900,202306,5397,13855,3386,9269,644,1896,1419,3312,2063,5208
310910,202306,2764,6191,1551,4010,265,751,420,911,685,1662
310920,202306,2303,5383,1528,4026,208,582,909,2245,1117,2827
310925,202306,1338,3025,908,2267,41,102,634,1464,675,1566
310930,202306,6950,16102,4146,11385,776,2195,1785,4878,2561,7073
310940,202306,8556,17833,5822,13378,286,812,4309,9152,4595,9964
310945,202306,1793,3997,1168,2889,145,397,664,1484,809,1881
310950,202306,2264,6226,1277,3961,209,727,336,785,545,1512
310960,202306,808,2112,405,1181,57,176,117,308,174,484
310970,202306,1424,4004,860,2709,214,678,155,420,369,1098
310980,202306,415,896,195,479,9,27,100,212,109,239
310990,202306,1869,4361,1315,3336,155,465,767,1699,922,2164
311000,202306,5319,13060,3625,9759,718,2037,1788,4294,2506,6331
311010,202306,1209,2904,914,2377,216,579,440,1122,656,1701
311020,202306,1454,3333,818,2133,61,189,459,1082,520,1271
311030,202306,2359,5328,1442,3709,392,1125,524,1157,916,2282
311040,202306,364,1033,245,756,76,259,57,141,133,400
311050,202306,3853,8627,2394,6006,365,1050,1257,2750,1622,3800
311060,202306,4683,10705,2767,6899,327,924,1334,2831,1661,3755
311070,202306,3183,6950,1993,4891,267,778,1063,2245,1330,3023
311080,202306,1440,2813,1029,2203,41,119,787,1532,828,1651
311090,202306,2868,8001,1907,5851,448,1347,553,1613,1001,2960
311100,202306,3127,8004,1911,5599,345,1113,527,1283,872,2396
311110,202306,4521,9087,1924,4791,468,1179,303,688,771,1867
311115,202306,1793,3349,1306,2661,25,83,1004,2050,1029,2133
311120,202306,9187,21610,5748,14464,864,2372,2589,5373,3453,7745
311130,202306,2305,5611,1485,4108,167,542,817,2009,984,2551
311140,202306,1994,4535,1239,3202,217,549,627,1533,844,2082
311150,202306,1745,5032,1226,3892,186,647,559,1598,745,2245
311160,202306,5226,13289,3313,9506,536,1690,1358,3423,1894,5113
311170,202306,1198,2790,826,2193,78,213,510,1363,588,1576
311180,202306,1887,3921,1031,2521,147,353,487,1077,634,1430
311190,202306,1024,2682,653,1881,78,255,292,690,370,945
311200,202306,2936,7003,1852,4778,374,1034,767,1625,1141,2659
311205,202306,1130,2946,828,2358,44,140,500,1306,544,1446
311210,202306,1270,3350,1040,2954,126,319,695,2039,821,2358
311220,202306,1096,2402,857,1912,20,62,689,1406,709,1468
311230,202306,9609,26416,6290,19041,1376,4280,1981,5825,3357,10105
311240,202306,1485,3278,1008,2470,128,364,604,1273,732,1637
311250,202306,1730,4292,1102,2985,208,576,472,1114,680,1690
311260,202306,3214,7275,1634,4197,208,574,744,1585,952,2159
311265,202306,1715,3633,1103,2618,50,134,825,1790,875,1924
311270,202306,3706,9670,2772,7835,191,726,1772,4513,1963,5239
311280,202306,1583,3782,841,2309,199,556,232,533,431,1089
311290,202306,2189,6134,1787,5275,140,431,1127,3222,1267,3653
311300,202306,5329,12992,4112,10896,200,640,3126,7864,3326,8504
311310,202306,650,1644,448,1202,35,93,290,726,325,819
311320,202306,3893,10621,2742,7819,357,1074,1302,3157,1659,4231
311330,202306,7913,17026,5182,12344,756,1989,2336,5429,3092,7418
311340,202306,13668,34108,9206,25089,1999,5639,2942,7228,4941,12867
311350,202306,2811,6347,1669,4124,287,748,706,1468,993,2216
311360,202306,1428,3173,861,2221,204,545,384,925,588,1470
311370,202306,5640,12624,3601,9084,478,1352,1791,3951,2269,5303
311380,202306,478,1375,338,1060,40,137,181,549,221,686
311390,202306,2083,5744,1448,4507,437,1370,339,911,776,2281
311400,202306,2066,5031,1188,3105,208,588,448,909,656,1497
311410,202306,2370,6459,1644,4929,246,822,667,1712,913,2534
311420,202306,2045,5310,1293,3739,247,726,399,920,646,1646
311430,202306,5691,13644,3259,8605,486,1357,1368,3266,1854,4623
311440,202306,3873,9784,2361,6683,656,2066,408,813,1064,2879
311450,202306,3149,8401,1775,5308,431,1462,426,940,857,2402
311455,202306,1318,2781,735,1793,70,183,457,1022,527,1205
311460,202306,752,2054,412,1277,68,233,102,248,170,481
311470,202306,603,1689,353,1132,81,292,56,147,137,439
311480,202306,1460,2932,1099,2354,97,202,845,1724,942,1926
311490,202306,346,944,221,660,37,131,95,222,132,353
311500,202306,650,1470,437,1095,47,131,242,536,289,667
311510,202306,4476,9764,2791,6752,355,905,1548,3343,1903,4248
311520,202306,841,2023,619,1572,60,170,397,955,457,1125
311530,202306,11700,24626,6785,16271,1798,4961,2175,4264,3973,9225
311535,202306,1215,2902,696,1805,97,267,338,754,435,1021
311540,202306,671,1760,533,1498,89,254,316,869,405,1123
311545,202306,2471,6270,1923,5311,109,328,1416,3752,1525,4080
311547,202306,2202,4302,1634,3381,56,132,1387,2748,1443,2880
311550,202306,3650,8805,2553,6652,408,1172,1143,2485,1551,3657
311560,202306,363,729,178,409,30,79,69,127,99,206
311570,202306,1600,3437,973,2476,63,170,643,1650,706,1820
311580,202306,2728,4832,1645,3342,149,307,1129,2156,1278,2463
311590,202306,772,1797,565,1457,59,181,342,809,401,990
311600,202306,1760,4029,1356,3429,179,526,902,2173,1081,2699
311610,202306,2833,7419,1861,5357,121,394,1193,3180,1314,3574
311615,202306,4542,10262,3315,8199,146,473,2533,5803,2679,6276
311620,202306,725,1784,469,1324,52,163,239,612,291,775
311630,202306,1586,4036,1103,2993,111,287,622,1632,733,1919
311640,202306,962,2313,601,1614,98,278,314,765,412,1043
311650,202306,2303,5115,1615,3936,239,618,936,2096,1175,2714
311660,202306,4063,10472,2454,6791,332,1074,875,1831,1207,2905
311670,202306,2040,4511,1261,3063,144,347,648,1435,792,1782
311680,202306,2855,6667,1991,5120,130,312,1384,3488,1514,3800
311690,202306,759,1473,483,1078,46,96,303,651,349,747
311700,202306,2474,5311,1750,4219,38,127,1408,3217,1446,3344
311710,202306,1925,5132,1240,3722,326,1069,343,903,669,1972
311720,202306,529,1428,386,1124,56,178,218,617,274,795
311730,202306,5784,12895,3604,8716,707,1933,1812,3871,2519,5804
311740,202306,1188,2911,908,2461,70,187,638,1735,708,1922
311750,202306,4873,12874,3351,9599,294,948,2009,5086,2303,6034
311760,202306,927,2345,639,1700,95,315,278,559,373,874
311770,202306,2732,6941,1788,5015,388,1085,573,1402,961,2487
311780,202306,1902,4851,1119,3185,221,620,399,954,620,1574
311783,202306,2862,6500,2094,5180,61,227,1668,3845,1729,4072
311787,202306,1004,2647,613,1727,93,276,207,453,300,729
311790,202306,1906,4886,1079,3090,248,764,267,622,515,1386
311800,202306,6702,17971,3903,11050,948,2750,846,1801,1794,4551
311810,202306,1252,3044,937,2438,55,177,717,1713,772,1890
311820,202306,1279,2692,822,1938,67,177,554,1175,621,1352
311830,202306,11545,29436,7380,20311,2013,5714,1453,3613,3466,9327
311840,202306,4926,10809,3545,8688,307,780,2393,5723,2700,6503
311850,202306,432,987,310,768,13,48,215,465,228,513
311860,202306,100672,219105,68525,159311,7257,19072,41866,86688,49123,105760
311870,202306,2241,5488,1340,3735,215,706,565,1315,780,2021
311880,202306,7547,17660,5545,14381,451,1150,3804,9642,4255,10792
311890,202306,2342,4718,1675,3662,59,172,1284,2551,1343,2723
311900,202306,783,1879,518,1457,91,248,263,724,354,972
311910,202306,5334,12093,3798,9619,659,1784,2045,4779,2704,6563
311920,202306,2671,5902,1986,4789,137,312,1374,3198,1511,3510
311930,202306,6166,12393,4049,8989,678,1704,2249,4386,2927,6090
311940,202306,19537,46033,11144,28599,1652,4492,4696,10570,6348,15062
311950,202306,2938,6785,1935,4887,171,444,1148,2777,1319,3221
311960,202306,582,1352,356,913,49,138,148,317,197,455
311970,202306,484,1461,309,1009,51,183,70,177,121,360
311980,202306,568,1387,260,770,41,132,91,230,132,362
311990,202306,623,1424,323,885,46,144,139,311,185,455
311995,202306,1185,3162,426,1289,47,160,81,153,128,313
312000,202306,978,2038,649,1515,29,67,465,1006,494,1073
312010,202306,1427,3172,973,2328,62,148,655,1469,717,1617
312015,202306,1653,3992,1326,3473,66,243,999,2444,1065,2687
312020,202306,2374,6476,1428,4204,236,707,356,878,592,1585
312030,202306,2676,5259,2007,4365,52,188,1711,3526,1763,3714
312040,202306,1039,2805,604,1818,107,336,250,645,357,981
312050,202306,1485,4123,1108,3346,203,706,365,914,568,1620
312060,202306,1175,2698,702,1923,174,506,214,516,388,1022
312070,202306,1122,2925,685,1934,24,76,425,1100,449,1176
312080,202306,3673,8019,2508,5957,144,408,1692,3478,1836,3886
312083,202306,1362,2797,1017,2284,52,137,814,1725,866,1862
312087,202306,3066,6751,2227,5349,122,345,1713,3912,1835,4257
312090,202306,15033,34426,10298,25909,1045,3122,5879,12915,6924,16037
312100,202306,2068,5041,1357,3603,86,272,880,2118,966,2390
312110,202306,1226,3461,905,2731,154,572,440,1107,594,1679
312120,202306,1329,3338,778,2253,194,618,227,528,421,1146
312125,202306,2537,5530,1842,4412,107,280,1354,3041,1461,3321
312130,202306,1504,3158,945,2153,59,179,590,1122,649,1301
312140,202306,951,2516,688,1940,180,518,263,660,443,1178
312150,202306,698,1674,527,1332,44,114,345,790,389,904
312160,202306,12258,28478,8189,20546,936,2601,4293,9330,5229,11931
312170,202306,1057,2446,716,1792,54,140,450,1056,504,1196
312180,202306,1727,4048,1163,2948,114,299,668,1496,782,1795
312190,202306,1015,2418,688,1772,81,225,344,773,425,998
312200,202306,5722,13937,3934,10777,897,2926,1951,4530,2848,7456
312210,202306,1772,3268,1214,2464,80,165,943,1803,1023,1968
312220,202306,1991,5420,1527,4491,153,480,981,2814,1134,3294
312230,202306,27120,61271,16625,40929,3121,8358,6242,12350,9363,20708
312235,202306,2741,5621,1960,4387,206,397,1408,2989,1614,3386
312240,202306,974,2792,629,2011,128,408,187,520,315,928
312245,202306,4013,7454,3187,6251,60,174,2843,5332,2903,5506
312247,202306,1237,2606,726,1762,95,222,425,942,520,1164
312250,202306,1118,2733,591,1656,75,231,219,540,294,771
312260,202306,1252,2908,926,2291,60,139,692,1593,752,1732
312270,202306,934,2290,613,1581,21,82,383,843,404,925
312280,202306,522,1447,380,1115,89,301,151,380,240,681
312290,202306,1226,3168,850,2419,162,499,288,691,450,1190
312300,202306,1506,4013,949,2704,202,599,246,543,448,1142
312310,202306,1268,3402,846,2427,103,356,430,1067,533,1423
312320,202306,2659,6020,1509,3786,238,613,543,1126,781,1739
312330,202306,1181,2934,850,2286,145,456,462,1109,607,1565
312340,202306,287,678,187,486,22,73,101,221,123,294
312350,202306,287,568,189,433,9,26,127,246,136,272
312352,202306,1779,5177,1427,4436,270,889,636,2099,906,2988
312360,202306,4535,11404,2821,7818,547,1582,1185,2789,1732,4371
312370,202306,2621,5816,1880,4598,217,617,1128,2496,1345,3113
312380,202306,2600,5261,1848,4105,43,141,1496,3110,1539,3251
312385,202306,1507,3688,1022,2755,339,946,291,777,630,1723
312390,202306,2429,6222,1521,4231,237,743,436,965,673,1708
312400,202306,3846,9932,2798,7936,1005,3088,449,1185,1454,4273
312410,202306,20258,46015,14362,35143,1756,4505,8725,19554,10481,24059
312420,202306,5028,12080,3718,9806,808,2393,1638,3935,2446,6328
312430,202306,11140,24114,8101,18760,370,1069,5951,12584,6321,13653
312440,202306,1343,3787,1019,3093,529,1679,179,499,708,2178
312450,202306,1699,4461,1089,3215,288,897,380,1069,668,1966
312460,202306,612,1319,393,960,21,65,281,634,302,699
312470,202306,575,1299,303,787,44,131,113,224,157,355
312480,202306,1255,2936,822,2142,73,203,433,1046,506,1249
312490,202306,3346,6599,2250,4845,188,450,1415,2779,1603,3229
312500,202306,1347,2820,970,2213,43,119,697,1471,740,1590
312510,202306,6756,16424,3282,8900,551,1460,938,2103,1489,3563
312520,202306,463,1052,312,789,45,127,184,419,229,546
312530,202306,929,1866,685,1533,45,109,511,1098,556,1207
312540,202306,1823,4490,1138,3069,136,358,654,1627,790,1985
312550,202306,993,2279,610,1493,37,98,393,857,430,955
312560,202306,2200,5180,1592,4183,97,284,1108,2807,1205,3091
312570,202306,3428,7167,2233,5399,350,884,1135,2574,1485,3458
312580,202306,807,1986,462,1246,51,159,235,548,286,707
312590,202306,1813,4723,1318,3671,202,645,656,1597,858,2242
312595,202306,2667,6691,2001,5556,321,870,989,2885,1310,3755
312600,202306,1609,3710,865,2104,126,336,296,633,422,969
312610,202306,8924,20994,5018,13116,981,2736,1522,3288,2503,6024
312620,202306,3059,6758,2052,5180,56,234,1641,3900,1697,4134
312630,202306,403,1034,258,751,50,175,101,237,151,412
312640,202306,614,1567,447,1250,59,184,224,554,283,738
312650,202306,2520,5579,1493,3611,55,168,1114,2417,1169,2585
312660,202306,1636,3487,1097,2547,86,211,732,1540,818,1751
312670,202306,7535,15730,5727,12800,146,537,4617,9447,4763,9984
312675,202306,1411,3240,1069,2689,68,189,781,1854,849,2043
312680,202306,1968,4218,1614,3661,62,203,1349,2859,1411,3062
312690,202306,3662,6844,2454,5190,197,376,1809,3666,2006,4042
312695,202306,1273,2891,980,2366,51,105,804,1877,855,1982
312700,202306,2560,6279,1535,4237,178,571,812,1994,990,2565
312705,202306,2105,3802,1702,3250,24,56,1566,2898,1590,2954
312707,202306,1652,4190,1022,2950,44,172,670,1725,714,1897
312710,202306,9533,20551,5335,13496,1422,3663,1417,3422,2839,7085
312720,202306,1275,3069,904,2406,89,218,538,1291,627,1509
312730,202306,1917,4183,1219,3090,105,272,773,1861,878,2133
312733,202306,1544,3776,1010,2719,36,140,663,1602,699,1742
312735,202306,988,2291,629,1559,53,142,412,909,465,1051
312737,202306,1005,2038,641,1488,62,173,440,946,502,1119
312738,202306,1035,2314,643,1588,70,196,398,871,468,1067
312740,202306,505,1273,284,818,64,189,79,171,143,360
312750,202306,1740,4436,1077,3083,140,431,475,1185,615,1616
312760,202306,2211,5926,1397,4163,237,701,489,1326,726,2027
312770,202306,56844,125703,32073,80534,5272,14453,13042,28689,18314,43142
312780,202306,3291,8206,2497,6724,406,1059,1373,3549,1779,4608
312790,202306,285,645,115,329,9,23,31,59,40,82
312800,202306,7450,17444,5166,12927,387,1196,3241,7201,3628,8397
312810,202306,1914,4843,1119,3332,326,1030,310,762,636,1792
312820,202306,2095,4958,1469,3792,100,235,979,2418,1079,2653
312825,202306,1924,3671,1395,2906,51,120,1133,2261,1184,2381
312830,202306,3373,8578,1760,5108,435,1192,565,1333,1000,2525
312840,202306,1794,4156,1205,3061,150,405,591,1301,741,1706
312850,202306,1432,2694,901,1827,28,101,665,1159,693,1260
312860,202306,1212,2963,752,2096,200,560,236,587,436,1147
312870,202306,7460,18336,3809,10747,628,1847,1154,2784,1782,4631
312880,202306,1898,4180,1231,2956,209,455,629,1476,838,1931
312890,202306,2872,6236,1776,4245,149,368,1075,2364,1224,2732
312900,202306,1651,3768,1100,2825,315,855,455,1045,770,1900
312910,202306,1745,3080,911,1934,134,260,501,1019,635,1279
312920,202306,1156,2862,689,1956,101,345,224,468,325,813
312930,202306,3036,6612,1920,4686,281,718,1013,2421,1294,3139
312940,202306,1209,2965,817,2256,62,187,432,1065,494,1252
312950,202306,4235,9123,2658,6436,392,1054,1523,3292,1915,4346
312960,202306,2134,5028,1602,4149,133,313,1083,2822,1216,3135
312965,202306,1977,4756,1450,3852,154,374,865,2276,1019,2650
312970,202306,2111,5182,1462,3990,144,485,832,1974,976,2459
312980,202306,33008,81487,21883,58012,4105,11046,8818,21042,12923,32088
312990,202306,639,1458,376,1010,71,209,156,381,227,590
313000,202306,605,1528,415,1177,23,94,246,596,269,690
313005,202306,2934,7579,2175,6167,136,402,1555,4216,1691,4618
313010,202306,7634,18379,5353,14037,789,2335,2888,6813,3677,9148
313020,202306,1275,3504,880,2636,187,605,174,405,361,1010
313030,202306,1467,3035,839,2013,102,256,506,1076,608,1332
313040,202306,1113,3016,777,2262,40,149,456,1175,496,1324
313050,202306,2237,5705,1375,4093,230,741,326,808,556,1549
313055,202306,2230,5489,1708,4571,672,1976,651,1541,1323,3517
313060,202306,1324,2987,819,2037,152,456,219,424,371,880
313065,202306,2106,5074,1686,4274,36,153,1375,3251,1411,3404
313070,202306,1062,2620,730,1981,106,313,341,855,447,1168
313080,202306,482,1206,288,787,56,185,110,228,166,413
313090,202306,6942,15571,4819,11704,228,604,3459,7971,3687,8575
313100,202306,1578,3726,1141,2934,59,201,791,1840,850,2041
313110,202306,1867,4478,1149,3082,138,402,545,1300,683,1702
313115,202306,3513,8649,2357,6200,222,659,1308,2965,1530,3624
313120,202306,4433,9847,2885,7435,391,1065,1714,4213,2105,5278
313130,202306,41241,94562,24678,61595,2859,7858,13506,29753,16365,37611
313140,202306,998,1935,587,1340,52,123,400,840,452,963
313150,202306,1720,4491,1056,3092,287,941,151,333,438,1274
313160,202306,1820,4023,1171,2922,61,173,811,1900,872,2073
313170,202306,14438,37218,8724,24256,1354,3914,3344,7952,4698,11866
313180,202306,3127,7171,2150,5219,156,399,1447,3261,1603,3660
313190,202306,5821,14747,3515,9711,617,1817,1369,3140,1986,4957
313200,202306,1380,3098,1002,2369,44,133,765,1663,809,1796
313210,202306,5357,12216,3909,9737,345,985,2589,5870,2934,6855
313220,202306,2435,5849,1387,3641,222,610,596,1280,818,1890
313230,202306,3394,8423,2558,7178,68,268,1966,5337,2034,5605
313240,202306,14355,31698,8929,22098,1040,2942,4690,10035,5730,12977
313250,202306,7807,20461,5326,15010,1044,3086,2287,5787,3331,8873
313260,202306,1006,2261,606,1582,57,186,315,662,372,848
313270,202306,8304,16225,5998,12905,530,1149,4454,9060,4984,10209
313280,202306,574,1386,340,921,40,113,159,373,199,486
313290,202306,1290,3827,923,3041,207,751,309,908,516,1659
313300,202306,2329,5780,1480,4015,315,902,561,1331,876,2233
313310,202306,1893,5022,1256,3484,246,709,400,854,646,1563
313320,202306,2395,5760,1532,4239,354,1075,499,1328,853,2403
313330,202306,5216,11811,3404,8797,281,781,2138,5264,2419,6045
313340,202306,2169,4362,1410,3136,98,252,1014,2026,1112,2278
313350,202306,3740,9321,2138,5690,282,826,934,2083,1216,2909
313360,202306,2170,4810,1231,3110,194,580,604,1275,798,1855
313370,202306,2069,5047,1181,3106,232,620,392,787,624,1407
313375,202306,2311,5593,1144,3155,236,704,316,701,552,1405
313380,202306,8433,19370,5373,13247,845,2353,2379,4821,3224,7174
313390,202306,974,2701,742,2200,44,163,479,1307,523,1470
313400,202306,4661,10133,3104,7577,142,375,2292,5303,2434,5678
313410,202306,1788,4065,1166,2987,269,690,619,1447,888,2137
313420,202306,20019,41616,9682,23795,2161,5747,2704,5682,4865,11429
313430,202306,1579,3515,1149,2654,46,151,907,1879,953,2030
313440,202306,9287,17086,5943,12348,226,616,4544,8766,4770,9382
313450,202306,894,2233,518,1425,80,247,182,366,262,613
313460,202306,2992,7567,2204,6152,380,1155,940,2408,1320,3563
313470,202306,3363,7553,2432,6032,147,416,1818,4283,1965,4699
313480,202306,1466,3830,806,2367,112,319,344,888,456,1207
313490,202306,3847,9327,1631,4724,300,902,407,990,707,1892
313500,202306,721,1692,390,1006,75,161,160,388,235,549
313505,202306,13255,29891,9729,24100,534,1404,7109,16723,7643,18127
313507,202306,1610,3682,1113,2834,50,182,802,1868,852,2050
313510,202306,19663,46487,13021,32896,1237,3363,7278,16278,8515,19641
313520,202306,20007,45312,15064,37121,736,2169,11322,26087,12058,28256
313530,202306,721,1991,414,1231,57,191,173,422,230,613
313535,202306,2746,6993,1948,5402,217,549,1120,2952,1337,3501
313540,202306,1111,2829,670,1786,85,268,330,727,415,995
313545,202306,1368,4049,972,3123,161,550,437,1283,598,1833
313550,202306,2669,6804,1988,5322,215,617,1319,3384,1534,4001
313560,202306,3704,5918,2606,4553,50,97,2279,3842,2329,3939
313570,202306,1197,3084,848,2409,176,536,365,898,541,1434
313580,202306,7740,15993,5637,12519,295,778,4187,8591,4482,9369
313590,202306,1438,3408,940,2525,148,402,474,1190,622,1592
313600,202306,5503,11471,4349,9730,116,377,3699,7781,3815,8158
313610,202306,1206,2734,831,1987,73,198,528,1137,601,1335
313620,202306,7174,17179,5082,13134,536,1605,2939,6747,3475,8352
313630,202306,10955,24392,7031,17690,703,2080,4167,9516,4870,11596
313640,202306,1642,3047,1068,2250,78,190,792,1596,870,1786
313650,202306,1932,5378,1410,4401,153,505,785,2376,938,2881
313652,202306,1097,2767,847,2250,72,203,590,1446,662,1649
313655,202306,1460,3081,1046,2498,70,193,760,1737,830,1930
313657,202306,1296,3088,925,2421,31,136,655,1536,686,1672
313660,202306,1534,3461,1124,2741,90,307,766,1655,856,1962
313665,202306,7348,16782,5040,12293,536,1462,3040,6548,3576,8010
313670,202306,72726,161430,44492,111092,6015,16164,21319,47234,27334,63398
313680,202306,1360,3101,948,2350,49,148,619,1373,668,1521
313690,202306,1257,3447,814,2516,160,540,149,372,309,912
313695,202306,2111,5094,1421,3903,122,326,868,2363,990,2689
313700,202306,3488,9627,2665,8222,187,589,1971,5911,2158,6500
313710,202306,1747,3660,1048,2541,148,443,620,1352,768,1795
313720,202306,8259,20453,5065,13375,725,2013,2418,5562,3143,7575
313730,202306,1661,3242,1074,2340,72,151,740,1587,812,1738
313740,202306,2065,6741,1491,5198,321,1228,388,1147,709,2375
313750,202306,2973,6870,2112,5272,282,813,1248,2757,1530,3570
313753,202306,2502,5764,1426,3790,388,1101,321,745,709,1846
313760,202306,8007,19948,5491,14725,862,2559,2486,5711,3348,8270
313770,202306,5069,12980,3654,10471,782,2198,2104,6010,2886,8208
313780,202306,5105,11969,3066,8138,668,1734,1043,2633,1711,4367
313790,202306,761,1950,557,1520,62,172,330,828,392,1000
313800,202306,1661,3452,1050,2472,107,263,588,1258,695,1521
313810,202306,2328,4813,1626,3671,52,166,1261,2631,1313,2797
313820,202306,21387,50780,11014,27795,1855,4737,3512,7511,5367,12248
313830,202306,496,1331,332,974,58,181,122,310,180,491
313835,202306,1159,2823,707,1948,65,211,355,868,420,1079
313840,202306,10513,24523,6745,17599,1593,4233,1979,4753,3572,8986
313850,202306,1235,2610,845,1954,143,335,443,894,586,1229
313860,202306,3667,8484,2428,6127,343,900,1223,2721,1566,3621
313862,202306,1386,2937,592,1577,51,147,289,689,340,836
313865,202306,3236,7382,2360,5899,89,268,1671,3789,1760,4057
313867,202306,1678,4834,1243,3914,320,1019,495,1553,815,2572
313868,202306,2042,5536,1470,4393,71,270,1072,2985,1143,3255
313870,202306,1336,3148,739,1940,126,337,305,699,431,1036
313880,202306,2860,6633,1839,4604,298,881,921,1874,1219,2755
313890,202306,2923,5192,2117,4122,58,130,1687,3098,1745,3228
313900,202306,6955,17559,4012,11241,1040,2961,1160,2628,2200,5589
313910,202306,949,2518,590,1712,117,348,159,412,276,760
313920,202306,3457,9139,2614,7437,498,1373,1226,3444,1724,4817
313925,202306,1952,4390,1303,3183,190,409,804,1850,994,2259
313930,202306,6432,15354,4605,12156,428,1112,2899,7359,3327,8471
313940,202306,12674,33819,8281,25064,2033,6685,1806,5574,3839,12259
313950,202306,6982,13527,4821,10460,277,723,3546,7203,3823,7926
313960,202306,7093,15518,4221,10470,584,1667,1911,4090,2495,5757
313970,202306,2022,4653,1449,3552,57,152,975,2179,1032,2331
313980,202306,1812,4332,1182,3251,217,637,443,1086,660,1723
313990,202306,2821,7226,1895,5256,306,984,1038,2488,1344,3472
314000,202306,13493,30139,8852,21342,641,1873,5421,12050,6062,13923
314010,202306,1633,3559,1143,2789,78,207,782,1775,860,1982
314015,202306,3053,7390,2110,5502,255,764,1193,2718,1448,3482
314020,202306,671,1620,354,1046,122,428,18,37,140,465
314030,202306,1044,2654,625,1739,94,272,248,625,342,897
314040,202306,761,1931,566,1554,68,228,358,899,426,1127
314050,202306,2666,6129,1750,4346,129,381,1106,2433,1235,2814
314053,202306,2617,6608,1871,5123,301,797,1084,2994,1385,3791
314055,202306,2903,6341,2245,5342,74,209,1786,4096,1860,4305
314060,202306,1589,3733,1036,2711,39,101,731,1821,770,1922
314070,202306,6260,14781,4394,11095,606,1607,2276,5101,2882,6708
314080,202306,2476,5955,1535,4098,152,432,753,1758,905,2190
314085,202306,2850,6960,2094,5737,235,673,1268,3358,1503,4031
314090,202306,6259,14635,4578,11694,457,1209,2724,6712,3181,7921
314100,202306,3526,7907,2444,6202,109,322,1753,4301,1862,4623
314110,202306,6304,15823,4231,11194,655,1890,1992,4550,2647,6440
314120,202306,826,1803,316,834,56,160,130,294,186,454
314130,202306,865,2031,571,1460,22,73,395,936,417,1009
314140,202306,5659,13620,3911,10209,484,1329,2203,5330,2687,6659
314150,202306,1728,3948,1073,2789,158,411,581,1433,739,1844
314160,202306,2904,6553,1739,4407,187,472,697,1654,884,2126
314170,202306,1160,2845,743,1907,73,231,464,1035,537,1266
314180,202306,6714,16484,4461,12223,653,1824,2078,5372,2731,7196
314190,202306,753,1727,500,1278,62,193,283,598,345,791
314200,202306,3685,9173,2667,7254,255,639,1625,4238,1880,4877
314210,202306,2382,5639,1519,3936,276,766,504,1131,780,1897
314220,202306,2201,5348,1526,4120,263,798,645,1535,908,2333
314225,202306,1237,3249,837,2431,142,424,413,1095,555,1519
314230,202306,1088,2628,681,1852,116,314,318,772,434,1086
314240,202306,1345,3390,913,2598,196,567,354,976,550,1543
314250,202306,512,1372,293,886,46,153,115,294,161,447
314260,202306,1348,3215,937,2521,341,943,226,510,567,1453
314270,202306,4015,9898,2949,7988,103,299,2096,5450,2199,5749
314280,202306,4401,9495,2662,6620,291,802,1500,3374,1791,4176
314290,202306,5563,12539,4042,9641,216,574,2972,6630,3188,7204
314300,202306,2424,6347,1334,3888,320,991,358,857,678,1848
314310,202306,4455,10966,2642,7502,720,2328,313,650,1033,2978
314315,202306,1228,3342,904,2665,66,236,611,1670,677,1906
314320,202306,4247,10194,2502,6699,365,1097,1094,2470,1459,3567
314330,202306,71437,183604,46687,133948,10924,31082,12523,33264,23447,64346
314340,202306,3383,7812,2084,5359,366,1122,974,2019,1340,3141
314345,202306,2009,4811,1428,3726,120,280,953,2302,1073,2582
314350,202306,1239,3197,640,1898,97,281,147,311,244,592
314360,202306,692,1805,399,1183,49,133,130,345,179,478
314370,202306,923,2083,641,1609,59,158,429,977,488,1135
314380,202306,1519,3806,922,2618,216,655,308,787,524,1442
314390,202306,19972,44453,12116,30050,1884,5159,5335,11176,7219,16335
314400,202306,4768,13163,3291,10114,1172,3771,805,2447,1977,6218
314410,202306,3717,9765,2204,6461,554,1975,419,905,973,2880
314420,202306,953,2135,589,1513,29,98,376,889,405,987
314430,202306,9809,20909,6022,14432,910,2290,2779,6073,3689,8363
314435,202306,2293,5563,1416,3849,244,619,659,1650,903,2269
314437,202306,1106,2499,734,1831,58,159,505,1187,563,1346
314440,202306,746,1973,458,1353,96,337,152,348,248,685
314450,202306,1787,4224,1173,2985,174,494,606,1327,780,1821
314460,202306,4308,11559,2892,8395,626,1973,1184,2913,1810,4886
314465,202306,2841,7005,2125,5612,134,312,1492,3711,1626,4023
314467,202306,1191,2808,870,2260,124,388,529,1289,653,1677
314470,202306,2920,7354,1982,5250,404,1155,856,1929,1260,3084
314480,202306,11354,28028,7272,19103,1060,3004,3239,7253,4299,10257
314490,202306,1298,3042,867,2235,81,233,539,1288,620,1521
314500,202306,2433,5397,1410,3680,416,1048,275,691,691,1739
314505,202306,2860,5618,2047,4376,132,224,1494,3107,1626,3331
314510,202306,2716,6652,1871,5307,640,2064,518,1271,1158,3335
314520,202306,10268,27527,7278,21103,1498,4475,1673,4331,3171,8806
314530,202306,6705,17911,5311,15164,434,1339,3615,9652,4049,10991
314535,202306,3546,7421,2584,5910,144,376,2007,4384,2151,4760
314537,202306,1456,3666,1002,2773,80,209,630,1653,710,1862
314540,202306,522,1176,319,826,20,69,172,377,192,446
314545,202306,2304,4829,1669,3904,71,238,1233,2647,1304,2885
314550,202306,912,2018,511,1284,50,142,263,564,313,706
314560,202306,6238,15999,3915,10595,440,1357,1863,4130,2303,5487
314570,202306,410,1062,275,812,45,150,127,349,172,499
314580,202306,622,1624,389,1128,87,252,116,296,203,548
314585,202306,917,2489,555,1631,47,160,261,683,308,843
314587,202306,2802,6710,1968,5241,643,1791,876,2127,1519,3918
314590,202306,5497,13153,3546,9162,469,1320,1664,3802,2133,5122
314600,202306,2284,5793,1248,3712,255,835,153,370,408,1205
314610,202306,12176,27832,7844,19568,915,2567,3707,8569,4622,11136
314620,202306,3071,6048,2292,4975,163,314,1760,3798,1923,4112
314625,202306,1998,4376,1437,3500,64,261,1099,2418,1163,2679
314630,202306,6062,13756,4393,11179,203,630,3288,7938,3491,8568
314640,202306,1067,2038,727,1477,23,76,573,1051,596,1127
314650,202306,1016,2257,574,1445,70,199,291,614,361,813
314655,202306,1803,4452,1115,3155,187,454,571,1607,758,2061
314660,202306,449,867,307,629,13,32,229,419,242,451
314670,202306,1881,3904,1173,2805,42,129,820,1818,862,1947
314675,202306,2023,4664,1558,3857,98,241,1143,2715,1241,2956
314690,202306,2577,6528,1760,5056,435,1253,515,1389,950,2642
314700,202306,14929,36487,8929,24439,1360,4063,3965,9680,5325,13743
314710,202306,9896,25146,6151,16546,1009,2896,2358,5277,3367,8173
314720,202306,2947,8011,1689,5145,350,1155,295,634,645,1789
314730,202306,3177,7607,1692,4482,290,856,608,1267,898,2123
314740,202306,4087,10234,2866,7903,519,1524,1319,3201,1838,4725
314750,202306,365,879,238,605,16,44,144,315,160,359
314760,202306,2386,6338,1339,3930,245,773,344,704,589,1477
314770,202306,1297,3534,638,1937,80,237,125,327,205,564
314780,202306,448,1029,276,725,22,62,169,396,191,458
314790,202306,15500,37465,9449,25420,1743,5123,3800,8979,5543,14102
314795,202306,1836,4156,1375,3366,68,188,979,2201,1047,2389
314800,202306,14927,35108,8816,23075,1389,3964,3568,7870,4957,11834
314810,202306,13667,32526,8686,22915,1974,5330,3310,7905,5284,13235
314820,202306,1544,3397,1001,2484,62,177,619,1373,681,1550
314830,202306,2245,5504,1586,4205,144,407,954,2265,1098,2672
314840,202306,1087,2949,810,2404,82,324,530,1421,612,1745
314850,202306,3431,5721,2598,4692,46,112,2338,4106,2384,4218
314860,202306,4153,10105,3143,8240,121,413,2300,5666,2421,6079
314870,202306,8625,16622,5794,12749,289,701,4245,9073,4534,9774
314875,202306,2192,5992,1756,5217,247,650,1094,3247,1341,3897
314880,202306,936,2127,581,1484,42,124,330,765,372,889
314890,202306,608,1706,389,1174,70,251,150,364,220,615
314900,202306,1151,2474,736,1719,77,171,464,991,541,1162
314910,202306,2001,5309,1262,3848,258,917,503,1332,761,2249
314915,202306,2560,6749,1860,5434,213,562,1028,2943,1241,3505
314920,202306,704,1558,430,1096,27,73,267,647,294,720
314930,202306,8288,20628,5377,14275,918,2656,2374,5302,3292,7958
314940,202306,527,1119,370,850,40,104,223,475,263,579
314950,202306,856,1926,496,1280,48,156,280,636,328,792
314960,202306,1183,2567,820,1940,81,199,518,1161,599,1360
314970,202306,1518,4076,1013,3008,193,622,365,860,558,1482
314980,202306,2788,6367,1917,4809,186,491,1232,2852,1418,3343
314990,202306,3470,9169,1979,5662,331,934,497,1167,828,2101
314995,202306,2112,5165,1432,3814,87,295,888,2093,975,2388
315000,202306,1308,3002,844,2242,94,282,544,1356,638,1638
315010,202306,510,1237,368,1004,32,102,229,570,261,672
315015,202306,3074,7410,2425,6228,229,707,1646,3899,1875,4606
315020,202306,964,2538,537,1549,47,145,276,681,323,826
315030,202306,853,1997,508,1355,160,412,126,285,286,697
315040,202306,1234,2847,936,2299,138,389,600,1366,738,1755
315050,202306,1406,3304,857,2277,87,263,399,969,486,1232
315053,202306,1520,3430,981,2444,125,292,533,1231,658,1523
315057,202306,2267,5635,1599,4461,142,351,962,2774,1104,3125
315060,202306,898,2391,583,1698,110,351,167,415,277,766
315070,202306,1149,2204,785,1654,92,225,541,1047,633,1272
315080,202306,4222,9827,2798,7101,130,365,1973,4619,2103,4984
315090,202306,1013,2703,688,2023,101,309,320,820,421,1129
315100,202306,1777,4745,984,2873,153,478,397,971,550,1449
315110,202306,2858,6034,1790,4275,144,357,1028,2316,1172,2673
315120,202306,15850,33588,9981,23815,1165,2770,5520,12323,6685,15093
315130,202306,2292,5527,1618,4142,184,527,841,1846,1025,2373
315140,202306,4154,10255,2972,7871,466,1329,1659,4006,2125,5335
315150,202306,5716,13496,3463,9296,595,1696,1400,3338,1995,5034
315160,202306,2550,5513,1478,3602,209,545,832,1835,1041,2380
315170,202306,1773,5151,1116,3551,201,690,344,977,545,1667
315180,202306,22360,51227,10693,28103,1594,4468,3775,8173,5369,12641
315190,202306,2679,5460,1856,4276,284,600,1227,2811,1511,3411
315200,202306,5933,14502,3957,10868,1200,3459,1278,2994,2478,6453
315210,202306,10571,25494,6114,15840,689,1910,2808,6112,3497,8022
315213,202306,1255,3042,967,2530,22,73,754,1881,776,1954
315217,202306,3222,8202,2157,6249,576,1782,964,2526,1540,4308
315220,202306,10757,26449,7368,20156,643,1624,3900,10549,4543,12173
315230,202306,3648,7116,2624,5559,153,293,1920,3937,2073,4230
315240,202306,3111,7827,2233,6187,541,1599,897,2305,1438,3904
315250,202306,19669,47559,12066,31769,1811,5178,5409,12037,7220,17215
315260,202306,1156,2885,605,1739,100,267,145,343,245,610
315270,202306,1265,3235,852,2343,97,292,412,910,509,1202
315280,202306,4132,9491,2426,6273,629,1679,769,1770,1398,3449
315290,202306,1493,3374,804,2148,134,389,340,777,474,1166
315300,202306,798,1796,535,1384,39,116,352,858,391,974
315310,202306,1592,3588,1029,2513,52,156,718,1545,770,1701
315320,202306,750,2027,468,1417,76,235,172,448,248,683
315330,202306,873,2576,463,1491,58,206,194,524,252,730
315340,202306,3365,7780,1881,5042,495,1293,595,1541,1090,2834
315350,202306,2391,5245,1863,4383,147,373,1414,3162,1561,3535
315360,202306,2136,5570,1395,3930,184,552,624,1547,808,2099
315370,202306,774,1870,508,1358,67,195,248,563,315,758
315380,202306,287,742,165,481,33,104,22,41,55,145
315390,202306,1591,4010,1117,3004,121,407,595,1335,716,1742
315400,202306,5017,12029,3428,9012,441,1241,1926,4655,2367,5896
315410,202306,2756,5795,1556,3725,341,942,455,936,796,1878
315415,202306,1850,4720,1250,3519,376,1229,218,497,594,1726
315420,202306,1878,4857,1149,3358,284,852,291,709,575,1561
315430,202306,4308,9825,2589,6936,435,1292,1172,2858,1607,4150
315440,202306,1258,2922,819,2095,91,266,503,1151,594,1417
315445,202306,2829,5461,1918,4151,138,278,1442,3036,1580,3314
315450,202306,2646,6565,1824,4977,183,519,1156,2897,1339,3416
315460,202306,61508,144050,45380,112995,4522,13202,27968,61875,32490,75077
315470,202306,836,2127,488,1281,62,188,226,506,288,694
315480,202306,1957,4812,1175,3069,156,423,570,1262,726,1685
315490,202306,3516,8129,1961,5223,312,812,699,1678,1011,2490
315500,202306,649,1568,347,907,17,40,218,506,235,546
315510,202306,1693,3677,1263,3025,25,102,1009,2223,1034,2325
315520,202306,1371,3040,1059,2521,43,93,848,1904,891,1997
315530,202306,1047,2285,787,1794,56,157,577,1182,633,1339
315540,202306,2089,4963,1182,3182,131,396,513,1205,644,1601
315550,202306,2214,5554,1274,3619,194,617,419,1090,613,1707
315560,202306,8147,21094,6228,17230,462,1196,4245,11259,4707,12455
315570,202306,3112,7140,1794,4523,294,880,917,1912,1211,2792
315580,202306,4133,8585,2696,6081,349,911,1255,2483,1604,3394
315590,202306,1624,2982,1279,2452,38,119,1043,1783,1081,1902
315600,202306,3039,8253,1906,5925,517,1526,671,2212,1188,3738
315610,202306,1231,2798,775,1907,82,248,397,792,479,1040
315620,202306,653,1575,421,1170,35,118,220,580,255,698
315630,202306,1533,3684,1016,2616,158,430,456,1009,614,1439
315640,202306,502,1110,346,860,31,83,212,477,243,560
315645,202306,1167,2813,718,1980,133,395,260,631,393,1026
315650,202306,2279,4517,1676,3588,76,179,1313,2661,1389,2840
315660,202306,2523,5972,1752,4579,221,596,928,2278,1149,2874
315670,202306,21142,50067,14292,36408,2547,6724,6566,14859,9113,21583
315680,202306,3852,9602,2545,7047,356,1070,1257,3227,1613,4297
315690,202306,4831,11132,2355,6412,475,1244,658,1870,1133,3114
315700,202306,10874,26020,7388,18976,690,1947,4213,9683,4903,11630
315710,202306,2105,4614,1351,3417,90,251,876,2054,966,2305
315720,202306,5574,13366,3741,9558,181,609,2481,5681,2662,6290
315725,202306,2881,6542,2045,5168,242,572,1264,3217,1506,3789
315727,202306,785,1813,535,1382,65,205,270,609,335,814
315730,202306,753,2045,525,1528,106,314,186,448,292,762
315733,202306,1881,4303,1250,3105,228,572,544,1196,772,1768
315737,202306,1429,3475,914,2453,40,134,635,1578,675,1712
315740,202306,1058,2688,760,2050,59,175,487,1173,546,1348
315750,202306,1590,3607,1111,2869,100,236,683,1768,783,2004
315760,202306,1476,3017,1011,2315,28,86,803,1706,831,1792
315765,202306,2500,5246,1978,4574,35,143,1741,3908,1776,4051
315770,202306,1509,3864,1009,2911,282,824,251,700,533,1524
315780,202306,40358,97529,28992,74298,2389,7015,17605,40658,19994,47673
315790,202306,4252,11945,3384,10267,327,989,1949,6115,2276,7104
315800,202306,1661,4724,1101,3328,122,439,490,1208,612,1647
315810,202306,1745,3654,1302,2928,59,167,999,2079,1058,2246
315820,202306,3659,7901,2710,6437,265,560,1840,4265,2105,4825
315830,202306,1542,4147,805,2349,97,278,245,549,342,827
315840,202306,1094,2391,656,1589,61,150,358,731,419,881
315850,202306,1450,3714,1041,2959,175,530,530,1416,705,1946
315860,202306,666,1705,430,1250,73,222,146,335,219,557
315870,202306,560,1390,410,1121,25,71,285,726,310,797
315880,202306,1401,3115,857,2064,108,307,467,930,575,1237
315890,202306,2203,5539,1702,4763,566,1759,564,1466,1130,3225
315895,202306,7990,19793,4638,12525,584,1736,2099,4977,2683,6713
315900,202306,1097,2640,812,2123,131,351,437,1060,568,1411
315910,202306,791,1774,629,1519,34,97,478,1079,512,1176
315920,202306,1598,3742,791,2144,136,485,325,699,461,1184
315930,202306,1412,2836,826,1914,59,142,532,1146,591,1288
315935,202306,1455,3802,990,2834,171,521,464,1239,635,1760
315940,202306,719,1742,489,1317,66,201,252,612,318,813
315950,202306,1569,3770,1245,3216,136,371,864,2166,1000,2537
315960,202306,6596,17189,3511,10179,766,2344,730,1496,1496,3840
315970,202306,681,1709,504,1426,58,172,297,788,355,960
315980,202306,5188,10584,2574,5934,378,920,1313,2644,1691,3564
315990,202306,4277,10016,2762,7003,445,1157,1363,3106,1808,4263
316000,202306,982,2078,668,1569,63,186,417,865,480,1051
316010,202306,828,2190,542,1544,77,222,216,490,293,712
316020,202306,1146,2807,843,2204,71,211,556,1318,627,1529
316030,202306,3326,8093,2253,6091,334,913,1222,3320,1556,4233
316040,202306,3259,8677,1889,5772,330,1128,513,1216,843,2344
316045,202306,2790,5708,2307,5000,156,284,1891,4019,2047,4303
316050,202306,532,1260,358,941,33,81,225,535,258,616
316060,202306,878,1836,555,1351,29,85,391,854,420,939
316070,202306,7538,18103,5244,13289,860,2120,2461,5715,3321,7835
316080,202306,1041,2815,700,2039,116,350,311,797,427,1147
316090,202306,666,1615,436,1085,41,133,251,533,292,666
316095,202306,1520,4301,1006,3061,229,732,310,828,539,1560
316100,202306,3035,7736,1901,5261,292,920,809,1913,1101,2833
316105,202306,873,2075,609,1611,43,118,372,969,415,1087
316110,202306,18347,42661,13951,34954,861,2668,10248,23808,11109,26476
316120,202306,1517,3768,773,2090,126,391,263,534,389,925
316130,202306,1534,3177,846,1952,75,204,511,1032,586,1236
316140,202306,1277,3151,686,1994,155,459,217,578,372,1037
316150,202306,2711,5692,1631,3733,172,388,927,1899,1099,2287
316160,202306,1195,2816,839,2144,25,83,580,1362,605,1445
316165,202306,1074,2318,713,1728,64,171,465,1025,529,1196
316170,202306,1804,3628,1217,2648,57,159,892,1744,949,1903
316180,202306,2016,5134,1115,3146,199,586,380,895,579,1481
316190,202306,3302,8674,1498,4241,162,509,658,1496,820,2005
316200,202306,4747,11547,3163,8424,431,1280,1606,3733,2037,5013
316210,202306,7246,19163,4071,11473,1211,3580,433,968,1644,4548
316220,202306,913,2556,483,1572,92,320,112,333,204,653
316225,202306,1995,4088,1375,3112,63,230,1024,2034,1087,2264
316230,202306,616,1448,421,1094,94,261,209,503,303,764
316240,202306,6879,17414,5372,14472,392,1144,3843,9746,4235,10890
316245,202306,3879,10739,3185,9487,222,893,2174,5941,2396,6834
316250,202306,14628,31817,9278,21927,1657,4186,3937,8331,5594,12517
316255,202306,3538,9317,2749,7837,237,686,1882,5284,2119,5970
316257,202306,1958,4003,1285,2917,113,250,870,1861,983,2111
316260,202306,3349,6616,2373,5058,244,474,1540,3175,1784,3649
316265,202306,1321,3202,914,2440,30,69,676,1731,706,1800
316270,202306,4720,12678,3579,10152,488,1463,1860,4714,2348,6177
316280,202306,3785,8978,2790,7089,374,1006,1517,3589,1891,4595
316290,202306,5109,12252,3143,8165,371,979,1275,2914,1646,3893
316292,202306,7856,18774,5444,14198,593,1746,3328,7818,3921,9564
316294,202306,1177,3223,730,2295,153,536,243,642,396,1178
316295,202306,4650,11543,3123,8400,258,809,1868,4432,2126,5241
316300,202306,1361,3180,1007,2624,57,171,719,1742,776,1913
316310,202306,899,2367,545,1551,96,301,171,422,267,723
316320,202306,826,2140,497,1418,85,272,117,292,202,564
316330,202306,1298,2977,893,2269,39,108,671,1599,710,1707
316340,202306,1267,3068,880,2284,102,295,510,1162,612,1457
316350,202306,1784,4121,1399,3439,142,345,996,2311,1138,2656
316360,202306,783,1887,565,1523,78,206,369,984,447,1190
316370,202306,7696,17628,5038,12564,556,1677,2683,5509,3239,7186
316380,202306,2168,4493,1491,3401,81,189,1081,2342,1162,2531
316390,202306,918,2280,598,1677,225,700,137,315,362,1015
316400,202306,1533,3968,771,2312,101,309,247,609,348,918
316410,202306,1533,3434,1164,2788,22,56,924,2078,946,2134
316420,202306,2275,5527,1742,4660,67,239,1267,3153,1334,3392
316430,202306,1152,2742,698,1901,121,383,288,672,409,1055
316440,202306,1057,3036,632,2046,120,408,155,443,275,851
316443,202306,700,1774,415,1188,93,309,145,360,238,669
316447,202306,2739,5905,2152,4973,149,262,1723,3898,1872,4160
316450,202306,2535,6630,1713,4939,215,648,979,2688,1194,3336
316460,202306,1712,4087,1149,2986,90,276,686,1592,776,1868
316470,202306,9398,24098,5888,16354,895,2643,2453,5725,3348,8368
316480,202306,280,641,210,507,30,75,120,260,150,335
316490,202306,412,1064,234,674,45,146,84,196,129,342
316500,202306,1702,4665,1025,3064,204,622,316,797,520,1419
316510,202306,981,2834,691,2180,121,376,293,882,414,1258
316520,202306,1676,3672,1097,2568,184,454,403,784,587,1238
316530,202306,1502,3372,1007,2442,82,229,614,1291,696,1520
316540,202306,1389,3111,954,2345,162,431,388,840,550,1271
316550,202306,1849,4412,1461,3728,46,164,1155,2791,1201,2955
316553,202306,6266,16281,3699,10041,507,1533,1773,4035,2280,5568
316555,202306,3288,8427,2608,7415,116,491,2078,5595,2194,6086
316556,202306,682,1443,440,971,33,71,276,523,309,594
316557,202306,1531,4132,1182,3473,393,1215,424,1168,817,2383
316560,202306,499,1396,295,948,49,174,68,178,117,352
316570,202306,1820,4564,1236,3391,288,693,387,1114,675,1807
316580,202306,450,947,239,577,32,82,100,196,132,278
316590,202306,1587,3585,939,2287,95,190,597,1367,692,1557
316600,202306,1254,3175,991,2625,137,417,628,1475,765,1892
316610,202306,771,2003,549,1588,54,162,319,838,373,1000
316620,202306,2885,6359,2171,5098,167,375,1629,3653,1796,4028
316630,202306,1851,5053,1442,4199,412,1165,549,1743,961,2908
316640,202306,224,551,159,420,36,105,58,130,94,235
316650,202306,1416,3481,1029,2791,86,260,667,1672,753,1932
316660,202306,200,474,90,241,6,15,31,65,37,80
316670,202306,2025,4580,1356,3457,378,1027,412,934,790,1961
316680,202306,2918,6917,1896,4864,181,489,1134,2747,1315,3236
316690,202306,1638,4382,917,2770,162,495,150,318,312,813
316695,202306,1169,3105,819,2397,26,112,527,1435,553,1547
316700,202306,663,1125,504,922,7,15,432,733,439,748
316710,202306,4471,11988,3182,9169,379,1212,1809,4616,2188,5828
316720,202306,29500,71124,19684,51085,2805,7858,9985,22945,12790,30803
316730,202306,693,1488,473,1084,50,110,274,562,324,672
316740,202306,1091,2650,777,2067,99,287,494,1232,593,1519
316750,202306,513,1299,327,932,67,202,143,372,210,574
316760,202306,4932,13535,3786,11227,1259,4210,1402,3892,2661,8102
316770,202306,1899,3842,1315,2997,45,124,1029,2302,1074,2426
316780,202306,750,2005,538,1583,175,553,95,193,270,746
316790,202306,909,2238,564,1546,112,310,163,413,275,723
316800,202306,8414,20864,5868,15988,879,2579,2859,7130,3738,9709
316805,202306,1505,2755,1135,2295,33,92,953,1841,986,1933
316810,202306,959,2339,592,1604,54,170,370,912,424,1082
316820,202306,483,941,266,595,9,24,185,372,194,396
316830,202306,1139,2584,800,2008,94,234,475,1122,569,1356
316840,202306,3727,8105,2665,6353,111,346,2028,4409,2139,4755
316850,202306,2922,6317,1877,4430,162,459,1197,2471,1359,2930
316860,202306,29874,65639,20265,49500,2769,7773,10800,23861,13569,31634
316870,202306,11322,26835,7011,17881,807,2342,3640,7805,4447,10147
316880,202306,1465,3386,1074,2684,141,381,604,1327,745,1708
316890,202306,1405,3005,796,2108,116,356,456,1079,572,1435
316900,202306,3694,8494,2427,6039,405,1109,1166,2514,1571,3623
316905,202306,594,1610,400,1202,214,642,87,270,301,912
316910,202306,1251,3021,741,2037,161,473,175,419,336,892
316920,202306,2469,5061,1690,3804,297,566,1036,2181,1333,2747
316930,202306,12165,30406,8030,21933,1627,4746,3075,7134,4702,11880
316935,202306,5589,13256,3546,9230,583,1627,1612,3675,2195,5302
316940,202306,7708,20284,5332,15066,916,2680,2211,5286,3127,7966
316950,202306,2508,4966,1767,3902,120,283,1361,2831,1481,3114
316960,202306,6855,13369,4245,9457,316,775,2922,6113,3238,6888
316970,202306,5424,12930,3727,9525,647,1722,1703,3755,2350,5477
316980,202306,1141,2888,792,2258,210,655,314,770,524,1425
316990,202306,16785,40260,10392,26785,2533,6813,2644,5705,5177,12518
317000,202306,3351,7995,2611,6827,112,292,2093,5276,2205,5568
317005,202306,3217,8154,2208,6056,387,1137,1064,2628,1451,3765
317010,202306,38191,83264,23596,58554,3449,9517,12552,28097,16001,37614
317020,202306,97221,214599,53464,133229,10265,27168,19441,41953,29706,69121
317030,202306,817,1981,601,1623,15,51,431,1110,446,1161
317040,202306,14493,33621,7990,21584,1975,5658,1790,4642,3765,10300
317043,202306,1190,2260,716,1557,30,71,564,1169,594,1240
317047,202306,1364,2907,841,2012,48,134,572,1253,620,1387
317050,202306,1465,4270,855,2710,120,369,279,693,399,1062
317052,202306,3010,7044,2073,5414,198,570,1325,3168,1523,3738
317057,202306,2854,5247,1913,3799,40,116,1566,2879,1606,2995
317060,202306,594,1497,298,870,62,196,99,242,161,438
317065,202306,1333,3495,927,2565,58,199,571,1361,629,1560
317070,202306,10909,27688,7595,20903,1137,3499,3506,8239,4643,11738
317075,202306,1380,3123,923,2251,164,393,479,1083,643,1476
317080,202306,8480,18025,5632,13023,1073,2669,2695,5826,3768,8495
317090,202306,5827,14705,4610,12567,406,1020,3262,8722,3668,9742
317100,202306,3157,7020,1812,4548,393,1012,755,1688,1148,2700
317103,202306,3092,6486,2260,5121,148,365,1676,3533,1824,3898
317107,202306,1829,4220,1223,3023,52,160,797,1653,849,1813
317110,202306,828,1790,417,1091,79,213,179,417,258,630
317115,202306,1390,3541,1023,2832,144,438,569,1486,713,1924
317120,202306,25515,58894,18035,44813,1563,4523,11127,24650,12690,29173
317130,202306,14318,30847,8556,20402,1208,3025,3420,7409,4628,10434
317140,202306,1180,2557,729,1773,81,196,491,1151,572,1347
317150,202306,1304,2604,911,2045,27,97,743,1536,770,1633
317160,202306,4090,9238,2297,6066,282,675,1078,3005,1360,3680
317170,202306,2569,5786,1808,4330,97,310,1237,2535,1334,2845
317180,202306,2238,6319,1333,4146,268,840,241,682,509,1522
317190,202306,1328,3327,877,2505,160,489,408,1053,568,1542
317200,202306,8206,19940,4740,12439,997,2713,1212,2647,2209,5360
317210,202306,1533,3248,1013,2417,36,109,699,1537,735,1646
317220,202306,429,1045,319,843,53,178,182,395,235,573
320010,202306,5994,16228,3994,11930,805,2590,1529,4342,2334,6932
320013,202306,2571,6367,1560,4344,309,919,701,1911,1010,2830
320016,202306,3516,8341,2364,6334,230,648,1550,3980,1780,4628
320020,202306,6289,14219,4235,10428,578,1636,2333,5171,2911,6807
320030,202306,2302,5696,1370,3763,214,665,611,1417,825,2082
320035,202306,2446,5849,1771,4609,274,769,1032,2532,1306,3301
320040,202306,5815,14573,4099,10999,574,1601,2101,4992,2675,6593
320050,202306,2459,4983,1752,3860,182,529,1197,2319,1379,2848
320060,202306,19376,47818,11940,32090,2243,6372,5124,12190,7367,18562
320070,202306,2445,5828,1567,3996,170,510,863,1880,1033,2390
320080,202306,7137,16620,4405,11111,706,1913,1992,4423,2698,6336
320090,202306,10363,25649,5892,16223,1250,3729,1995,4669,3245,8398
320100,202306,4477,10171,3265,7959,385,1086,2044,4535,2429,5621
320110,202306,3205,6447,2014,4526,341,791,1153,2305,1494,3096
320115,202306,2778,7953,2191,6818,757,2436,674,2097,1431,4533
320120,202306,34803,78798,21122,52565,2843,7489,10747,23788,13590,31277
320130,202306,78583,182677,55167,137842,7121,19283,31847,72452,38968,91735
320140,202306,5335,12962,3280,8607,597,1756,1538,3542,2135,5298
320150,202306,18826,44145,10825,28273,2719,7851,1803,3491,4522,11342
320160,202306,8468,20718,5563,15104,798,2373,2901,7262,3699,9635
320170,202306,2311,5926,1471,4216,399,1170,446,1338,845,2508
320180,202306,942,2698,676,2138,217,773,125,321,342,1094
320190,202306,4048,11492,2650,8361,572,1991,494,1280,1066,3271
320200,202306,1690,4268,1050,3019,226,693,277,746,503,1439
320210,202306,5756,13216,3967,9971,654,1740,2012,4567,2666,6307
320220,202306,4808,10881,3028,7564,641,1645,1316,2989,1957,4634
320225,202306,1969,5472,1238,3827,351,1201,272,763,623,1964
320230,202306,7261,17290,4733,12551,1237,3346,1247,3347,2484,6693
320240,202306,22600,52396,14615,38218,3816,10887,3984,9253,7800,20140
320245,202306,4122,11251,2687,8065,681,2188,303,797,984,2985
320250,202306,3823,8970,2066,5110,327,887,1029,2160,1356,3047
320255,202306,2782,7387,2168,6184,357,1090,1369,3786,1726,4876
320260,202306,1794,4663,967,2850,258,755,234,573,492,1328
320265,202306,2930,8323,1951,6183,663,2261,202,563,865,2824
320270,202306,2864,7225,1854,5191,493,1548,580,1485,1073,3033
320280,202306,11484,25778,8217,19962,871,2412,5490,12070,6361,14482
320290,202306,1650,4564,968,2936,242,814,257,718,499,1532
320300,202306,5707,15034,4099,11776,1191,3792,1230,3219,2421,7011
320305,202306,7057,17620,4832,13262,829,2493,2281,5750,3110,8243
320310,202306,2674,6537,1651,4348,282,795,747,1736,1029,2531
320313,202306,3245,7278,1744,4260,327,902,660,1301,987,2203
320316,202306,1972,5121,1330,3912,239,710,670,1957,909,2667
320320,202306,27535,67334,17259,47734,4300,12381,4804,12297,9104,24678
320330,202306,3603,8650,2557,6816,403,1077,1414,3693,1817,4770
320332,202306,11125,26064,7807,19867,1600,4239,4058,9550,5658,13789
320334,202306,2591,6559,1473,4255,231,774,346,731,577,1505
320335,202306,2393,6291,1360,3955,287,955,425,1053,712,2008
320340,202306,7422,15354,5261,11813,423,1006,3685,7805,4108,8811
320350,202306,6715,14627,4166,9917,512,1381,2306,4918,2818,6299
320360,202306,1717,4045,1056,2744,141,392,523,1213,664,1605
320370,202306,3736,10073,2640,7695,672,2197,942,2447,1614,4644
320380,202306,4023,8728,2957,6718,212,584,2135,4354,2347,4938
320390,202306,10382,24578,6566,16753,1395,3761,2635,6068,4030,9829
320400,202306,4016,10491,2588,7445,735,2279,887,2323,1622,4602
320405,202306,6788,15723,4340,11093,613,1637,2314,5462,2927,7099
320410,202306,5865,14146,3900,10555,746,2030,1713,4469,2459,6499
320420,202306,5675,12514,3827,9323,876,2285,1554,3524,2430,5809
320425,202306,2709,5727,1830,4206,124,307,1251,2615,1375,2922
320430,202306,3943,9170,2626,6677,353,917,1517,3583,1870,4500
320435,202306,3100,8656,2301,6932,804,2628,632,1860,1436,4488
320440,202306,1915,4786,1211,3358,220,697,524,1218,744,1915
320450,202306,2778,6676,2006,5183,292,956,1149,2543,1441,3499
320455,202306,5829,16328,3512,10920,857,2942,845,2158,1702,5100
320460,202306,2640,7190,1630,4925,472,1531,415,1066,887,2597
320465,202306,2065,5296,1242,3589,319,959,451,1258,770,2217
320470,202306,5639,13624,3629,9586,704,2025,1203,2727,1907,4752
320480,202306,3386,7172,2336,5362,291,667,1467,3077,1758,3744
320490,202306,34568,77859,21300,52969,4098,9979,9254,22180,13352,32159
320495,202306,1810,4531,1169,3219,285,876,175,322,460,1198
320500,202306,92514,213938,64643,161264,7964,21962,37126,83130,45090,105092
320501,202306,6268,16312,3720,10970,976,2992,837,2219,1813,5211
320503,202306,3347,8758,1977,5861,561,1820,525,1321,1086,3141
320506,202306,3703,9978,2297,6631,641,1990,622,1501,1263,3491
320510,202306,16129,38167,10632,27579,1911,4935,4780,11654,6691,16589
320515,202306,2330,5867,1470,4017,444,1292,439,1085,883,2377
320517,202306,2949,7845,2152,6170,596,1832,833,2296,1429,4128
320520,202306,64447,145642,43362,106811,6396,17004,21358,47357,27754,64361
320530,202306,47882,107768,32775,79345,2550,7453,20897,44153,23447,51606
330010,202306,37936,82612,28018,64925,2201,5762,19836,42408,22037,48170
330015,202306,2396,4972,1665,3737,215,555,986,1979,1201,2534
330020,202306,31848,67521,24456,55778,2337,6096,17559,37451,19896,43547
330022,202306,2593,6425,1653,4651,331,968,619,1624,950,2592
330023,202306,9838,20625,6989,15973,948,2439,4239,8731,5187,11170
330025,202306,10442,21011,6583,14642,967,2405,3448,6861,4415,9266
330030,202306,16013,35382,11231,27133,974,2710,7350,15872,8324,18582
330040,202306,25979,57443,18993,44675,963,2852,13955,29826,14918,32678
330045,202306,147256,277215,115568,233673,5436,12297,95650,184935,101086,197232
330050,202306,4901,10771,3618,8578,536,1554,2235,4611,2771,6165
330060,202306,8620,18909,5539,13469,980,2707,2199,4651,3179,7358
330070,202306,46037,95599,35349,79367,4089,9747,23401,49993,27490,59740
330080,202306,15014,30442,11549,25037,1425,3068,7894,16392,9319,19460
330090,202306,4535,8433,3014,6237,267,438,2022,4172,2289,4610
330093,202306,4179,8594,2746,6302,155,443,2087,4419,2242,4862
330095,202306,2041,4887,1313,3427,113,325,769,1792,882,2117
330100,202306,107757,234082,87163,200511,4987,12763,66986,145225,71973,157988
330110,202306,3309,7663,2523,6257,232,669,1679,3758,1911,4427
330115,202306,3961,8343,2420,5741,398,1035,1321,2720,1719,3755
330120,202306,4813,9171,3293,7030,156,384,2520,4985,2676,5369
330130,202306,8083,18476,6082,15144,772,1991,3791,8811,4563,10802
330140,202306,6207,12144,4792,10108,214,611,3913,7679,4127,8290
330150,202306,3661,8229,2551,6296,404,1038,1337,3046,1741,4084
330160,202306,2296,5284,1693,4204,253,738,953,2041,1206,2779
330170,202306,235417,449748,184633,376088,19788,42498,135625,263600,155413,306098
330180,202306,3175,6159,2313,4833,73,212,1760,3325,1833,3537
330185,202306,17463,33864,13383,27938,477,1321,10862,20964,11339,22285
330187,202306,8583,17730,6107,13675,821,2051,3957,8096,4778,10147
330190,202306,68276,131597,53401,109268,2528,6142,42704,82084,45232,88226
330200,202306,28833,59792,21983,49735,2537,6038,15434,33294,17971,39332
330205,202306,3046,6692,2015,4885,182,513,1319,2861,1501,3374
330210,202306,4620,9929,3118,7350,387,986,1725,3610,2112,4596
330220,202306,20798,44078,13512,31123,2160,5477,6978,14057,9138,19534
330225,202306,6380,13914,4461,10735,325,896,2889,6329,3214,7225
330227,202306,29103,57616,23172,49186,613,1775,19761,39404,20374,41179
330230,202306,2504,5270,1439,3573,157,395,671,1595,828,1990
330240,202306,42202,90749,32300,73546,3209,8145,22230,47199,25439,55344
330245,202306,2272,5157,1278,3359,261,762,540,1186,801,1948
330250,202306,72337,143728,57937,121727,5640,12626,42926,85903,48566,98529
330260,202306,9923,19648,7481,16214,438,1187,5822,11859,6260,13046
330270,202306,48570,102725,27887,66923,3454,9091,14792,32144,18246,41235
330280,202306,4111,8567,2887,6479,221,565,1961,3950,2182,4515
330285,202306,46133,87439,35411,71445,1538,4017,28866,54065,30404,58082
330290,202306,6914,13147,5144,10665,326,957,3977,7495,4303,8452
330300,202306,8272,16593,5585,12561,412,996,4070,8678,4482,9674
330310,202306,3832,7854,2647,5878,115,295,2004,4141,2119,4436
330320,202306,27576,54140,19710,42978,2423,5182,13819,28482,16242,33664
330330,202306,78075,147299,57864,117746,4408,9658,43889,84106,48297,93764
330340,202306,29023,59971,19561,44355,2553,6845,11407,22641,13960,29486
330350,202306,255316,473420,200987,399903,8958,19884,169451,322151,178409,342035
330360,202306,11226,22098,8697,18206,356,794,7067,13797,7423,14591
330370,202306,8272,19340,5814,14785,974,2705,2957,6802,3931,9507
330380,202306,10721,22769,7739,17559,442,1258,5677,11758,6119,13016
330385,202306,6333,14698,4752,12085,798,2251,2439,5696,3237,7947
330390,202306,53799,115534,37479,86490,3279,9215,25279,51593,28558,60808
330395,202306,5159,10575,3818,8545,157,504,2947,6084,3104,6588
330400,202306,5118,11448,3927,9412,226,702,2765,5911,2991,6613
330410,202306,4837,10330,3345,7786,351,1006,2305,4824,2656,5830
330411,202306,4018,9557,2717,7002,169,532,1754,4076,1923,4608
330412,202306,2485,5703,1864,4590,148,437,1260,2778,1408,3215
330414,202306,35814,76957,27235,63605,2094,5299,20138,44524,22232,49823
330415,202306,6401,15158,4112,10821,423,1210,2418,5841,2841,7051
330420,202306,18647,41031,12336,29729,1336,3606,7213,15492,8549,19098
330430,202306,16125,30361,12519,25001,500,1146,10165,19007,10665,20153
330440,202306,4358,9701,2810,6796,307,856,1843,3959,2150,4815
330450,202306,2089,4956,1466,3775,111,321,915,2144,1026,2465
330452,202306,30866,65671,23356,53193,1869,5144,16907,35414,18776,40558
330455,202306,1096296,2095032,841514,1715054,82392,181123,603915,1159602,686307,1340725
330460,202306,1743,4055,1240,3221,171,444,643,1614,814,2058
330470,202306,8796,18488,5605,13240,1276,3288,2262,4773,3538,8061
330475,202306,13619,29497,10444,24924,1360,3644,6844,15420,8204,19064
330480,202306,7984,17823,6092,14521,527,1370,4075,8922,4602,10292
330490,202306,176740,346675,131699,278410,10918,24373,96596,192877,107514,217250
330500,202306,12212,25480,9174,20772,579,1486,6807,14548,7386,16034
330510,202306,74790,153917,55626,125333,4746,11822,40666,85496,45412,97318
330513,202306,1835,4025,1296,3169,191,503,687,1546,878,2049
330515,202306,3953,9137,2859,7323,462,1291,1333,3044,1795,4335
330520,202306,21655,46389,16815,38547,1526,4070,11485,24339,13011,28409
330530,202306,2249,4879,1455,3564,262,695,692,1625,954,2320
330540,202306,4405,10029,3051,7582,586,1507,1534,3533,2120,5040
330550,202306,30095,58263,19861,42792,2515,5922,12265,24578,14780,30500
330555,202306,31952,54906,24880,45730,900,1950,20987,37189,21887,39139
330560,202306,5738,12599,4301,10231,618,1540,2719,6109,3337,7649
330570,202306,4434,9848,3585,8531,491,1377,2433,5477,2924,6854
330575,202306,9272,19195,7391,15923,334,887,5953,11793,6287,12680
330580,202306,35010,75614,25878,59030,3492,8268,15820,32810,19312,41078
330590,202306,2178,4843,1736,4202,234,548,1031,2467,1265,3015
330600,202306,19329,42034,13740,32009,846,2406,9733,20568,10579,22974
330610,202306,14502,31277,10922,25183,1068,2748,7418,15780,8486,18528
330615,202306,3045,6959,2328,5916,393,851,1468,3832,1861,4683
330620,202306,6492,15211,4700,12001,653,1821,2666,6124,3319,7945
330630,202306,46368,96392,31153,70085,1530,4456,22681,45936,24211,50392
350010,202306,3071,7321,1579,4129,271,755,400,821,671,1576
350020,202306,838,2054,423,1176,59,161,162,374,221,535
350030,202306,5018,12272,3432,9166,694,2013,1708,4050,2402,6063
350040,202306,986,2590,520,1564,77,259,170,375,247,634
350050,202306,2003,4501,1135,2924,179,528,353,670,532,1198
350055,202306,1259,2775,857,2048,110,277,507,1055,617,1332
350060,202306,422,926,180,443,37,96,71,150,108,246
350070,202306,4498,10742,2780,7402,440,1282,1156,2585,1596,3867
350075,202306,869,2240,511,1490,131,365,85,236,216,601
350080,202306,871,2118,481,1299,52,169,246,556,298,725
350090,202306,802,1596,465,1035,58,154,302,599,360,753
350100,202306,3436,7892,2108,5331,115,346,1416,3154,1531,3500
350110,202306,673,1455,434,1008,15,48,319,675,334,723
350115,202306,1413,3857,957,2774,147,450,414,1063,561,1513
350120,202306,708,1565,356,927,43,113,178,424,221,537
350130,202306,4512,10735,3017,7637,355,999,1756,3923,2111,4922
350140,202306,900,2244,491,1377,37,117,283,702,320,819
350150,202306,592,1652,329,1005,77,257,103,243,180,500
350160,202306,16514,38537,10238,25721,1368,3757,5785,12904,7153,16661
350170,202306,3908,9525,2712,6755,475,1249,1432,3073,1907,4322
350180,202306,1250,2770,678,1672,80,209,388,846,468,1055
350190,202306,5108,13000,3231,8441,386,1205,1823,3919,2209,5124
350200,202306,720,1681,479,1205,46,113,290,676,336,789
350210,202306,8820,18451,5484,12635,405,1162,3698,7502,4103,8664
350220,202306,4171,10383,2491,6718,450,1314,1117,2513,1567,3827
350230,202306,1498,3355,995,2553,127,373,578,1334,705,1707
350240,202306,789,2093,393,1165,82,236,93,233,175,469
350250,202306,4811,11838,3089,8543,780,2171,851,2198,1631,4369
350260,202306,1076,2345,556,1418,77,214,282,636,359,850
350270,202306,5754,13565,3954,10022,526,1432,2195,4958,2721,6390
350275,202306,4089,9434,2936,7288,174,537,2074,4633,2248,5170
350280,202306,25122,53427,14617,34787,2011,5098,7509,15776,9520,20874
350290,202306,4666,11632,2944,7920,554,1583,1256,2872,1810,4455
350300,202306,1005,2188,608,1434,80,224,416,888,496,1112
350310,202306,1258,3197,763,2104,104,307,358,842,462,1149
350315,202306,861,1864,477,1187,23,77,289,622,312,699
350320,202306,23373,54797,15196,38471,2511,7016,7481,16160,9992,23176
350330,202306,18559,41285,11671,27717,1094,3022,7608,16166,8702,19188
350335,202306,467,1227,281,826,34,100,119,333,153,433
350340,202306,1721,4180,942,2519,132,399,457,1035,589,1434
350350,202306,907,2101,647,1695,95,214,359,910,454,1124
350360,202306,1560,3974,1002,2683,152,409,447,1065,599,1474
350370,202306,942,2116,593,1401,163,370,227,477,390,847
350380,202306,6502,16566,3748,10276,787,2290,1328,3155,2115,5445
350390,202306,15708,36378,10440,26160,1375,3894,6201,13922,7576,17816
350395,202306,495,1182,197,577,23,70,73,189,96,259
350400,202306,11520,26373,7088,18015,1802,4861,2265,5154,4067,10015
350410,202306,14625,37087,9236,26033,1811,5463,3465,8786,5276,14249
350420,202306,1581,3742,910,2348,173,442,292,617,465,1059
350430,202306,854,2052,611,1621,98,300,305,705,403,1005
350440,202306,2803,6230,1902,4551,206,567,1242,2680,1448,3247
350450,202306,9904,24750,6795,18646,1380,4174,3091,7335,4471,11509
350460,202306,3202,7539,1793,4788,280,817,830,1907,1110,2724
350470,202306,338,751,220,536,10,31,164,367,174,398
350480,202306,1179,2795,688,1871,177,539,134,287,311,826
350490,202306,2693,6054,1678,4229,237,682,876,1831,1113,2513
350500,202306,808,2016,514,1442,90,282,192,476,282,758
350510,202306,1605,3607,1062,2559,112,290,651,1407,763,1697
350520,202306,3226,8571,2171,6319,314,994,999,2572,1313,3566
350530,202306,4196,9601,2649,6409,198,571,1654,3512,1852,4083
350535,202306,1955,4661,1439,3738,195,547,907,2210,1102,2757
350540,202306,2594,5242,1789,3977,229,653,1234,2393,1463,3046
350550,202306,13380,29905,8443,20852,921,2593,4725,10142,5646,12735
350560,202306,6306,14025,4640,10937,189,574,3531,7664,3720,8238
350570,202306,43388,105702,29923,78172,4856,13527,14786,34195,19642,47722
350580,202306,2847,6864,1489,4040,393,1087,351,690,744,1777
350590,202306,7023,16967,4616,11657,647,1880,2726,6051,3373,7931
350600,202306,44654,98270,24933,62144,4143,11308,11045,23729,15188,35037
350610,202306,9789,23913,6188,16320,685,2016,3502,8015,4187,10031
350620,202306,511,1231,267,737,28,70,147,365,175,435
350630,202306,2346,4965,1462,3379,94,259,1010,2113,1104,2372
350635,202306,15745,33270,10896,25059,1085,2725,7553,16053,8638,18778
350640,202306,1131,2855,506,1476,86,260,142,348,228,608
350650,202306,11538,28229,7152,19007,1294,3669,2961,6770,4255,10439
350660,202306,6518,14876,4535,11376,669,1616,2650,6341,3319,7957
350670,202306,2443,6015,1575,4332,265,756,772,1932,1037,2688
350680,202306,1565,3797,956,2580,124,361,479,1143,603,1504
350690,202306,1932,4608,1213,3262,208,594,563,1356,771,1950
350700,202306,7184,16236,4847,12098,1042,2897,2420,5245,3462,8142
350710,202306,4158,9687,2870,7190,477,1379,1524,3327,2001,4706
350715,202306,899,2406,662,1902,131,423,306,709,437,1132
350720,202306,219,506,118,308,17,50,42,89,59,139
350730,202306,823,2225,498,1493,47,155,259,671,306,826
350740,202306,2091,5067,1261,3331,212,608,450,1016,662,1624
350745,202306,788,1913,370,1021,26,86,204,492,230,578
350750,202306,16064,37816,11134,28281,1884,5267,5110,11362,6994,16629
350760,202306,24815,53862,15788,36998,2006,5525,8869,17856,10875,23381
350770,202306,1348,2981,779,1953,79,217,496,1116,575,1333
350775,202306,934,1961,504,1207,72,190,269,590,341,780
350780,202306,3041,6810,1991,5155,523,1291,725,1969,1248,3260
350790,202306,2584,6367,1426,4057,342,993,342,766,684,1759
350800,202306,4648,11671,3454,9326,459,1250,2003,4963,2462,6213
350810,202306,3753,8224,2443,5967,572,1442,1085,2429,1657,3871
350820,202306,1225,2629,662,1565,57,165,411,849,468,1014
350830,202306,1100,2673,556,1492,103,279,201,434,304,713
350840,202306,4506,12312,2908,8741,557,1834,1084,2756,1641,4590
350850,202306,11389,27909,7957,21069,1276,3613,4168,10022,5444,13635
350860,202306,5333,12093,4095,10018,484,1263,2601,5937,3085,7200
350870,202306,3487,8661,2225,6359,444,1288,938,2488,1382,3776
350880,202306,2163,5292,1512,3918,388,1046,648,1382,1036,2428
350890,202306,633,1543,291,761,60,164,110,239,170,403
350900,202306,13232,31341,8225,20564,1245,3337,4412,9790,5657,13127
350910,202306,1236,2604,894,2017,93,190,617,1327,710,1517
350920,202306,17349,39512,12102,29541,821,2262,8327,18539,9148,20801
350925,202306,5789,13718,3877,10169,588,1725,2064,4596,2652,6321
350930,202306,1869,4465,971,2551,68,175,562,1359,630,1534
350940,202306,3715,8301,2690,6501,277,775,1809,3918,2086,4693
350945,202306,1255,3155,791,2169,151,421,319,764,470,1185
350950,202306,136969,312479,90724,220325,11547,30503,52494,114478,64041,144981
350960,202306,10121,23897,6713,16966,1016,2857,3406,7453,4422,10310
350970,202306,5210,13177,3028,8291,748,2337,1029,2116,1777,4453
350980,202306,1016,2320,764,1848,100,278,475,1032,575,1310
350990,202306,2879,6694,2074,5298,468,1377,1054,2377,1522,3754
350995,202306,1130,3054,859,2403,53,180,561,1416,614,1596
351000,202306,3885,9984,2134,6113,433,1336,543,1354,976,2690
351010,202306,519,1212,279,745,52,146,115,283,167,429
351015,202306,1312,3511,826,2325,145,448,366,886,511,1334
351020,202306,10955,26270,7066,18502,1327,3536,3264,7448,4591,10984
351030,202306,4153,10998,2852,8125,584,1817,1237,3117,1821,4934
351040,202306,7804,16453,5481,12426,356,958,3997,8156,4353,9114
351050,202306,23730,53602,15869,39796,2680,7197,8282,18810,10962,26007
351060,202306,68578,154037,45658,111635,4289,11914,29500,66148,33789,78062
351070,202306,1961,4480,983,2706,270,775,185,426,455,1201
351080,202306,3750,8175,2496,6214,311,832,1432,3177,1743,4009
351090,202306,441,1083,293,807,55,143,125,310,180,453
351100,202306,3727,9083,1953,5256,317,923,770,1858,1087,2781
351110,202306,7631,18335,4916,13091,836,2446,2293,5390,3129,7836
351120,202306,1020,2399,573,1469,106,314,209,432,315,746
351130,202306,1544,4008,587,1757,111,351,129,332,240,683
351140,202306,2964,7398,1906,5229,398,1174,730,1680,1128,2854
351150,202306,3777,9807,2167,6213,384,1197,619,1497,1003,2694
351160,202306,1908,5309,1148,3509,194,616,186,436,380,1052
351170,202306,2188,5104,1654,4059,126,379,1126,2475,1252,2854
351190,202306,1270,3266,731,2075,172,515,200,504,372,1019
351200,202306,1964,4557,1247,3248,150,430,613,1341,763,1771
351210,202306,1913,4271,1101,2714,72,213,730,1626,802,1839
351220,202306,5086,11816,3716,9211,470,1141,2320,5392,2790,6533
351230,202306,2982,6899,1955,4945,349,965,902,1916,1251,2881
351240,202306,2996,7477,1406,3887,310,893,224,456,534,1349
351250,202306,1295,3283,597,1713,99,277,219,572,318,849
351260,202306,1019,2328,626,1594,127,318,238,543,365,861
351270,202306,682,1690,399,1076,53,159,196,411,249,570
351280,202306,5077,12325,3229,8432,752,2070,1110,2594,1862,4664
351290,202306,1977,4257,1137,2711,91,264,810,1782,901,2046
351300,202306,31318,75733,20404,54130,3639,10258,9586,22837,13225,33095
351310,202306,5228,11378,3462,8120,254,665,2347,4953,2601,5618
351320,202306,1026,2777,608,1880,97,293,147,392,244,685
351330,202306,370,913,180,511,16,48,76,179,92,227
351340,202306,11139,24824,8602,19934,1505,4005,5262,10518,6767,14523
351350,202306,18169,40534,12659,29769,1041,2818,8971,19085,10012,21903
351360,202306,5186,11958,3877,9707,718,2006,1972,4307,2690,6313
351370,202306,2615,6761,1450,4201,331,1035,309,669,640,1704
351380,202306,62874,136589,38357,91181,3970,10353,23871,51758,27841,62111
351385,202306,480,1199,160,465,30,84,61,150,91,234
351390,202306,1863,4177,1177,3137,66,211,873,2159,939,2370
351400,202306,1574,3872,1035,2679,224,530,487,1201,711,1731
351410,202306,3468,8604,2193,5930,440,1244,883,2137,1323,3381
351420,202306,623,1401,324,826,66,155,171,408,237,563
351430,202306,1330,3050,874,2125,104,269,544,1169,648,1438
351440,202306,4847,11481,2756,7013,468,1241,1031,2124,1499,3365
351450,202306,2249,5412,1222,3297,230,746,421,875,651,1621
351460,202306,1352,3145,897,2295,159,412,512,1190,671,1602
351470,202306,1558,3605,980,2470,80,207,617,1418,697,1625
351480,202306,3137,8057,2171,6202,376,1123,982,2508,1358,3631
351490,202306,2985,7355,2130,5608,96,313,1522,3687,1618,4000
351492,202306,485,1131,341,818,16,47,256,561,272,608
351495,202306,289,711,183,487,18,37,107,257,125,294
351500,202306,60469,128901,40746,93826,5407,13511,25846,54058,31253,67569
351510,202306,18626,40222,12201,28486,1349,3593,7784,16723,9133,20316
351512,202306,583,1461,337,908,59,155,107,243,166,398
351515,202306,4118,9182,2143,5398,440,1201,515,1201,955,2402
351518,202306,2546,6238,1511,4177,255,743,579,1327,834,2070
351519,202306,781,2010,360,1092,72,235,81,195,153,430
351520,202306,1368,3161,575,1594,70,213,275,668,345,881
351530,202306,438,1051,227,592,38,106,93,175,131,281
351535,202306,2064,4810,1269,3301,216,596,556,1329,772,1925
351540,202306,3516,7794,2114,5209,249,723,1117,2353,1366,3076
351550,202306,9819,22312,5719,14305,813,2110,2907,6419,3720,8529
351560,202306,704,1867,429,1249,76,227,162,408,238,635
351565,202306,353,857,223,602,34,111,109,247,143,358
351570,202306,32002,74558,21994,54131,1880,5313,14450,32497,16330,37810
351580,202306,281,688,136,401,23,72,56,168,79,240
351590,202306,540,1176,240,633,24,78,121,275,145,353
351600,202306,1649,4096,1040,2754,175,445,448,1016,623,1461
351610,202306,854,1877,433,1062,53,107,244,561,297,668
351620,202306,32192,78229,20313,55591,2958,9101,9134,21645,12092,30746
351630,202306,39247,89531,26826,65989,2294,6371,17932,39916,20226,46287
351640,202306,27719,62156,19228,46026,1469,4161,13166,28528,14635,32689
351650,202306,480,1264,189,590,38,121,40,107,78,228
351660,202306,765,2002,470,1345,83,255,125,301,208,556
351670,202306,8065,20139,4276,11359,893,2382,1812,4134,2705,6516
351680,202306,531,1367,319,932,61,174,111,290,172,464
351685,202306,617,1564,385,1065,68,176,156,364,224,540
351690,202306,1514,3585,780,2137,108,349,319,729,427,1078
351700,202306,1785,3972,1115,2715,160,411,642,1372,802,1783
351710,202306,1021,2418,618,1583,49,151,351,781,400,932
351720,202306,1972,4728,1159,3096,201,538,532,1286,733,1824
351730,202306,1332,3009,887,2202,73,183,550,1231,623,1414
351740,202306,4237,9711,3002,7328,394,1032,1735,3799,2129,4831
351750,202306,2498,6070,1303,3564,174,507,641,1532,815,2039
351760,202306,4255,10513,2861,7668,565,1735,1276,2908,1841,4643
351770,202306,2731,6504,2020,5054,503,1246,1021,2356,1524,3602
351780,202306,1371,3188,691,1828,78,220,315,756,393,976
351790,202306,2020,4343,1367,3267,241,541,746,1700,987,2241
351800,202306,554,1224,240,611,37,110,87,169,124,279
351810,202306,1460,3460,979,2529,260,746,419,941,679,1687
351820,202306,4132,9932,2648,6814,557,1539,1087,2395,1644,3934
351830,202306,6798,15298,4416,10809,346,1006,2862,6170,3208,7176
351840,202306,12876,31507,8996,23873,821,2481,5617,13382,6438,15863
351850,202306,1855,4881,1030,3095,185,624,304,686,489,1310
351860,202306,3588,9243,2419,6806,729,2166,866,2074,1595,4240
351870,202306,39924,90904,28349,69969,5383,13698,14251,33235,19634,46933
351880,202306,235302,512776,161339,376656,21829,60463,100067,206475,121896,266938
351885,202306,1371,3043,986,2369,47,128,732,1633,779,1761
351890,202306,1039,2507,535,1531,100,322,145,345,245,667
351900,202306,1637,3985,1073,2943,113,335,685,1800,798,2135
351905,202306,810,2114,505,1404,56,160,211,499,267,659
351907,202306,31315,74022,20583,52593,2496,7206,11914,27126,14410,34332
351910,202306,2322,5290,1396,3353,146,419,862,1784,1008,2203
351920,202306,1146,2718,750,1912,130,344,296,648,426,992
351925,202306,1302,3118,860,2209,80,247,499,1138,579,1385
351930,202306,6032,13233,4781,10898,572,1382,3239,6827,3811,8209
351940,202306,1432,3408,910,2398,169,454,357,899,526,1353
351950,202306,2093,4106,1384,2987,70,182,1025,2033,1095,2215
351960,202306,7370,16876,4701,11769,1059,2777,1898,4143,2957,6920
351970,202306,14849,34420,11168,27925,1258,3903,7392,16521,8650,20424
351980,202306,1413,3129,754,1906,126,339,333,723,459,1062
351990,202306,1817,3975,1055,2543,46,140,639,1322,685,1462
352000,202306,3693,8953,2673,6735,246,753,1794,4040,2040,4793
352010,202306,3113,7418,2135,5582,585,1558,558,1374,1143,2932
352020,202306,2249,5281,1547,3941,249,697,809,1850,1058,2547
352030,202306,8304,18576,5963,14361,743,2089,3844,8327,4587,10416
352040,202306,6069,13994,3781,9458,672,1826,1571,3422,2243,5248
352042,202306,5097,10811,3075,7412,341,922,1951,4348,2292,5270
352044,202306,2659,6538,1351,3834,233,719,301,643,534,1362
352050,202306,18096,44390,10160,27511,2847,8159,2226,4550,5073,12709
352060,202306,1005,2394,648,1686,120,338,311,708,431,1046
352070,202306,1190,2367,647,1488,91,222,345,710,436,932
352080,202306,553,1316,241,630,35,96,100,215,135,311
352090,202306,2050,5290,1408,3857,176,555,726,1675,902,2230
352100,202306,5088,12938,3307,9204,637,1911,1340,3328,1977,5239
352110,202306,988,2470,598,1617,119,323,257,597,376,920
352115,202306,624,1600,481,1376,129,424,200,471,329,895
352120,202306,1088,2805,786,2177,72,209,473,1176,545,1385
352130,202306,2460,6517,1330,3674,203,580,599,1431,802,2011
352140,202306,1834,4473,1136,2976,219,577,441,1033,660,1610
352150,202306,1097,2658,731,1957,111,315,431,1075,542,1390
352160,202306,1227,2792,710,1815,75,211,367,864,442,1075
352170,202306,3794,9437,2508,6664,450,1370,1110,2474,1560,3844
352180,202306,3584,8974,2408,6620,459,1352,974,2367,1433,3719
352190,202306,2190,4996,1573,3913,278,713,800,1867,1078,2580
352200,202306,426,1252,249,815,37,117,84,232,121,349
352210,202306,32175,64078,23494,51180,1351,3447,18272,37157,19623,40604
352215,202306,805,1984,568,1538,112,319,271,682,383,1001
352220,202306,39017,82427,26214,58941,3324,8593,16713,33142,20037,41735
352230,202306,20666,53096,13876,38762,3478,10310,4982,11641,8460,21951
352240,202306,14048,33081,9881,25604,2004,5689,4944,11165,6948,16854
352250,202306,34830,88119,25375,70091,3530,10577,14820,37727,18350,48304
352260,202306,6585,15225,3914,9629,710,1887,1832,3745,2542,5632
352265,202306,1121,2983,925,2641,214,644,421,1119,635,1763
352270,202306,2799,7152,2001,5440,383,1081,873,2117,1256,3198
352280,202306,3152,6888,2238,5411,382,1025,1194,2551,1576,3576
352290,202306,2043,5081,1266,3365,177,483,643,1451,820,1934
352300,202306,1205,2857,622,1613,71,206,304,660,375,866
352310,202306,59963,141719,41344,107295,6406,17036,24845,60456,31251,77492
352320,202306,9089,20514,6486,15570,835,2243,3922,8173,4757,10416
352330,202306,3492,7704,2527,6173,226,731,1672,3614,1898,4345
352340,202306,10833,25848,6861,17603,1010,2877,3553,7891,4563,10768
352350,202306,3358,8088,2265,5734,149,445,1505,3423,1654,3868
352360,202306,2042,4758,1407,3527,161,436,825,1791,986,2227
352370,202306,1333,3355,985,2674,84,270,669,1685,753,1955
352380,202306,1264,2960,775,1989,165,423,273,631,438,1054
352390,202306,19525,44705,12069,30223,1736,4853,6751,14777,8487,19630
352400,202306,5044,13036,3199,9037,732,2165,960,2268,1692,4433
352410,202306,5078,11295,3452,8292,454,1146,1938,4238,2392,5384
352420,202306,1069,2528,629,1655,106,270,279,635,385,905
352430,202306,11885,25225,7660,17400,930,2361,4541,9293,5471,11654
352440,202306,26060,64112,16907,44975,3798,10216,5858,14314,9656,24530
352450,202306,1016,2391,473,1347,67,218,204,484,271,702
352460,202306,3490,8725,2283,6369,396,1214,1022,2501,1418,3715
352470,202306,3927,9559,2547,6849,260,811,1454,3464,1714,4275
352480,202306,6010,12998,3411,8167,501,1350,1662,3365,2163,4715
352490,202306,1101,2740,689,1863,128,332,277,685,405,1017
352500,202306,15367,36302,8468,22545,2806,8199,1547,2529,4353,10728
352510,202306,6243,14728,4383,11119,504,1379,2851,6711,3355,8090
352520,202306,3780,9337,2488,6849,428,1249,1218,2908,1646,4157
352530,202306,15790,36559,9458,23889,2082,5804,3340,6729,5422,12533
352540,202306,726,1852,477,1311,61,175,252,621,313,796
352550,202306,1436,3500,909,2548,173,590,326,729,499,1319
352560,202306,848,2015,551,1366,38,115,361,784,399,899
352570,202306,2818,7233,1738,5099,436,1414,275,506,711,1920
352580,202306,987,2211,723,1698,101,283,444,926,545,1209
352585,202306,496,1282,272,793,33,114,105,227,138,341
352590,202306,16297,39975,9957,27157,1670,5021,4682,10829,6352,15850
352600,202306,2566,6129,1803,4576,299,841,1052,2348,1351,3189
352610,202306,3899,9192,2697,7052,397,1162,1358,3157,1755,4319
352620,202306,7888,17405,5317,13153,1229,3094,2411,5660,3640,8754
352630,202306,1048,2354,701,1777,112,315,327,754,439,1069
352640,202306,4452,10257,2856,7060,261,690,1724,3758,1985,4448
352650,202306,702,1846,396,1167,67,216,156,403,223,619
352660,202306,1460,3741,1023,2775,67,205,691,1703,758,1908
352670,202306,14047,33260,9000,22731,1710,4582,4237,9309,5947,13891
352680,202306,4443,11792,2901,8171,558,1800,1288,2833,1846,4633
352690,202306,34734,80288,23104,57675,1311,3974,16029,36497,17340,40471
352700,202306,1058,2493,673,1774,90,256,339,794,429,1050
352710,202306,7252,17113,4576,11916,1274,3529,1630,3522,2904,7051
352720,202306,13589,30543,9670,22930,1252,3334,5818,12484,7070,15818
352725,202306,661,1433,308,798,26,80,172,370,198,450
352730,202306,5308,14641,3411,9623,490,1522,1545,3492,2035,5014
352740,202306,3027,6841,1872,4707,260,729,875,1880,1135,2609
352750,202306,532,1240,265,724,33,93,114,254,147,347
352760,202306,1874,4662,1278,3456,175,494,673,1674,848,2168
352770,202306,1201,2856,739,1931,97,260,408,972,505,1232
352780,202306,815,2155,442,1317,113,299,120,332,233,631
352790,202306,513,1240,300,770,53,130,127,277,180,407
352800,202306,1732,4722,966,2880,184,563,208,446,392,1009
352810,202306,2168,4730,1525,3496,153,378,1097,2368,1250,2746
352820,202306,542,1435,328,981,67,208,80,195,147,403
352830,202306,682,1630,279,774,36,97,94,220,130,317
352840,202306,5041,12961,3456,9619,765,2266,1399,3517,2164,5783
352850,202306,17755,37725,11470,27015,1866,4898,6420,13221,8286,18119
352860,202306,1518,3818,914,2532,180,496,331,845,511,1341
352870,202306,1030,2490,609,1580,68,165,346,827,414,992
352880,202306,2158,4800,1226,2926,216,534,508,1040,724,1574
352885,202306,456,1133,303,820,33,95,184,448,217,543
352890,202306,878,1886,492,1082,49,119,347,667,396,786
352900,202306,25673,60839,15144,39392,2523,6725,5898,13657,8421,20382
352910,202306,461,1141,212,613,14,38,86,207,100,245
352920,202306,3565,8299,2412,6074,144,437,1727,3964,1871,4401
352930,202306,7637,18097,5370,13330,861,2490,2689,5613,3550,8103
352940,202306,36686,87969,26023,65535,3822,10414,14901,33914,18723,44328
352950,202306,693,1766,382,1145,74,236,115,268,189,504
352960,202306,924,2269,445,1209,67,194,154,332,221,526
352965,202306,283,726,158,465,27,70,48,135,75,205
352970,202306,5154,9520,3865,7524,118,298,3219,5860,3337,6158
352980,202306,1939,4298,1381,3385,364,946,654,1438,1018,2384
352990,202306,5796,13430,3953,10113,697,1853,2056,4880,2753,6733
353000,202306,557,1397,270,766,36,113,93,228,129,341
353010,202306,3522,7905,2070,5083,337,910,1001,2111,1338,3021
353020,202306,4020,9626,2162,5811,347,1070,898,2102,1245,3172
353030,202306,6214,14636,3582,9698,849,2455,983,2339,1832,4794
353040,202306,949,2071,618,1485,64,180,404,866,468,1046
353050,202306,6744,17298,4288,12042,727,2231,2087,5203,2814,7434
353060,202306,67930,153054,50016,120968,3494,10256,35734,78865,39228,89121
353070,202306,15103,37860,9439,24932,1611,4630,4415,10039,6026,14669
353080,202306,6690,16075,4162,10860,812,2324,1670,3505,2482,5829
353090,202306,742,2034,484,1459,51,167,248,645,299,812
353100,202306,387,934,148,433,25,76,48,105,73,181
353110,202306,10885,24936,7870,20157,1681,4296,3889,9964,5570,14260
353120,202306,656,1535,433,1112,63,203,214,443,277,646
353130,202306,4005,8744,2280,5435,492,1264,1004,1945,1496,3209
353140,202306,4113,8919,2715,6402,412,1147,1580,3301,1992,4448
353150,202306,2223,5090,1409,3575,274,735,630,1407,904,2142
353160,202306,797,1913,442,1192,56,171,192,405,248,576
353170,202306,885,2045,596,1550,55,168,360,842,415,1010
353180,202306,12880,29899,8291,20976,1893,5158,3351,7373,5244,12531
353190,202306,4629,11088,2930,7422,361,971,1660,3822,2021,4793
353200,202306,2235,5538,1174,3248,156,483,485,1142,641,1625
353205,202306,620,1609,400,1065,41,121,235,540,276,661
353210,202306,1154,2262,651,1424,25,62,499,1003,524,1065
353215,202306,489,1213,311,822,51,150,136,307,187,457
353220,202306,966,2461,519,1460,99,287,180,431,279,718
353230,202306,1073,2748,757,2195,194,621,161,426,355,1047
353240,202306,3343,7861,2465,6299,353,1036,1450,3354,1803,4390
353250,202306,1764,3555,1045,2319,125,317,652,1302,777,1619
353260,202306,1494,3225,763,1994,168,493,300,668,468,1161
353270,202306,1098,2489,769,1827,90,260,462,953,552,1213
353280,202306,954,2327,589,1632,118,333,210,515,328,848
353282,202306,2127,5502,1526,4230,157,491,842,2060,999,2551
353284,202306,454,1042,215,577,20,66,88,183,108,249
353286,202306,200,501,100,307,21,60,12,31,33,91
353290,202306,1638,4009,742,2035,162,418,191,472,353,890
353300,202306,2861,7023,1725,4567,347,1000,772,1727,1119,2727
353310,202306,502,1126,315,741,22,60,219,465,241,525
353320,202306,817,2033,514,1388,60,180,270,638,330,818
353325,202306,1027,2628,550,1511,84,239,239,554,323,793
353330,202306,811,1862,422,1087,58,149,200,446,258,595
353340,202306,4158,10322,2923,7707,474,1432,1467,3247,1941,4679
353350,202306,5839,12987,3616,8730,948,2477,1069,2180,2017,4657
353360,202306,898,2295,602,1624,48,147,372,892,420,1039
353370,202306,786,2055,560,1636,79,248,305,824,384,1072
353380,202306,403,1007,272,732,36,113,158,356,194,469
353390,202306,8364,19277,5046,12899,473,1417,2886,6442,3359,7859
353400,202306,750,1821,469,1227,71,200,220,442,291,642
353410,202306,680,1633,434,1132,147,382,145,302,292,684
353420,202306,634,1487,382,978,77,218,106,215,183,433
353430,202306,2957,7457,1988,5465,434,1229,797,1951,1231,3180
353440,202306,107106,254393,70527,179140,9152,25884,40773,91235,49925,117119
353450,202306,491,1161,290,784,34,85,136,335,170,420
353460,202306,4217,10510,2371,6549,492,1496,591,1265,1083,2761
353470,202306,12315,29085,7775,20054,1332,3700,3441,7561,4773,11261
353475,202306,2044,4728,1084,2787,148,425,478,1045,626,1470
353480,202306,2054,4678,1386,3423,88,241,956,2146,1044,2387
353490,202306,1389,3276,875,2238,114,322,471,1045,585,1367
353500,202306,1589,3540,1050,2556,223,573,497,1078,720,1651
353510,202306,1338,3428,778,2076,140,396,324,713,464,1109
353520,202306,1341,3228,754,2097,122,353,276,600,398,953
353530,202306,3280,7568,2318,5629,259,726,1492,3238,1751,3964
353540,202306,2887,6893,2011,5262,302,823,1174,2803,1476,3626
353550,202306,8172,18200,5454,12962,793,2002,3248,6902,4041,8904
353560,202306,3054,7437,2083,5700,583,1682,656,1461,1239,3143
353570,202306,816,2048,423,1218,70,213,151,370,221,583
353580,202306,3202,7604,2157,5476,391,973,1141,2692,1532,3665
353590,202306,936,2189,591,1529,97,250,304,722,401,972
353600,202306,1965,4655,1159,3061,166,444,560,1370,726,1814
353610,202306,1071,2847,657,1944,94,287,269,700,363,987
353620,202306,3805,8887,2363,6244,565,1517,712,1620,1277,3137
353625,202306,800,1833,388,1040,42,142,206,488,248,630
353630,202306,2084,5472,1515,4182,212,623,811,1973,1023,2596
353640,202306,1802,4244,1188,3051,148,371,743,1769,891,2140
353650,202306,9102,22800,5822,15819,868,2564,2987,7193,3855,9757
353657,202306,463,1147,255,712,23,74,109,252,132,326
353660,202306,1741,3354,1137,2487,145,363,776,1575,921,1938
353670,202306,5772,14304,3605,9535,714,2145,1522,3304,2236,5449
353680,202306,919,2136,596,1608,96,277,301,732,397,1009
353690,202306,527,1354,194,575,26,81,46,103,72,184
353700,202306,2917,6655,2016,5058,225,579,1228,2846,1453,3425
353710,202306,5372,11564,3332,7613,569,1346,1808,3512,2377,4858
353715,202306,528,1322,254,713,25,84,117,270,142,354
353720,202306,2488,5973,1683,4486,350,993,684,1648,1034,2641
353730,202306,6821,15783,4836,12045,664,1901,2812,6219,3476,8120
353740,202306,2832,6757,1840,4807,348,1011,857,1893,1205,2904
353750,202306,1156,3186,704,2217,174,548,116,316,290,864
353760,202306,19736,39289,13719,30470,2653,6438,7305,14992,9958,21430
353770,202306,818,2189,393,1228,55,206,49,114,104,320
353780,202306,9177,21446,6638,16410,1191,3300,3599,7985,4790,11285
353790,202306,3534,9586,2250,6658,516,1647,506,1147,1022,2794
353800,202306,24968,58615,17599,44832,2363,6454,10541,24589,12904,31043
353810,202306,1636,3970,970,2511,172,444,390,935,562,1379
353820,202306,2366,5719,1416,3826,400,1072,377,868,777,1940
353830,202306,773,1788,467,1244,67,203,237,534,304,737
353850,202306,2050,5017,1388,3680,244,687,640,1547,884,2234
353860,202306,3714,8963,2611,6957,576,1780,1128,2440,1704,4220
353870,202306,39811,95775,24624,64226,4010,11082,10935,24969,14945,36051
353880,202306,3963,9655,2865,7449,231,711,1853,4348,2084,5059
353890,202306,4291,8121,2715,5672,197,493,1894,3492,2091,3985
353900,202306,946,2426,562,1555,85,261,212,494,297,755
353910,202306,4203,9710,3081,7653,261,746,2053,4647,2314,5393
353920,202306,2612,6474,1626,4432,451,1344,373,737,824,2081
353930,202306,7308,17269,4733,12150,890,2442,2015,4454,2905,6896
353940,202306,1714,4490,975,2795,170,494,363,882,533,1376
353950,202306,4544,10952,3059,7953,910,2476,867,1980,1777,4456
353960,202306,948,2317,561,1531,127,350,92,216,219,566
353970,202306,888,1849,589,1351,50,133,440,938,490,1071
353980,202306,23589,51925,16136,38097,783,2354,11927,25640,12710,27994
353990,202306,1270,2748,773,1841,123,337,446,947,569,1284
354000,202306,3229,7375,1462,3728,228,636,636,1356,864,1992
354010,202306,419,1008,267,715,41,117,156,391,197,508
354020,202306,5338,12521,3595,8725,787,2080,1595,3406,2382,5486
354025,202306,886,2273,483,1372,86,262,125,287,211,549
354030,202306,641,1377,286,709,42,109,137,294,179,403
354040,202306,978,2045,549,1336,46,124,372,835,418,959
354050,202306,1363,3527,848,2547,169,542,317,879,486,1421
354060,202306,5512,13625,3495,9078,512,1497,1822,3972,2334,5469
354070,202306,5385,12468,3278,8142,555,1463,1387,2907,1942,4370
354075,202306,3756,9304,2758,7412,530,1525,1504,3569,2034,5094
354080,202306,1949,4949,1200,3360,181,539,566,1370,747,1909
354085,202306,523,976,335,674,5,13,259,473,264,486
354090,202306,2247,5533,1702,4342,118,352,1209,2843,1327,3195
354100,202306,32885,80637,22147,60837,4053,12231,10471,25714,14524,37945
354105,202306,1473,3499,876,2337,125,355,432,994,557,1349
354110,202306,611,1540,378,1064,55,157,169,418,224,575
354120,202306,1827,4511,1044,2786,213,572,375,849,588,1421
354130,202306,7813,18488,4445,11491,1212,3202,1126,2419,2338,5621
354140,202306,25092,58065,15716,39211,2336,6300,8038,17395,10374,23695
354150,202306,3558,7848,2447,5941,623,1484,735,1756,1358,3240
354160,202306,3572,9242,2599,7205,583,1681,1107,2735,1690,4416
354165,202306,947,2449,658,1829,67,228,417,1009,484,1237
354170,202306,2601,6519,1590,4266,291,875,729,1610,1020,2485
354180,202306,568,1457,336,917,39,121,182,432,221,553
354190,202306,1966,5046,1184,3316,85,283,695,1728,780,2011
354200,202306,1153,2625,742,1849,97,268,417,897,514,1165
354210,202306,1405,3308,883,2202,90,240,544,1220,634,1460
354220,202306,4096,9792,2679,6907,529,1422,1093,2483,1622,3905
354230,202306,1033,2335,766,1933,51,155,524,1217,575,1372
354240,202306,2373,6027,1375,3814,267,755,536,1250,803,2005
354250,202306,821,1950,463,1256,110,297,152,371,262,668
354260,202306,11919,27051,8108,19956,1262,3284,3877,8720,5139,12004
354270,202306,1262,3337,854,2390,131,371,423,1013,554,1384
354280,202306,1037,2306,737,1759,40,127,533,1121,573,1248
354290,202306,1267,3544,903,2708,132,415,470,1284,602,1699
354300,202306,4235,11284,3243,9276,833,2407,1223,3145,2056,5552
354310,202306,1048,2653,739,2012,98,304,452,1093,550,1397
354320,202306,1175,2614,649,1654,113,299,306,646,419,945
354323,202306,563,1254,292,734,36,102,158,358,194,460
354325,202306,1701,4803,837,2638,172,543,133,340,305,883
354330,202306,13315,30161,8064,19315,1086,2854,4622,9868,5708,12722
354340,202306,56494,128894,36694,92524,6006,15882,18802,43085,24808,58967
354350,202306,1489,3383,1104,2678,128,380,696,1480,824,1860
354360,202306,814,1789,440,1134,109,276,150,323,259,599
354370,202306,1259,3160,872,2400,146,442,489,1228,635,1670
354380,202306,670,1673,431,1244,61,214,156,366,217,580
354390,202306,20396,44733,12277,29345,1671,4369,6633,13938,8304,18307
354400,202306,2106,6031,1331,4137,240,781,408,1136,648,1917
354410,202306,9507,21330,6258,14727,960,2530,3598,7543,4558,10073
354420,202306,1843,4426,1119,2987,176,504,529,1232,705,1736
354425,202306,3713,8149,2325,5557,389,950,1298,2860,1687,3810
354430,202306,2287,5267,1505,3787,139,416,937,2097,1076,2513
354440,202306,745,1795,362,934,45,126,192,426,237,552
354450,202306,639,1586,306,885,40,125,106,236,146,361
354460,202306,992,2380,588,1616,164,499,155,338,319,837
354470,202306,502,1268,238,653,23,73,99,219,122,292
354480,202306,1785,3747,1035,2443,74,207,693,1466,767,1673
354490,202306,1049,2819,649,1857,145,386,289,749,434,1135
354500,202306,3065,7544,2128,5760,526,1516,736,1769,1262,3285
354510,202306,941,2400,589,1626,75,216,294,670,369,886
354515,202306,558,1480,311,918,59,178,90,219,149,397
354520,202306,11076,26961,6913,17954,940,2740,3799,8505,4739,11245
354530,202306,6922,16900,4537,11796,1141,2916,1769,4174,2910,7090
354540,202306,1607,3875,1001,2664,176,496,447,1084,623,1580
354550,202306,725,1812,472,1294,74,223,224,516,298,739
354560,202306,2775,6211,1296,3327,142,361,712,1651,854,2012
354570,202306,1118,2631,417,1190,72,221,64,165,136,386
354580,202306,11021,27470,6690,18501,964,2914,3342,8178,4306,11092
354600,202306,2685,6606,1735,4663,296,796,883,2150,1179,2946
354610,202306,578,1447,263,752,33,96,118,295,151,391
354620,202306,629,1644,335,1023,32,115,168,453,200,568
354625,202306,379,1001,189,581,16,50,59,149,75,199
354630,202306,3335,8461,2455,6587,753,2052,698,1665,1451,3717
354640,202306,5140,12757,3438,9155,452,1370,1820,4204,2272,5574
354650,202306,1110,2635,679,1689,191,448,303,706,494,1154
354660,202306,4451,9818,2175,5753,291,858,882,1999,1173,2857
354670,202306,1584,3939,1025,2741,210,604,354,783,564,1387
354680,202306,8525,19093,5898,14372,933,2480,3368,7477,4301,9957
354690,202306,678,1892,386,1180,55,172,152,390,207,562
354700,202306,1199,2839,737,1892,97,284,401,920,498,1204
354710,202306,603,1492,327,903,36,94,157,367,193,461
354720,202306,385,851,164,433,57,138,42,93,99,231
354730,202306,15211,39402,10227,28799,1400,4088,5391,13572,6791,17660
354740,202306,390,1002,143,433,35,104,21,46,56,150
354750,202306,3173,7563,1831,4744,281,779,829,1809,1110,2588
354760,202306,2926,6942,1804,4734,340,939,716,1580,1056,2519
354765,202306,434,1090,153,458,16,64,42,96,58,160
354770,202306,3176,7250,1997,4858,414,1128,968,2067,1382,3195
354780,202306,86402,189091,58065,132493,4059,11316,40834,82976,44893,94292
354790,202306,1164,2950,862,2430,83,250,495,1293,578,1543
354800,202306,3550,8397,2156,5696,462,1256,746,1645,1208,2901
354805,202306,1841,3958,1145,2716,80,214,791,1682,871,1896
354810,202306,666,1877,360,1202,69,262,95,254,164,516
354820,202306,1218,3261,786,2371,162,496,233,573,395,1069
354830,202306,682,1528,340,865,72,200,132,270,204,470
354840,202306,1071,2601,523,1400,41,113,284,654,325,767
354850,202306,30977,69283,20374,49761,1693,4909,13665,29743,15358,34652
354860,202306,2024,4980,1170,3254,140,444,503,1201,643,1645
354870,202306,94946,211217,62414,146425,5206,14149,40826,84512,46032,98661
354880,202306,8328,19295,4036,10103,548,1562,1894,3697,2442,5259
354890,202306,25444,56477,17455,41423,2175,5779,9868,20890,12043,26669
354900,202306,475,1117,267,723,80,228,86,198,166,426
354910,202306,8089,19551,4340,12124,908,2693,1338,3090,2246,5783
354920,202306,594,1524,222,661,35,106,58,132,93,238
354925,202306,334,896,154,494,19,65,31,74,50,139
354930,202306,445,1032,228,566,20,52,134,306,154,358
354940,202306,3606,9517,2398,6778,662,1938,920,2181,1582,4119
354950,202306,2008,4497,1345,3285,67,214,955,2092,1022,2306
354960,202306,1069,2607,681,1918,74,255,323,787,397,1042
354970,202306,5783,14127,3990,10757,295,960,2562,6237,2857,7197
354980,202306,48424,105690,30437,72861,3737,10318,18629,39249,22366,49567
354990,202306,107495,238208,68015,163434,4880,14171,45043,95863,49923,110034
354995,202306,4521,8470,3157,6483,154,367,2479,4732,2633,5099
355000,202306,1940,4429,1257,3251,213,619,584,1303,797,1922
355010,202306,5376,13160,2987,8017,910,2356,776,1873,1686,4229
355020,202306,4085,10962,2914,8671,714,2343,1005,2540,1719,4883
355030,202306,1802215,4058160,1119580,2680623,159359,415574,612531,1306604,771890,1722178
355040,202306,4767,10198,3320,7997,424,1134,2199,4822,2623,5956
355050,202306,1461,3120,933,2237,231,554,366,805,597,1359
355060,202306,9236,22501,6057,16097,974,2813,3080,7162,4054,9975
355070,202306,14939,33511,10624,25482,1225,3329,6683,14323,7908,17652
355080,202306,1254,3266,663,2038,166,506,109,282,275,788
355090,202306,1795,4398,1221,3257,198,535,640,1488,838,2023
355100,202306,44265,99447,33767,81094,3278,8782,23676,52385,26954,61167
355110,202306,1268,3188,775,2288,147,445,52,135,199,580
355120,202306,917,2212,534,1518,77,235,255,633,332,868
355130,202306,1105,2202,506,1076,16,49,382,736,398,785
355140,202306,3019,5541,2334,4558,92,227,1942,3538,2034,3765
355150,202306,6697,15407,4758,11689,576,1544,2892,6513,3468,8057
355160,202306,3178,7836,1897,5305,409,1182,567,1363,976,2545
355170,202306,16457,37221,11075,27030,1724,4615,6218,13724,7942,18339
355180,202306,3745,8540,2528,6523,550,1577,1206,2762,1756,4339
355190,202306,2425,5932,1538,4183,567,1561,354,977,921,2538
355200,202306,1170,3170,872,2604,228,768,309,797,537,1565
355210,202306,4227,10306,2689,7062,740,1896,931,2217,1671,4113
355220,202306,73589,171272,51281,125219,6246,17513,30433,65365,36679,82878
355230,202306,1576,3752,672,1788,119,369,278,580,397,949
355240,202306,33292,80182,20627,53718,2283,6603,12295,28737,14578,35340
355250,202306,55754,132688,37278,94268,8302,21614,17983,41278,26285,62892
355255,202306,811,1875,348,934,35,102,151,326,186,428
355260,202306,2018,4281,1253,2918,100,293,878,1833,978,2126
355270,202306,1631,4292,1119,3171,291,791,422,1095,713,1886
355280,202306,44463,100814,27774,68006,3524,9359,15595,34376,19119,43735
355290,202306,1207,2944,786,2095,170,441,356,843,526,1284
355300,202306,1849,4802,1316,3668,214,623,572,1354,786,1977
355310,202306,1168,2891,749,2045,101,299,392,978,493,1277
355320,202306,704,1737,423,1123,83,238,166,339,249,577
355330,202306,4077,9268,2686,6564,131,391,1989,4434,2120,4825
355340,202306,5293,11071,3301,7747,608,1425,1437,3399,2045,4824
355350,202306,1819,4610,1219,3367,229,700,561,1366,790,2066
355360,202306,1628,3740,1061,2729,152,427,569,1236,721,1663
355365,202306,431,987,184,515,30,80,65,149,95,229
355370,202306,7492,17208,5001,12703,1004,2279,2393,5962,3397,8241
355380,202306,3889,9402,2579,6813,462,1308,964,2115,1426,3423
355385,202306,1777,4204,1175,2984,108,309,688,1533,796,1842
355390,202306,985,2494,613,1638,98,268,292,645,390,913
355395,202306,2248,6032,1216,3587,205,656,474,1151,679,1807
355400,202306,13131,33391,9078,24515,1766,5228,3958,8977,5724,14205
355410,202306,32488,81341,19940,54668,3754,11070,8160,19652,11914,30722
355420,202306,755,2199,540,1714,110,374,160,450,270,824
355430,202306,4692,10926,3043,7587,494,1364,1683,3858,2177,5222
355440,202306,873,2165,463,1275,90,267,131,303,221,570
355450,202306,4816,11288,2667,6793,344,945,1348,2828,1692,3773
355460,202306,595,1373,351,925,37,114,153,345,190,459
355465,202306,564,1328,384,1003,58,156,216,516,274,672
355470,202306,1437,3382,712,1900,207,604,257,606,464,1210
355475,202306,440,950,286,678,14,31,189,406,203,437
355480,202306,5510,13962,3927,11077,580,1805,2226,5773,2806,7578
355490,202306,1118,2831,521,1546,65,212,223,556,288,768
355495,202306,1235,2975,755,2094,92,298,361,815,453,1113
355500,202306,9203,21323,5130,13010,675,1950,2434,5251,3109,7201
355510,202306,1796,4149,1016,2626,163,445,468,1044,631,1489
355520,202306,383,874,172,500,29,86,31,73,60,159
355530,202306,376,798,141,355,12,36,83,183,95,219
355535,202306,682,1694,469,1279,92,292,212,453,304,745
355540,202306,18039,39138,13603,31990,1343,3471,9354,20391,10697,23862
355550,202306,851,2295,612,1785,71,240,348,892,419,1132
355560,202306,1435,3491,683,1950,145,454,35,103,180,557
355570,202306,381,922,172,482,38,99,64,153,102,252
355580,202306,1477,3390,697,1879,123,331,137,331,260,662
355590,202306,201,501,135,380,11,32,73,182,84,214
355600,202306,1711,4059,1005,2696,140,405,285,634,425,1039
355610,202306,2607,5935,1504,3816,281,734,713,1582,994,2316
355620,202306,6603,15879,4121,10647,491,1533,2295,5076,2786,6609
355630,202306,3412,8306,2146,5681,272,783,1258,2962,1530,3745
355635,202306,1308,3412,751,2145,97,293,283,682,380,975
355640,202306,4611,11735,2668,7702,723,2075,414,1195,1137,3270
355645,202306,4761,12261,2950,8551,423,1340,1386,3575,1809,4915
355650,202306,10895,25932,7269,18494,1293,3414,3522,7956,4815,11370
355660,202306,1664,4186,827,2455,151,446,139,345,290,791
355670,202306,6015,14440,3570,8983,459,1368,1799,3720,2258,5088
355680,202306,3157,8288,1257,3759,344,1097,112,286,456,1383
355690,202306,921,2511,534,1660,182,561,15,34,197,595
355695,202306,321,821,168,491,15,48,33,67,48,115
355700,202306,11925,29451,8640,22091,1024,2935,5084,11524,6108,14459
355710,202306,13357,29407,7818,18321,1145,3006,4062,8018,5207,11024
355715,202306,603,1536,286,813,73,200,80,194,153,394
355720,202306,1915,4691,1314,3492,223,611,684,1621,907,2232
355730,202306,1396,3410,916,2433,86,261,531,1261,617,1522
410010,202306,1490,3902,938,2648,210,583,208,515,418,1098
410020,202306,1415,3675,912,2562,267,734,224,553,491,1287
410030,202306,2167,5257,1538,4105,235,659,806,2055,1041,2714
410040,202306,19340,48364,11861,32937,2466,7155,3617,8851,6083,16006
410045,202306,879,2240,536,1489,117,330,133,315,250,645
410050,202306,2602,6411,1503,4210,236,729,451,1067,687,1796
410060,202306,2550,6584,1715,4862,436,1378,515,1247,951,2625
410070,202306,2450,5762,1330,3471,242,647,495,1081,737,1728
410080,202306,1692,4223,1046,2961,247,712,229,558,476,1270
410090,202306,1418,3110,932,2235,236,543,315,814,551,1357
410100,202306,2601,6898,1285,3784,205,639,103,358,308,997
410105,202306,714,1607,377,952,20,64,220,447,240,511
410110,202306,3888,8700,2459,6021,344,916,1405,3082,1749,3998
410115,202306,665,1625,398,1076,55,179,146,298,201,477
410120,202306,4211,9706,3268,8017,650,1366,1868,4448,2518,5814
410130,202306,1666,3943,1281,3150,160,419,791,1825,951,2244
410140,202306,22258,50455,11980,30587,2362,6321,4066,9051,6428,15372
410150,202306,19597,43947,8881,22520,1486,4171,3168,6611,4654,10782
410160,202306,3707,9671,2460,6947,545,1677,902,2274,1447,3951
410165,202306,750,1921,528,1408,78,235,245,583,323,818
410170,202306,3672,8850,1687,4452,337,903,388,877,725,1780
410180,202306,22673,57292,14116,38154,2545,7406,6417,14897,8962,22303
410185,202306,577,1532,362,1033,66,202,144,350,210,552
410190,202306,2742,6449,1535,4013,325,858,328,715,653,1573
410200,202306,7146,15243,3251,8218,716,1911,595,1228,1311,3139
410210,202306,3772,9010,1961,5474,314,969,623,1392,937,2361
410220,202306,764,1870,358,931,77,201,133,296,210,497
410230,202306,2617,6411,1536,4046,240,702,642,1393,882,2095
410240,202306,6258,15507,3424,9494,727,2380,621,1416,1348,3796
410250,202306,2836,6404,1655,4195,217,552,759,1774,976,2326
410260,202306,2484,5627,1349,3457,274,746,630,1393,904,2139
410270,202306,621,1519,335,911,50,154,156,346,206,500
410275,202306,720,1856,386,1118,73,235,160,406,233,641
410280,202306,2867,7024,1577,4324,220,667,700,1597,920,2264
410290,202306,4017,10319,2352,6739,922,2578,506,1394,1428,3972
410300,202306,833,1924,554,1386,65,200,286,589,351,789
410302,202306,397,938,199,561,30,89,89,224,119,313
410304,202306,1850,4013,1356,3127,163,412,769,1724,932,2136
410305,202306,2101,4670,1311,3351,180,522,798,1861,978,2383
410310,202306,4050,9227,2748,6694,204,659,1874,4061,2078,4720
410315,202306,857,1855,487,1207,120,307,160,356,280,663
410320,202306,1136,3025,580,1738,75,242,99,255,174,497
410322,202306,755,1936,296,843,32,91,103,225,135,316
410330,202306,1747,4023,1003,2575,188,475,337,751,525,1226
410335,202306,1023,2558,602,1654,124,363,182,414,306,777
410337,202306,980,2303,502,1274,70,177,188,398,258,575
410340,202306,549,1432,290,769,22,71,146,289,168,360
410345,202306,3448,8461,1634,4396,412,1114,598,1394,1010,2508
410347,202306,954,2320,538,1467,88,236,133,327,221,563
410350,202306,2018,4598,1174,3028,105,314,660,1468,765,1782
410360,202306,4796,11576,2848,7655,546,1526,793,1908,1339,3434
410370,202306,18291,45723,9375,24278,1196,3499,4186,8805,5382,12304
410380,202306,2186,4985,1128,2864,167,470,380,836,547,1306
410390,202306,3491,7686,2037,5072,389,1159,857,1724,1246,2883
410395,202306,1084,2865,738,2140,157,431,246,707,403,1138
410400,202306,10264,23210,6409,15556,655,1849,3953,8432,4608,10281
410405,202306,1134,2469,656,1672,79,241,325,737,404,978
410410,202306,2011,4727,1480,3732,120,338,946,2273,1066,2611
410420,202306,16100,39195,9965,26161,1658,4676,4410,9828,6068,14504
410425,202306,4859,12192,2915,8047,535,1519,1015,2453,1550,3972
410430,202306,16840,38812,9435,23886,1467,4053,3816,8415,5283,12468
410440,202306,3026,7749,2328,6309,422,1154,1186,2950,1608,4104
410442,202306,3127,8386,2045,5888,538,1558,492,1291,1030,2849
410445,202306,2742,7203,1585,4786,354,1180,186,558,540,1738
410450,202306,1960,4534,1154,3073,213,578,329,752,542,1330
410460,202306,3228,7255,1901,4692,263,696,937,1980,1200,2676
410465,202306,3752,9857,2186,6277,532,1547,538,1243,1070,2790
410470,202306,3008,7652,1843,5410,620,2042,130,336,750,2378
410480,202306,52348,117577,24306,64728,3791,11022,7711,17133,11502,28155
410490,202306,14937,37323,9030,24254,1563,4493,4306,10042,5869,14535
410500,202306,2223,5372,1175,3239,243,638,207,457,450,1095
410510,202306,2188,5092,1195,3120,275,685,379,946,654,1631
410520,202306,3815,10644,3059,9027,963,3027,1157,3159,2120,6186
410530,202306,1830,4318,649,1738,85,259,190,394,275,653
410540,202306,3512,8631,2038,5525,370,1096,881,2030,1251,3126
410550,202306,9548,23811,5338,14396,904,2664,1680,3546,2584,6210
410560,202306,1862,4501,1061,2789,202,595,263,550,465,1145
410570,202306,3381,8297,2007,5641,721,2280,193,455,914,2735
410580,202306,38254,89843,24457,62792,3840,10659,11705,26530,15545,37189
410590,202306,2130,5472,1226,3345,192,556,348,740,540,1296
410600,202306,2264,5425,1539,4001,310,819,632,1513,942,2332
410610,202306,859,2033,527,1360,49,139,274,619,323,758
410620,202306,3698,9044,2303,6018,554,1535,706,1616,1260,3151
410630,202306,3061,7333,1647,4352,325,1021,352,629,677,1650
410640,202306,6419,14039,3550,8656,841,2172,648,1465,1489,3637
410645,202306,1762,3991,1280,3258,116,329,889,2138,1005,2467
410650,202306,3304,8210,1749,4801,378,1036,667,1585,1045,2621
410655,202306,1056,2406,547,1386,100,278,216,468,316,746
410657,202306,709,1816,378,1056,61,198,176,384,237,582
410660,202306,4643,10697,2288,5729,361,957,868,1841,1229,2798
410670,202306,1209,2878,577,1541,90,260,209,468,299,728
410680,202306,2949,8193,1846,5530,513,1526,447,1293,960,2819
410685,202306,642,1560,394,1081,101,297,155,372,256,669
410690,202306,182389,413143,104876,258620,16686,45572,44792,92406,61478,137978
410700,202306,3011,7175,1993,5172,478,1258,678,1562,1156,2820
410710,202306,1109,2635,563,1522,143,411,202,443,345,854
410712,202306,813,2049,530,1457,101,286,259,670,360,956
410715,202306,1063,2828,559,1672,73,256,233,612,306,868
410720,202306,4956,11338,3241,7955,470,1425,1257,2725,1727,4150
410725,202306,1429,3292,708,1890,169,475,170,377,339,852
410730,202306,1099,2599,577,1520,100,312,129,304,229,616
410740,202306,1035,2710,567,1669,43,147,311,874,354,1021
410750,202306,2441,5478,1538,3713,250,637,692,1516,942,2153
410752,202306,486,1118,201,542,79,199,30,67,109,266
410753,202306,431,1148,218,662,40,120,68,171,108,291
410754,202306,1411,3218,943,2418,80,231,652,1591,732,1822
410755,202306,658,1592,388,1036,46,145,189,428,235,573
410760,202306,4432,10796,2668,7318,740,2385,649,1537,1389,3922
410765,202306,24296,59715,15669,41353,3168,9184,5435,11822,8603,21006
410770,202306,1236,2796,695,1799,76,181,349,863,425,1044
410773,202306,1622,3870,1164,2987,265,692,580,1302,845,1994
410775,202306,2060,4192,1528,3250,46,122,1189,2323,1235,2445
410780,202306,722,1703,400,1042,67,174,137,330,204,504
410785,202306,1006,2243,605,1550,86,259,270,608,356,867
410790,202306,1401,3784,880,2587,195,645,167,394,362,1039
410800,202306,4258,8439,2540,5375,82,232,1830,3546,1912,3778
410810,202306,561,1390,333,908,36,102,160,376,196,478
410820,202306,1234,3212,534,1472,118,339,115,250,233,589
410830,202306,59070,128032,35994,86039,5681,15131,18077,37991,23758,53122
410832,202306,1358,3318,881,2328,97,296,481,1102,578,1398
410840,202306,11510,27021,5446,14660,1300,3582,1176,2453,2476,6035
410845,202306,1491,3158,1026,2368,111,315,680,1422,791,1737
410850,202306,2626,6711,1918,5240,381,1148,874,2182,1255,3330
410855,202306,864,2038,472,1247,67,212,219,470,286,682
410860,202306,6116,13091,4085,9330,180,544,2900,5894,3080,6438
410865,202306,1761,4528,1290,3597,215,622,666,1871,881,2493
410870,202306,1454,3601,958,2640,135,404,497,1245,632,1649
410880,202306,5942,14629,3295,9401,557,1614,525,1590,1082,3204
410890,202306,1455,3629,969,2578,191,480,454,1094,645,1574
410895,202306,1204,3493,900,2785,272,922,257,685,529,1607
410900,202306,1051,2643,564,1626,93,277,112,237,205,514
410910,202306,543,1184,274,660,19,53,158,332,177,385
410920,202306,1152,2529,614,1490,50,118,389,862,439,980
410930,202306,2147,5118,1201,3352,276,854,192,426,468,1280
410940,202306,32090,79335,19442,53589,3923,11923,7815,18844,11738,30767
410950,202306,2440,6153,1999,5342,199,465,1445,3711,1644,4176
410960,202306,11038,24445,7023,17554,2042,5600,2317,4940,4359,10540
410965,202306,1355,3280,657,1848,115,350,257,632,372,982
410970,202306,5359,13384,3073,8476,782,2518,608,1265,1390,3783
410975,202306,1845,4116,1038,2625,193,503,419,952,612,1455
410980,202306,9649,22084,5429,13934,600,1764,2743,6035,3343,7799
410990,202306,1890,4071,1154,2837,200,563,593,1330,793,1893
411000,202306,839,2152,484,1400,88,271,156,379,244,650
411005,202306,567,1327,265,688,34,96,104,214,138,310
411007,202306,3131,7594,1855,5008,371,1112,656,1488,1027,2600
411010,202306,5939,15550,3559,10235,936,2764,768,1793,1704,4557
411020,202306,2856,7351,1984,5600,535,1525,571,1525,1106,3050
411030,202306,857,2017,476,1208,64,167,208,448,272,615
411040,202306,1264,3004,506,1363,99,244,147,322,246,566
411050,202306,2469,7114,1648,5192,354,1193,264,651,618,1844
411060,202306,2862,6986,1463,3985,255,728,514,1076,769,1804
411065,202306,475,1143,229,627,25,70,93,230,118,300
411070,202306,9898,22550,6477,16046,1038,2749,3237,7039,4275,9788
411080,202306,2554,6129,1619,4243,381,1107,562,1219,943,2326
411090,202306,958,2471,442,1306,66,223,131,316,197,539
411095,202306,2949,6660,1227,3239,215,577,211,427,426,1004
411100,202306,1481,3577,803,2182,121,399,314,734,435,1133
411110,202306,771,1940,288,865,34,98,23,39,57,137
411120,202306,2143,5105,1349,3529,219,687,631,1396,850,2083
411125,202306,6849,17939,4800,13497,1420,4019,1544,3960,2964,7979
411130,202306,919,2267,499,1356,148,373,138,372,286,745
411140,202306,2617,7501,1795,5586,454,1439,469,1449,923,2888
411150,202306,5004,11779,2722,7032,590,1605,255,508,845,2113
411155,202306,1358,3080,749,1846,111,323,412,832,523,1155
411160,202306,487,1046,255,654,45,126,67,171,112,297
411170,202306,995,2606,667,1927,133,418,301,792,434,1210
411180,202306,6906,15971,4917,12020,712,1931,2701,5770,3413,7701
411190,202306,2734,6541,1588,4128,209,594,742,1647,951,2241
411200,202306,6300,15491,4051,10790,846,2537,1399,3001,2245,5538
411210,202306,4447,9479,2406,5619,292,807,1168,2286,1460,3093
411220,202306,1220,2824,666,1734,128,360,254,549,382,909
411230,202306,1029,2554,634,1744,140,384,169,403,309,787
411240,202306,1883,4171,1057,2613,217,557,361,770,578,1327
411250,202306,2799,6803,1643,4500,392,1182,443,1003,835,2185
411260,202306,401,962,219,591,34,105,99,215,133,320
411270,202306,2454,6089,1473,4008,212,621,670,1567,882,2188
411275,202306,2019,4140,1205,2719,112,324,698,1316,810,1640
411280,202306,1890,4685,1110,3004,245,698,404,922,649,1620
411290,202306,1009,2440,562,1517,64,200,281,682,345,882
411295,202306,1595,3797,978,2560,192,488,402,911,594,1399
411300,202306,1202,2898,565,1520,63,191,211,434,274,625
411310,202306,1178,2436,735,1684,130,320,394,776,524,1096
411320,202306,7312,16744,4733,11720,714,1970,2287,4716,3001,6686
411325,202306,1877,4655,1328,3579,211,586,719,1875,930,2461
411330,202306,3912,9694,2561,7167,659,2015,704,1772,1363,3787
411340,202306,988,2519,460,1287,74,210,155,364,229,574
411342,202306,1258,2912,571,1509,126,353,203,427,329,780
411345,202306,1482,3432,904,2345,65,191,586,1408,651,1599
411350,202306,3720,9324,1960,5557,460,1386,260,605,720,1991
411360,202306,864,1975,535,1320,87,253,254,535,341,788
411370,202306,74496,171301,44289,112569,3955,11599,25311,56648,29266,68247
411373,202306,1719,3969,1104,2826,177,454,458,1096,635,1550
411375,202306,1340,3132,713,1885,118,307,240,535,358,842
411380,202306,1410,3035,732,1662,36,87,502,1034,538,1121
411390,202306,1906,4695,1167,2992,196,578,496,1014,692,1592
411400,202306,2939,6634,1844,4525,219,608,1013,2182,1232,2790
411410,202306,3769,9883,2162,6192,537,1582,501,1168,1038,2750
411420,202306,5159,11957,2097,5701,329,1003,417,755,746,1758
411430,202306,5189,12301,3401,8758,653,1893,1244,2615,1897,4508
411435,202306,535,1345,224,650,41,125,44,95,85,220
411440,202306,3349,8285,2010,5541,515,1425,524,1250,1039,2675
411450,202306,3058,7536,2022,5501,323,831,1092,2893,1415,3724
411460,202306,5615,13623,2711,7558,385,1203,716,1543,1101,2746
411470,202306,1123,2532,739,1839,64,218,455,963,519,1181
411480,202306,6990,17014,3897,10591,771,2370,1186,2732,1957,5102
411490,202306,2096,4832,1356,3465,167,512,718,1600,885,2112
411500,202306,1693,4171,937,2475,182,531,254,508,436,1039
411510,202306,2789,6309,1708,4264,312,921,498,1124,810,2045
411520,202306,46439,106295,22216,56359,2853,8316,10126,21470,12979,29786
411530,202306,1134,2723,523,1493,79,240,116,283,195,523
411535,202306,639,1779,325,1026,36,133,81,211,117,344
411540,202306,3306,7383,1834,4515,180,503,1094,2458,1274,2961
411545,202306,1049,2806,781,2241,68,219,466,1274,534,1493
411550,202306,852,1963,548,1349,95,242,205,436,300,678
411560,202306,2353,6199,950,2845,150,469,69,151,219,620
411570,202306,9647,20770,5848,14377,1296,3413,2068,4522,3364,7935
411573,202306,949,2345,683,1813,91,308,396,922,487,1230
411575,202306,2525,6170,1540,4146,295,858,546,1307,841,2165
411580,202306,5383,12483,2579,7178,347,1086,491,1007,838,2093
411585,202306,713,2011,272,851,37,117,33,79,70,196
411590,202306,597,1471,354,939,44,143,176,385,220,528
411600,202306,423,973,201,538,31,76,80,176,111,252
411605,202306,1959,4193,990,2480,121,373,469,1143,590,1516
411610,202306,3597,7267,2178,4671,67,199,1615,3070,1682,3269
411620,202306,3752,8726,2749,6940,573,1452,1182,2902,1755,4354
411630,202306,1088,2567,581,1545,77,255,272,590,349,845
411640,202306,563,1417,293,776,39,105,111,249,150,354
411650,202306,242,641,129,382,21,62,42,97,63,159
411660,202306,1043,2511,577,1532,91,247,220,479,311,726
411670,202306,1907,4178,1070,2599,111,289,572,1214,683,1503
411680,202306,1700,4163,1047,2836,216,616,376,898,592,1514
411690,202306,5005,11699,2899,7523,582,1501,1009,2362,1591,3863
411695,202306,792,2190,450,1299,34,108,203,535,237,643
411700,202306,1989,4802,1077,2878,247,649,293,668,540,1317
411705,202306,3096,7603,2284,6073,349,971,1386,3573,1735,4544
411710,202306,2615,6165,1420,3670,290,767,488,1044,778,1811
411720,202306,1258,2939,671,1766,95,248,221,512,316,760
411721,202306,1206,2850,747,1935,156,400,212,501,368,901
411722,202306,1202,3168,561,1628,83,233,211,507,294,740
411725,202306,1567,4162,851,2617,212,727,169,411,381,1138
411727,202306,1777,4579,1014,2939,207,629,135,227,342,856
411729,202306,724,1751,347,981,89,303,91,175,180,478
411730,202306,6896,16521,4441,11484,1084,3055,1660,3903,2744,6958
411740,202306,572,1410,265,746,71,178,55,138,126,316
411745,202306,962,2550,498,1468,76,227,108,253,184,480
411750,202306,8385,19988,4894,12835,665,1837,2276,5394,2941,7231
411760,202306,9399,22192,5909,15843,1814,4969,1212,3183,3026,8152
411770,202306,3902,10423,2349,6732,530,1590,546,1322,1076,2912
411780,202306,3169,8222,2323,6601,617,1799,605,1753,1222,3552
411790,202306,3990,8882,2073,5212,288,808,820,1647,1108,2455
411800,202306,1418,3807,823,2270,155,477,234,524,389,1001
411810,202306,1888,4549,1089,2830,197,516,385,874,582,1390
411820,202306,22280,52431,16881,42258,3819,9563,8663,20480,12482,30043
411830,202306,569,1391,330,889,65,170,64,138,129,308
411840,202306,16128,39035,9025,23812,1448,4019,3545,7881,4993,11900
411845,202306,786,2078,371,1119,70,231,83,193,153,424
411850,202306,10124,24158,5459,14780,1527,4357,887,1742,2414,6099
411860,202306,937,2427,564,1592,133,357,114,291,247,648
411870,202306,723,1905,446,1267,124,405,101,205,225,610
411880,202306,2963,6485,1786,4374,325,804,771,1681,1096,2485
411885,202306,1276,3173,674,1869,107,324,181,421,288,745
411890,202306,1825,4543,1089,3033,201,579,140,364,341,943
411900,202306,1057,2699,511,1507,174,519,47,144,221,663
411910,202306,1420,3867,861,2631,161,535,296,749,457,1284
411915,202306,20756,47363,11867,29563,1751,4758,5145,10807,6896,15565
411920,202306,1478,3818,1026,2874,260,783,380,912,640,1695
411925,202306,603,1473,357,977,89,240,137,331,226,571
411930,202306,6395,17190,4616,13474,2296,6821,512,1594,2808,8415
411940,202306,4100,10783,2727,7678,646,1833,952,2292,1598,4125
411950,202306,20160,48637,14260,37080,1758,5166,8222,19065,9980,24231
411960,202306,7356,17835,4784,12469,1000,2851,1932,4281,2932,7132
411965,202306,639,1617,356,988,59,166,150,347,209,513
411970,202306,1442,2920,853,1932,155,269,396,995,551,1264
411980,202306,2096,4500,1235,3012,291,669,446,1031,737,1700
411990,202306,50497,121306,28737,78201,5403,15658,11541,27458,16944,43116
411995,202306,6438,14322,4302,10685,1243,3382,1242,2756,2485,6138
412000,202306,2459,5102,1492,3304,69,199,1101,2154,1170,2353
412010,202306,758,2096,366,1087,42,139,117,267,159,406
412015,202306,609,1595,439,1248,98,293,192,532,290,825
412020,202306,564,1508,290,924,39,134,85,224,124,358
412030,202306,776,2012,530,1516,93,237,243,636,336,873
412033,202306,1118,2745,548,1477,61,162,248,584,309,746
412035,202306,854,2168,438,1305,84,233,171,456,255,689
412040,202306,856,2127,389,1063,66,186,135,295,201,481
412050,202306,1752,4149,1019,2720,280,797,195,481,475,1278
412060,202306,8956,23270,6026,16936,1642,5177,1656,3939,3298,9116
412065,202306,747,1866,415,1150,76,226,123,285,199,511
412070,202306,1660,3858,1061,2638,114,316,542,1088,656,1404
412080,202306,3464,8187,2140,5366,253,685,1158,2414,1411,3099
412085,202306,402,977,127,389,23,80,35,88,58,168
412090,202306,8072,18533,4979,12831,1088,3113,2140,5127,3228,8240
412100,202306,2322,5700,1438,4045,415,1252,274,778,689,2030
412110,202306,1165,2886,586,1652,88,253,161,367,249,620
412120,202306,2899,7371,1932,5450,409,1255,585,1396,994,2651
412125,202306,979,2576,463,1376,78,227,112,290,190,517
412130,202306,955,2250,500,1333,111,305,122,294,233,599
412135,202306,656,1664,277,807,33,117,123,290,156,407
412140,202306,2478,5656,1412,3580,259,674,333,789,592,1463
412150,202306,3368,7969,2366,5968,543,1428,1104,2394,1647,3822
412160,202306,1142,3340,437,1441,41,141,35,72,76,213
412170,202306,5756,13973,4221,11046,836,2320,2009,4603,2845,6923
412175,202306,1598,4250,1133,3247,249,719,366,998,615,1717
412180,202306,2090,5375,1245,3566,230,728,425,1020,655,1748
412190,202306,3848,9222,2246,6041,310,934,933,2201,1243,3135
412200,202306,2403,6332,1435,4099,383,1175,256,598,639,1773
412210,202306,791,1801,408,1085,61,171,188,439,249,610
412215,202306,4070,9999,2560,7014,535,1544,1065,2819,1600,4363
412217,202306,1241,2855,896,2195,23,71,674,1495,697,1566
412220,202306,7622,20444,4787,14114,1125,3274,1079,2942,2204,6216
412230,202306,3473,9175,2059,5948,343,1126,485,1136,828,2262
412240,202306,10155,24839,5193,14251,954,2843,1619,3529,2573,6372
412250,202306,2334,5692,1398,3792,370,1045,244,536,614,1581
412260,202306,1674,3977,904,2271,155,398,323,690,478,1088
412265,202306,1298,3054,869,2259,108,311,514,1199,622,1510
412270,202306,1370,3511,750,2092,84,254,311,706,395,960
412280,202306,520,1346,319,911,62,160,77,200,139,360
412290,202306,1297,3001,807,2058,139,360,331,754,470,1114
412300,202306,2276,5331,1361,3536,269,732,441,960,710,1692
412310,202306,778,2136,447,1401,73,238,127,339,200,577
412320,202306,868,2108,460,1266,55,183,171,415,226,598
412330,202306,1957,4788,1090,3045,218,637,288,731,506,1368
412340,202306,1519,3813,859,2400,138,424,101,254,239,678
412350,202306,3786,9521,1927,5507,322,1009,562,1274,884,2283
412360,202306,354,839,215,558,11,38,141,319,152,357
412370,202306,1482,3646,782,2162,150,438,187,461,337,899
412380,202306,1790,4644,1018,2927,246,751,71,194,317,945
412382,202306,617,1435,355,931,35,111,184,397,219,508
412385,202306,2894,6889,1969,5080,608,1546,610,1588,1218,3134
412390,202306,3044,6938,1747,4463,362,932,532,1220,894,2152
412395,202306,930,2313,550,1465,70,186,277,673,347,859
412400,202306,1154,2771,692,1841,114,332,245,524,359,856
412402,202306,3014,6918,1618,4256,353,921,526,1331,879,2252
412405,202306,3741,9469,1943,5723,563,1612,336,881,899,2493
412410,202306,8183,19849,4856,13508,928,2847,1616,3962,2544,6809
412420,202306,638,1502,319,826,35,104,122,272,157,376
412430,202306,636,1549,261,713,53,137,94,246,147,383
412440,202306,3677,8840,2119,5692,471,1258,677,1683,1148,2941
412450,202306,671,1813,352,1021,39,119,49,99,88,218
412460,202306,1454,3297,900,2227,185,486,384,871,569,1357
412470,202306,1942,5464,1455,4367,351,1131,418,1091,769,2222
412480,202306,1755,4023,933,2294,176,462,351,710,527,1172
412490,202306,1607,3624,995,2434,65,192,601,1264,666,1456
412500,202306,2524,5868,1443,3687,254,689,480,1018,734,1707
412510,202306,2303,6428,1469,4427,363,1191,220,468,583,1659
412520,202306,1705,4074,832,2250,149,403,108,252,257,655
412530,202306,835,2125,457,1296,96,251,109,280,205,531
412535,202306,962,2420,465,1335,87,273,61,116,148,389
412540,202306,1244,3113,755,2160,157,557,138,309,295,866
412545,202306,864,2100,453,1244,79,228,149,369,228,597
412550,202306,48095,116331,28526,74184,4042,11581,13447,29938,17489,41519
412555,202306,353,846,165,423,20,61,61,112,81,173
412560,202306,6787,17374,4140,11337,1087,3255,775,1700,1862,4955
412570,202306,5309,12249,2764,7273,502,1484,701,1466,1203,2950
412575,202306,1432,3234,951,2301,282,648,374,777,656,1425
412580,202306,1948,4487,1089,2753,113,287,619,1386,732,1673
412590,202306,554,1382,251,720,51,151,34,63,85,214
412600,202306,2121,4910,1439,3525,99,312,945,2038,1044,2350
412610,202306,1016,2545,565,1516,92,237,229,509,321,746
412620,202306,1609,3796,1081,2810,211,583,489,1115,700,1698
412625,202306,12066,29899,6522,18174,1317,3904,1249,2796,2566,6700
412627,202306,1365,3559,766,2257,173,538,174,436,347,974
412630,202306,3302,9049,1820,5513,320,1036,402,1008,722,2044
412635,202306,602,1463,298,820,47,141,96,208,143,349
412640,202306,1190,3009,561,1580,85,245,113,229,198,474
412650,202306,2067,5210,1299,3525,227,671,487,1129,714,1800
412660,202306,3544,8232,2133,5371,270,753,871,1854,1141,2607
412665,202306,523,1210,332,853,73,189,113,255,186,444
412667,202306,2065,5146,1278,3505,230,716,495,1236,725,1952
412670,202306,1158,2475,652,1560,110,319,303,598,413,917
412680,202306,2657,6519,1350,3745,177,579,426,904,603,1483
412690,202306,1409,3352,798,2080,154,440,286,595,440,1035
412700,202306,2157,5317,1504,3980,355,1015,666,1588,1021,2603
412710,202306,6636,17583,3929,11298,713,2227,1103,2441,1816,4668
412720,202306,1671,4437,1093,3069,181,537,314,666,495,1203
412730,202306,3401,8124,2050,5278,316,931,1027,2272,1343,3203
412740,202306,2460,6383,1362,4024,238,786,255,700,493,1486
412750,202306,4839,11930,3295,8921,467,1394,1686,4065,2153,5459
412760,202306,3970,9559,2801,7306,539,1534,1412,3300,1951,4834
412770,202306,15418,37821,6826,19680,895,2789,1773,4087,2668,6876
412780,202306,1563,3745,965,2568,251,756,289,603,540,1359
412785,202306,2748,5878,1684,4058,250,689,1015,2197,1265,2886
412788,202306,1732,4488,1194,3414,333,941,412,1050,745,1991
412790,202306,1690,4091,871,2376,139,435,364,775,503,1210
412795,202306,1489,3568,653,1858,135,343,153,405,288,748
412796,202306,2709,7221,1863,5381,439,1263,529,1362,968,2625
412800,202306,5251,11360,3135,7284,301,878,1765,3450,2066,4328
412810,202306,17088,40086,9198,23661,1079,3072,4247,9263,5326,12335
412820,202306,7787,19881,4581,12984,1171,3428,1111,2888,2282,6316
412830,202306,417,1101,235,665,38,113,85,194,123,307
412840,202306,2485,5224,1586,3505,131,344,1051,2016,1182,2360
412850,202306,3375,8094,2243,6011,265,841,1185,2765,1450,3606
412853,202306,1982,4383,1408,3221,175,470,836,1655,1011,2125
412855,202306,1666,4027,705,1932,99,284,172,366,271,650
412860,202306,955,2236,533,1442,106,328,205,471,311,799
412862,202306,785,1904,450,1258,77,220,197,484,274,704
412863,202306,1605,4282,1237,3484,250,795,590,1421,840,2216
412865,202306,784,2028,505,1421,126,367,102,250,228,617
412870,202306,1210,2887,716,1975,226,665,177,437,403,1102
412880,202306,1182,3002,723,2088,151,433,245,635,396,1068
420005,202306,566,1554,275,838,33,102,123,341,156,443
420010,202306,3679,8440,2153,5688,143,429,1437,3613,1580,4042
420020,202306,518,1520,344,1079,66,227,100,250,166,477
420030,202306,172,571,106,391,30,105,23,69,53,174
420040,202306,718,2090,332,1116,57,214,29,72,86,286
420050,202306,965,2280,526,1340,89,252,279,594,368,846
420055,202306,220,602,104,307,16,50,46,115,62,165
420060,202306,282,732,197,538,28,77,98,236,126,313
420070,202306,1100,2999,771,2294,140,458,404,1086,544,1544
420075,202306,98,257,50,141,6,17,20,43,26,60
420080,202306,522,1435,293,847,63,188,68,165,131,353
420090,202306,563,1616,311,1005,69,240,74,183,143,423
420100,202306,1844,4148,1295,3158,115,270,817,1905,932,2175
420110,202306,383,1122,280,876,46,140,133,389,179,529
420120,202306,843,2201,459,1327,68,215,195,449,263,664
420125,202306,476,1386,279,899,56,173,75,186,131,359
420127,202306,394,1035,139,442,11,36,51,144,62,180
420130,202306,6606,17102,4205,12102,819,2610,1605,3749,2424,6359
420140,202306,6228,15438,4009,11032,1046,3151,1061,2428,2107,5579
420150,202306,875,2185,521,1448,59,193,248,603,307,796
420160,202306,260,626,88,249,11,37,31,85,42,122
420165,202306,218,635,94,305,10,42,26,65,36,107
420170,202306,452,1246,314,930,35,123,172,437,207,560
420180,202306,178,550,84,304,16,68,18,56,34,124
420190,202306,260,720,127,387,20,62,31,80,51,142
420195,202306,2684,6460,1783,4733,303,920,931,2173,1234,3093
420200,202306,10763,23856,5861,14246,754,2067,2686,5261,3440,7328
420205,202306,2793,6848,1614,4436,231,680,788,1905,1019,2585
420207,202306,2959,7044,1714,4640,343,1017,658,1518,1001,2535
420208,202306,451,1216,218,683,73,243,53,116,126,359
420209,202306,227,666,118,363,18,64,57,148,75,212
420210,202306,6063,14562,3737,10072,603,1776,1796,4263,2399,6039
420213,202306,988,2737,697,2071,136,429,251,682,387,1111
420215,202306,304,828,172,510,44,141,44,116,88,257
420220,202306,447,1266,237,767,43,170,90,230,133,400
420230,202306,8313,20216,5401,14206,751,2153,2857,6560,3608,8713
420240,202306,21059,54721,11334,31408,1517,4689,4819,10647,6336,15336
420243,202306,638,1487,464,1159,76,213,280,656,356,869
420245,202306,2785,6510,1879,4780,180,514,1116,2514,1296,3028
420250,202306,893,1945,668,1556,54,162,469,977,523,1139
420253,202306,564,1318,338,901,50,125,193,486,243,611
420257,202306,211,512,122,347,16,53,60,159,76,212
420260,202306,1596,3712,1039,2803,76,244,688,1730,764,1974
420270,202306,778,1956,297,785,41,107,135,315,176,422
420280,202306,2072,5450,1346,3774,195,641,583,1392,778,2033
420285,202306,192,533,99,299,18,60,18,34,36,94
420287,202306,572,1256,318,813,47,141,139,311,186,452
420290,202306,7438,19357,4724,13051,701,2167,2385,5597,3086,7764
420300,202306,10408,27532,4801,13971,915,2742,1501,3653,2416,6395
420310,202306,930,2060,477,1217,39,103,200,442,239,545
420315,202306,1166,3026,605,1832,74,236,269,710,343,946
420320,202306,8830,22215,5651,16167,1503,4428,1475,3816,2978,8244
420325,202306,419,1145,244,744,36,125,81,192,117,317
420330,202306,1400,3859,737,2279,157,494,194,527,351,1021
420340,202306,1684,3904,1085,2719,234,628,486,1027,720,1655
420350,202306,1782,3923,1204,2884,129,303,793,1775,922,2078
420360,202306,3796,9992,1676,5125,272,901,157,415,429,1316
420370,202306,1845,4357,1366,3469,108,349,964,2222,1072,2571
420380,202306,5808,14305,3491,9530,630,1895,1523,3614,2153,5509
420390,202306,1454,3554,827,2184,132,377,281,520,413,897
420395,202306,1750,4551,993,2880,152,462,202,441,354,903
420400,202306,1544,3828,879,2420,118,354,475,1154,593,1508
420410,202306,752,1863,432,1180,64,188,213,538,277,726
420415,202306,444,1179,272,771,47,155,118,298,165,453
420417,202306,789,2201,502,1528,111,316,206,624,317,940
420419,202306,155,503,102,357,33,123,7,31,40,154
420420,202306,20494,50289,11892,32665,2949,8809,3424,7745,6373,16554
420425,202306,818,2168,480,1390,56,179,224,568,280,747
420430,202306,4455,11170,2339,6513,355,1135,956,2161,1311,3296
420435,202306,455,1134,226,666,48,138,113,320,161,458
420440,202306,1063,2630,580,1557,199,491,158,410,357,901
420445,202306,287,682,155,417,26,76,46,90,72,166
420450,202306,1140,3104,670,1970,127,390,263,631,390,1021
420455,202306,2713,6084,1693,4269,480,1138,575,1466,1055,2604
420460,202306,13332,32563,8602,22951,1250,3764,4381,10027,5631,13791
420470,202306,881,2239,411,1128,61,176,134,274,195,450
420475,202306,91,235,34,109,7,27,9,24,16,51
420480,202306,7297,17166,4009,10820,766,2132,1614,3995,2380,6127
420490,202306,510,1373,285,829,44,136,129,328,173,464
420500,202306,1732,4449,1004,3002,192,678,433,1109,625,1787
420510,202306,161,457,89,264,16,56,31,63,47,119
420515,202306,177,504,94,284,15,58,32,69,47,127
420517,202306,927,2189,650,1604,90,235,359,819,449,1054
420519,202306,372,956,214,631,27,87,101,286,128,373
420520,202306,350,912,155,496,18,69,3,7,21,76
420530,202306,952,2796,479,1543,91,326,150,379,241,705
420535,202306,278,777,81,265,11,40,22,53,33,93
420540,202306,55439,124751,32274,80212,4347,12229,13740,27730,18087,39959
420543,202306,318,867,184,544,26,89,73,182,99,271
420545,202306,2087,5935,1293,3952,231,741,494,1252,725,1993
420550,202306,5634,13607,2856,7931,481,1394,1087,2609,1568,4003
420555,202306,427,1156,242,732,32,108,117,310,149,418
420560,202306,549,1186,327,813,43,96,160,390,203,486
420570,202306,4219,9922,2748,7008,448,1221,1397,3186,1845,4407
420580,202306,2287,6134,1270,3984,271,906,344,922,615,1828
420590,202306,4233,10862,2356,6624,398,1219,678,1481,1076,2700
420600,202306,1841,4607,1253,3359,104,361,813,1963,917,2324
420610,202306,787,2008,442,1264,84,226,204,533,288,759
420620,202306,1099,2701,602,1710,106,315,232,592,338,907
420630,202306,1466,4176,915,2787,162,532,356,952,518,1484
420640,202306,606,1617,240,772,40,127,12,26,52,153
420650,202306,4793,11728,2717,7201,425,1246,1163,2543,1588,3789
420660,202306,580,1426,267,732,49,142,43,82,92,224
420665,202306,922,2241,472,1286,84,242,173,358,257,600
420670,202306,1544,4229,737,2328,77,300,136,291,213,591
420675,202306,277,690,154,462,13,44,92,242,105,286
420680,202306,338,764,155,448,21,76,78,195,99,271
420690,202306,1243,3385,672,1977,106,317,229,513,335,830
420700,202306,4296,10584,2871,7725,244,746,1843,4541,2087,5287
420710,202306,1408,3821,1063,3022,142,442,555,1320,697,1762
420720,202306,1728,4335,1159,3178,174,533,672,1654,846,2187
420730,202306,4915,11931,3325,8815,608,1769,1482,3426,2090,5195
420740,202306,526,1461,266,826,60,198,75,212,135,410
420750,202306,2946,8052,1640,4876,284,948,529,1281,813,2229
420757,202306,151,387,63,207,7,24,23,69,30,93
420760,202306,466,1291,184,548,38,104,58,155,96,259
420765,202306,785,2095,327,985,50,168,143,397,193,565
420768,202306,1815,4569,1279,3483,161,400,786,2050,947,2450
420770,202306,276,810,103,371,11,51,15,34,26,85
420775,202306,381,977,197,601,34,92,66,185,100,277
420780,202306,1269,3389,597,1753,128,373,104,263,232,636
420785,202306,288,705,160,411,6,21,83,166,89,187
420790,202306,1446,3836,1020,2887,200,715,565,1327,765,2042
420800,202306,993,2293,505,1354,130,354,225,546,355,900
420810,202306,1819,5060,1348,4036,304,1015,548,1350,852,2365
420820,202306,19072,45524,11848,31652,1634,4708,5762,13405,7396,18113
420830,202306,6832,16622,4198,11428,808,2440,1639,3943,2447,6383
420840,202306,776,2319,324,1116,55,222,33,82,88,304
420845,202306,4030,9715,2438,6726,467,1493,1020,2530,1487,4023
420850,202306,1329,3818,852,2601,162,536,271,643,433,1179
420860,202306,474,1222,253,774,81,258,62,151,143,409
420870,202306,1018,2715,595,1774,118,375,184,473,302,848
420880,202306,1597,4418,1077,3251,239,791,413,1055,652,1846
420890,202306,10337,26667,5447,15811,897,2798,1828,4331,2725,7129
420895,202306,247,684,119,355,14,38,55,145,69,183
420900,202306,2245,5244,1063,2940,135,453,433,931,568,1384
420910,202306,47340,117004,27637,76077,4391,13397,11949,27340,16340,40737
420915,202306,579,1974,441,1615,75,279,193,677,268,956
420917,202306,608,1485,228,589,39,79,115,282,154,361
420920,202306,118,310,36,116,6,20,6,13,12,33
420930,202306,24428,56670,15315,39057,2088,6007,8173,18105,10261,24112
420940,202306,4967,11474,2833,7427,616,1827,897,1767,1513,3594
420945,202306,261,789,115,362,15,57,43,108,58,165
420950,202306,538,1422,301,875,48,156,98,238,146,394
420960,202306,1403,3291,793,2059,139,397,327,699,466,1096
420970,202306,2876,7313,1690,4921,356,1035,455,1291,811,2326
420980,202306,311,1021,225,803,67,253,28,87,95,340
420985,202306,475,1239,196,617,31,97,46,116,77,213
420990,202306,474,1358,251,794,44,135,47,119,91,254
421000,202306,744,2164,424,1369,108,339,65,145,173,484
421003,202306,533,1286,121,349,14,36,10,23,24,59
421005,202306,139,400,84,262,15,52,24,67,39,119
421010,202306,5076,12474,3176,8634,510,1593,1294,2775,1804,4368
421020,202306,508,1512,336,1085,52,195,170,464,222,659
421030,202306,1356,3539,922,2596,170,519,348,860,518,1379
421040,202306,862,2046,428,1212,47,142,235,599,282,741
421050,202306,1591,4135,833,2305,153,454,262,551,415,1005
421055,202306,180,509,95,287,15,52,46,119,61,171
421060,202306,952,2551,595,1736,94,298,253,618,347,916
421070,202306,862,2354,451,1347,80,250,198,505,278,755
421080,202306,653,1765,422,1240,69,241,167,402,236,643
421085,202306,397,1101,121,408,13,40,18,48,31,88
421090,202306,380,955,173,453,17,63,79,165,96,228
421100,202306,1103,2353,422,1162,57,170,89,190,146,360
421105,202306,2013,5037,1085,3051,226,615,351,886,577,1501
421110,202306,1677,3972,1161,3015,136,419,708,1673,844,2092
421120,202306,1446,4086,859,2661,125,425,282,694,407,1119
421125,202306,515,1245,316,810,64,174,118,253,182,427
421130,202306,8893,23183,6422,17835,1159,3484,2986,7294,4145,10778
421140,202306,439,1149,243,709,55,142,80,213,135,355
421145,202306,448,1198,284,816,91,268,57,138,148,406
421150,202306,1000,2674,579,1682,112,363,215,465,327,828
421160,202306,873,2242,575,1564,64,209,321,732,385,941
421165,202306,296,826,140,409,22,62,42,90,64,152
421170,202306,1576,3881,1101,2910,101,296,684,1662,785,1958
421175,202306,1408,3504,734,2164,159,510,289,760,448,1270
421180,202306,507,1221,242,660,33,105,114,241,147,346
421185,202306,399,972,245,650,42,125,103,212,145,337
421187,202306,307,938,127,430,24,75,52,169,76,244
421189,202306,530,1391,320,940,53,172,118,306,171,478
421190,202306,19955,49813,13027,35038,2227,6551,5906,13727,8133,20278
421200,202306,1053,2640,653,1783,83,266,341,834,424,1100
421205,202306,317,810,199,561,40,105,77,218,117,323
421210,202306,1391,3357,651,1896,187,526,154,408,341,934
421220,202306,1785,4822,1223,3598,288,879,369,938,657,1817
421223,202306,538,1295,304,826,51,156,143,341,194,497
421225,202306,1430,3724,1071,3023,110,378,667,1728,777,2106
421227,202306,893,2378,457,1388,91,290,157,438,248,728
421230,202306,826,2093,504,1430,87,264,208,535,295,799
421240,202306,345,975,131,447,18,82,34,84,52,166
421250,202306,3512,8401,2247,6030,343,938,1258,3126,1601,4064
421260,202306,337,1037,64,181,11,32,11,25,22,57
421265,202306,1281,2835,908,2202,98,231,583,1318,681,1549
421270,202306,479,1241,214,700,54,180,71,210,125,390
421280,202306,3610,8783,2362,6409,374,1177,1132,2640,1506,3817
421290,202306,1437,3739,544,1547,80,233,88,211,168,444
421300,202306,420,1111,134,426,19,56,25,57,44,113
421310,202306,310,826,194,562,62,187,54,130,116,317
421315,202306,426,1101,206,605,38,118,59,146,97,264
421320,202306,799,2422,324,1030,28,89,50,81,78,170
421330,202306,782,2166,424,1312,82,255,116,307,198,562
421335,202306,534,1520,358,1127,47,162,157,446,204,608
421340,202306,1809,4800,959,3027,154,500,365,990,519,1490
421350,202306,2255,5351,1239,3404,255,692,394,973,649,1665
421360,202306,2721,6898,1456,4240,375,1290,419,795,794,2085
421370,202306,972,2969,526,1761,89,316,123,337,212,653
421380,202306,1092,2539,787,1976,73,250,499,1103,572,1353
421390,202306,200,526,70,232,14,45,20,61,34,106
421400,202306,832,2116,437,1248,75,230,172,401,247,631
421410,202306,243,629,117,361,30,82,20,66,50,148
421415,202306,247,651,147,397,23,68,49,119,72,187
421420,202306,772,2024,431,1233,65,186,189,442,254,628
421430,202306,124,366,66,207,11,39,14,30,25,69
421440,202306,888,2287,426,1278,83,253,153,404,236,657
421450,202306,498,1505,285,963,45,164,25,93,70,257
421460,202306,387,1176,181,655,10,33,14,28,24,61
421470,202306,486,1319,256,794,43,119,78,239,121,358
421480,202306,4259,10833,2566,7051,364,1152,1114,2563,1478,3715
421490,202306,149,452,73,238,10,49,21,57,31,106
421500,202306,3242,8666,1891,5604,358,1134,656,1529,1014,2663
421505,202306,416,1042,299,842,27,78,151,395,178,473
421507,202306,542,1352,268,733,48,125,83,190,131,315
421510,202306,592,1573,313,926,41,142,138,296,179,438
421520,202306,572,1486,271,753,41,115,88,191,129,306
421530,202306,416,1209,203,706,30,125,40,87,70,212
421535,202306,572,1429,299,825,44,128,149,343,193,471
421540,202306,478,1083,217,600,26,75,77,196,103,271
421545,202306,873,2443,556,1719,104,330,197,502,301,832
421550,202306,2884,7239,1838,5084,331,1001,804,1960,1135,2961
421555,202306,286,788,65,206,13,45,8,17,21,62
421560,202306,129,404,75,252,12,42,20,52,32,94
421565,202306,1331,3271,811,2267,196,588,342,847,538,1435
421567,202306,578,1670,381,1143,94,288,105,303,199,591
421568,202306,397,1120,164,527,34,120,48,125,82,245
421569,202306,183,497,64,185,14,46,27,58,41,104
421570,202306,2127,5632,1291,3669,218,685,513,1186,731,1871
421575,202306,409,1157,225,653,26,75,86,207,112,282
421580,202306,6779,17258,3442,9605,518,1590,1368,3059,1886,4649
421590,202306,251,667,178,505,38,117,71,176,109,293
421600,202306,793,1940,414,1088,47,134,202,427,249,561
421605,202306,874,2196,530,1522,107,320,194,499,301,819
421610,202306,1284,3214,718,2017,137,423,284,710,421,1133
421620,202306,5172,12701,3291,9087,666,2089,1344,3148,2010,5237
421625,202306,159,437,77,220,10,28,26,55,36,83
421630,202306,3769,9436,2017,5708,326,987,561,1276,887,2263
421635,202306,577,1470,342,946,28,91,195,458,223,549
421640,202306,953,2336,655,1838,171,485,308,813,479,1298
421650,202306,3646,9025,2162,6107,411,1265,704,1722,1115,2987
421660,202306,17237,43650,11104,30792,1560,4912,5500,13168,7060,18080
421670,202306,1173,3114,669,1866,132,397,259,614,391,1011
421680,202306,2335,4779,1713,3705,141,370,1251,2444,1392,2814
421690,202306,1953,5438,1117,3472,227,748,250,629,477,1377
421700,202306,774,2227,386,1226,53,183,85,201,138,384
421710,202306,267,804,121,391,17,61,46,135,63,196
421715,202306,215,515,142,341,24,74,79,146,103,220
421720,202306,2682,7001,1317,3846,289,877,332,717,621,1594
421725,202306,361,866,160,439,20,59,75,164,95,223
421730,202306,721,2015,333,950,48,139,149,359,197,498
421740,202306,1103,2917,575,1686,118,368,192,432,310,800
421750,202306,1259,2924,597,1629,136,404,188,423,324,827
421755,202306,202,543,77,235,16,48,26,62,42,110
421760,202306,1418,3448,720,1979,114,338,270,615,384,953
421770,202306,3269,8000,1971,5471,343,1025,727,1712,1070,2737
421775,202306,259,684,119,359,12,36,33,69,45,105
421780,202306,1234,3223,727,2077,113,333,295,693,408,1026
421790,202306,1174,2998,456,1367,86,251,132,323,218,574
421795,202306,312,911,136,431,21,76,34,98,55,174
421800,202306,4036,10425,2535,7290,449,1370,974,2430,1423,3800
421810,202306,734,1929,390,1162,50,182,174,469,224,651
421820,202306,1498,4045,757,2176,131,415,248,576,379,991
421825,202306,2088,4630,1524,3681,110,290,1032,2335,1142,2625
421830,202306,2527,6967,1597,4885,335,1078,369,1081,704,2159
421835,202306,321,744,193,485,25,74,122,284,147,358
421840,202306,488,1477,316,1016,61,209,90,242,151,451
421850,202306,504,1433,237,815,49,162,31,81,80,243
421860,202306,302,774,137,419,17,58,44,90,61,148
421870,202306,7460,17426,4669,11599,638,1883,2554,5240,3192,7123
421875,202306,397,1157,127,405,16,44,20,53,36,97
421880,202306,895,2377,459,1350,88,219,101,258,189,477
421885,202306,375,1023,167,515,25,88,44,117,69,205
421890,202306,1384,3506,922,2588,116,387,545,1322,661,1709
421895,202306,540,1319,382,1031,48,130,238,641,286,771
421900,202306,1442,3599,806,2092,124,356,352,730,476,1086
421910,202306,432,1248,180,613,26,90,34,89,60,179
421915,202306,479,1285,230,682,57,174,53,120,110,294
421917,202306,804,1797,365,1030,95,276,75,187,170,463
421920,202306,529,1498,312,974,78,236,78,227,156,463
421930,202306,4318,10294,2056,5678,381,1103,611,1354,992,2457
421935,202306,523,1472,379,1170,82,261,160,473,242,734
421940,202306,431,1201,154,447,29,88,52,122,81,210
421950,202306,4150,10253,2101,5962,380,1140,586,1325,966,2465
421960,202306,188,454,91,252,14,34,36,94,50,128
421970,202306,2710,6729,1322,3628,240,708,518,1145,758,1853
421985,202306,401,1066,222,642,22,69,102,276,124,345
422000,202306,2609,6158,1691,4515,132,413,1100,2756,1232,3169
430003,202306,797,1955,486,1365,66,184,255,686,321,870
430005,202306,463,1070,313,790,16,55,211,470,227,525
430010,202306,2289,4861,1488,3531,302,681,677,1554,979,2235
430020,202306,683,1470,445,1075,52,141,253,533,305,674
430030,202306,1242,2697,667,1578,95,233,392,802,487,1035
430040,202306,12208,26601,6699,16892,1773,4805,1947,4243,3720,9048
430045,202306,674,1450,416,1007,25,63,286,627,311,690
430047,202306,289,640,88,214,20,45,32,79,52,124
430050,202306,1044,2465,497,1353,98,253,159,390,257,643
430055,202306,308,698,125,325,18,44,57,128,75,172
430057,202306,114,261,43,120,11,24,11,30,22,54
430060,202306,28739,67457,20253,52316,3430,9420,10587,25133,14017,34553
430063,202306,824,2126,641,1767,134,366,353,935,487,1301
430064,202306,1397,3479,897,2498,201,596,387,987,588,1583
430066,202306,122,261,81,192,8,20,54,116,62,136
430070,202306,674,1697,139,405,24,79,19,39,43,118
430080,202306,1190,2850,540,1454,88,277,235,491,323,768
430085,202306,1151,2309,618,1463,111,265,263,611,374,876
430087,202306,1149,2675,685,1813,75,215,361,882,436,1097
430090,202306,555,1388,192,596,44,146,39,109,83,255
430100,202306,1404,3156,581,1458,80,216,240,519,320,735
430105,202306,1934,4437,1199,3123,162,488,646,1501,808,1989
430107,202306,209,553,95,272,14,40,29,70,43,110
430110,202306,2673,6133,1733,4419,314,844,834,1940,1148,2784
430120,202306,1489,3860,924,2487,155,405,416,1046,571,1451
430130,202306,4315,8890,2757,6469,1002,2287,535,1447,1537,3734
430140,202306,1287,3069,790,2103,130,363,373,935,503,1298
430150,202306,691,1706,337,994,75,228,88,235,163,463
430155,202306,261,613,91,249,13,34,26,51,39,85
430160,202306,28034,56688,19340,42892,1514,3805,13552,27813,15066,31618
430163,202306,4432,8780,2775,6261,73,253,2178,4521,2251,4774
430165,202306,399,997,103,310,15,36,9,21,24,57
430170,202306,1134,2777,300,941,75,271,49,93,124,364
430175,202306,1042,2361,819,1933,119,283,509,1161,628,1444
430180,202306,813,1923,483,1264,103,242,185,479,288,721
430185,202306,787,1915,307,888,77,214,57,134,134,348
430187,202306,1068,2074,674,1538,70,158,444,954,514,1112
430190,202306,1854,4224,1235,3135,248,637,558,1281,806,1918
430192,202306,132,331,39,106,8,22,13,29,21,51
430195,202306,526,1438,68,202,7,19,16,35,23,54
430200,202306,1381,3564,973,2748,261,766,173,492,434,1258
430205,202306,696,1339,563,1127,20,55,475,899,495,954
430210,202306,9322,22488,4351,11423,614,1732,1277,2614,1891,4346
430215,202306,447,994,234,580,29,90,110,233,139,323
430220,202306,699,1656,235,687,44,126,77,175,121,301
430222,202306,302,751,162,451,35,100,57,137,92,237
430223,202306,349,844,233,626,26,66,130,317,156,383
430225,202306,42,92,26,60,3,6,16,33,19,39
430230,202306,2708,6272,1927,4908,147,428,1317,3087,1464,3515
430235,202306,577,1439,288,807,48,138,69,146,117,284
430237,202306,659,1326,393,864,19,51,283,566,302,617
430240,202306,1661,3702,688,1795,97,266,283,589,380,855
430245,202306,905,2186,683,1782,139,343,349,934,488,1277
430250,202306,1339,3003,797,2023,235,622,211,466,446,1088
430258,202306,154,389,84,234,11,26,41,111,52,137
430260,202306,876,2030,495,1294,61,177,264,649,325,826
430265,202306,297,816,185,597,33,106,60,181,93,287
430270,202306,4220,8704,2943,6566,446,1022,1864,3889,2310,4911
430280,202306,6419,13299,3979,9057,621,1490,2121,4457,2742,5947
430290,202306,2742,5585,1986,4521,200,460,1412,3038,1612,3498
430300,202306,13718,29829,9086,21347,1282,3223,5335,11435,6617,14658
430310,202306,18349,41566,11104,27398,1413,3699,6379,14274,7792,17973
430320,202306,1096,2615,539,1504,51,154,293,752,344,906
430330,202306,755,1754,378,985,79,204,131,285,210,489
430340,202306,839,1717,496,1140,64,153,329,700,393,853
430350,202306,11099,24648,7404,17867,1014,2614,4400,9770,5414,12384
430355,202306,428,1137,113,342,29,83,13,26,42,109
430360,202306,1107,2528,573,1560,149,436,150,354,299,790
430367,202306,427,868,231,532,28,80,146,289,174,369
430370,202306,559,1478,178,527,39,108,53,126,92,234
430380,202306,756,1773,306,880,57,163,93,235,150,398
430390,202306,4431,10146,2301,5900,437,1164,294,525,731,1689
430400,202306,1284,2482,804,1741,108,293,480,913,588,1206
430410,202306,686,1442,458,1064,42,116,317,677,359,793
430420,202306,3723,8467,2572,6190,343,983,1480,3034,1823,4017
430430,202306,579,1394,206,599,43,130,29,79,72,209
430435,202306,2373,5339,1460,3627,259,666,702,1643,961,2309
430440,202306,6352,14503,4207,10305,431,1181,2604,5688,3035,6869
430450,202306,9981,20946,7277,16187,1098,2837,4259,8506,5357,11343
430460,202306,53302,118537,32719,81511,4822,12899,17068,39051,21890,51950
430461,202306,231,584,77,226,13,43,36,90,49,133
430462,202306,376,910,166,461,27,82,54,137,81,219
430463,202306,9437,22484,6218,16280,1136,3300,2968,7016,4104,10316
430465,202306,699,1555,412,1007,57,163,236,528,293,691
430466,202306,6266,13906,4377,10673,674,1764,2563,5627,3237,7391
430467,202306,636,1432,388,964,41,119,228,524,269,643
430468,202306,1862,4051,1284,3051,73,217,903,1952,976,2169
430469,202306,722,1919,103,299,11,33,33,65,44,98
430470,202306,7300,17299,4046,11032,992,3013,953,2065,1945,5078
430471,202306,996,2299,752,1845,75,199,501,1099,576,1298
430480,202306,807,2078,415,1179,62,200,123,263,185,463
430485,202306,209,508,85,224,18,40,24,49,42,89
430490,202306,599,1420,256,689,31,95,122,251,153,346
430495,202306,487,1249,267,808,43,134,121,328,164,462
430500,202306,1151,2731,687,1866,208,611,196,441,404,1052
430510,202306,35349,85363,21291,55511,3972,11322,8807,19379,12779,30701
430511,202306,393,1037,119,364,25,72,20,41,45,113
430512,202306,1264,2596,890,2019,197,474,368,767,565,1241
430513,202306,955,2120,429,1047,57,150,243,505,300,655
430515,202306,482,1181,279,762,47,129,128,327,175,456
430517,202306,1774,4420,1227,3248,253,624,641,1667,894,2291
430520,202306,1596,3795,772,2017,138,378,190,447,328,825
430530,202306,1089,2573,386,1087,70,209,115,285,185,494
430535,202306,4544,10486,2708,6924,384,1024,1330,3114,1714,4138
430537,202306,686,1501,546,1238,71,150,380,809,451,959
430540,202306,699,1606,358,973,60,166,170,443,230,609
430543,202306,1340,2274,697,1471,181,387,173,373,354,760
430544,202306,832,2188,502,1461,115,358,147,392,262,750
430545,202306,3072,7116,2026,5377,369,1002,1021,2505,1390,3507
430550,202306,480,1209,269,746,79,199,76,198,155,397
430558,202306,188,407,63,150,2,6,39,83,41,89
430560,202306,353,801,143,411,17,64,43,94,60,158
430570,202306,1010,2278,544,1318,113,321,240,455,353,776
430580,202306,929,2235,645,1745,157,398,214,607,371,1005
430583,202306,210,509,35,91,6,25,11,15,17,40
430585,202306,247,587,111,289,25,73,36,69,61,142
430587,202306,246,625,130,367,22,70,57,147,79,217
430590,202306,1623,3640,1085,2702,121,314,644,1495,765,1809
430593,202306,39,104,24,65,2,7,13,27,15,34
430595,202306,511,1271,94,286,14,32,16,35,30,67
430597,202306,558,1307,184,486,15,37,71,134,86,171
430600,202306,2337,5794,831,2324,138,396,158,404,296,800
430605,202306,1671,3918,1042,2722,149,401,508,1234,657,1635
430607,202306,838,1760,457,1056,57,117,275,605,332,722
430610,202306,7512,16140,4826,11820,1271,3412,1916,4056,3187,7468
430613,202306,305,684,66,176,14,40,17,37,31,77
430620,202306,1035,2262,636,1506,103,277,313,583,416,860
430630,202306,473,1254,139,400,28,84,37,87,65,171
430632,202306,505,1254,155,444,27,73,56,140,83,213
430635,202306,681,1404,437,965,64,125,284,608,348,733
430637,202306,631,1398,403,1000,47,129,253,568,300,697
430640,202306,1357,3534,662,1951,88,268,218,493,306,761
430642,202306,437,1134,209,600,35,100,84,210,119,310
430645,202306,191,435,78,207,16,42,21,43,37,85
430650,202306,2230,5471,1547,4309,446,1176,560,1669,1006,2845
430655,202306,399,912,187,471,22,63,107,221,129,284
430660,202306,6668,15072,4348,10925,710,1982,2264,5165,2974,7147
430670,202306,710,1592,407,1010,81,193,185,433,266,626
430673,202306,590,1275,228,613,58,144,75,177,133,321
430675,202306,286,803,55,184,9,31,11,37,20,68
430676,202306,7632,17123,5352,13190,878,2260,3017,6996,3895,9256
430680,202306,1522,3632,771,2095,206,599,233,432,439,1031
430690,202306,4184,9575,2935,7256,940,2429,1106,2539,2046,4968
430692,202306,243,669,172,543,9,31,115,345,124,376
430693,202306,1108,2761,548,1587,127,367,127,336,254,703
430695,202306,478,1114,256,634,43,119,147,315,190,434
430697,202306,642,1448,427,1087,51,144,265,634,316,778
430700,202306,10260,23493,5232,13535,1153,3204,1278,2605,2431,5809
430705,202306,422,955,172,476,20,57,72,170,92,227
430710,202306,2525,4332,1542,3036,65,183,1254,2280,1319,2463
430720,202306,941,2157,429,1194,58,174,212,523,270,697
430730,202306,1136,2884,663,1886,122,351,254,653,376,1004
430740,202306,848,2145,373,1072,52,146,125,328,177,474
430745,202306,614,1341,394,911,47,163,265,501,312,664
430750,202306,2110,4777,1222,3090,238,617,609,1378,847,1995
430755,202306,567,1289,323,790,31,97,197,414,228,511
430760,202306,3263,7389,2088,5206,421,1072,953,2108,1374,3180
430770,202306,9769,21547,6750,16228,816,2107,4096,9068,4912,11175
430780,202306,2747,6337,1547,4111,200,593,785,1833,985,2426
430781,202306,832,1945,479,1177,152,394,181,379,333,773
430783,202306,424,920,246,624,59,153,119,269,178,422
430786,202306,42,127,23,83,5,18,4,6,9,24
430790,202306,6126,13746,3634,8921,384,1115,2091,4339,2475,5454
430800,202306,1086,2105,720,1548,44,115,545,1076,589,1191
430805,202306,481,1048,305,696,12,27,232,486,244,513
430807,202306,739,1710,360,977,53,145,140,309,193,454
430810,202306,898,2058,378,985,61,176,147,307,208,483
430820,202306,1721,4469,793,2296,133,384,237,562,370,946
430825,202306,318,718,113,254,15,31,51,101,66,132
430830,202306,2556,5657,1808,4218,110,263,1328,2846,1438,3109
430840,202306,1487,3190,897,2193,143,345,535,1251,678,1596
430843,202306,236,550,89,242,10,25,30,71,40,96
430845,202306,641,1347,379,886,52,142,219,439,271,581
430850,202306,2991,7254,1711,4720,478,1398,390,939,868,2337
430860,202306,1504,3498,666,1770,91,287,274,575,365,862
430865,202306,737,1670,404,1057,110,309,158,348,268,657
430870,202306,617,1588,208,624,40,109,42,116,82,225
430880,202306,1850,3781,1184,2671,134,345,750,1525,884,1870
430885,202306,223,554,121,332,20,53,60,155,80,208
430890,202306,1356,3174,678,1871,169,546,64,113,233,659
430900,202306,4367,8052,2461,5180,123,354,1779,3318,1902,3672
430905,202306,1129,2662,639,1675,113,299,248,601,361,900
430910,202306,2914,7264,1670,4393,235,697,739,1591,974,2288
430912,202306,652,1704,360,1058,66,187,164,476,230,663
430915,202306,618,1641,347,1042,89,282,83,241,172,523
430920,202306,36016,80675,24743,60092,3094,8068,15152,34056,18246,42124
430925,202306,106,219,45,111,6,15,20,47,26,62
430930,202306,15850,33199,9856,23049,1090,2846,6255,13171,7345,16017
430940,202306,1606,3755,946,2470,180,465,357,809,537,1274
430950,202306,1021,2038,589,1289,59,155,394,737,453,892
430955,202306,543,1354,125,332,19,51,35,59,54,110
430957,202306,248,694,207,603,38,106,102,299,140,405
430960,202306,1702,3790,798,2064,211,558,219,494,430,1052
430965,202306,1969,4097,1382,3169,58,144,1052,2347,1110,2491
430970,202306,446,1029,219,598,24,68,98,248,122,316
430975,202306,595,1535,407,1126,81,249,136,328,217,577
430980,202306,535,1160,264,665,35,93,114,251,149,344
430990,202306,711,1785,460,1256,70,200,200,507,270,707
430995,202306,665,1480,374,947,64,158,192,442,256,600
431000,202306,1741,3901,577,1595,84,242,62,126,146,368
431010,202306,3469,8299,2030,5453,359,1074,780,1688,1139,2762
431020,202306,11284,23254,5773,14010,953,2573,2656,5446,3609,8019
431030,202306,398,1037,178,555,37,138,25,73,62,211
431033,202306,5288,11609,3056,7683,713,1768,1147,2732,1860,4500
431036,202306,348,763,76,220,10,31,23,58,33,89
431040,202306,1067,2449,605,1566,69,233,373,821,442,1054
431041,202306,494,1109,279,716,45,116,111,228,156,344
431043,202306,446,1067,267,683,23,68,159,348,182,416
431046,202306,114,286,37,95,6,15,8,17,14,32
431050,202306,1514,3284,991,2385,168,409,531,1212,699,1621
431053,202306,874,2057,422,1147,84,236,148,332,232,568
431055,202306,760,1688,495,1218,62,150,324,773,386,923
431057,202306,222,649,116,363,23,78,40,120,63,198
431060,202306,7072,15741,4316,10877,1038,2827,1737,3804,2775,6631
431065,202306,573,1307,304,818,39,109,166,404,205,513
431070,202306,501,1233,233,640,47,135,70,198,117,333
431075,202306,332,804,165,436,25,83,86,181,111,264
431080,202306,824,2113,407,1157,60,182,129,295,189,477
431085,202306,950,2310,418,1124,67,177,173,446,240,623
431087,202306,486,1231,339,913,49,148,200,498,249,646
431090,202306,469,1057,139,406,22,66,40,109,62,175
431100,202306,5560,10631,3727,8092,379,910,2459,4873,2838,5783
431110,202306,1779,3800,1117,2566,152,393,636,1295,788,1688
431112,202306,780,1811,572,1427,73,214,356,808,429,1022
431113,202306,663,1526,476,1168,112,270,265,607,377,877
431115,202306,1377,3289,941,2482,94,320,617,1465,711,1785
431120,202306,3347,7719,1995,5084,449,1276,805,1729,1254,3005
431123,202306,421,1024,245,660,42,97,113,289,155,386
431125,202306,1493,3468,958,2480,219,587,525,1316,744,1903
431127,202306,294,723,54,157,9,31,12,26,21,57
431130,202306,4166,9356,2743,6834,479,1262,1373,3077,1852,4339
431140,202306,7562,17059,3832,9532,519,1393,1748,3504,2267,4897
431142,202306,818,1796,497,1221,60,143,317,730,377,873
431150,202306,1258,3029,837,2243,102,299,481,1199,583,1498
431160,202306,832,2026,475,1298,131,374,142,312,273,686
431162,202306,725,1691,386,1017,36,115,217,505,253,620
431164,202306,197,448,38,112,8,28,10,21,18,49
431170,202306,570,1397,362,976,97,259,77,176,174,435
431171,202306,1182,2320,879,1885,127,281,656,1352,783,1633
431173,202306,576,1371,377,1063,114,355,102,233,216,588
431175,202306,1629,3515,855,2115,127,304,419,959,546,1263
431177,202306,1173,2725,777,2035,159,474,394,935,553,1409
431179,202306,362,783,95,269,24,78,35,82,59,160
431180,202306,3048,7409,1497,4078,365,944,364,838,729,1782
431190,202306,725,1728,246,698,26,78,63,124,89,202
431198,202306,511,1359,390,1104,87,253,160,436,247,689
431200,202306,345,832,85,220,21,51,12,29,33,80
431205,202306,285,720,146,407,41,119,44,111,85,230
431210,202306,800,1724,551,1301,104,242,276,635,380,877
431213,202306,359,875,216,582,17,48,116,283,133,331
431215,202306,755,1710,284,784,33,95,123,301,156,396
431217,202306,204,480,122,324,25,66,40,95,65,161
431220,202306,779,1768,408,1050,104,268,183,411,287,679
431225,202306,1987,4090,1296,2909,142,336,877,1858,1019,2194
431230,202306,940,2309,553,1445,100,284,263,548,363,832
431235,202306,207,557,29,90,2,4,7,15,9,19
431237,202306,471,1301,295,899,37,115,135,383,172,498
431238,202306,44,139,31,106,5,23,10,21,15,44
431240,202306,6804,14950,4621,10904,480,1299,2811,5892,3291,7191
431242,202306,391,879,261,605,34,91,143,289,177,380
431244,202306,486,1141,197,510,49,111,62,140,111,251
431245,202306,1564,3406,836,2085,105,267,378,818,483,1085
431247,202306,347,792,166,426,20,57,64,128,84,185
431250,202306,2454,5342,1698,4133,338,858,903,2067,1241,2925
431260,202306,400,989,190,542,21,68,72,165,93,233
431261,202306,350,933,230,673,24,84,135,350,159,434
431262,202306,332,895,156,502,24,98,68,199,92,297
431265,202306,1912,4278,625,1660,135,403,159,304,294,707
431267,202306,278,657,158,417,25,74,83,197,108,271
431270,202306,3630,7384,1712,4131,479,1182,535,1173,1014,2355
431275,202306,192,492,97,256,15,48,56,131,71,179
431280,202306,332,875,123,374,26,80,28,71,54,151
431290,202306,450,1286,226,713,43,146,45,116,88,262
431295,202306,85,214,25,79,5,10,5,18,10,28
431300,202306,367,946,79,232,15,53,22,51,37,104
431301,202306,315,875,70,233,9,30,8,25,17,55
431303,202306,824,1893,414,1077,33,97,208,437,241,534
431306,202306,2892,6498,1321,3455,185,511,550,1184,735,1695
431308,202306,48,132,37,106,14,40,9,22,23,62
431310,202306,677,1594,364,929,64,136,175,418,239,554
431320,202306,823,2123,404,1173,68,213,128,285,196,498
431330,202306,2539,5573,1168,2936,163,457,586,1252,749,1709
431333,202306,243,613,109,314,22,58,28,75,50,133
431335,202306,46,132,25,85,8,25,3,12,11,37
431337,202306,5396,11175,3995,8889,185,528,3118,6452,3303,6980
431339,202306,561,1312,327,870,70,184,135,328,205,512
431340,202306,24648,55598,14780,37190,2124,5813,7605,16953,9729,22766
431342,202306,475,1042,295,729,44,114,189,441,233,555
431344,202306,443,1081,219,633,42,115,103,279,145,394
431346,202306,260,615,85,251,17,54,25,58,42,112
431349,202306,1249,2630,656,1487,102,252,387,777,489,1029
431350,202306,6250,14173,4191,10507,618,1644,2395,5424,3013,7068
431360,202306,680,1552,284,760,82,241,79,166,161,407
431365,202306,3031,5923,2080,4532,132,375,1642,3290,1774,3665
431370,202306,6668,14127,4190,9922,718,1884,2233,4788,2951,6672
431380,202306,1165,2846,814,2191,173,449,398,1038,571,1487
431390,202306,3281,7523,1695,4375,185,552,888,1906,1073,2458
431395,202306,2269,4615,1541,3463,161,377,1083,2272,1244,2649
431400,202306,366,970,150,455,22,63,31,79,53,142
431402,202306,1078,2224,690,1609,76,178,417,902,493,1080
431403,202306,234,626,157,455,27,85,52,121,79,206
431405,202306,7369,17286,4660,12057,816,2267,2171,4903,2987,7170
431406,202306,709,1798,416,1180,110,290,112,341,222,631
431407,202306,651,1613,354,982,66,174,124,314,190,488
431410,202306,25055,56105,15212,37876,1931,5591,8693,18782,10624,24373
431413,202306,301,823,60,174,7,21,18,35,25,56
431415,202306,915,2122,511,1369,104,309,189,414,293,723
431417,202306,682,1374,377,865,66,165,182,388,248,553
431420,202306,2130,4276,1415,3210,99,256,977,2027,1076,2283
431430,202306,679,1624,279,791,43,128,100,243,143,371
431440,202306,50642,103861,34686,77645,5316,13249,19768,38806,25084,52055
431442,202306,202,539,67,215,8,26,7,18,15,44
431445,202306,821,1917,450,1023,22,62,330,653,352,715
431446,202306,333,871,239,680,26,80,130,350,156,430
431447,202306,917,2200,432,1203,73,204,151,386,224,590
431449,202306,974,2241,518,1358,80,218,262,602,342,820
431450,202306,3227,5679,2225,4222,193,311,1679,3033,1872,3344
431454,202306,52,162,32,106,5,20,14,44,19,64
431455,202306,634,1418,277,702,39,83,128,306,167,389
431460,202306,4003,8330,2279,5265,458,1163,1092,2298,1550,3461
431470,202306,1710,4272,1041,2878,245,704,330,844,575,1548
431475,202306,300,793,46,145,5,18,6,8,11,26
431477,202306,589,1372,286,763,84,194,86,210,170,404
431478,202306,283,775,48,152,10,34,9,18,19,52
431480,202306,4133,9900,2586,6885,560,1479,893,2164,1453,3643
431490,202306,179224,368022,121919,273083,7401,20992,86977,175749,94378,196741
431500,202306,569,1313,336,864,56,138,155,370,211,508
431505,202306,287,626,166,416,19,50,105,245,124,295
431507,202306,341,782,115,338,34,103,20,47,54,150
431510,202306,2093,4956,1149,3046,396,1037,250,631,646,1668
431513,202306,255,538,116,285,24,80,39,62,63,142
431514,202306,154,362,93,234,9,17,51,111,60,128
431515,202306,675,1439,447,1025,96,222,219,466,315,688
431517,202306,88,239,55,160,7,26,28,79,35,105
431520,202306,428,993,160,434,27,78,67,139,94,217
431530,202306,6632,13666,3445,8419,728,1885,1498,3295,2226,5180
431531,202306,261,597,113,303,18,51,33,90,51,141
431532,202306,748,1560,390,928,75,183,181,406,256,589
431535,202306,351,877,131,366,25,67,27,66,52,133
431540,202306,2379,6264,1819,5251,129,464,1188,3216,1317,3680
431545,202306,435,1008,92,219,13,27,44,95,57,122
431550,202306,2866,6526,1713,4288,230,614,867,1932,1097,2546
431555,202306,855,1775,438,1035,37,99,251,565,288,664
431560,202306,33387,74323,19031,48859,3247,8540,8176,19723,11423,28263
431570,202306,6927,13593,5029,10584,469,1116,3430,6491,3899,7607
431575,202306,487,1063,319,752,53,127,178,359,231,486
431580,202306,822,1956,441,1128,44,125,220,458,264,583
431590,202306,1065,2701,565,1567,143,427,203,473,346,900
431595,202306,438,1093,227,648,48,149,82,194,130,343
431600,202306,2323,5363,1375,3630,226,680,532,1161,758,1841
431610,202306,1868,4044,987,2425,180,470,362,922,542,1392
431620,202306,576,1340,274,697,59,176,148,298,207,474
431630,202306,1572,3653,650,1798,153,447,181,428,334,875
431640,202306,8885,17890,6300,13979,818,1934,3990,8197,4808,10131
431642,202306,813,1727,392,932,73,177,181,365,254,542
431643,202306,461,1085,152,408,17,38,61,146,78,184
431645,202306,3104,5386,2229,4179,47,114,1868,3322,1915,3436
431647,202306,369,856,91,252,15,42,10,15,25,57
431650,202306,165,439,102,303,15,44,45,117,60,161
431660,202306,1011,2489,434,1268,71,221,97,229,168,450
431670,202306,1558,3429,758,1883,115,303,383,840,498,1143
431673,202306,254,641,88,282,12,48,27,68,39,116
431675,202306,436,1065,94,304,9,28,11,21,20,49
431680,202306,12961,28344,7744,18424,1516,3969,3172,6386,4688,10355
431690,202306,36105,78765,22912,54497,4168,10744,11940,25159,16108,35903
431695,202306,277,648,133,357,15,47,68,137,83,184
431697,202306,547,1173,353,844,59,132,187,433,246,565
431700,202306,1855,4031,1281,2985,212,449,663,1548,875,1997
431710,202306,19537,39524,12776,29298,1398,3672,8339,17703,9737,21375
431720,202306,8863,19685,4163,10554,1134,2991,781,1574,1915,4565
431725,202306,42,107,24,73,7,26,5,8,12,34
431730,202306,5814,12415,3462,8555,643,1742,1742,3804,2385,5546
431740,202306,6480,14490,3590,9254,772,2175,1137,2450,1909,4625
431750,202306,10912,25290,6287,16629,1560,4306,1991,4752,3551,9058
431755,202306,363,941,60,192,7,21,7,24,14,45
431760,202306,6718,14164,4032,9390,457,1292,2397,4787,2854,6079
431770,202306,2638,5365,1768,4049,344,715,1032,2314,1376,3029
431775,202306,291,678,115,312,18,57,41,85,59,142
431780,202306,2675,5961,1431,3594,269,732,443,970,712,1702
431790,202306,922,2329,509,1450,136,402,167,437,303,839
431795,202306,311,756,129,377,17,57,32,87,49,144
431800,202306,10317,22663,5496,14319,1606,4681,688,1456,2294,6137
431805,202306,318,802,47,168,3,9,0,0,3,9
431810,202306,3949,8293,2382,5477,406,1022,1331,2759,1737,3781
431820,202306,2746,6483,1815,4851,429,1218,755,1832,1184,3050
431830,202306,10834,22607,6600,15982,2043,5389,1142,2669,3185,8058
431840,202306,3640,8029,2565,6188,402,1003,1500,3375,1902,4378
431842,202306,602,1406,178,501,33,93,32,69,65,162
431843,202306,372,953,198,550,51,156,77,192,128,348
431844,202306,209,559,54,179,11,35,17,53,28,88
431845,202306,589,1393,327,851,27,78,189,466,216,544
431846,202306,375,813,278,652,17,51,219,468,236,519
431848,202306,176,443,66,193,9,24,14,29,23,53
431849,202306,422,1028,61,168,9,24,9,17,18,41
431850,202306,5337,13070,3318,8895,902,2535,895,2209,1797,4744
431860,202306,851,1894,413,1018,69,176,242,547,311,723
431861,202306,120,297,59,166,8,26,23,52,31,78
431862,202306,616,1825,433,1443,85,316,183,535,268,851
431870,202306,31527,69873,21256,51441,2401,6313,13218,29214,15619,35527
431880,202306,5107,11857,3318,8592,484,1421,1720,3974,2204,5395
431890,202306,6173,14223,3272,8503,951,2507,842,1981,1793,4488
431900,202306,1303,3022,731,1885,133,382,327,694,460,1076
431910,202306,930,2081,307,803,66,168,84,157,150,325
431912,202306,714,1571,514,1223,76,176,319,723,395,899
431915,202306,1464,3037,1020,2286,61,160,767,1615,828,1775
431920,202306,1689,3227,1213,2550,45,114,1004,2011,1049,2125
431930,202306,915,2169,553,1493,182,501,168,419,350,920
431935,202306,96,230,44,124,7,21,7,12,14,33
431936,202306,361,918,165,456,29,82,83,206,112,288
431937,202306,187,455,97,253,27,62,28,72,55,134
431940,202306,3823,8118,2095,4969,188,463,1301,2865,1489,3328
431950,202306,2866,6549,1785,4534,420,1087,664,1511,1084,2598
431960,202306,3752,8405,2433,5922,731,1867,536,1224,1267,3091
431970,202306,518,1258,187,491,30,90,56,104,86,194
431971,202306,95,229,42,121,10,24,12,29,22,53
431973,202306,716,1971,462,1438,41,121,312,963,353,1084
431975,202306,130,271,33,85,8,19,8,15,16,34
431980,202306,1579,3342,1125,2586,119,337,747,1477,866,1814
431990,202306,8870,19063,5392,13417,364,1114,3460,7779,3824,8893
432000,202306,20628,42738,13610,30933,1631,4266,8832,18187,10463,22453
432010,202306,3595,7748,1829,4538,429,1077,647,1437,1076,2514
432020,202306,1899,4745,1003,2789,329,932,156,401,485,1333
432023,202306,672,1496,263,703,30,85,112,234,142,319
432026,202306,1250,3051,884,2332,261,688,315,869,576,1557
432030,202306,554,1240,239,637,20,64,142,338,162,402
432032,202306,378,911,222,585,23,76,107,234,130,310
432035,202306,858,2157,635,1728,165,435,262,696,427,1131
432040,202306,1188,2811,414,1178,51,170,165,371,216,541
432045,202306,229,550,112,312,15,47,47,117,62,164
432050,202306,695,1582,425,1080,64,184,222,515,286,699
432055,202306,893,2059,543,1393,171,415,159,424,330,839
432057,202306,183,452,134,340,12,29,86,190,98,219
432060,202306,538,1240,120,374,15,45,22,63,37,108
432065,202306,281,691,185,497,38,108,93,215,131,323
432067,202306,988,2466,739,1923,117,295,380,952,497,1247
432070,202306,1995,4562,1283,3203,186,534,644,1380,830,1914
432080,202306,6527,13527,3879,8981,762,2053,1777,3451,2539,5504
432085,202306,484,1231,339,927,58,156,153,376,211,532
432090,202306,3539,8161,1627,4244,285,722,712,1586,997,2308
432100,202306,1130,2659,466,1355,81,251,64,133,145,384
432110,202306,2651,6144,1685,4301,382,1070,558,1184,940,2254
432120,202306,4746,11487,3190,8557,496,1476,1607,3794,2103,5270
432130,202306,3517,7788,2335,5686,467,1158,1083,2578,1550,3736
432132,202306,338,840,163,439,26,78,82,197,108,275
432135,202306,1232,2559,721,1690,100,229,413,978,513,1207
432140,202306,2444,5898,1755,4564,230,608,1072,2601,1302,3209
432143,202306,2024,4758,1307,3470,125,362,775,1930,900,2292
432145,202306,2289,5624,1069,2951,176,523,338,736,514,1259
432146,202306,168,425,103,294,29,80,25,61,54,141
432147,202306,693,1745,314,912,95,277,44,130,139,407
432149,202306,619,1360,231,589,30,69,107,241,137,310
432150,202306,5391,12045,3594,8823,759,2098,1692,3489,2451,5587
432160,202306,8700,19510,5780,14681,1379,3668,2233,5258,3612,8926
432162,202306,238,517,39,109,7,19,6,6,13,25
432163,202306,198,460,29,83,2,5,6,13,8,18
432166,202306,807,2025,500,1368,99,282,170,394,269,676
432170,202306,1907,4776,996,2878,202,603,336,832,538,1435
432180,202306,3700,8155,1670,4272,251,713,764,1663,1015,2376
432183,202306,503,1289,327,898,58,191,174,418,232,609
432185,202306,1078,2488,546,1443,109,325,248,566,357,891
432190,202306,2888,6240,1719,4189,140,420,1103,2341,1243,2761
432195,202306,1238,2974,579,1623,106,300,172,458,278,758
432200,202306,4740,10539,3074,7582,279,711,1996,4567,2275,5278
432210,202306,509,1184,297,780,47,145,132,304,179,449
432215,202306,791,2004,558,1540,121,335,215,620,336,955
432218,202306,252,585,89,230,11,32,41,80,52,112
432220,202306,4746,10022,2913,6788,497,1204,1579,3345,2076,4549
432225,202306,204,502,122,337,30,70,29,72,59,142
432230,202306,957,2174,390,1065,70,210,108,235,178,445
432232,202306,577,1336,331,871,53,151,156,359,209,510
432234,202306,318,760,151,410,31,76,45,105,76,181
432235,202306,60,133,29,67,5,11,18,37,23,48
432237,202306,360,842,290,723,22,53,213,509,235,562
432240,202306,21974,47073,14476,35816,1402,3805,9288,21558,10690,25363
432250,202306,9309,22564,5815,15315,934,2670,2928,6821,3862,9491
432252,202306,569,1295,325,799,39,110,152,320,191,430
432253,202306,1158,3012,710,1955,203,585,144,353,347,938
432254,202306,686,1589,145,399,18,53,34,70,52,123
432255,202306,122,306,60,166,4,10,28,60,32,70
432260,202306,7577,17027,4488,11026,776,2063,2037,4331,2813,6394
432270,202306,2963,6992,1904,4916,509,1300,533,1314,1042,2614
432280,202306,1492,3588,582,1665,83,259,158,344,241,603
432285,202306,161,473,22,57,3,5,5,14,8,19
432290,202306,425,1034,229,591,44,130,90,184,134,314
432300,202306,41161,89512,28036,67007,2323,6646,18790,40447,21113,47093
432310,202306,1337,2865,940,2228,125,261,660,1565,785,1826
432320,202306,191,442,88,245,20,59,30,72,50,131
432330,202306,208,470,58,178,18,51,9,33,27,84
432335,202306,204,577,62,210,3,8,12,29,15,37
432340,202306,400,943,144,393,21,57,58,147,79,204
432345,202306,1131,2039,889,1722,26,63,751,1398,777,1461
432350,202306,372,883,157,458,31,105,52,124,83,229
432360,202306,257,748,46,150,7,22,11,29,18,51
432370,202306,470,1063,218,601,22,62,110,283,132,345
432375,202306,610,1389,351,876,127,330,73,175,200,505
432377,202306,207,610,39,139,4,14,8,19,12,33
432380,202306,2441,6308,1444,4266,232,750,592,1582,824,2332
500020,202306,4319,9642,2468,6383,256,765,1506,3592,1762,4357
500025,202306,1444,3274,752,1937,101,264,400,943,501,1207
500060,202306,10628,26360,6961,18785,909,2667,3908,9892,4817,12559
500070,202306,6492,14635,4017,10205,755,2064,1844,4437,2599,6501
500080,202306,1918,4401,1018,2706,182,503,408,952,590,1455
500085,202306,2648,6057,1473,3827,339,909,548,1234,887,2143
500090,202306,2488,5993,1546,4402,292,886,416,1227,708,2113
500100,202306,5053,11715,3153,8254,512,1434,1272,2984,1784,4418
500110,202306,13757,30773,8333,21453,1811,4915,3801,9096,5612,14011
500124,202306,2802,6989,2046,5714,325,887,1192,3256,1517,4143
500150,202306,1975,4125,1199,2890,183,479,658,1431,841,1910
500190,202306,6388,15267,3367,8962,784,2061,1025,2412,1809,4473
500200,202306,3366,7187,1806,4387,250,659,952,2082,1202,2741
500210,202306,6476,13637,4068,10268,1024,2808,2074,4830,3098,7638
500215,202306,1810,4533,1108,3196,134,380,576,1609,710,1989
500220,202306,4406,10750,2828,7790,391,1161,1467,3612,1858,4773
500230,202306,2669,5886,1677,4168,260,686,934,2155,1194,2841
500240,202306,5261,14011,3405,10061,512,1661,1308,3636,1820,5297
500260,202306,3956,7977,2290,5394,244,659,1377,2976,1621,3635
500270,202306,192152,418560,107435,269561,14452,40913,50263,109626,64715,150539
500280,202306,1731,3972,1012,2807,158,418,541,1460,699,1878
500290,202306,4614,10487,2331,6262,379,1170,844,1889,1223,3059
500295,202306,5381,11929,3042,7591,470,1288,1285,2717,1755,4005
500310,202306,1286,2400,673,1549,105,169,329,735,434,904
500315,202306,6158,13169,4770,11205,297,806,3849,8640,4146,9446
500320,202306,25935,63178,15815,44876,3758,10006,6492,18967,10250,28973
500325,202306,7935,16060,4807,11147,636,1667,2931,6223,3567,7890
500330,202306,8557,18071,4904,12171,621,1646,2592,6140,3213,7786
500345,202306,2764,6388,1518,4075,300,820,502,1197,802,2017
500348,202306,2938,6731,2050,5200,284,762,1316,3106,1600,3868
500350,202306,1479,3775,767,2257,118,370,246,620,364,990
500370,202306,35638,85922,22405,61839,3231,9861,10252,25868,13483,35729
500375,202306,3172,7918,1652,4665,217,665,587,1384,804,2049
500380,202306,4515,10553,2487,6673,691,1785,369,1016,1060,2801
500390,202306,921,1792,492,1207,63,169,315,733,378,902
500400,202306,2073,4965,1171,3133,192,569,429,986,621,1555
500410,202306,2961,6494,1795,4635,208,522,923,2374,1131,2896
500430,202306,3561,8176,2030,5574,332,897,754,2141,1086,3038
500440,202306,2005,4521,868,2400,149,418,320,853,469,1271
500450,202306,2467,5824,1320,3684,277,787,292,800,569,1587
500460,202306,4804,11776,2517,7116,462,1435,470,1164,932,2599
500470,202306,3672,9147,2098,5846,488,1480,592,1317,1080,2797
500480,202306,2367,6830,1754,5757,198,704,1107,3587,1305,4291
500490,202306,1427,3239,717,2025,147,462,169,442,316,904
500500,202306,5001,12443,2822,8552,883,3084,271,791,1154,3875
500510,202306,875,2079,498,1338,46,118,298,699,344,817
500515,202306,2013,4804,1253,3394,206,575,606,1615,812,2190
500520,202306,4288,11210,2893,8593,568,1663,1430,4189,1998,5852
500525,202306,1247,3346,861,2610,120,350,431,1249,551,1599
500540,202306,6571,16164,3373,10064,932,3099,527,1223,1459,4322
500560,202306,7261,17250,5465,14637,384,1054,4170,10927,4554,11981
500568,202306,5783,11865,3125,7608,705,1732,1244,2684,1949,4416
500570,202306,11427,24444,6933,16615,920,2562,3923,8284,4843,10846
500580,202306,3947,9393,2473,6632,647,1721,916,2375,1563,4096
500600,202306,4695,10979,2779,7459,668,1832,743,1867,1411,3699
500620,202306,10583,25084,5998,15877,881,2443,2864,6736,3745,9179
500625,202306,701,1753,418,1180,59,167,183,461,242,628
500627,202306,965,2493,491,1484,95,310,110,284,205,594
500630,202306,9966,21027,4944,12280,1091,2922,1545,3379,2636,6301
500635,202306,3272,9727,2277,8210,354,1180,1298,5125,1652,6305
500640,202306,2164,4346,1298,3058,70,158,883,1968,953,2126
500660,202306,27870,63129,16250,44619,4314,12433,5384,14325,9698,26758
500690,202306,3484,8207,2174,6015,731,2238,680,1744,1411,3982
500710,202306,4258,10456,2449,6859,524,1563,589,1465,1113,3028
500720,202306,6404,15325,3615,10143,738,2196,1039,2623,1777,4819
500730,202306,1316,2983,630,1706,148,393,185,475,333,868
500740,202306,5659,12709,3119,8373,785,2148,976,2520,1761,4668
500750,202306,1449,3309,806,2114,118,336,357,818,475,1154
500755,202306,1420,3429,738,2040,127,378,222,498,349,876
500769,202306,6541,15246,2900,8014,697,1967,396,877,1093,2844
500770,202306,1686,4276,1111,3252,196,623,355,992,551,1615
500780,202306,1604,3854,811,2257,130,375,208,450,338,825
500790,202306,9962,24579,5910,16629,1063,3214,2041,5181,3104,8395
500793,202306,2691,6351,1550,4043,319,880,580,1320,899,2200
500795,202306,3817,7969,2775,6489,566,1471,1751,3829,2317,5300
500797,202306,1047,2413,569,1476,166,431,183,421,349,852
500800,202306,4444,9638,2305,6055,554,1609,620,1566,1174,3175
500830,202306,27077,61961,14788,37685,3354,8864,5084,11479,8438,20343
500840,202306,1783,4016,952,2387,111,284,477,1035,588,1319
510010,202306,2170,4407,1389,3285,158,346,916,2106,1074,2452
510020,202306,5359,12885,2281,6482,366,1037,658,1680,1024,2717
510025,202306,9627,21842,5462,14575,638,1829,2935,7129,3573,8958
510030,202306,3911,8139,2099,5062,163,422,1051,2446,1214,2868
510035,202306,1327,3410,788,2475,201,646,288,956,489,1602
510040,202306,3021,6196,1894,4478,254,578,1100,2574,1354,3152
510050,202306,2847,5368,1774,3908,194,528,1206,2432,1400,2960
510060,202306,1946,4719,1095,2951,291,820,242,529,533,1349
510080,202306,1932,4620,1139,3256,190,610,402,943,592,1553
510100,202306,856,1781,561,1305,65,170,353,748,418,918
510120,202306,325,557,179,377,8,23,138,261,146,284
510125,202306,2606,6255,1625,4393,240,730,651,1499,891,2229
510130,202306,2082,4737,1288,3362,235,690,608,1387,843,2077
510140,202306,3705,9344,2283,7076,950,3113,561,1721,1511,4834
510160,202306,2593,5538,1836,4481,47,133,1613,3856,1660,3989
510170,202306,6313,14859,4068,10692,678,1930,2044,4910,2722,6840
510180,202306,18878,38575,11254,26977,1561,4035,6012,13996,7573,18031
510185,202306,2104,5198,1245,3778,418,1348,402,1311,820,2659
510190,202306,3151,8151,1714,5491,380,1260,479,1500,859,2760
510250,202306,22630,51525,14521,38065,2058,5804,8088,20108,10146,25912
510260,202306,2278,9155,1829,8341,244,1149,1110,5542,1354,6691
510263,202306,5054,13115,2758,7991,504,1564,670,1542,1174,3106
510267,202306,7212,19485,3469,10455,615,1951,704,1778,1319,3729
510268,202306,1543,3827,876,2506,206,609,166,429,372,1038
510269,202306,1187,3010,694,2044,133,432,297,790,430,1222
510270,202306,3637,9789,2240,7066,370,1260,852,2509,1222,3769
510279,202306,2285,5522,1120,3265,167,500,335,840,502,1340
510285,202306,1316,3221,763,2178,192,605,253,642,445,1247
510300,202306,5251,11488,3563,8944,254,709,2529,5987,2783,6696
510305,202306,1876,4803,1100,3259,245,749,382,1090,627,1839
510310,202306,1372,3124,886,2279,227,562,330,851,557,1413
510320,202306,5186,11832,2875,7575,641,1882,870,1938,1511,3820
510325,202306,5388,14635,3392,10583,799,2698,601,1718,1400,4416
510330,202306,3354,8680,2105,6443,576,1805,872,2608,1448,4413
510335,202306,6264,16299,4284,12807,966,3074,1927,5461,2893,8535
510336,202306,667,1754,432,1353,50,145,235,770,285,915
510337,202306,1792,4761,1061,3405,371,1256,241,690,612,1946
510340,202306,127700,267843,75142,183311,13924,38801,34351,73115,48275,111916
510343,202306,1558,3455,914,2339,122,324,476,1125,598,1449
510345,202306,1809,4281,1108,2863,215,592,592,1362,807,1954
510350,202306,4007,9645,2101,6056,565,1607,458,1264,1023,2871
510360,202306,2280,4292,1202,2906,47,110,886,2152,933,2262
510370,202306,2259,5871,1571,4703,284,794,875,2683,1159,3477
510380,202306,667,1518,345,960,49,159,146,376,195,535
510385,202306,1580,4796,1074,3787,74,327,738,2572,812,2899
510390,202306,1836,4040,1195,3221,211,638,746,1911,957,2549
510395,202306,842,1714,494,1185,37,72,325,777,362,849
510410,202306,6795,16438,4460,12277,544,1584,2769,7311,3313,8895
510420,202306,3336,6088,2041,4236,61,157,1605,3172,1666,3329
510450,202306,633,1437,326,873,64,169,146,362,210,531
510452,202306,1218,3080,835,2283,131,352,479,1277,610,1629
510454,202306,1478,3579,888,2503,159,412,451,1320,610,1732
510455,202306,1160,2956,652,1904,127,419,238,606,365,1025
510460,202306,2444,5748,1470,3947,508,1554,440,822,948,2376
510480,202306,6180,13978,3391,8535,594,1619,1529,3309,2123,4928
510490,202306,2184,5012,1495,3996,179,446,912,2420,1091,2866
510500,202306,1781,4067,942,2644,229,690,251,669,480,1359
510510,202306,5058,12996,3104,9399,903,2953,911,2580,1814,5533
510515,202306,6782,16539,4040,11322,775,2253,1605,4133,2380,6386
510517,202306,2066,4895,1252,3530,393,1244,411,1019,804,2263
510520,202306,2812,5558,1248,3159,201,557,537,1352,738,1909
510523,202306,1414,3133,874,2195,155,410,460,1050,615,1460
510525,202306,10778,27817,6204,17849,1190,3518,1892,4740,3082,8258
510530,202306,717,1693,497,1366,33,94,348,918,381,1012
510550,202306,3224,8485,2171,6471,396,1208,1088,3043,1484,4251
510558,202306,2834,7166,1860,5497,274,756,910,2748,1184,3504
510560,202306,2490,6678,1372,4314,311,1044,220,669,531,1713
510562,202306,7788,16757,4829,11408,788,2029,2531,5195,3319,7224
510590,202306,4105,9268,2662,7094,291,820,1798,4582,2089,5402
510600,202306,1612,3225,1004,2276,217,635,509,941,726,1576
510610,202306,3512,7712,2184,5689,282,840,1285,3102,1567,3942
510615,202306,3572,8409,2204,6086,442,1279,1078,2827,1520,4106
510617,202306,1344,3658,1014,3115,121,406,707,2206,828,2612
510618,202306,1622,3871,1030,2829,186,581,530,1326,716,1907
510619,202306,905,2206,441,1310,100,295,96,236,196,531
510620,202306,1746,3681,710,1921,253,769,87,191,340,960
510621,202306,1974,4979,1004,3018,246,797,263,651,509,1448
510622,202306,7172,18473,3487,10209,878,2632,444,1016,1322,3648
510623,202306,3460,7853,2014,5194,398,1088,770,1788,1168,2876
510624,202306,1872,4710,861,2627,105,360,171,434,276,794
510625,202306,4591,10346,2461,6435,529,1481,840,2092,1369,3573
510626,202306,1638,3908,990,2781,273,866,232,582,505,1448
510627,202306,814,1952,394,1121,119,374,102,294,221,668
510628,202306,1785,3751,1028,2665,341,982,321,714,662,1696
510629,202306,2254,5787,1264,3803,296,999,266,714,562,1713
510630,202306,4254,10824,2320,7027,556,1687,594,1947,1150,3634
510631,202306,732,1593,491,1200,30,76,371,887,401,963
510637,202306,4477,9873,2512,6407,690,1922,844,1897,1534,3819
510642,202306,7289,18305,4973,14463,896,2861,2606,7120,3502,9981
510645,202306,1242,2369,666,1580,161,367,294,707,455,1074
510650,202306,9754,21067,6637,17029,768,1381,4580,12403,5348,13784
510665,202306,2102,4320,1136,2706,232,509,455,1115,687,1624
510670,202306,498,1055,283,736,32,83,158,409,190,492
510675,202306,8386,21440,4866,14269,1156,3712,982,2391,2138,6103
510677,202306,2707,6579,1774,4998,314,944,1015,2756,1329,3700
510680,202306,862,2093,394,1167,63,200,102,261,165,461
510682,202306,2157,5580,1445,4287,389,1208,590,1643,979,2851
510685,202306,650,1659,411,1184,39,110,233,640,272,750
510700,202306,5379,11773,3345,8628,343,1019,2130,5178,2473,6197
510704,202306,14509,32120,7948,20097,1788,4810,2602,5643,4390,10453
510706,202306,3196,8690,2033,6464,381,1220,872,2863,1253,4083
510710,202306,3729,8560,1963,5062,609,1533,460,1061,1069,2594
510715,202306,788,1599,435,1059,35,99,277,616,312,715
510718,202306,2708,6103,1494,4261,279,825,692,2129,971,2954
510719,202306,586,1177,317,765,46,124,147,287,193,411
510720,202306,1111,2380,661,1693,133,384,287,640,420,1024
510724,202306,1079,2895,610,1881,85,288,231,608,316,896
510726,202306,1069,1972,520,1184,52,123,315,671,367,794
510729,202306,746,1647,319,864,41,109,96,258,137,367
510730,202306,3631,8203,2233,5783,452,1332,1089,2459,1541,3791
510735,202306,1681,4307,1232,3533,116,325,939,2661,1055,2986
510740,202306,1186,2642,658,1607,49,136,436,962,485,1098
510757,202306,640,1915,452,1546,106,399,173,526,279,925
510760,202306,56508,118592,28952,72445,6521,17882,8839,18810,15360,36692
510770,202306,5357,10700,3489,8093,194,485,2500,5633,2694,6118
510774,202306,550,1337,358,1001,63,182,204,562,267,744
510775,202306,833,1993,443,1282,94,285,118,302,212,587
510776,202306,985,2379,566,1504,101,278,271,702,372,980
510777,202306,1715,4314,1129,3435,215,742,619,1742,834,2484
510779,202306,1025,2602,628,1846,74,204,390,1187,464,1391
510780,202306,5458,12331,3440,9136,575,1535,1751,4768,2326,6303
510785,202306,2493,6077,1289,3757,294,892,415,1145,709,2037
510787,202306,4526,11822,2467,7257,852,2558,274,696,1126,3254
510788,202306,588,1324,360,949,58,135,168,480,226,615
510790,202306,25274,61956,13146,38420,2752,8636,1415,3560,4167,12196
510792,202306,14178,36902,7824,23446,1827,5717,1793,4662,3620,10379
510794,202306,1543,4013,970,2910,271,877,139,313,410,1190
510795,202306,14411,33821,8834,23510,1883,5470,3153,7233,5036,12703
510800,202306,1860,4744,1045,3089,292,884,142,317,434,1201
510805,202306,1852,4801,1001,3087,200,643,329,912,529,1555
510810,202306,831,1595,497,1124,150,301,260,624,410,925
510820,202306,922,1703,497,1129,28,80,340,700,368,780
510830,202306,1070,2454,730,1954,108,323,440,1162,548,1485
510835,202306,742,1602,443,1150,59,176,263,628,322,804
510840,202306,81677,159189,50447,115011,7635,17178,29332,64097,36967,81275
510850,202306,2208,5473,1099,3381,254,857,84,177,338,1034
510860,202306,3386,8233,2047,5991,719,2234,421,1168,1140,3402
510880,202306,896,2403,547,1708,192,609,87,257,279,866
510885,202306,782,1825,419,1156,91,240,116,311,207,551
510890,202306,1041,2717,636,1912,184,589,141,369,325,958
510895,202306,1846,4390,1120,3053,216,660,518,1213,734,1873
520005,202306,4936,11881,3452,9546,1039,2596,1222,3839,2261,6435
520010,202306,3817,9305,2476,6584,521,1501,996,2271,1517,3772
520013,202306,4549,10634,2536,6764,688,1791,648,1776,1336,3567
520015,202306,612,1457,364,1023,86,225,133,392,219,617
520017,202306,1567,3624,947,2498,165,514,414,971,579,1485
520020,202306,706,1250,469,933,49,84,345,659,394,743
520025,202306,50777,122403,39017,102444,6087,16527,22387,55628,28474,72155
520030,202306,9105,19050,6678,15208,509,1079,4879,10635,5388,11714
520050,202306,519,1180,245,657,48,132,99,252,147,384
520055,202306,2107,4907,940,2393,151,390,394,892,545,1282
520060,202306,2461,5801,1502,4067,289,857,394,1016,683,1873
520080,202306,2352,5421,1581,4225,329,867,677,1764,1006,2631
520082,202306,1019,2442,625,1692,145,433,225,587,370,1020
520085,202306,1273,2907,874,2226,182,439,424,1022,606,1461
520090,202306,1091,1973,732,1536,108,155,538,1179,646,1334
520110,202306,56942,139704,31727,90913,8280,24979,2075,5021,10355,30000
520120,202306,320,706,153,400,26,84,65,146,91,230
520130,202306,5027,11002,3052,7392,594,1446,1292,2851,1886,4297
520140,202306,66428,161446,40338,113284,12431,36661,4334,11628,16765,48289
520145,202306,767,1639,389,1019,76,203,113,250,189,453
520150,202306,884,2008,569,1484,73,169,319,780,392,949
520160,202306,1102,2511,641,1648,122,302,283,725,405,1027
520170,202306,5816,11770,3384,8275,445,1181,2018,4520,2463,5701
520180,202306,3583,8111,2597,6551,322,910,1643,3887,1965,4797
520215,202306,2244,4911,1466,3623,140,403,958,2194,1098,2597
520235,202306,952,1871,537,1254,94,235,298,623,392,858
520250,202306,2250,5191,1406,3769,525,1516,123,369,648,1885
520260,202306,904,2023,468,1237,93,238,157,385,250,623
520280,202306,1050,2173,679,1555,166,375,296,655,462,1030
520310,202306,1129,2298,673,1599,142,388,323,731,465,1119
520320,202306,2674,6324,1602,4241,216,565,769,1976,985,2541
520330,202306,6472,15106,4425,11352,678,1930,2493,5824,3171,7754
520340,202306,2798,5695,1506,3724,184,427,738,1867,922,2294
520350,202306,4422,10001,2513,6631,774,2067,670,1745,1444,3812
520355,202306,2281,5824,1448,4103,442,1341,203,503,645,1844
520357,202306,1102,2383,738,1835,79,213,516,1246,595,1459
520360,202306,1014,2336,673,1698,93,262,324,706,417,968
520380,202306,1698,4026,862,2354,158,424,234,548,392,972
520390,202306,1435,3215,815,2200,211,656,142,371,353,1027
520393,202306,880,1868,516,1260,66,178,245,525,311,703
520396,202306,1090,2470,772,1882,61,136,517,1178,578,1314
520400,202306,2025,4402,1401,3457,121,306,960,2359,1081,2665
520410,202306,2743,5619,1620,3764,236,615,895,1910,1131,2525
520420,202306,460,956,337,752,20,56,234,468,254,524
520425,202306,1914,4396,890,2295,258,710,182,366,440,1076
520430,202306,3068,6756,1515,3902,301,795,278,586,579,1381
520440,202306,3737,8583,1868,4993,380,1092,391,970,771,2062
520450,202306,18416,41235,10740,27751,2548,6696,2832,6690,5380,13386
520455,202306,1009,2408,585,1674,163,484,161,452,324,936
520460,202306,1295,2805,854,2129,219,472,366,924,585,1396
520465,202306,1094,2346,811,1918,42,119,587,1305,629,1424
520470,202306,3092,6888,2087,5291,626,1695,839,2017,1465,3712
520480,202306,1289,3184,805,2259,168,479,328,843,496,1322
520485,202306,1914,5247,1386,4225,218,673,685,1956,903,2629
520490,202306,5529,12948,3715,9868,585,1633,2082,5192,2667,6825
520495,202306,2000,3826,1400,2981,117,265,1008,2059,1125,2324
520500,202306,2242,5004,1431,3453,255,714,756,1596,1011,2310
520505,202306,1195,2240,861,1789,94,162,622,1269,716,1431
520510,202306,13059,29505,8678,21834,1388,4048,4385,9786,5773,13834
520520,202306,1410,3336,974,2567,265,737,379,922,644,1659
520530,202306,3291,7886,2175,5909,422,1148,981,2794,1403,3942
520540,202306,3812,9169,2040,5534,319,902,694,1605,1013,2507
520545,202306,1858,4183,1196,3041,284,712,462,1122,746,1834
520547,202306,1849,4384,1242,3225,255,647,609,1547,864,2194
520549,202306,22109,50798,16457,41402,2046,5630,10288,24006,12334,29636
520551,202306,6604,14805,4969,12095,412,1257,3604,8052,4016,9309
520552,202306,1283,2971,874,2341,239,630,326,892,565,1522
520570,202306,680,1435,381,938,55,116,180,420,235,536
520580,202306,2922,5778,1824,4307,397,921,893,2083,1290,3004
520590,202306,1711,3971,1013,2717,202,558,395,986,597,1544
520620,202306,12535,29215,8847,22981,1503,4103,4691,11385,6194,15488
520630,202306,1073,2498,690,1827,97,267,311,798,408,1065
520640,202306,2744,6242,1773,4377,443,1109,469,1157,912,2266
520650,202306,1307,2587,827,1855,167,358,439,974,606,1332
520660,202306,588,1441,294,841,72,212,83,236,155,448
520670,202306,1221,2828,869,2208,78,168,578,1387,656,1555
520680,202306,1056,2252,716,1674,96,178,443,1021,539,1199
520690,202306,429,1029,270,731,69,185,85,206,154,391
520710,202306,551,1243,312,789,19,56,200,463,219,519
520725,202306,1660,3740,998,2562,212,551,385,945,597,1496
520735,202306,1160,2488,700,1713,216,508,189,450,405,958
520740,202306,3247,6911,1943,4805,369,946,850,2035,1219,2981
520750,202306,929,1923,603,1408,111,248,325,725,436,973
520753,202306,1609,3832,1101,2914,191,553,513,1202,704,1755
520760,202306,1862,3540,1371,2907,46,126,1141,2302,1187,2428
520780,202306,1982,4372,1237,3118,194,494,598,1410,792,1904
520790,202306,3933,8705,2285,5846,367,863,1224,3202,1591,4065
520800,202306,24313,55152,16840,42654,3070,7769,8777,21576,11847,29345
520810,202306,1421,2905,935,2272,259,627,387,953,646,1580
520815,202306,709,2028,427,1357,78,243,128,402,206,645
520830,202306,2157,4352,1423,3341,84,191,1047,2361,1131,2552
520840,202306,3677,8999,2576,7184,657,1972,795,2118,1452,4090
520850,202306,1166,2381,699,1634,138,351,335,701,473,1052
520860,202306,12299,29885,7554,20590,1877,5314,2334,5684,4211,10998
520870,202306,199284,424123,123754,297038,22578,57241,56249,122045,78827,179286
520880,202306,12604,32817,8743,24914,1765,5006,3477,9324,5242,14330
520890,202306,6173,12557,3775,8600,587,1553,2050,4113,2637,5666
520910,202306,5818,13576,3386,8935,794,2178,812,1895,1606,4073
520915,202306,1031,2453,572,1492,105,291,250,574,355,865
520920,202306,5533,11410,3606,8593,708,1544,1948,4653,2656,6197
520929,202306,774,1710,501,1233,93,181,212,551,305,732
520940,202306,1195,2912,827,2285,60,189,548,1399,608,1588
520945,202306,587,1221,368,863,40,97,210,462,250,559
520960,202306,1432,2936,978,2272,363,781,341,850,704,1631
520970,202306,4798,11273,3095,8304,1036,2748,656,1777,1692,4525
520980,202306,938,1990,610,1483,76,185,303,658,379,843
520990,202306,3913,8485,2861,6955,414,880,1942,4702,2356,5582
520993,202306,1488,3427,795,2019,250,622,216,513,466,1135
520995,202306,3206,7446,1928,5074,506,1441,404,1115,910,2556
521000,202306,12118,28781,6737,17799,1118,3020,2218,5186,3336,8206
521010,202306,5048,11755,3315,8458,522,1491,1640,3760,2162,5251
521015,202306,963,2212,559,1424,25,70,390,909,415,979
521020,202306,6052,13715,3301,8558,791,2074,876,2125,1667,4199
521030,202306,1024,1729,669,1236,23,51,554,970,577,1021
521040,202306,10822,24719,6574,17086,1651,4256,1831,4702,3482,8958
521056,202306,1299,3178,799,2258,236,640,129,376,365,1016
521060,202306,1232,2974,770,2089,176,504,243,634,419,1138
521080,202306,1268,2598,600,1534,113,289,173,389,286,678
521090,202306,3828,9672,2107,5885,475,1421,221,541,696,1962
521100,202306,2433,4948,1603,3730,203,501,955,2133,1158,2634
521120,202306,6160,13873,4076,10531,1273,3324,894,2505,2167,5829
521130,202306,1296,2905,610,1624,76,230,307,784,383,1014
521140,202306,2103,4783,1321,3309,149,399,781,1751,930,2150
521150,202306,18121,38181,10318,25757,2600,6993,3770,8465,6370,15458
521160,202306,1046,1990,587,1247,56,117,387,745,443,862
521170,202306,1338,2909,820,2029,140,379,343,758,483,1137
521180,202306,10959,25870,7535,19615,1578,4397,3319,8167,4897,12564
521190,202306,14853,34498,8339,22699,1852,5408,2599,6257,4451,11665
521200,202306,867,1979,511,1349,99,279,201,453,300,732
521205,202306,773,1667,550,1300,33,88,410,901,443,989
521210,202306,1087,2691,543,1530,136,392,131,279,267,671
521220,202306,4778,10519,2838,7141,700,2006,1148,2416,1848,4422
521225,202306,536,1019,345,778,28,69,260,567,288,636
521230,202306,1835,4235,1279,3293,491,1287,343,823,834,2110
521250,202306,47543,108500,34116,86993,6869,18994,17726,41230,24595,60224
521260,202306,657,1365,454,1048,65,166,247,514,312,680
521270,202306,2696,5887,2041,4918,218,503,1402,3351,1620,3854
521280,202306,2251,5552,1442,4039,292,836,500,1316,792,2152
521290,202306,711,1493,396,986,42,118,225,515,267,633
521295,202306,1476,3000,961,2221,142,322,529,1120,671,1442
521300,202306,2291,5166,1518,3848,323,839,742,1825,1065,2664
521305,202306,821,1755,505,1251,44,117,323,755,367,872
521308,202306,5986,14417,3535,9540,332,953,2080,5188,2412,6141
521310,202306,14069,32814,7999,20861,1646,4519,2855,6609,4501,11128
521340,202306,533,1118,305,750,30,81,163,361,193,442
521350,202306,2366,5629,1637,4425,121,378,1145,2919,1266,3297
521370,202306,1601,3895,853,2448,287,846,140,432,427,1278
521375,202306,2098,5104,1176,3263,241,648,297,842,538,1490
521377,202306,1597,3199,1039,2443,127,266,704,1691,831,1957
521380,202306,8230,20370,4193,12111,702,2160,791,2184,1493,4344
521385,202306,869,1919,539,1409,71,170,301,810,372,980
521390,202306,897,2151,509,1453,110,363,103,223,213,586
521400,202306,3792,8201,2406,5930,331,834,1345,3141,1676,3975
521405,202306,1668,4100,917,2562,104,314,442,1118,546,1432
521410,202306,1150,2500,822,1961,208,436,413,1031,621,1467
521440,202306,1745,3967,1144,2936,322,764,474,1215,796,1979
521450,202306,5408,14559,3361,10044,836,2448,744,2123,1580,4571
521460,202306,8292,19219,4847,12745,1245,3346,1415,3523,2660,6869
521470,202306,1063,2431,602,1505,108,234,287,675,395,909
521480,202306,666,1339,392,869,51,116,224,419,275,535
521483,202306,2817,6334,1776,4595,578,1470,544,1407,1122,2877
521486,202306,2122,4758,1405,3552,119,232,900,2199,1019,2431
521487,202306,602,1305,401,981,72,153,230,548,302,701
521490,202306,1033,2487,699,1882,38,127,478,1161,516,1288
521500,202306,2455,5976,1525,4178,167,501,788,1943,955,2444
521520,202306,1050,2209,737,1699,101,218,448,1010,549,1228
521523,202306,19107,50113,13289,38636,3871,11198,4786,12936,8657,24134
521525,202306,1315,2905,884,2217,114,344,524,1202,638,1546
521530,202306,2744,6750,1576,4344,302,834,456,1124,758,1958
521540,202306,902,2181,613,1676,153,460,232,559,385,1019
521550,202306,2187,5132,912,2480,187,549,211,585,398,1134
521560,202306,7403,17151,4807,13119,1319,3697,1744,4741,3063,8438
521565,202306,842,1938,516,1361,89,247,220,538,309,785
521570,202306,5605,13867,3235,9076,741,2227,482,1317,1223,3544
521580,202306,689,1517,365,924,66,166,147,319,213,485
521590,202306,1103,2234,717,1663,103,253,412,880,515,1133
521600,202306,541,1292,279,774,46,137,124,301,170,438
521630,202306,2136,4297,1104,2641,352,876,269,570,621,1446
521640,202306,2434,5428,1365,3592,276,826,375,876,651,1702
521645,202306,646,1568,309,910,141,390,20,47,161,437
521680,202306,1774,4365,1242,3388,316,857,502,1310,818,2167
521690,202306,645,1504,454,1184,68,198,242,577,310,775
521710,202306,4307,9719,2534,6516,478,1352,766,1680,1244,3032
521720,202306,3067,6424,1667,4107,192,496,884,2053,1076,2549
521730,202306,5417,13299,3347,9372,886,2720,695,1517,1581,4237
521740,202306,6010,13849,3777,9717,1054,2894,1258,2621,2312,5515
521760,202306,24423,55554,17923,45077,3546,9944,9897,22531,13443,32475
521770,202306,4023,8790,2210,5676,439,1154,497,1230,936,2384
521800,202306,9075,21408,5515,15034,1758,4824,1283,3725,3041,8549
521805,202306,1422,2781,760,1773,152,330,335,787,487,1117
521810,202306,930,1985,591,1461,93,237,351,855,444,1092
521830,202306,7695,18671,5589,14927,581,1741,3634,8967,4215,10708
521839,202306,1092,2318,719,1660,57,152,490,1013,547,1165
521850,202306,9051,19564,4885,12457,1566,4021,624,1488,2190,5509
521860,202306,2055,5249,1184,3423,231,708,310,764,541,1472
521870,202306,922,2310,575,1595,106,323,236,553,342,876
521878,202306,1083,2612,588,1574,62,175,312,754,374,929
521880,202306,32454,73497,20318,52222,3937,10846,8652,19729,12589,30575
521890,202306,4209,9885,2328,6224,626,1649,597,1453,1223,3102
521900,202306,1757,3882,858,2269,258,603,50,130,308,733
521910,202306,1693,3564,1099,2655,277,657,398,908,675,1565
521920,202306,694,1614,464,1193,49,160,263,605,312,765
521925,202306,1058,2428,627,1662,120,309,284,700,404,1009
521930,202306,6955,15714,3956,10684,1189,2782,1389,4010,2578,6792
521935,202306,1236,2792,738,1886,88,239,428,1009,516,1248
521940,202306,1614,3355,922,2258,148,395,505,1142,653,1537
521945,202306,834,1925,464,1221,87,201,229,591,316,792
521950,202306,924,2014,555,1378,106,245,248,602,354,847
521960,202306,813,1949,522,1391,62,190,283,656,345,846
521970,202306,3474,7242,2402,5734,272,610,1584,3710,1856,4320
521971,202306,951,2197,469,1272,111,286,116,273,227,559
521973,202306,2116,5062,1288,3485,201,551,598,1503,799,2054
521975,202306,17956,41142,12965,32806,2111,5692,7503,17510,9614,23202
521980,202306,2760,6030,1867,4700,141,397,1339,3223,1480,3620
521990,202306,1774,3975,1280,3142,215,541,713,1668,928,2209
522000,202306,3210,7655,2186,6075,810,2329,636,1771,1446,4100
522005,202306,525,1074,271,678,45,131,96,220,141,351
522010,202306,6042,14009,3666,9615,827,2270,1176,2787,2003,5057
522015,202306,1332,3187,876,2369,234,630,338,870,572,1500
522020,202306,6833,14777,3949,9886,846,2247,1738,4146,2584,6393
522026,202306,942,2298,554,1553,84,258,178,437,262,695
522028,202306,666,1497,387,956,51,149,210,455,261,604
522040,202306,4787,9620,2777,6453,466,1133,1463,3003,1929,4136
522045,202306,27136,68178,17229,48799,3798,11104,4354,11421,8152,22525
522050,202306,1513,3583,929,2453,168,495,421,951,589,1446
522060,202306,4003,9657,2437,6766,484,1287,959,2599,1443,3886
522068,202306,2272,4887,1598,3925,163,350,1083,2559,1246,2909
522070,202306,1075,2090,817,1716,26,61,668,1326,694,1387
522100,202306,1122,2599,656,1770,107,291,262,665,369,956
522108,202306,1463,2954,1028,2322,58,168,785,1650,843,1818
522119,202306,2495,5300,1822,4326,259,549,1100,2563,1359,3112
522130,202306,687,1519,458,1139,34,83,329,780,363,863
522140,202306,32183,75745,19190,50492,4192,11470,5658,13259,9850,24729
522145,202306,926,2077,594,1535,132,380,299,714,431,1094
522150,202306,1374,3005,781,1961,169,393,237,598,406,991
522155,202306,1211,2903,737,1982,125,336,387,1001,512,1337
522157,202306,932,1833,680,1487,48,110,505,1092,553,1202
522160,202306,7890,18560,4344,11711,1096,3142,467,1278,1563,4420
522170,202306,3426,8107,2389,6333,378,948,1359,3523,1737,4471
522180,202306,935,1977,501,1150,97,217,139,313,236,530
522185,202306,32408,72913,20548,54482,8357,23480,3190,8601,11547,32081
522190,202306,1011,2134,600,1468,92,252,301,615,393,867
522200,202306,2694,6738,1735,4853,424,1163,606,1611,1030,2774
522205,202306,2006,4583,1232,3184,488,1363,257,560,745,1923
522220,202306,1512,3247,956,2432,126,324,527,1328,653,1652
522230,202306,1677,3684,1072,2650,129,354,631,1451,760,1805
530010,202306,364292,845195,275240,688980,40588,106906,154667,357524,195255,464430
110001,202305,4773,12356,3222,9492,802,2617,952,2645,1754,5262
110002,202305,17757,41750,13103,34224,3347,9505,3786,9327,7133,18832
110003,202305,904,2472,662,2001,161,513,141,372,302,885
110004,202305,17714,41382,12250,32268,2742,7735,4253,10613,6995,18348
110005,202305,3035,7474,2220,6174,567,1630,678,1899,1245,3529
110006,202305,1820,4785,1131,3435,205,693,210,570,415,1263
110007,202305,1488,3547,930,2611,255,739,181,551,436,1290
110008,202305,4295,9986,3229,8530,680,1602,1756,5219,2436,6821
110009,202305,5501,14285,3593,10894,789,2614,1182,3335,1971,5949
110010,202305,10071,27632,7869,23873,2040,5656,3496,12201,5536,17857
110011,202305,9506,23045,6667,18209,1886,5443,1454,3728,3340,9171
110012,202305,22187,51194,15063,39649,3875,10449,3953,9746,7828,20195
110013,202305,7274,19028,5051,14826,1926,6080,820,2336,2746,8416
110014,202305,4675,11285,3126,8478,548,1594,1373,3576,1921,5170
110015,202305,7552,17712,4933,13114,1135,3444,1458,3109,2593,6553
110018,202305,5651,13255,3624,9742,773,2215,860,1997,1633,4212
110020,202305,118947,248681,91946,212829,19828,47900,48071,110665,67899,158565
110025,202305,5844,13270,4161,10492,656,1875,2159,5097,2815,6972
110026,202305,700,1746,493,1387,122,366,137,400,259,766
110028,202305,9161,21648,5865,16048,1534,4719,605,1544,2139,6263
110029,202305,1915,4446,1196,3255,233,635,476,1277,709,1912
110030,202305,17878,39382,11411,29758,3368,9586,1563,3992,4931,13578
110032,202305,4552,11601,2789,8181,902,2710,467,1395,1369,4105
110033,202305,5792,15713,4400,13181,1354,4161,1481,4650,2835,8811
110034,202305,3804,8553,2576,6791,954,2783,575,1608,1529,4391
110037,202305,1814,5096,1249,4027,356,1206,334,1048,690,2254
110040,202305,3530,9080,2526,7343,697,2216,581,1506,1278,3722
110045,202305,5545,14732,4088,12161,1205,3903,1274,3697,2479,7600
110050,202305,2054,5195,1352,3995,457,1538,143,317,600,1855
110060,202305,1151,3171,750,2270,200,609,151,438,351,1047
110070,202305,1781,5071,1264,3979,353,1210,294,782,647,1992
110080,202305,7920,17713,5983,15122,1436,3768,2835,7317,4271,11085
110090,202305,720,1848,510,1470,129,433,146,394,275,827
110092,202305,1683,4505,1222,3674,308,954,593,1771,901,2725
110094,202305,3476,9373,2564,7705,895,2853,430,1338,1325,4191
110100,202305,2100,5557,1660,4796,620,1889,485,1399,1105,3288
110110,202305,2192,5490,1561,4477,469,1461,268,839,737,2300
110120,202305,1626,4248,1141,3341,293,902,294,827,587,1729
110130,202305,3246,7553,2001,5412,444,1242,230,614,674,1856
110140,202305,3035,7872,2293,6520,500,1574,1032,2759,1532,4333
110143,202305,1716,4355,1253,3564,344,1103,394,1039,738,2142
110145,202305,1124,2743,685,1921,195,536,243,715,438,1251
110146,202305,636,1575,422,1213,151,404,123,397,274,801
110147,202305,950,2244,629,1676,81,245,308,716,389,961
110148,202305,1174,2975,608,1796,133,438,70,141,203,579
110149,202305,4292,10210,2937,8045,1009,2895,650,1840,1659,4735
110150,202305,2977,7310,1920,5616,610,1974,254,774,864,2748
110155,202305,1049,2812,720,2038,148,476,298,752,446,1228
110160,202305,1777,4878,1271,3846,444,1405,179,513,623,1918
110170,202305,2443,5794,1610,4326,274,841,896,2200,1170,3041
110175,202305,2646,6889,1830,5239,337,1063,804,2161,1141,3224
110180,202305,1606,4000,1116,3102,273,818,345,890,618,1708
120001,202305,4331,10895,3502,9677,526,1692,2262,6031,2788,7723
120005,202305,2478,8362,2222,7946,273,980,1623,5957,1896,6937
120010,202305,7652,18145,6808,17030,644,1500,5302,13346,5946,14846
120013,202305,3136,8840,2692,8215,970,2915,1018,3494,1988,6409
120017,202305,3759,9015,3142,8180,442,1102,2055,5637,2497,6739
120020,202305,19661,59965,18227,57541,1332,4557,14359,45139,15691,49696
120025,202305,4599,10336,3833,9478,592,1454,2496,6471,3088,7925
120030,202305,7640,27249,7089,26350,549,2259,5284,20227,5833,22486
120032,202305,2125,8362,2001,8124,105,637,1680,6688,1785,7325
120033,202305,5448,16077,5111,15527,125,542,4520,13501,4645,14043
120034,202305,3633,10827,3181,10112,180,716,2638,8248,2818,8964
120035,202305,5186,16016,4810,15397,249,927,4162,13201,4411,14128
120038,202305,4086,10401,3500,9537,592,1684,2109,5865,2701,7549
120039,202305,2506,9431,2282,8947,136,725,1793,6934,1929,7659
120040,202305,78184,187802,67975,173317,8950,24105,45011,113049,53961,137154
120042,202305,4411,13206,4048,12597,193,727,3353,10285,3546,11012
120043,202305,1822,6375,1540,5967,60,380,1278,4860,1338,5240
120045,202305,7291,16564,6167,15187,660,1699,4546,11218,5206,12917
120050,202305,12301,36226,11381,34973,520,1917,9672,29677,10192,31594
120060,202305,12282,40439,11272,38979,497,2262,9673,33265,10170,35527
120070,202305,4338,11905,3734,11071,683,1933,2234,7067,2917,9000
120080,202305,6988,16052,6285,15097,728,1754,4815,11556,5543,13310
130002,202305,4258,13437,3735,12746,421,1116,3005,10840,3426,11956
130006,202305,3200,9902,2651,9060,558,1798,1589,5899,2147,7697
130008,202305,3288,9823,2823,9174,212,675,2205,7415,2417,8090
130010,202305,5380,12691,4694,11912,153,375,4263,10840,4416,11215
130014,202305,4914,12296,3662,10436,781,2269,1937,5815,2718,8084
130020,202305,3375,11975,2943,11358,154,858,2346,8916,2500,9774
130030,202305,19833,40635,18571,39250,191,477,17813,37350,18004,37827
130040,202305,4978,13444,4091,12329,647,1831,2861,8982,3508,10813
130050,202305,8705,28871,7643,27491,573,1951,6340,23308,6913,25259
130060,202305,8794,31857,7567,30246,367,2079,6347,24940,6714,27019
130063,202305,7865,22714,7030,21780,212,863,6386,19717,6598,20580
130068,202305,4764,13355,4004,12379,251,972,3198,9809,3449,10781
130070,202305,9015,23309,7487,21641,840,2040,5589,16939,6429,18979
130080,202305,9481,27720,8176,26222,393,1154,7051,23013,7444,24167
130083,202305,3629,10126,3148,9548,274,835,2522,7889,2796,8724
130090,202305,5041,12344,4493,11722,90,215,3988,10703,4078,10918
130100,202305,9031,25281,7598,23753,158,444,6966,22049,7124,22493
130110,202305,10918,26143,8989,23748,1828,4297,5526,16103,7354,20400
130115,202305,6231,17051,5409,16114,152,430,4692,14213,4844,14643
130120,202305,20727,56866,18483,54058,1763,5415,15158,44387,16921,49802
130130,202305,7252,19261,5637,17205,711,2090,3953,12800,4664,14890
130140,202305,8978,27280,7901,26070,345,1365,6867,22741,7212,24106
130150,202305,4832,14441,4553,14139,89,423,4220,13074,4309,13497
130160,202305,8076,21499,7029,20228,375,962,6161,17994,6536,18956
130165,202305,4224,13548,3984,13274,151,583,3571,11908,3722,12491
130170,202305,17711,40002,15033,37092,445,1308,13568,33229,14013,34537
130180,202305,5364,15197,5154,14968,37,227,4985,14404,5022,14631
130185,202305,25228,52874,21263,48636,1780,2346,17898,43309,19678,45655
130190,202305,26105,72680,21694,66516,2314,6867,16118,50144,18432,57011
130195,202305,3005,9871,2553,9322,121,531,2136,7891,2257,8422
130200,202305,3770,8873,3109,8020,220,686,2454,6168,2674,6854
130210,202305,1977,6546,1794,6327,179,745,1441,5058,1620,5803
130220,202305,3270,8879,2712,8228,115,324,2389,7395,2504,7719
130230,202305,6235,21856,5492,20882,205,1067,4841,18449,5046,19516
130240,202305,17877,39874,15000,36383,149,696,14005,33463,14154,34159
130250,202305,32282,85273,27852,80179,1771,4359,22901,67917,24672,72276
130255,202305,6117,16225,5231,14774,268,665,4266,12095,4534,12760
130260,202305,483416,1058413,417151,973692,76744,192135,275952,630698,352696,822833
130270,202305,12393,37555,10351,34579,2147,6499,6438,22767,8585,29266
130280,202305,4639,15098,4232,14636,145,555,3887,13491,4032,14046
130290,202305,21748,51853,19692,49474,608,1608,18187,45563,18795,47171
130300,202305,6157,17547,5475,16664,179,697,4641,14036,4820,14733
130310,202305,10754,24928,9537,23507,499,1162,8349,20630,8848,21792
130320,202305,4228,12571,3559,11643,518,1610,2453,8347,2971,9957
130330,202305,5590,15507,4563,14307,240,796,3823,12200,4063,12996
130340,202305,31274,79604,27145,75071,1760,4095,22851,65319,24611,69414
130350,202305,4592,15012,4118,14401,167,755,3582,12511,3749,13266
130353,202305,9651,23248,7992,21100,1395,3435,5113,14111,6508,17546
130356,202305,7002,18912,5964,17392,1256,3596,3419,10433,4675,14029
130360,202305,3632,10724,2860,9749,97,418,2514,8556,2611,8974
130370,202305,6175,24582,5206,23154,775,4118,3088,13818,3863,17936
130380,202305,9853,38100,9231,37179,814,3655,7366,29747,8180,33402
130390,202305,9082,30587,8011,29065,399,1802,7114,25720,7513,27522
130395,202305,3098,8509,2566,7678,180,631,2093,6146,2273,6777
130400,202305,3629,9620,3114,8947,108,328,2745,7909,2853,8237
130406,202305,14579,44978,12523,42490,3042,9328,7677,27835,10719,37163
130410,202305,5538,16820,4799,15740,1331,4431,2582,8877,3913,13308
130420,202305,19385,56378,16502,52864,2330,7062,11629,38540,13959,45602
130423,202305,5388,15428,4684,14590,205,812,4149,12774,4354,13586
130426,202305,3889,12089,3491,11654,71,201,3083,10845,3154,11046
130430,202305,6239,13694,5403,12665,220,504,4831,11215,5051,11719
130440,202305,7254,17177,6293,16047,150,443,5882,14983,6032,15426
140002,202305,3076,8105,2697,7661,295,736,2057,6130,2352,6866
140005,202305,4075,10674,3544,10049,1300,3740,1761,5249,3061,8989
140010,202305,68612,176446,56625,159163,15082,44885,21327,60809,36409,105694
140015,202305,7301,14917,6406,13964,316,617,5780,12736,6096,13353
140017,202305,7198,16347,6288,15238,420,956,5191,12810,5611,13766
140020,202305,6975,17096,6022,15951,685,1841,4283,11592,4968,13433
140023,202305,3504,8873,2829,7962,327,995,2159,6121,2486,7116
140028,202305,2517,5942,2125,5464,152,376,1648,4293,1800,4669
140030,202305,7763,16032,7100,15288,356,509,6463,14223,6819,14732
140040,202305,3602,12577,3335,12233,115,587,3037,11084,3152,11671
140045,202305,4779,15012,4232,14293,1195,3229,2308,9021,3503,12250
140047,202305,7563,19420,6434,17792,1047,2990,4064,11435,5111,14425
140050,202305,2142,5452,1824,5006,342,811,1163,3403,1505,4214
140060,202305,2815,6019,2537,5667,261,503,2108,4778,2369,5281
140070,202305,2492,11695,2406,11553,156,1047,2069,9751,2225,10798
150010,202305,65702,134351,59163,126301,1355,2616,53471,112943,54826,115559
150013,202305,2751,5627,2324,5166,144,244,1968,4468,2112,4712
150020,202305,19172,48091,17641,46070,1812,3766,14052,37985,15864,41751
150030,202305,11523,35926,10452,34699,847,2171,8465,30157,9312,32328
150034,202305,5309,11397,4360,10235,307,659,3593,8563,3900,9222
150040,202305,20100,47030,17841,44563,1127,1540,15792,41309,16919,42849
150050,202305,9942,26472,9006,25280,250,691,8172,23179,8422,23870
150060,202305,30170,72667,24662,64700,3802,10101,15459,40987,19261,51088
150070,202305,10909,30648,9709,29249,230,884,8997,27023,9227,27907
150080,202305,114283,241913,94609,216315,26472,60113,33136,84841,59608,144954
150085,202305,12255,27736,11185,26503,161,361,10594,25166,10755,25527
150090,202305,15876,40051,14799,38423,563,1447,13109,33661,13672,35108
150095,202305,9208,19563,8089,18230,902,1171,6610,15695,7512,16866
150100,202305,3636,11114,3207,10456,199,638,2668,8783,2867,9421
150110,202305,5715,19102,5331,18688,154,558,4948,17638,5102,18196
150120,202305,10080,26684,9307,25764,372,704,8275,23368,8647,24072
150125,202305,1098,2576,821,2190,95,295,537,1408,632,1703
150130,202305,31385,78438,26959,71942,5470,13080,16179,45722,21649,58802
150140,202305,382873,727614,329388,661113,29066,58686,245791,479870,274857,538556
150145,202305,5063,14556,4161,13119,1688,5414,1136,4316,2824,9730
150150,202305,23060,49774,19567,45462,1734,3845,14573,33771,16307,37616
150157,202305,4448,10948,3517,9662,497,1402,2167,6080,2664,7482
150160,202305,5126,10680,4769,10223,407,988,3877,8060,4284,9048
150170,202305,35947,90086,32375,84469,5693,12897,20948,58148,26641,71045
150172,202305,7249,15974,5911,14219,368,918,4637,11081,5005,11999
150175,202305,2556,6200,2177,5614,179,625,1708,4173,1887,4798
150178,202305,15848,33133,12189,28989,1191,1571,9693,24971,10884,26542
150180,202305,36220,91005,32739,87189,2802,4606,26569,76473,29371,81079
150190,202305,9821,23814,8957,22803,133,391,8383,21247,8516,21638
150195,202305,6474,17350,5993,16703,184,618,5465,15147,5649,15765
150200,202305,7352,18452,6661,17675,57,165,6128,16304,6185,16469
150210,202305,41621,106050,39343,103378,1402,3290,35309,93865,36711,97155
150215,202305,14061,35802,12036,32541,2055,5831,7332,19512,9387,25343
150220,202305,17862,42099,15626,39132,858,2010,12094,30058,12952,32068
150230,202305,17844,41768,15919,39247,1390,2938,12213,30600,13603,33538
150240,202305,45260,109633,38174,98361,8259,21805,17753,43802,26012,65607
150250,202305,5361,17545,5026,17185,419,1444,4407,15251,4826,16695
150260,202305,3657,9653,3180,8973,111,339,2682,7499,2793,7838
150270,202305,10928,28014,7808,22543,2297,6940,2127,6205,4424,13145
150275,202305,9707,24232,8895,23203,205,740,7972,20348,8177,21088
150276,202305,2899,7144,2548,6721,294,709,1803,5120,2097,5829
150277,202305,7014,15241,5575,13585,768,1822,3914,9771,4682,11593
150280,202305,9369,29867,8993,29332,728,1838,7484,25528,8212,27366
150285,202305,4387,12759,3809,11827,286,850,2921,9106,3207,9956
150290,202305,13943,32222,12689,30913,529,763,11471,28662,12000,29425
150293,202305,11787,26038,9439,23017,1067,2672,6663,16080,7730,18752
150295,202305,9091,21928,6344,18091,2142,6013,2100,6816,4242,12829
150300,202305,4254,8677,3921,8298,41,101,3721,7830,3762,7931
150304,202305,5397,13971,4531,12645,794,2050,2914,8470,3708,10520
150307,202305,7079,19647,6354,18497,301,828,5088,14826,5389,15654
150309,202305,7947,20227,6423,17851,1022,2785,3776,10757,4798,13542
150310,202305,9072,30822,8495,30091,349,1474,7383,26474,7732,27948
150320,202305,11747,27273,10665,25781,1105,2438,7873,19222,8978,21660
150330,202305,19187,50236,17659,48231,2637,5649,12066,36260,14703,41909
150340,202305,2978,7949,2611,7439,315,841,1904,5466,2219,6307
150345,202305,11461,27105,10182,25491,424,1152,8904,22100,9328,23252
150350,202305,12853,26008,11550,24386,1060,1700,9557,20517,10617,22217
150360,202305,31411,77149,25657,69989,2535,4844,19448,55599,21983,60443
150370,202305,14233,36378,11791,33187,1646,3909,8289,24936,9935,28845
150375,202305,4921,17811,4501,17234,288,1077,3932,15237,4220,16314
150380,202305,12769,28420,10306,25195,351,978,8666,20911,9017,21889
150390,202305,9671,34354,8568,32526,2028,6483,5022,21199,7050,27682
150400,202305,8168,25369,7717,24666,174,534,6605,21727,6779,22261
150405,202305,11119,25291,9618,23532,880,1501,7527,19237,8407,20738
150410,202305,2368,6378,2011,5819,188,481,1402,4095,1590,4576
150420,202305,59272,141953,47146,124868,10817,30255,23163,62154,33980,92409
150430,202305,10134,25565,9228,24462,741,1386,7709,20980,8450,22366
150440,202305,8529,19845,7719,18829,509,1178,6476,15768,6985,16946
150442,202305,39202,78358,33162,71248,2000,4331,26625,55905,28625,60236
150445,202305,10068,23675,9081,22358,158,407,8383,20543,8541,20950
150450,202305,8098,24073,7573,23419,292,1368,6971,21089,7263,22457
150460,202305,10834,29264,9790,27969,526,1207,8161,24154,8687,25361
150470,202305,25556,61001,22849,57736,539,1916,20524,50839,21063,52755
150475,202305,6909,18642,5848,17011,1038,2730,3702,11308,4740,14038
150480,202305,17789,47386,16099,45049,4206,10399,9540,29201,13746,39600
150490,202305,10133,31162,9095,29699,780,2129,7085,24083,7865,26212
150495,202305,6794,18514,6366,17964,169,668,5818,16243,5987,16911
150497,202305,3332,9378,2654,8243,531,1718,1431,4619,1962,6337
150500,202305,3815,8990,3353,8323,218,568,2616,6305,2834,6873
150503,202305,7236,17087,5298,14652,1800,4431,1984,6138,3784,10569
150506,202305,16828,41303,14492,38253,2414,5884,9887,27556,12301,33440
150510,202305,16276,41964,14109,38552,1159,2911,11128,30487,12287,33398
150520,202305,10387,30938,9938,30413,140,761,9433,28605,9573,29366
150530,202305,15519,46410,13409,43457,1249,3445,10336,34380,11585,37825
150540,202305,6532,14674,5644,13392,350,810,4687,11021,5037,11831
150543,202305,9080,23043,7581,21138,735,2123,5664,16054,6399,18177
150548,202305,12995,34511,11536,32486,548,1469,9952,28221,10500,29690
150549,202305,2326,5803,1934,5255,99,316,1523,4093,1622,4409
150550,202305,25296,66627,20625,59287,6002,17845,7477,21987,13479,39832
150553,202305,50346,124219,38822,105696,10892,30382,15675,42638,26567,73020
150555,202305,2547,5998,1978,5166,185,459,1336,3578,1521,4037
150560,202305,2431,5971,2152,5526,217,534,1467,3748,1684,4282
150563,202305,3310,8695,2661,7568,630,1884,1334,3740,1964,5624
150565,202305,5588,16001,4936,15027,164,548,3920,12148,4084,12696
150570,202305,9908,23284,9092,22230,263,809,8184,19747,8447,20556
150580,202305,14474,48860,12382,46553,1880,5518,9266,37507,11146,43025
150590,202305,10515,30299,9037,28573,332,1104,8079,25766,8411,26870
150600,202305,13086,34263,12131,33113,433,1112,10952,30122,11385,31234
150610,202305,4048,9040,3602,8409,147,416,3092,7023,3239,7439
150611,202305,4073,9603,3525,8859,78,264,3080,7537,3158,7801
150613,202305,18257,45711,14005,38853,2984,8958,6577,17490,9561,26448
150616,202305,4634,11737,3350,9543,656,2031,1559,4240,2215,6271
150618,202305,9018,22565,7406,20139,1092,3217,4590,12307,5682,15524
150619,202305,7968,20347,6536,18381,1059,2646,4295,12636,5354,15282
150620,202305,9608,27657,8426,25690,1952,5573,4529,14558,6481,20131
150630,202305,9081,18784,8354,17922,138,339,7682,16204,7820,16543
150635,202305,6875,16163,5741,14406,715,1640,3762,9517,4477,11157
150640,202305,2536,6716,2289,6405,56,168,2058,5772,2114,5940
150650,202305,15151,36242,13143,33240,3993,9947,5434,14597,9427,24544
150655,202305,6904,17150,6271,16282,103,348,5671,14518,5774,14866
150658,202305,5408,14411,3884,11839,1084,3505,1547,4708,2631,8213
150660,202305,6954,17692,6001,16311,1411,3727,3214,8706,4625,12433
150670,202305,12692,24615,10233,21817,1213,2686,7648,16474,8861,19160
150680,202305,98483,244183,79611,216385,18041,45912,41630,120925,59671,166837
150690,202305,3279,7049,2833,6523,151,280,2425,5680,2576,5960
150700,202305,8720,21716,7761,20541,997,1985,5653,15908,6650,17893
150710,202305,4719,13369,4234,12650,747,2223,2689,8198,3436,10421
150715,202305,6617,15548,5426,13912,370,958,4375,11140,4745,12098
150720,202305,10578,25870,9758,24792,351,1060,8661,21728,9012,22788
150730,202305,16572,43921,14050,40243,2237,6760,9334,27054,11571,33814
150740,202305,5002,12258,4322,11246,512,1056,3114,8401,3626,9457
150745,202305,6973,17043,5581,15078,769,2253,3709,9979,4478,12232
150746,202305,2166,5419,1927,5082,73,181,1586,4116,1659,4297
150747,202305,6762,16366,6029,15361,446,982,4827,12411,5273,13393
150750,202305,4762,12520,3846,11225,441,1304,2695,8189,3136,9493
150760,202305,14503,37167,13046,35135,2639,6586,8012,22738,10651,29324
150770,202305,8917,26106,8172,25263,273,576,7401,23633,7674,24209
150775,202305,1491,3449,1177,3073,135,399,827,2136,962,2535
150780,202305,6268,16548,5567,15739,253,660,4985,14330,5238,14990
150790,202305,7823,18167,6660,16921,603,1158,4414,13345,5017,14503
150795,202305,21158,53744,18327,49814,3456,9388,11358,31590,14814,40978
150796,202305,5127,10393,4430,9600,222,436,3822,8276,4044,8712
150797,202305,5617,14388,4788,13237,577,1503,3690,10278,4267,11781
150800,202305,18569,49877,16507,47202,3173,8506,10360,31082,13533,39588
150803,202305,10947,24976,10053,23832,277,748,9164,21440,9441,22188
150805,202305,4488,12149,3769,11196,457,1317,2694,8208,3151,9525
150808,202305,8215,22052,6083,18562,2106,7206,842,2610,2948,9816
150810,202305,26908,59816,20868,52613,5010,12453,10670,29346,15680,41799
150812,202305,8279,18753,7382,17442,502,1482,5886,13246,6388,14728
150815,202305,11670,30984,9849,28826,1615,4728,7155,21314,8770,26042
150820,202305,19015,38485,16862,36005,1834,2701,13321,30146,15155,32847
150830,202305,16316,45258,15183,43883,608,1404,13585,40074,14193,41478
150835,202305,4516,11858,3867,10898,436,1262,2728,7633,3164,8895
150840,202305,10732,26553,8812,23674,1245,3762,5455,14113,6700,17875
160005,202305,1851,3853,1622,3592,65,160,1441,3161,1506,3321
160010,202305,2759,6689,2542,6464,22,88,2460,6219,2482,6307
160015,202305,5118,10486,4650,9964,467,801,4013,8782,4480,9583
160020,202305,3225,8262,2785,7689,370,889,2002,5827,2372,6716
160021,202305,1579,5081,1371,4828,68,301,991,3633,1059,3934
160023,202305,1748,5228,1532,4868,294,917,891,2961,1185,3878
160025,202305,2413,6180,2239,5991,106,201,2082,5657,2188,5858
160027,202305,14632,29724,13258,28078,935,1982,11310,23896,12245,25878
160030,202305,114648,266885,96329,243827,18167,43836,57581,152785,75748,196621
160040,202305,7829,22251,6944,21060,580,1573,5795,17929,6375,19502
160050,202305,8186,19513,6928,17941,2472,5644,3438,10181,5910,15825
160053,202305,5543,14115,4865,13202,287,697,4024,11138,4311,11835
160055,202305,2208,4229,2124,4138,34,90,2041,3945,2075,4035
160060,202305,39344,82937,33671,76614,3813,7084,26213,61881,30026,68965
160070,202305,3953,11702,3422,10952,467,1214,2467,8455,2934,9669
160080,202305,4048,10437,3544,9889,53,170,3285,9271,3338,9441
170025,202305,768,1925,446,1326,97,263,106,323,203,586
170030,202305,1361,3755,1016,3125,221,671,343,1099,564,1770
170035,202305,1688,3997,1249,3314,123,353,715,1793,838,2146
170040,202305,2206,5398,1705,4714,276,776,867,2534,1143,3310
170070,202305,2332,4953,1664,4113,116,323,961,2350,1077,2673
170100,202305,2995,7382,2440,6536,354,849,1539,4192,1893,5041
170105,202305,779,2060,491,1491,108,332,151,399,259,731
170110,202305,1298,3357,966,2827,84,327,568,1557,652,1884
170130,202305,1754,4328,1312,3611,117,368,845,2255,962,2623
170190,202305,1852,4334,1466,3757,191,621,924,2217,1115,2838
170200,202305,2339,5176,1560,3976,314,799,559,1341,873,2140
170210,202305,33600,83624,25574,70916,7246,21580,4784,13329,12030,34909
170215,202305,1507,3644,1188,3212,94,311,838,2201,932,2512
170220,202305,6790,19283,5515,17092,2516,7993,1107,3913,3623,11906
170230,202305,1482,3851,1125,3222,227,685,455,1234,682,1919
170240,202305,3572,8124,2876,7082,237,626,2121,5085,2358,5711
170255,202305,4361,11633,3311,9890,596,1878,1616,4782,2212,6660
170270,202305,978,2280,678,1804,85,226,374,950,459,1176
170290,202305,3744,9160,3231,8472,310,578,2452,6744,2762,7322
170300,202305,2583,5839,2094,5144,144,342,1578,3768,1722,4110
170305,202305,799,1995,647,1731,108,274,319,871,427,1145
170307,202305,1323,3625,1115,3289,148,488,713,1985,861,2473
170310,202305,1904,4286,1343,3434,187,518,696,1735,883,2253
170320,202305,1248,3030,916,2510,122,377,537,1449,659,1826
170330,202305,1183,3179,1074,3026,31,126,946,2602,977,2728
170360,202305,707,1625,516,1346,33,88,324,778,357,866
170370,202305,1594,3626,1111,2866,173,506,594,1399,767,1905
170380,202305,2115,5535,1628,4786,146,479,946,2858,1092,3337
170382,202305,588,1578,478,1401,23,91,323,886,346,977
170384,202305,2060,6232,1740,5675,360,1190,929,2976,1289,4166
170386,202305,1131,2918,692,2098,82,289,248,693,330,982
170388,202305,830,2016,610,1678,102,290,324,844,426,1134
170389,202305,967,2806,750,2431,130,453,393,1297,523,1750
170390,202305,2163,4278,1600,3615,68,167,1327,3021,1395,3188
170410,202305,718,1641,520,1323,38,117,343,803,381,920
170460,202305,500,1252,386,1065,51,154,232,630,283,784
170510,202305,1060,2700,764,2211,35,151,492,1285,527,1436
170550,202305,8134,19494,6253,16713,1702,4945,2125,5360,3827,10305
170555,202305,1623,3923,1287,3426,163,392,604,1634,767,2026
170560,202305,1134,2912,875,2546,118,341,477,1426,595,1767
170600,202305,1623,3962,1280,3463,189,452,754,2108,943,2560
170610,202305,1980,4556,1482,3821,128,404,983,2396,1111,2800
170625,202305,518,1256,361,977,51,134,140,337,191,471
170650,202305,1794,4387,1484,3922,133,396,1000,2510,1133,2906
170700,202305,4260,11362,3275,9532,686,2095,1400,3866,2086,5961
170710,202305,2044,4403,1557,3732,168,423,1070,2494,1238,2917
170720,202305,2244,4898,1651,4013,154,371,1177,2825,1331,3196
170730,202305,1309,3143,994,2698,130,285,612,1687,742,1972
170740,202305,2388,6991,2043,6398,151,542,1535,4704,1686,5246
170755,202305,1025,2471,716,1986,136,427,324,811,460,1238
170765,202305,1317,3125,956,2573,157,423,473,1219,630,1642
170770,202305,2213,5663,1793,5043,121,361,1334,3667,1455,4028
170820,202305,4688,12194,3544,10308,750,2226,1622,4591,2372,6817
170825,202305,1264,2625,1055,2366,104,230,790,1752,894,1982
170830,202305,1585,3760,1192,3137,342,1011,508,1165,850,2176
170900,202305,3666,9871,3174,9216,450,1113,2362,7119,2812,8232
170930,202305,4817,11819,3718,9931,852,2440,1290,3182,2142,5622
170950,202305,13881,35731,9978,29076,3023,9549,1320,3697,4343,13246
170980,202305,621,1430,396,1048,51,145,190,484,241,629
171050,202305,1986,5521,1680,5008,149,455,1251,3798,1400,4253
171070,202305,1586,3958,1359,3642,313,735,662,2069,975,2804
171090,202305,1163,2851,892,2434,165,489,450,1193,615,1682
171110,202305,663,1687,455,1316,64,180,210,564,274,744
171150,202305,1125,2582,676,1841,117,383,339,813,456,1196
171180,202305,820,2152,500,1556,90,272,184,574,274,846
171190,202305,2381,6776,1987,6097,327,1044,1137,3492,1464,4536
171195,202305,991,2757,762,2339,105,387,443,1261,548,1648
171200,202305,720,1876,519,1533,137,459,148,395,285,854
171215,202305,478,1142,382,990,59,175,174,402,233,577
171240,202305,898,2624,692,2272,14,83,475,1502,489,1585
171245,202305,900,2398,678,1977,71,234,349,931,420,1165
171250,202305,1098,2842,771,2279,133,428,308,893,441,1321
171270,202305,576,1830,444,1557,76,321,209,704,285,1025
171280,202305,1033,2780,830,2459,75,228,515,1523,590,1751
171320,202305,4726,12137,3562,10119,763,2241,1303,3640,2066,5881
171330,202305,3551,8771,2625,7210,732,2092,1090,2894,1822,4986
171360,202305,1876,4593,1356,3853,139,362,829,2565,968,2927
171370,202305,812,1920,629,1665,78,224,378,957,456,1181
171380,202305,1633,4077,1354,3695,186,468,894,2546,1080,3014
171395,202305,1178,2791,798,2181,124,359,450,1198,574,1557
171420,202305,2374,5826,1797,4843,341,937,923,2383,1264,3320
171430,202305,1285,3346,1044,2932,92,284,648,1706,740,1990
171488,202305,2975,7437,2306,6401,413,1198,1164,3142,1577,4340
171500,202305,1019,2408,687,1847,93,273,375,973,468,1246
171510,202305,1000,2794,841,2531,75,274,561,1618,636,1892
171515,202305,571,1273,399,1005,37,119,256,579,293,698
171525,202305,848,2070,628,1720,77,238,373,970,450,1208
171550,202305,404,1051,299,906,44,168,140,377,184,545
171570,202305,1294,3391,1099,3071,168,480,649,1815,817,2295
171575,202305,1880,4517,1263,3503,137,372,695,1871,832,2243
171610,202305,7148,18629,5306,15610,1422,4656,997,2986,2419,7642
171620,202305,3593,7945,3121,7310,162,378,2600,6065,2762,6443
171630,202305,1317,3157,989,2691,152,430,592,1627,744,2057
171650,202305,2692,7093,2045,5984,528,1693,437,1233,965,2926
171660,202305,2729,6267,1951,5080,165,492,1290,3251,1455,3743
171665,202305,1472,3799,1142,3282,277,881,448,1252,725,2133
171670,202305,2167,5259,1638,4389,278,810,751,1881,1029,2691
171700,202305,1350,3430,1019,2840,147,402,577,1559,724,1961
171720,202305,866,2030,654,1708,86,236,425,1096,511,1332
171750,202305,1601,4449,1148,3620,249,797,318,1164,567,1961
171780,202305,1503,3424,1068,2766,103,326,684,1668,787,1994
171790,202305,1613,4810,1301,4182,197,636,675,2131,872,2767
171800,202305,850,2054,652,1768,70,188,378,963,448,1151
171820,202305,14253,36530,10637,30777,2570,8105,2773,8047,5343,16152
171830,202305,1851,5207,1597,4809,391,1094,728,2422,1119,3516
171840,202305,837,2000,620,1665,23,71,370,942,393,1013
171845,202305,812,1798,611,1510,59,176,404,922,463,1098
171850,202305,1223,3182,1043,2845,45,173,846,2207,891,2380
171855,202305,1194,3344,990,2990,116,351,560,1661,676,2012
171865,202305,584,1503,492,1367,72,224,284,726,356,950
171870,202305,922,2327,647,1857,131,405,286,783,417,1188
171875,202305,1751,4177,1454,3749,61,243,1154,2834,1215,3077
171880,202305,1790,4154,1536,3813,53,139,1224,3003,1277,3142
171884,202305,1367,3162,1048,2663,200,492,579,1466,779,1958
171886,202305,1727,4320,1285,3705,348,1114,317,964,665,2078
171888,202305,682,1815,457,1367,37,134,260,715,297,849
171889,202305,504,1439,339,1103,92,317,98,297,190,614
171890,202305,1539,3989,1108,3270,144,465,666,1918,810,2383
171900,202305,673,2024,514,1719,74,212,249,833,323,1045
172000,202305,661,1842,505,1551,92,294,186,548,278,842
172010,202305,1533,4201,1274,3791,122,329,794,2378,916,2707
172015,202305,433,1367,328,1169,57,213,142,483,199,696
172020,202305,3449,8657,2992,8086,331,891,2093,5822,2424,6713
172025,202305,858,2097,615,1718,53,161,427,1150,480,1311
172030,202305,1438,3871,1157,3412,103,358,822,2375,925,2733
172049,202305,1388,3275,924,2620,123,335,478,1388,601,1723
172065,202305,1744,3956,1368,3485,172,356,857,2456,1029,2812
172080,202305,2726,7259,2220,6397,133,430,1488,4190,1621,4620
172085,202305,496,1259,307,884,54,151,100,260,154,411
172090,202305,4911,10567,3934,9293,150,399,3217,7377,3367,7776
172093,202305,530,1467,389,1219,29,126,233,684,262,810
172097,202305,766,1848,504,1410,87,280,173,450,260,730
172100,202305,63282,143826,47538,120278,9142,25788,20770,50361,29912,76149
172110,202305,2063,6362,1768,5938,115,475,1384,4605,1499,5080
172120,202305,6237,16199,4897,14088,578,1699,2939,8360,3517,10059
172125,202305,479,1175,365,994,28,102,202,477,230,579
172130,202305,639,1529,469,1245,20,74,291,691,311,765
172208,202305,2967,6494,2279,5569,194,455,1648,3982,1842,4437
172210,202305,3119,6965,2466,6176,271,606,1630,4236,1901,4842
210005,202305,23593,60418,17755,51399,4922,15078,7029,20376,11951,35454
210010,202305,2641,6565,2427,6325,43,182,2241,5757,2284,5939
210015,202305,3736,10028,3230,9360,138,419,2707,7846,2845,8265
210020,202305,9605,18634,8363,17186,468,656,7429,15494,7897,16150
210030,202305,5340,16012,4867,15312,521,1696,3819,12045,4340,13741
210040,202305,2539,4996,2243,4646,67,186,2038,4122,2105,4308
210043,202305,6766,17424,5722,16030,391,1181,4483,12546,4874,13727
210047,202305,8243,21631,6481,19350,153,594,5586,16610,5739,17204
210050,202305,2977,8029,2395,7027,162,608,1823,5150,1985,5758
210055,202305,2542,6523,2215,6079,55,149,1918,5372,1973,5521
210060,202305,8690,28727,7716,27028,990,3555,5115,18387,6105,21942
210070,202305,8015,18620,7419,17873,104,262,6939,16633,7043,16895
210080,202305,5342,14553,5013,14205,38,197,4683,13228,4721,13425
210083,202305,7201,16517,6109,15342,103,338,5756,14378,5859,14716
210087,202305,3109,8024,2649,7417,113,344,2230,6232,2343,6576
210090,202305,10752,29505,9876,28144,484,1129,8439,24164,8923,25293
210095,202305,7308,22560,6616,21633,744,2390,4934,16772,5678,19162
210100,202305,7561,20810,6520,19025,938,2635,4196,12418,5134,15053
210110,202305,3695,9210,3378,8819,47,204,3094,7989,3141,8193
210120,202305,35041,74760,30054,68691,1428,2732,24373,56062,25801,58794
210125,202305,5438,12905,4735,12111,999,1981,3135,8754,4134,10735
210130,202305,4892,11264,3988,10166,65,156,3541,9001,3606,9157
210135,202305,2152,4704,1778,4179,53,115,1546,3611,1599,3726
210140,202305,25438,60841,20147,53934,2948,7722,12505,33790,15453,41512
210150,202305,5549,11852,4856,10934,106,306,4223,9288,4329,9594
210160,202305,26331,59062,22530,54386,1888,3911,17683,43526,19571,47437
210170,202305,21245,53454,19322,50919,2089,4598,14744,40154,16833,44752
210173,202305,2524,8249,2389,8046,88,389,2079,6937,2167,7326
210177,202305,3810,9545,3273,8862,461,1146,2425,6777,2886,7923
210180,202305,1837,4084,1609,3817,31,75,1458,3464,1489,3539
210190,202305,6839,15000,5782,13629,107,262,4998,11627,5105,11889
210193,202305,1576,3970,1357,3642,53,159,1053,2809,1106,2968
210197,202305,2320,6481,2082,6155,167,450,1651,4993,1818,5443
210200,202305,9607,26250,8434,24578,716,2171,6534,19005,7250,21176
210203,202305,8131,21603,6804,19920,594,1675,5232,15744,5826,17419
210207,202305,4508,10010,3698,9084,161,375,3084,7674,3245,8049
210210,202305,8743,24506,7811,23235,127,656,6740,19761,6867,20417
210215,202305,2868,8095,2499,7579,146,598,2051,6140,2197,6738
210220,202305,8457,23211,7968,22552,259,1098,7105,19611,7364,20709
210230,202305,6840,17207,6259,16337,162,422,5693,14834,5855,15256
210232,202305,14391,38511,11939,35026,1635,4739,8116,24513,9751,29252
210235,202305,3952,10672,3447,9961,154,533,2866,8236,3020,8769
210237,202305,5020,10756,4310,9970,46,137,4083,9347,4129,9484
210240,202305,3001,8106,2673,7620,102,265,2158,6156,2260,6421
210250,202305,7181,17663,6498,16815,102,387,5976,15324,6078,15711
210255,202305,3122,8521,2628,7635,315,991,1640,4601,1955,5592
210260,202305,6298,16629,5450,15416,470,1402,4326,12185,4796,13587
210270,202305,5669,13657,4996,12821,74,333,4524,11449,4598,11782
210275,202305,3928,9003,3345,8312,182,405,2745,6875,2927,7280
210280,202305,7566,17088,6349,15407,138,580,5361,12455,5499,13035
210290,202305,9890,21493,8865,20284,114,310,8396,19105,8510,19415
210300,202305,37540,95510,30812,86023,7900,22156,13087,40783,20987,62939
210310,202305,3576,7961,3091,7313,32,94,2827,6628,2859,6722
210312,202305,3460,7205,3072,6789,22,72,2832,6150,2854,6222
210315,202305,4340,9447,3888,8953,117,261,3615,8336,3732,8597
210317,202305,5148,14192,4687,13652,111,444,4271,12376,4382,12820
210320,202305,33452,70505,31285,67929,233,1067,29646,63242,29879,64309
210325,202305,4063,10591,3345,9606,594,1820,2183,6191,2777,8011
210330,202305,31312,74254,25324,67172,3820,8172,16994,49583,20814,57755
210340,202305,15142,33097,13676,31351,681,1248,11602,27183,12283,28431
210350,202305,11564,27738,10163,26030,125,394,9245,23489,9370,23883
210355,202305,4386,13413,3869,12615,97,461,3242,10531,3339,10992
210360,202305,14762,42263,13115,39703,568,2340,9747,28490,10315,30830
210370,202305,14498,27072,10862,23280,287,438,10053,21821,10340,22259
210375,202305,3783,9627,2771,8104,1042,3221,572,1749,1614,4970
210380,202305,6602,15162,5717,14103,240,648,4946,12085,5186,12733
210390,202305,3837,9622,3584,9265,59,225,3302,8437,3361,8662
210400,202305,5365,13610,4764,12926,288,545,4194,11737,4482,12282
210405,202305,8743,20174,7214,18154,1174,2683,4547,11904,5721,14587
210407,202305,2439,6896,2057,6246,157,452,1533,4705,1690,5157
210408,202305,3231,10387,2982,10070,182,760,2405,8172,2587,8932
210409,202305,4496,13629,4005,12918,217,781,3193,10513,3410,11294
210410,202305,4323,11258,3638,10050,79,322,3008,8067,3087,8389
210420,202305,4508,12955,3980,12056,240,683,3248,9870,3488,10553
210430,202305,2668,6970,2324,6512,200,549,1912,5395,2112,5944
210440,202305,4964,12156,4323,11386,184,383,3855,10231,4039,10614
210450,202305,2643,6992,2279,6487,295,705,1651,4901,1946,5606
210455,202305,5815,13399,4551,11832,1132,3092,2095,5477,3227,8569
210460,202305,3930,10352,3264,9476,119,420,2689,7709,2808,8129
210462,202305,1955,5315,1635,4843,60,178,1282,3806,1342,3984
210465,202305,3118,8001,2699,7445,130,456,2280,6184,2410,6640
210467,202305,7257,18954,6220,17615,864,2311,4593,13381,5457,15692
210470,202305,1989,5233,1595,4694,206,565,1094,3311,1300,3876
210480,202305,19805,52962,16534,48968,2318,4883,11389,37431,13707,42314
210490,202305,3843,8697,3046,7642,87,218,2588,6460,2675,6678
210500,202305,7524,24819,6969,23942,379,1513,5859,20038,6238,21551
210510,202305,8048,20665,7229,19796,109,302,6739,18571,6848,18873
210515,202305,4363,11598,3710,10789,221,650,3054,9012,3275,9662
210520,202305,3025,7958,2722,7576,156,484,2268,6242,2424,6726
210530,202305,66866,150892,52775,131111,10588,27648,24305,62625,34893,90273
210535,202305,4384,12011,3973,11457,146,494,3499,10090,3645,10584
210540,202305,17962,46341,14943,42012,2427,6115,9376,28094,11803,34209
210542,202305,7472,16283,5835,14412,612,1499,4393,10904,5005,12403
210545,202305,2461,7036,2261,6699,51,204,1927,5643,1978,5847
210547,202305,4330,13818,3866,13048,277,858,2947,10256,3224,11114
210550,202305,6732,18879,5212,16496,742,2469,3026,9844,3768,12313
210560,202305,4282,12102,3790,11351,107,366,3222,9548,3329,9914
210565,202305,1763,4610,1435,4165,108,353,1039,3035,1147,3388
210570,202305,12626,31629,11226,29924,266,689,10031,26915,10297,27604
210580,202305,3380,7926,2649,7017,208,516,1920,5313,2128,5829
210590,202305,4739,12900,4054,12043,89,440,3609,10639,3698,11079
210592,202305,3339,8183,3118,7859,37,156,2759,6793,2796,6949
210594,202305,2843,7409,2218,6440,241,665,1507,4489,1748,5154
210596,202305,3442,10286,3017,9584,364,1159,2218,7226,2582,8385
210598,202305,2390,5798,2143,5483,109,303,1858,4743,1967,5046
210600,202305,3517,8888,2835,7922,374,977,1831,5165,2205,6142
210610,202305,3690,8453,3124,7774,58,214,2700,6616,2758,6830
210620,202305,3538,7749,2891,6967,155,334,2431,5816,2586,6150
210630,202305,3711,10535,3299,9841,242,798,2528,7493,2770,8291
210632,202305,7235,16443,6427,15421,180,585,5769,13564,5949,14149
210635,202305,1820,6035,1708,5824,196,606,1280,4500,1476,5106
210637,202305,3120,8742,2612,8037,155,559,2013,6261,2168,6820
210640,202305,5880,16680,5437,16186,53,263,5074,15023,5127,15286
210650,202305,8098,20433,7287,19442,114,395,6492,17288,6606,17683
210660,202305,9308,24250,8400,22864,144,650,7317,19325,7461,19975
210663,202305,3616,8170,3188,7668,348,586,2364,6191,2712,6777
210667,202305,2247,6419,1982,6023,55,177,1704,5269,1759,5446
210670,202305,6854,17141,6165,16122,129,474,5549,14251,5678,14725
210675,202305,6517,14429,5396,13034,681,1467,4057,10039,4738,11506
210680,202305,5771,11693,4908,10703,78,137,4618,10056,4696,10193
210690,202305,11264,25210,9579,23322,268,749,8759,21096,9027,21845
210700,202305,3220,7831,2534,6855,172,424,1914,5214,2086,5638
210710,202305,6333,16323,5576,15364,100,395,5020,13701,5120,14096
210720,202305,3561,10040,3093,9473,103,404,2712,8302,2815,8706
210725,202305,1524,4353,1310,4040,51,158,939,3007,990,3165
210730,202305,1724,3559,1428,3169,56,100,1257,2804,1313,2904
210735,202305,5246,13309,4456,12348,390,945,3547,10264,3937,11209
210740,202305,6086,13880,5218,12912,122,260,4480,11016,4602,11276
210745,202305,4901,11941,4403,11337,59,191,3953,10089,4012,10280
210750,202305,31545,74832,27577,69718,4598,10170,17334,46344,21932,56514
210760,202305,7511,15503,6378,14303,106,193,5974,13552,6080,13745
210770,202305,7360,16237,6299,15034,50,199,5877,13874,5927,14073
210780,202305,8614,23818,7461,21972,524,1537,5826,17094,6350,18631
210790,202305,5167,14105,4542,13272,334,879,3670,11066,4004,11945
210800,202305,5720,13640,4932,12600,67,269,4476,11220,4543,11489
210805,202305,4964,15313,4531,14672,228,766,3748,12234,3976,13000
210810,202305,5823,15129,5226,14387,479,1155,4207,11936,4686,13091
210820,202305,8313,21570,6945,19460,1082,2884,4084,11811,5166,14695
210825,202305,10277,23399,9374,22280,224,624,8655,20352,8879,20976
210830,202305,10558,24322,9574,23161,943,1586,7772,19762,8715,21348
210840,202305,5962,10251,5491,9708,26,118,5249,9050,5275,9168
210845,202305,7257,17275,6343,16241,85,193,5994,15439,6079,15632
210850,202305,8400,21845,6993,19868,471,1354,5646,16048,6117,17402
210860,202305,25460,55771,21060,50527,1459,2855,16998,42161,18457,45016
210870,202305,8777,19157,6993,17147,205,408,6225,15294,6430,15702
210880,202305,4855,13003,4307,12283,221,682,3435,9732,3656,10414
210890,202305,5929,12975,5450,12431,165,416,4950,11139,5115,11555
210900,202305,5719,14960,4487,12865,1644,4753,896,2900,2540,7653
210905,202305,2709,5587,2328,5132,48,78,2185,4825,2233,4903
210910,202305,8662,24368,7182,22046,1234,3765,4236,13124,5470,16889
210920,202305,3663,10183,3263,9651,63,263,2991,8756,3054,9019
210923,202305,2318,5168,1990,4721,95,222,1637,3802,1732,4024
210927,202305,5401,16239,4709,15378,818,2588,2961,10195,3779,12783
210930,202305,3434,8883,3016,8178,84,343,2626,6868,2710,7211
210940,202305,4066,10885,3663,10383,295,1311,2973,7795,3268,9106
210945,202305,9971,22643,8930,21465,782,1289,7247,18253,8029,19542
210950,202305,6333,15685,4925,13724,626,1362,3295,9841,3921,11203
210955,202305,1760,4844,1464,4379,224,641,913,2747,1137,3388
210960,202305,10907,29270,9293,26779,3621,10439,2942,9501,6563,19940
210970,202305,2071,4774,1709,4219,98,274,1425,3377,1523,3651
210975,202305,1986,5526,1798,5251,232,695,1272,3696,1504,4391
210980,202305,12619,24393,11351,23079,196,275,10726,21861,10922,22136
210990,202305,21170,51916,16652,46222,1766,4276,11778,34008,13544,38284
211000,202305,17015,43467,14064,39831,3105,7811,8846,26904,11951,34715
211003,202305,7485,17374,6286,15988,103,397,5592,14168,5695,14565
211010,202305,8244,23439,7474,22501,71,327,6887,20829,6958,21156
211020,202305,10994,25716,9726,24327,194,562,8718,22113,8912,22675
211023,202305,2449,6986,2237,6715,152,423,1807,5437,1959,5860
211027,202305,4701,11459,4412,11039,95,304,4111,10158,4206,10462
211030,202305,4449,11158,3975,10571,419,1051,2955,8014,3374,9065
211040,202305,5199,16481,4772,15778,124,604,4236,13879,4360,14483
211050,202305,10764,24187,9611,22782,125,396,8778,20670,8903,21066
211060,202305,9167,22367,8317,21259,179,601,7488,18824,7667,19425
211065,202305,2932,6733,2447,6145,127,264,2095,5345,2222,5609
211070,202305,10040,26815,8573,24715,355,1122,7291,20911,7646,22033
211080,202305,1543,3729,1225,3254,31,160,952,2341,983,2501
211085,202305,2567,6368,2133,5830,242,489,1622,4717,1864,5206
211090,202305,3646,8970,3315,8600,32,106,3069,7919,3101,8025
211100,202305,9031,18318,8376,17595,46,112,7937,16596,7983,16708
211102,202305,3904,10976,3539,10467,464,1407,2678,7933,3142,9340
211105,202305,2713,7585,2318,6935,139,418,1807,5333,1946,5751
211107,202305,5426,15428,4647,14285,170,563,3742,11949,3912,12512
211110,202305,7608,17589,6109,15433,284,845,5025,12336,5309,13181
211120,202305,61038,132570,50446,120119,8744,19122,31819,78668,40563,97790
211125,202305,2151,5856,1818,5382,36,170,1541,4522,1577,4692
211130,202305,227924,487970,197785,449132,26605,54199,133694,309775,160299,363974
211140,202305,5449,14523,4711,13588,170,514,3947,11465,4117,11979
211150,202305,11428,26777,9592,24526,581,1129,7630,20255,8211,21384
211153,202305,3556,8570,2455,7206,483,1240,1449,4615,1932,5855
211157,202305,1499,4134,1284,3742,113,351,917,2632,1030,2983
211160,202305,6452,14026,5321,12546,143,454,4452,9965,4595,10419
211163,202305,1705,4944,1537,4706,68,220,1278,3974,1346,4194
211167,202305,2053,5207,1887,4992,33,106,1757,4617,1790,4723
211170,202305,8729,16966,8073,16235,62,152,7681,15268,7743,15420
211172,202305,2994,7550,2493,6816,88,293,2019,5313,2107,5606
211174,202305,3386,8512,3070,8173,30,146,2932,7738,2962,7884
211176,202305,4884,12513,3862,11085,282,886,3027,8640,3309,9526
211178,202305,6414,12125,5558,11230,27,100,5375,10761,5402,10861
211180,202305,4886,14264,4452,13653,171,667,3699,11242,3870,11909
211190,202305,3808,9379,3280,8643,32,160,2985,7746,3017,7906
211195,202305,1902,4382,1663,4052,83,183,1442,3517,1525,3700
211200,202305,2436,6681,1930,5874,210,676,1329,3986,1539,4662
211210,202305,7079,19774,6327,18749,538,1559,4993,14901,5531,16460
211220,202305,52480,111770,44178,101735,4107,8872,33791,77607,37898,86479
211223,202305,6193,15056,4998,13480,703,1924,3136,8460,3839,10384
211227,202305,1985,5563,1699,5158,53,190,1410,4296,1463,4486
211230,202305,10176,24714,8737,22770,311,641,7583,19893,7894,20534
211240,202305,12475,27942,11769,27108,129,506,11269,25581,11398,26087
211245,202305,9187,19709,8082,18550,187,414,7649,17483,7836,17897
211250,202305,18239,46645,16498,44093,1383,3681,12991,34550,14374,38231
211260,202305,9830,26833,8453,25282,174,633,7613,22863,7787,23496
211270,202305,11872,32987,10162,30818,392,1414,8380,25556,8772,26970
211280,202305,19259,40441,17298,38110,326,728,16037,35122,16363,35850
211285,202305,2387,6642,2128,6323,198,622,1541,4581,1739,5203
211290,202305,8429,22537,7512,21260,367,1053,6108,17204,6475,18257
211300,202305,8299,22258,7185,20458,480,1453,5430,15183,5910,16636
211400,202305,13795,33919,11264,30527,1583,4037,7408,20958,8991,24995
220005,202305,2335,5242,2124,4974,54,125,1776,4028,1830,4153
220010,202305,1761,4398,1441,3876,81,164,1101,2984,1182,3148
220020,202305,5592,11733,4838,10777,302,622,4149,9150,4451,9772
220025,202305,2722,5314,2330,4761,57,102,1971,3891,2028,3993
220027,202305,1627,3463,1422,3197,25,71,1238,2702,1263,2773
220030,202305,4648,9664,4271,9200,99,247,3807,8023,3906,8270
220040,202305,9876,26130,8580,23833,1682,4342,4852,13913,6534,18255
220045,202305,1926,4824,1598,4334,23,108,1371,3604,1394,3712
220050,202305,6776,14222,5992,13283,60,186,5651,12307,5711,12493
220060,202305,3458,5835,3011,5340,77,113,2823,4993,2900,5106
220070,202305,2785,6402,2274,5695,70,181,1904,4685,1974,4866
220080,202305,868,2224,746,2053,20,74,625,1685,645,1759
220090,202305,2013,4263,1646,3725,57,91,1396,3154,1453,3245
220095,202305,1216,2154,1155,2090,26,44,1078,1941,1104,1985
220100,202305,1661,3951,1325,3463,38,118,1066,2668,1104,2786
220105,202305,2366,6424,2030,5872,171,528,1487,4280,1658,4808
220110,202305,4222,9849,3624,8903,43,166,3227,7793,3270,7959
220115,202305,3434,8654,3140,8280,159,449,2735,7158,2894,7607
220117,202305,1577,3366,1263,2947,23,66,1057,2374,1080,2440
220120,202305,20785,39391,19344,37679,87,265,18418,35315,18505,35580
220130,202305,1320,3091,1097,2791,30,122,970,2386,1000,2508
220140,202305,2839,5087,2429,4621,85,146,2162,4173,2247,4319
220150,202305,7846,19510,7092,18289,159,524,5973,14948,6132,15472
220155,202305,1390,3642,1104,3137,27,100,778,2125,805,2225
220157,202305,1309,2760,1098,2462,32,65,895,1963,927,2028
220160,202305,3386,8170,2864,7278,56,186,2340,5725,2396,5911
220170,202305,1798,4364,1499,3949,32,106,1281,3336,1313,3442
220173,202305,2492,6287,1898,5240,45,139,1490,3961,1535,4100
220177,202305,2851,6121,2709,5970,8,25,2670,5858,2678,5883
220180,202305,1379,2822,1140,2451,3,17,957,1920,960,1937
220190,202305,10161,20082,8679,18252,683,1205,6654,14367,7337,15572
220191,202305,1962,5148,1783,4872,152,452,1299,3459,1451,3911
220192,202305,2395,5669,1748,4609,45,141,1412,3656,1457,3797
220194,202305,2240,5284,1933,4793,43,160,1612,3791,1655,3951
220196,202305,2548,5746,2332,5440,18,79,2006,4573,2024,4652
220198,202305,1555,3447,1321,3161,12,19,1202,2905,1214,2924
220200,202305,5931,15520,5218,14553,167,573,4351,11998,4518,12571
220202,202305,2527,6129,2164,5577,30,126,1844,4635,1874,4761
220205,202305,3245,7483,2910,6930,80,222,2489,5760,2569,5982
220207,202305,927,2435,795,2226,92,223,495,1441,587,1664
220208,202305,2123,5871,1732,5180,445,1377,722,2157,1167,3534
220209,202305,1848,4888,1537,4328,38,144,1156,3142,1194,3286
220210,202305,2277,4594,1994,4203,25,68,1749,3572,1774,3640
220211,202305,2006,4160,1828,3935,18,63,1611,3393,1629,3456
220213,202305,2131,4943,1819,4443,31,95,1463,3380,1494,3475
220217,202305,2901,6919,2674,6662,158,229,2369,6117,2527,6346
220220,202305,16558,32727,14395,29784,433,959,12331,24880,12764,25839
220225,202305,1202,2636,974,2355,2,12,926,2212,928,2224
220230,202305,6888,15004,5991,13817,487,924,4959,11571,5446,12495
220240,202305,3915,9622,3176,8388,97,358,2583,6591,2680,6949
220245,202305,2498,4342,1936,3692,9,35,1819,3407,1828,3442
220250,202305,3643,8712,3193,8164,28,100,2987,7580,3015,7680
220253,202305,1984,4795,1658,4312,37,126,1399,3544,1436,3670
220255,202305,2390,4939,2031,4449,43,140,1763,3705,1806,3845
220260,202305,6223,15032,5405,13694,258,641,4362,10962,4620,11603
220265,202305,1861,4788,1697,4574,75,259,1426,3733,1501,3992
220270,202305,7292,20978,6853,20216,211,922,5772,16376,5983,17298
220271,202305,1783,3932,1576,3653,61,138,1354,3095,1415,3233
220272,202305,2060,5345,1774,4836,55,182,1358,3534,1413,3716
220273,202305,1495,3922,1208,3405,62,201,888,2470,950,2671
220275,202305,3114,5904,2563,5187,76,107,2312,4659,2388,4766
220277,202305,2809,5830,2380,5262,88,178,1999,4322,2087,4500
220280,202305,2391,4326,2021,3877,21,38,1843,3470,1864,3508
220285,202305,2023,4016,1753,3691,9,38,1683,3487,1692,3525
220290,202305,8337,20391,6698,18185,613,1444,4672,13211,5285,14655
220300,202305,2271,5907,1772,5255,45,202,1422,4176,1467,4378
220310,202305,3857,8920,3099,8050,52,169,2715,7007,2767,7176
220320,202305,3672,9269,2832,7858,57,261,2276,6046,2333,6307
220323,202305,2034,5004,1578,4301,47,161,1323,3492,1370,3653
220325,202305,1433,3914,1177,3472,34,136,938,2708,972,2844
220327,202305,1999,4845,1766,4487,76,243,1474,3626,1550,3869
220330,202305,6575,12885,5699,11884,90,244,5262,10789,5352,11033
220335,202305,2231,5483,2057,5255,137,252,1708,4452,1845,4704
220340,202305,2068,5161,1556,4302,120,385,940,2502,1060,2887
220342,202305,1489,3660,1318,3417,120,213,999,2679,1119,2892
220345,202305,3553,7164,2759,6115,19,60,2471,5364,2490,5424
220350,202305,3845,8894,3110,7829,244,565,2158,5372,2402,5937
220360,202305,1587,3538,1221,2960,15,54,995,2316,1010,2370
220370,202305,10931,26967,9931,25478,452,1130,8360,21260,8812,22390
220375,202305,2054,4777,1825,4508,11,20,1760,4346,1771,4366
220380,202305,1865,3719,1466,3191,27,43,1264,2745,1291,2788
220385,202305,1130,2209,919,1868,3,5,830,1644,833,1649
220390,202305,15919,33348,12827,29100,2256,5156,7167,15967,9423,21123
220400,202305,1811,3865,1385,3227,19,54,1085,2396,1104,2450
220410,202305,1397,3412,1129,2975,28,98,933,2392,961,2490
220415,202305,984,2308,798,1991,23,44,613,1497,636,1541
220420,202305,2164,5664,1737,4851,137,432,1157,3103,1294,3535
220430,202305,3539,7479,3112,6934,39,95,2827,6187,2866,6282
220435,202305,2475,5237,2142,4729,41,108,1825,3888,1866,3996
220440,202305,3947,8921,3368,8132,74,313,2990,6898,3064,7211
220450,202305,3315,7257,2774,6598,50,169,2453,5718,2503,5887
220455,202305,1731,4201,1630,4078,16,56,1505,3762,1521,3818
220460,202305,1391,2782,1268,2613,28,66,1122,2232,1150,2298
220465,202305,2905,7759,2568,7267,201,565,2008,5704,2209,6269
220470,202305,4630,11006,4072,10147,219,435,3119,7714,3338,8149
220480,202305,3153,7449,2481,6462,269,490,1602,4247,1871,4737
220490,202305,2863,6358,2446,5853,28,126,2143,5001,2171,5127
220500,202305,3973,8537,3307,7561,152,271,2540,5702,2692,5973
220510,202305,3233,7522,2643,6558,137,325,2065,5176,2202,5501
220515,202305,2190,4445,1990,4175,67,82,1718,3600,1785,3682
220520,202305,6243,13801,5673,13021,116,260,4884,11088,5000,11348
220525,202305,1650,3522,1374,3197,32,65,1234,2891,1266,2956
220527,202305,1978,4167,1645,3667,67,137,1449,3227,1516,3364
220530,202305,2012,4035,1668,3610,167,335,1251,2813,1418,3148
220535,202305,952,2347,890,2253,27,98,722,1746,749,1844
220540,202305,3820,10602,3489,9968,222,598,2784,7906,3006,8504
220545,202305,1814,4666,1620,4390,88,306,1358,3615,1446,3921
220550,202305,10387,29348,9125,27026,614,1962,6516,18720,7130,20682
220551,202305,1739,4123,1505,3732,18,45,1274,3092,1292,3137
220552,202305,1890,4930,1536,4339,22,104,1235,3326,1257,3430
220553,202305,2573,5042,2169,4537,20,37,1983,4094,2003,4131
220554,202305,1144,2486,891,2123,76,152,645,1507,721,1659
220555,202305,4754,8515,4218,7905,27,67,3805,7110,3832,7177
220556,202305,1532,3825,1292,3425,43,187,941,2309,984,2496
220557,202305,2281,5947,1620,4587,109,379,1182,3181,1291,3560
220558,202305,1758,4026,1417,3567,31,108,1210,2948,1241,3056
220559,202305,2204,4705,1877,4223,76,134,1525,3418,1601,3552
220560,202305,2328,4368,1994,3975,19,37,1880,3712,1899,3749
220570,202305,9846,25122,8802,23589,822,2045,6650,17716,7472,19761
220580,202305,8069,19279,7284,18174,108,303,6472,16019,6580,16322
220585,202305,2497,6853,2062,6053,60,151,1666,4881,1726,5032
220590,202305,1983,4158,1651,3712,104,212,1357,2992,1461,3204
220595,202305,3340,7948,2991,7480,85,298,2533,6156,2618,6454
220600,202305,2224,3758,1933,3431,25,41,1833,3223,1858,3264
220605,202305,1695,4566,1435,4089,21,101,1140,3136,1161,3237
220610,202305,3534,8325,3292,8008,12,66,3118,7503,3130,7569
220620,202305,10804,25825,9884,24608,124,582,9083,22145,9207,22727
220630,202305,429,1131,322,947,33,105,193,528,226,633
220635,202305,2126,5585,1864,5085,61,183,1502,3988,1563,4171
220640,202305,2812,6974,2444,6468,78,271,1964,5097,2042,5368
220650,202305,2960,6573,2535,5953,66,144,2138,5001,2204,5145
220660,202305,3044,8345,2525,7502,66,311,2080,5976,2146,6287
220665,202305,1673,4135,1451,3797,29,127,1268,3214,1297,3341
220667,202305,1904,4995,1737,4726,71,227,1419,3805,1490,4032
220669,202305,1958,5126,1845,4972,32,129,1658,4363,1690,4492
220670,202305,2815,5905,2280,5179,31,76,2009,4477,2040,4553
220672,202305,4095,8965,3427,8162,101,330,3039,7082,3140,7412
220675,202305,1517,3721,1361,3449,99,275,1021,2539,1120,2814
220680,202305,3749,7818,3553,7584,207,316,3153,6810,3360,7126
220690,202305,1857,4347,1586,3952,133,362,1182,2869,1315,3231
220695,202305,1107,2740,990,2540,20,54,825,2080,845,2134
220700,202305,15244,29209,12593,25804,495,1050,10434,20616,10929,21666
220710,202305,1049,2536,754,2057,31,90,561,1470,592,1560
220720,202305,2687,5347,2414,5020,27,75,2159,4376,2186,4451
220730,202305,1692,3851,1463,3509,18,63,1284,2982,1302,3045
220735,202305,1207,2427,938,2036,48,90,708,1496,756,1586
220740,202305,1607,3701,1272,3267,59,139,1026,2654,1085,2793
220750,202305,5268,10875,4656,10089,262,434,4122,9016,4384,9450
220755,202305,1819,3661,1513,3248,38,73,1273,2676,1311,2749
220760,202305,4206,8955,3673,8282,43,138,3460,7748,3503,7886
220770,202305,34614,85880,29890,78461,8497,23693,12108,31333,20605,55026
220775,202305,1760,3592,1567,3365,3,8,1529,3262,1532,3270
220777,202305,1813,4100,1475,3609,42,82,1035,2672,1077,2754
220779,202305,1419,3450,1221,3153,49,134,1006,2566,1055,2700
220780,202305,7250,15523,6453,14422,468,994,4989,11127,5457,12121
220785,202305,1725,3439,1534,3215,16,33,1458,3030,1474,3063
220790,202305,12562,30313,11287,28584,243,802,9742,24238,9985,25040
220793,202305,1180,2626,965,2278,14,25,833,1942,847,1967
220795,202305,1632,3752,1443,3500,29,83,1268,3060,1297,3143
220800,202305,26365,49479,22825,44980,2222,4494,17640,33629,19862,38123
220810,202305,3712,8921,3128,8018,73,157,2541,6581,2614,6738
220820,202305,7361,15231,6515,14086,324,543,5457,11811,5781,12354
220830,202305,9306,20703,8274,19266,447,983,6717,15314,7164,16297
220840,202305,16428,40721,14119,36753,1801,4570,9380,23806,11181,28376
220850,202305,3535,9641,3148,9160,56,263,2800,8137,2856,8400
220855,202305,1054,1974,913,1802,23,58,840,1639,863,1697
220860,202305,1480,2876,1264,2577,24,67,1179,2356,1203,2423
220865,202305,2658,6631,2048,5570,59,233,1511,3916,1570,4149
220870,202305,3967,8802,3307,7982,35,132,3015,7153,3050,7285
220880,202305,8164,14472,7055,13168,183,338,6461,11968,6644,12306
220885,202305,1820,4354,1522,3921,117,313,1197,3054,1314,3367
220887,202305,1978,3599,1658,3191,41,51,1531,2934,1572,2985
220890,202305,1659,4435,1421,4092,50,175,1149,3289,1199,3464
220900,202305,2596,5172,2191,4647,24,65,1964,4073,1988,4138
220910,202305,2181,4652,1852,4187,298,487,1308,3133,1606,3620
220915,202305,1074,2661,841,2267,28,88,609,1552,637,1640
220920,202305,1939,4913,1683,4585,118,294,1370,3789,1488,4083
220930,202305,2378,5004,2010,4525,19,56,1828,4166,1847,4222
220935,202305,1254,3287,959,2670,16,77,653,1712,669,1789
220937,202305,1749,4057,1478,3636,35,105,1181,2804,1216,2909
220940,202305,2279,4747,1857,4080,41,106,1582,3360,1623,3466
220945,202305,584,1794,463,1580,22,113,322,1067,344,1180
220950,202305,1621,3338,1128,2623,8,20,918,2020,926,2040
220955,202305,2034,4339,1688,3798,19,39,1484,3280,1503,3319
220960,202305,877,2069,633,1663,44,155,408,969,452,1124
220965,202305,2252,5087,1929,4618,15,73,1709,3959,1724,4032
220970,202305,2591,4999,1943,4111,10,28,1715,3499,1725,3527
220975,202305,910,2083,769,1909,12,43,677,1635,689,1678
220980,202305,1582,3587,1407,3360,33,85,1239,2891,1272,2976
220985,202305,1754,3703,1524,3371,101,178,1186,2586,1287,2764
220987,202305,1782,4509,1619,4261,48,162,1365,3529,1413,3691
220990,202305,1937,4793,1725,4491,27,94,1449,3723,1476,3817
220995,202305,1709,3781,1404,3303,13,44,1216,2799,1229,2843
220997,202305,2888,7391,2635,6987,49,179,2326,6009,2375,6188
221000,202305,5851,13407,5071,12343,207,588,4210,10062,4417,10650
221005,202305,1980,4313,1817,4061,28,104,1573,3341,1601,3445
221010,202305,1538,2927,1225,2555,38,54,1068,2200,1106,2254
221020,202305,1801,4925,1607,4611,25,102,1268,3589,1293,3691
221030,202305,2060,4086,1781,3753,20,53,1620,3415,1640,3468
221035,202305,1893,4117,1587,3715,41,59,1374,3242,1415,3301
221037,202305,838,2010,696,1773,8,35,522,1229,530,1264
221038,202305,607,1515,480,1317,34,96,331,882,365,978
221039,202305,979,2403,806,2133,31,105,638,1638,669,1743
221040,202305,5370,13525,4563,12236,268,701,3604,9657,3872,10358
221050,202305,5613,10979,5066,10312,70,192,4670,9392,4740,9584
221060,202305,11802,27995,9761,24741,492,1100,7755,19412,8247,20512
221062,202305,1627,4060,1400,3727,119,263,1066,2889,1185,3152
221063,202305,1510,3507,1316,3233,58,165,1093,2604,1151,2769
221065,202305,3566,7474,3055,6676,18,54,2749,5881,2767,5935
221070,202305,3957,10905,3173,9360,521,1505,1830,5482,2351,6987
221080,202305,4362,9306,3597,8220,52,173,3034,6623,3086,6796
221090,202305,1663,3585,1401,3214,14,30,1228,2747,1242,2777
221093,202305,2054,4548,1844,4222,190,385,1358,3025,1548,3410
221095,202305,1072,2467,881,2203,31,78,718,1773,749,1851
221097,202305,979,2228,745,1844,25,64,565,1324,590,1388
221100,202305,185012,406214,157943,365093,10869,28290,117299,256888,128168,285178
221110,202305,14028,32956,12731,31368,357,793,11299,27733,11656,28526
221120,202305,6002,15225,5371,14334,229,667,4567,12083,4796,12750
221130,202305,7264,15477,5802,13012,1371,2801,3239,7065,4610,9866
221135,202305,2425,5045,2089,4623,102,177,1786,4029,1888,4206
221140,202305,1908,3485,1572,3082,75,110,1359,2657,1434,2767
221150,202305,1354,2993,1009,2444,28,98,787,1788,815,1886
221160,202305,848,1894,775,1802,41,56,612,1433,653,1489
221170,202305,1291,2932,1209,2801,13,26,1119,2553,1132,2579
230010,202305,3586,8441,2890,7271,118,306,2321,5639,2439,5945
230015,202305,4435,11593,3840,10417,257,732,2679,7163,2936,7895
230020,202305,18665,47250,17286,45183,1125,2876,14050,36726,15175,39602
230030,202305,15491,34124,13014,30783,611,1232,10364,24867,10975,26099
230040,202305,5645,12003,4745,10693,58,200,3835,8793,3893,8993
230050,202305,2979,8592,2345,7190,366,1133,1113,3153,1479,4286
230060,202305,2956,6898,2286,5793,30,118,1850,4544,1880,4662
230070,202305,5386,11849,4244,9931,657,1468,2673,6235,3330,7703
230075,202305,12021,31750,10922,29970,663,1993,8740,23443,9403,25436
230080,202305,3655,6743,2836,5748,10,24,2624,5260,2634,5284
230090,202305,5617,11607,4712,10243,150,325,3968,8359,4118,8684
230100,202305,27939,59222,24348,54618,2343,5318,17262,38170,19605,43488
230110,202305,17259,44908,14622,40171,2843,7793,7460,20028,10303,27821
230120,202305,9851,22879,8106,20275,936,2292,5292,13225,6228,15517
230125,202305,3736,8731,3062,7671,73,254,2507,6014,2580,6268
230130,202305,6803,18332,5485,15666,414,1094,3748,10521,4162,11615
230140,202305,4311,11184,3582,9823,104,409,2800,7328,2904,7737
230150,202305,1910,5030,1577,4374,248,661,890,2481,1138,3142
230160,202305,8835,17800,7635,16126,245,472,6582,13591,6827,14063
230170,202305,7389,19063,5987,16353,475,1217,4072,10889,4547,12106
230180,202305,1982,4772,1604,4116,17,64,1310,3210,1327,3274
230185,202305,5665,13200,4653,11642,495,1203,3277,8244,3772,9447
230190,202305,17882,48619,14570,42263,2278,6598,7661,21679,9939,28277
230195,202305,7060,17876,6333,16720,344,912,4837,12631,5181,13543
230200,202305,5837,14576,4826,12751,360,883,3469,8917,3829,9800
230205,202305,5626,13123,4961,12208,476,959,3738,9289,4214,10248
230210,202305,13095,26579,11297,24261,456,940,9246,19331,9702,20271
230220,202305,18888,40654,16691,37692,1080,2400,13456,29785,14536,32185
230230,202305,8739,21671,7908,20171,730,1598,5840,14881,6570,16479
230240,202305,16891,37590,14261,33495,897,1785,11004,25554,11901,27339
230250,202305,11619,27951,10800,26788,1033,2440,7541,18232,8574,20672
230260,202305,18448,46420,15908,42202,2297,5861,9766,25553,12063,31414
230270,202305,8615,20683,6631,17266,850,2086,3876,10298,4726,12384
230280,202305,24340,55320,20456,49232,461,1713,16732,37949,17193,39662
230290,202305,6279,14186,5385,12649,249,571,4284,9723,4533,10294
230300,202305,6097,13641,5461,12792,81,230,4839,11278,4920,11508
230310,202305,5755,14566,4653,12571,148,503,3358,8688,3506,9191
230320,202305,9091,23295,7564,20768,241,905,5896,15587,6137,16492
230330,202305,5817,13789,4504,11449,182,523,3388,8232,3570,8755
230340,202305,4587,12788,3941,11542,335,984,2646,7557,2981,8541
230350,202305,23413,53719,20522,49725,1150,3204,15146,35496,16296,38700
230360,202305,3749,8487,2919,7152,157,368,2166,5300,2323,5668
230365,202305,3674,7769,3099,6974,72,197,2736,6056,2808,6253
230370,202305,102239,214960,90791,199860,5387,13559,72571,152555,77958,166114
230380,202305,7408,18242,5890,15555,123,406,4462,11276,4585,11682
230390,202305,4041,10222,3470,9343,81,339,2757,7168,2838,7507
230393,202305,4148,10164,3321,8630,76,340,2688,6595,2764,6935
230395,202305,6848,16802,5786,15078,555,1455,3781,9566,4336,11021
230400,202305,6885,16252,6084,15076,100,395,4973,11713,5073,12108
230410,202305,16119,42721,13431,38178,1269,3525,9088,25666,10357,29191
230420,202305,37742,89122,31106,78429,3428,8843,19413,46765,22841,55608
230423,202305,5376,14285,4788,13232,325,936,3450,9263,3775,10199
230425,202305,7580,19851,6988,18782,778,2023,4846,12893,5624,14916
230426,202305,3223,7453,2341,5864,52,182,1773,4227,1825,4409
230427,202305,2128,5397,1553,4303,138,411,883,2232,1021,2643
230428,202305,12347,29914,10699,27619,1741,4415,6091,15239,7832,19654
230430,202305,5930,15145,4644,12956,197,572,3459,9412,3656,9984
230435,202305,7734,17378,6337,15129,921,2146,3668,8612,4589,10758
230440,202305,615823,1246315,533255,1135983,36860,86255,400694,815544,437554,901799
230445,202305,4858,12047,4058,10763,293,756,2747,6967,3040,7723
230450,202305,4586,11171,3996,10344,206,683,3028,7421,3234,8104
230460,202305,2722,6302,2336,5714,71,230,1964,4664,2035,4894
230465,202305,5024,12205,4236,10782,208,521,3223,7950,3431,8471
230470,202305,14127,39508,12702,37018,982,2949,9305,26374,10287,29323
230480,202305,1851,4535,1510,3969,54,207,1151,2835,1205,3042
230490,202305,3331,8215,2762,7160,238,688,1808,4322,2046,5010
230495,202305,7531,18197,6555,16624,896,2384,4085,9958,4981,12342
230500,202305,11239,31988,9859,29619,557,1632,7661,23108,8218,24740
230510,202305,2170,5188,1712,4348,184,494,1083,2593,1267,3087
230520,202305,5809,13717,5042,12477,418,999,3702,8919,4120,9918
230523,202305,20605,54176,16152,45466,3727,10249,4122,12039,7849,22288
230526,202305,4796,11426,4079,10327,317,637,2899,7552,3216,8189
230530,202305,6630,18757,5574,16838,1325,4026,2927,8916,4252,12942
230533,202305,6043,11428,4827,9693,63,163,4198,8058,4261,8221
230535,202305,5786,14998,4959,13696,381,1156,3289,8896,3670,10052
230540,202305,18230,44935,15808,41426,266,916,13136,33726,13402,34642
230550,202305,28078,63017,23327,55680,2481,5477,15768,36796,18249,42273
230560,202305,9180,19265,7282,16518,507,690,5717,13481,6224,14171
230565,202305,3697,8940,3112,7929,107,312,2489,6114,2596,6426
230570,202305,4004,9200,3379,8329,64,207,2799,6707,2863,6914
230580,202305,14955,32213,12929,29428,648,1376,10795,24239,11443,25615
230590,202305,11650,28456,9770,25385,779,1891,7097,18200,7876,20091
230600,202305,4589,10172,3636,8653,151,347,2533,5998,2684,6345
230610,202305,8229,19721,7226,18136,537,1324,5642,14007,6179,15331
230620,202305,2677,6034,2133,5101,84,270,1562,3405,1646,3675
230625,202305,12725,30022,11013,27278,2235,5816,5348,12542,7583,18358
230630,202305,14175,35036,12527,32287,1672,3934,7977,20730,9649,24664
230640,202305,32188,88476,29258,83860,1626,5224,23069,64723,24695,69947
230650,202305,6293,14869,5277,13227,232,723,4260,10244,4492,10967
230655,202305,11959,33304,11311,32303,864,2242,9176,26525,10040,28767
230660,202305,7182,18719,5820,16382,178,720,4693,12829,4871,13549
230670,202305,7144,15118,5157,12098,216,491,4069,9239,4285,9730
230680,202305,3436,8208,2762,7084,170,347,1919,4885,2089,5232
230690,202305,8449,22264,7103,19807,573,1601,4429,12297,5002,13898
230700,202305,12867,28016,10253,23552,387,956,8079,17965,8466,18921
230710,202305,8021,22680,7050,20793,684,2076,4589,13086,5273,15162
230720,202305,2287,6053,1902,5407,146,424,1251,3431,1397,3855
230725,202305,5746,14656,5227,13857,443,1272,3603,9185,4046,10457
230730,202305,74723,173702,59629,152843,13254,34190,25213,65706,38467,99896
230740,202305,7237,17988,6038,16127,166,472,4794,12671,4960,13143
230750,202305,10104,23768,8311,20975,143,478,6742,16365,6885,16843
230760,202305,14410,33256,12526,30571,498,1528,9621,22364,10119,23892
230763,202305,5797,13817,4764,12147,104,393,3790,9208,3894,9601
230765,202305,57970,134685,50285,123467,4977,13127,33301,77486,38278,90613
230770,202305,35664,70515,30671,64355,1984,4267,24027,48782,26011,53049
230780,202305,8111,24362,7291,22596,1038,3013,4388,13742,5426,16755
230790,202305,3880,9330,3442,8661,150,456,2701,6496,2851,6952
230800,202305,10809,29223,9423,26664,1146,3349,5747,15466,6893,18815
230810,202305,12886,34902,11467,32630,724,1943,8663,24334,9387,26277
230820,202305,4279,12286,3567,10898,426,1403,2142,6250,2568,7653
230830,202305,9137,21543,7825,19501,359,727,6165,15080,6524,15807
230835,202305,4907,10395,3925,8985,127,302,3217,7137,3344,7439
230837,202305,4812,10758,4377,10096,83,290,3859,8571,3942,8861
230840,202305,11330,29947,9751,27287,848,2398,7062,19518,7910,21916
230850,202305,12306,29734,10446,26564,602,1416,7783,19547,8385,20963
230860,202305,7882,14695,6708,13156,178,296,5984,11520,6162,11816
230870,202305,22404,44171,19274,39430,820,1548,15897,31618,16717,33166
230880,202305,2343,6383,2164,6070,71,285,1691,4536,1762,4821
230890,202305,5574,15486,5041,14619,226,803,3698,10558,3924,11361
230900,202305,4038,10036,3349,8742,131,481,2454,6037,2585,6518
230910,202305,4225,9222,3299,7880,63,234,2787,6497,2850,6731
230920,202305,5720,14157,4500,12158,142,424,3437,9009,3579,9433
230930,202305,8323,20688,6787,18123,739,1684,4329,11544,5068,13228
230940,202305,10093,22056,8726,20165,190,418,7500,17089,7690,17507
230945,202305,7835,19690,6674,17671,486,1142,4669,12065,5155,13207
230950,202305,7645,16593,6763,15444,156,343,5775,13118,5931,13461
230960,202305,15619,40256,13540,36588,2286,6305,6806,17509,9092,23814
230970,202305,19467,45079,16618,40930,1844,4594,10810,25756,12654,30350
230980,202305,4306,9154,3734,8268,313,665,2808,6090,3121,6755
230990,202305,2044,5049,1705,4439,77,278,1261,3063,1338,3341
231000,202305,3427,7690,2679,6369,78,219,2100,4735,2178,4954
231010,202305,4510,8921,3417,7218,50,149,3011,6123,3061,6272
231020,202305,11173,28164,9895,25988,1757,4171,5952,15872,7709,20043
231025,202305,10465,23706,9356,22073,651,1424,7367,17146,8018,18570
231030,202305,8708,23492,6580,19352,895,2613,3741,10906,4636,13519
231040,202305,3763,8709,3226,7812,106,305,2682,6235,2788,6540
231050,202305,14634,32079,12054,27893,524,1350,9485,21092,10009,22442
231060,202305,3556,8549,3136,7940,127,372,2503,6260,2630,6632
231070,202305,9782,24829,8536,22774,845,2192,5755,15029,6600,17221
231080,202305,4509,11367,3730,10108,253,679,2572,6907,2825,7586
231085,202305,9007,19030,7236,16926,282,681,5688,12999,5970,13680
231090,202305,5167,12139,3833,9689,148,474,2686,6360,2834,6834
231095,202305,2617,7211,2046,6023,192,566,1351,3918,1543,4484
231100,202305,3622,9285,2976,8163,165,502,2223,5906,2388,6408
231110,202305,4475,11787,4089,11132,852,2372,2380,6178,3232,8550
231120,202305,2935,7233,2477,6495,107,266,1878,4820,1985,5086
231123,202305,2331,5420,1834,4575,103,270,1293,3137,1396,3407
231126,202305,6604,16027,5367,13840,324,757,3970,10159,4294,10916
231130,202305,30846,62231,25943,56153,1344,3492,20469,41938,21813,45430
231135,202305,4955,12487,4157,11046,198,509,3002,7841,3200,8350
231140,202305,21503,50985,17715,45036,1295,3508,12684,30842,13979,34350
231150,202305,7054,17290,5058,13490,911,2495,1892,4820,2803,7315
231160,202305,8577,21752,7626,20086,964,2367,4873,12710,5837,15077
231170,202305,5585,14145,4688,12577,317,907,3359,8622,3676,9529
231180,202305,19097,46548,15671,40150,2366,5988,8482,20973,10848,26961
231190,202305,5017,12183,3929,10336,94,300,3031,7674,3125,7974
231195,202305,5899,16107,4849,14149,318,1021,3422,9913,3740,10934
231200,202305,10253,24991,9021,22831,148,621,7638,18425,7786,19046
231210,202305,5779,14910,4863,13420,156,629,3905,10382,4061,11011
231220,202305,16138,34797,12931,29382,684,1428,9578,20834,10262,22262
231230,202305,12005,33666,10615,31190,834,2561,7781,22538,8615,25099
231240,202305,14349,38032,12681,35142,1767,4791,7758,21157,9525,25948
231250,202305,2504,5360,1681,3771,66,149,1189,2455,1255,2604
231260,202305,4037,9569,3387,8541,379,828,2281,5825,2660,6653
231270,202305,7708,17353,6306,15149,157,534,4867,11015,5024,11549
231280,202305,2181,5956,1875,5439,149,424,1297,3764,1446,4188
231290,202305,44194,118309,37493,106795,5370,15134,19695,53987,25065,69121
231300,202305,5037,12212,3896,10081,306,786,2581,6416,2887,7202
231310,202305,10455,21749,8322,18211,565,1455,6269,12889,6834,14344
231320,202305,8224,20913,6384,17696,275,618,4832,13387,5107,14005
231325,202305,2880,6692,2197,5624,117,233,1573,3985,1690,4218
231330,202305,13780,34097,11322,29819,1387,3538,7375,19203,8762,22741
231335,202305,6649,15522,5586,13946,151,442,4740,11649,4891,12091
231340,202305,22518,61041,20158,57341,1708,4781,14787,42491,16495,47272
231350,202305,19601,46751,17879,44403,325,951,15944,39094,16269,40045
231355,202305,5324,13833,4750,12837,273,753,3699,9812,3972,10565
231360,202305,9615,25624,8325,23561,437,1345,6529,18169,6966,19514
231370,202305,2424,6053,1922,5207,35,106,1474,3919,1509,4025
231375,202305,4852,13231,4365,12445,182,569,3400,9769,3582,10338
231380,202305,7379,16716,6505,15586,192,373,5453,12984,5645,13357
231390,202305,4071,10680,3626,9968,122,473,2751,7226,2873,7699
231395,202305,5315,13243,4485,11942,329,824,3156,8246,3485,9070
231400,202305,12003,29428,10062,26098,318,1212,7837,19292,8155,20504
231410,202305,20027,49776,18237,47249,790,1983,15311,39419,16101,41402
240010,202305,3026,7080,2364,5978,388,1014,1156,2765,1544,3779
240020,202305,17521,40398,14638,35656,895,2640,10522,24265,11417,26905
240030,202305,4817,8874,4336,8221,77,219,3970,7240,4047,7459
240040,202305,923,2436,755,2145,23,71,501,1353,524,1424
240050,202305,4149,9854,3237,8279,58,153,2493,6171,2551,6324
240060,202305,1793,4151,1402,3486,47,118,1093,2648,1140,2766
240070,202305,3203,7860,2811,7085,229,664,1991,4668,2220,5332
240080,202305,3481,8469,2747,7239,133,400,1915,4870,2048,5270
240090,202305,2779,5758,2293,5020,42,89,1981,4242,2023,4331
240100,202305,13444,27795,10961,23848,234,673,8936,18319,9170,18992
240110,202305,6038,14920,5049,13175,212,683,3752,9250,3964,9933
240120,202305,4069,10280,3402,9362,297,920,2369,6310,2666,7230
240130,202305,4870,8374,4004,7302,29,68,3658,6523,3687,6591
240140,202305,2111,5851,1783,5270,197,669,1088,3039,1285,3708
240145,202305,8383,21100,6813,18482,721,2041,4420,11712,5141,13753
240150,202305,1307,3034,1073,2618,59,174,837,1955,896,2129
240160,202305,1734,4465,1427,3930,41,177,1056,2775,1097,2952
240165,202305,1179,2831,977,2479,24,92,799,1948,823,2040
240170,202305,3436,7927,2886,7014,314,760,1913,4545,2227,5305
240180,202305,3649,9650,2959,8300,628,1745,1371,3953,1999,5698
240185,202305,1720,4599,1523,4262,54,200,1212,3233,1266,3433
240190,202305,1381,3256,1127,2852,43,159,857,2046,900,2205
240200,202305,16164,34099,13148,29441,1752,3887,7889,16914,9641,20801
240210,202305,4243,8524,3516,7409,23,91,3090,6201,3113,6292
240220,202305,8653,23279,7767,21939,549,1816,5895,16282,6444,18098
240230,202305,6910,15563,5492,13335,345,688,3949,9711,4294,10399
240240,202305,2132,5672,1491,4331,246,735,485,1213,731,1948
240250,202305,3702,8203,3206,7481,56,180,2706,6060,2762,6240
240260,202305,19840,50388,17312,46416,5069,13203,7269,21564,12338,34767
240270,202305,3033,7709,2498,6890,120,341,1695,4767,1815,5108
240280,202305,1892,4385,1579,3889,62,139,1234,2989,1296,3128
240290,202305,1325,3448,1102,3015,25,92,760,1894,785,1986
240300,202305,2614,6066,1946,4976,111,298,1228,2991,1339,3289
240310,202305,10270,24632,8187,21135,1238,3151,4075,10145,5313,13296
240320,202305,2257,5661,1581,4384,103,310,1058,2767,1161,3077
240325,202305,47174,105997,39138,93582,4469,12050,24558,54698,29027,66748
240330,202305,2154,5273,1693,4489,74,246,1150,2861,1224,3107
240340,202305,2479,4843,2009,4166,55,122,1663,3276,1718,3398
240350,202305,3026,6215,2683,5813,69,181,2452,5249,2521,5430
240360,202305,15999,37454,14264,34870,2204,5234,9175,22265,11379,27499
240370,202305,2664,5667,2042,4601,111,296,1520,3201,1631,3497
240375,202305,1124,2425,907,2084,30,85,659,1378,689,1463
240380,202305,2730,6835,2145,5684,266,708,1225,3102,1491,3810
240390,202305,1141,2572,774,1908,25,54,475,1071,500,1125
240400,202305,1684,3818,1248,3102,42,133,870,2018,912,2151
240410,202305,694,1869,565,1636,60,216,310,829,370,1045
240420,202305,6258,18172,5626,16990,442,1679,3977,11458,4419,13137
240430,202305,4178,9421,3525,8376,119,363,2754,6219,2873,6582
240440,202305,3369,6729,2887,6069,266,523,2209,4560,2475,5083
240450,202305,5340,12992,4203,11032,326,1037,2670,6378,2996,7415
240460,202305,4204,9663,3781,9034,296,655,3023,7225,3319,7880
240470,202305,4030,11185,2964,8928,754,2044,1194,3792,1948,5836
240480,202305,670,1674,412,1128,27,55,198,530,225,585
240485,202305,2478,6366,1993,5528,169,505,1239,3404,1408,3909
240490,202305,1965,4329,1479,3520,87,165,1074,2504,1161,2669
240500,202305,2587,6210,2254,5671,116,286,1810,4480,1926,4766
240510,202305,2019,4833,1735,4409,106,328,1376,3342,1482,3670
240520,202305,1929,3905,1477,3308,151,275,1108,2515,1259,2790
240530,202305,2853,6768,2518,6265,147,289,2028,5004,2175,5293
240540,202305,2738,5883,2490,5519,43,113,2249,4921,2292,5034
240550,202305,1065,2296,952,2117,16,48,843,1815,859,1863
240560,202305,4756,9862,4178,9140,140,247,3563,7742,3703,7989
240570,202305,3282,7973,2204,5749,314,854,862,1955,1176,2809
240580,202305,10649,26391,9462,24429,571,1553,7658,19441,8229,20994
240590,202305,1119,2158,976,1967,22,40,802,1553,824,1593
240600,202305,2101,5054,1536,4002,58,168,1063,2606,1121,2774
240610,202305,5461,12360,4694,11083,303,793,3330,7348,3633,8141
240615,202305,1540,3451,1248,2987,92,242,935,2110,1027,2352
240620,202305,2362,5627,2013,5058,67,221,1680,4089,1747,4310
240630,202305,2842,6213,2553,5780,232,364,1937,4495,2169,4859
240640,202305,1085,2570,856,2196,41,126,633,1553,674,1679
240650,202305,4784,12773,3950,11141,343,930,2559,7204,2902,8134
240660,202305,5402,9435,4883,8810,74,137,4599,8205,4673,8342
240670,202305,3071,7485,2426,6268,239,646,1546,3807,1785,4453
240680,202305,1904,4398,1527,3792,91,243,1131,2680,1222,2923
240690,202305,1473,3077,1146,2555,21,73,955,1994,976,2067
240700,202305,2814,7429,2257,6469,120,344,1646,4656,1766,5000
240710,202305,24830,51096,21384,46020,1866,4132,15992,33073,17858,37205
240720,202305,6212,14155,5199,12710,671,1691,3295,7862,3966,9553
240725,202305,1267,3325,969,2807,47,132,613,1714,660,1846
240730,202305,2671,6639,2086,5574,84,258,1561,4010,1645,4268
240740,202305,2233,5568,1798,4736,95,296,1267,3111,1362,3407
240750,202305,2617,7577,2257,6854,245,800,1399,4083,1644,4883
240760,202305,2049,4106,1518,3364,114,166,1120,2590,1234,2756
240770,202305,4015,9467,3384,8628,124,410,2813,6959,2937,7369
240780,202305,6475,15470,5441,13824,767,1915,3493,8696,4260,10611
240790,202305,1056,2633,861,2307,27,116,625,1577,652,1693
240800,202305,72902,146499,59273,127200,6327,13756,38813,78249,45140,92005
240810,202305,136868,290277,120938,267035,11698,26183,87497,186818,99195,213001
240820,202305,7902,20678,6894,18916,1130,3119,4050,11012,5180,14131
240830,202305,10447,25823,9091,23907,416,1257,7199,18604,7615,19861
240840,202305,1292,2929,1029,2518,44,93,717,1693,761,1786
240850,202305,1651,4112,1133,3068,84,217,677,1729,761,1946
240860,202305,1806,3879,1365,3159,37,122,1128,2483,1165,2605
240870,202305,1223,2813,958,2404,177,423,474,1212,651,1635
240880,202305,1522,4347,1295,3908,98,386,926,2682,1024,3068
240890,202305,6598,14564,5262,12359,512,1374,3504,7471,4016,8845
240895,202305,3564,9541,3218,9015,395,1078,2339,6615,2734,7693
240910,202305,4139,10023,3400,8772,65,219,2725,6760,2790,6979
240920,202305,1301,2821,1042,2471,123,218,670,1648,793,1866
240930,202305,4325,8857,3503,7852,261,395,2315,5677,2576,6072
240933,202305,1892,4303,1607,3907,41,172,1352,3142,1393,3314
240940,202305,8896,18485,7173,15848,741,1571,4809,10141,5550,11712
240950,202305,1311,3514,1117,3136,27,113,877,2339,904,2452
240960,202305,831,2063,746,1895,16,58,580,1401,596,1459
240970,202305,2393,5078,1948,4394,73,190,1605,3501,1678,3691
240980,202305,4824,10920,4337,10174,70,281,3848,8687,3918,8968
240990,202305,3582,8151,3154,7423,262,700,2304,5065,2566,5765
241000,202305,1271,2729,999,2275,13,46,821,1757,834,1803
241010,202305,3858,9904,3478,9211,135,435,2838,7235,2973,7670
241020,202305,2512,5988,1888,4806,100,303,1354,3227,1454,3530
241025,202305,1934,5006,1563,4385,34,136,1123,3014,1157,3150
241030,202305,2995,8312,2450,7276,247,747,1669,4820,1916,5567
241040,202305,2631,7264,2190,6519,160,506,1593,4721,1753,5227
241050,202305,1720,4256,1376,3646,45,139,1017,2619,1062,2758
241060,202305,988,2383,822,2055,39,102,588,1369,627,1471
241070,202305,853,2013,702,1789,17,49,542,1310,559,1359
241080,202305,1299,3308,1023,2782,43,151,709,1827,752,1978
241090,202305,2469,6161,1963,5351,62,237,1465,3824,1527,4061
241100,202305,1381,3454,1051,2826,104,208,640,1703,744,1911
241105,202305,1383,3574,1139,3159,210,621,564,1470,774,2091
241110,202305,1070,2751,798,2209,49,152,499,1300,548,1452
241120,202305,9032,23145,7751,21090,825,2296,5113,13750,5938,16046
241140,202305,3906,9392,2974,7629,196,464,2044,5138,2240,5602
241142,202305,887,2191,672,1809,64,171,354,856,418,1027
241150,202305,7031,16264,6146,14951,273,654,4820,11557,5093,12211
241160,202305,1312,3404,988,2797,160,486,473,1271,633,1757
241170,202305,1569,3553,1332,3151,35,98,1099,2492,1134,2590
241180,202305,1222,2779,912,2260,53,169,516,1205,569,1374
241190,202305,1416,3207,1162,2762,24,76,851,1907,875,1983
241200,202305,32341,68204,28721,62918,3205,7373,20070,41707,23275,49080
241210,202305,1987,4445,1436,3495,146,318,864,2080,1010,2398
241220,202305,12358,30531,10915,28239,2667,6861,5179,13509,7846,20370
241230,202305,3462,8098,3004,7459,116,265,2458,6041,2574,6306
241240,202305,1452,3735,898,2575,122,377,305,804,427,1181
241250,202305,7709,17958,6208,15476,140,550,4939,11634,5079,12184
241255,202305,3256,8589,2762,7689,195,619,1962,5261,2157,5880
241260,202305,5802,13475,4760,11825,180,523,3615,8566,3795,9089
241270,202305,1865,4953,1565,4401,110,341,1095,2987,1205,3328
241280,202305,3147,6195,2758,5564,86,167,2391,4692,2477,4859
241290,202305,3754,8303,2808,6854,104,323,2223,5193,2327,5516
241300,202305,1886,4405,1530,3859,48,159,1072,2551,1120,2710
241310,202305,2853,5742,2450,5221,64,130,2121,4462,2185,4592
241320,202305,1128,3344,962,3050,115,395,552,1693,667,2088
241330,202305,2061,4671,1655,4139,24,69,1475,3658,1499,3727
241335,202305,4477,11004,3931,10088,136,426,3185,7890,3321,8316
241340,202305,2063,4856,1638,4096,225,655,914,2094,1139,2749
241350,202305,2585,6178,2237,5601,103,253,1728,4241,1831,4494
241355,202305,1651,3916,1321,3310,53,114,988,2416,1041,2530
241360,202305,2471,5655,1788,4384,63,176,1314,3047,1377,3223
241370,202305,1589,3811,1237,3171,59,183,902,2135,961,2318
241380,202305,848,1986,678,1700,69,163,417,1034,486,1197
241390,202305,3304,8494,2893,7895,163,500,2226,5995,2389,6495
241400,202305,4362,10686,3818,9882,257,737,2948,7425,3205,8162
241410,202305,2987,7994,2407,6861,255,766,1531,4270,1786,5036
241415,202305,2274,5370,1922,4779,77,258,1500,3481,1577,3739
241420,202305,3809,9757,3419,9149,625,1754,2028,5411,2653,7165
241430,202305,854,1892,571,1391,19,51,392,867,411,918
241440,202305,10384,27023,9434,25493,250,834,7817,20650,8067,21484
241445,202305,1655,3369,1424,3066,27,61,1276,2709,1303,2770
241450,202305,3711,7505,3004,6450,207,406,2370,5009,2577,5415
241460,202305,4723,11390,3703,9427,313,867,2411,5737,2724,6604
241470,202305,1741,4058,1380,3554,39,142,1167,2940,1206,3082
241475,202305,1424,3455,1100,2880,21,70,827,2034,848,2104
241480,202305,3718,10213,3074,8937,896,2603,1079,3324,1975,5927
241490,202305,909,1828,643,1441,13,35,531,1145,544,1180
241500,202305,970,2357,851,2217,16,36,725,1890,741,1926
250010,202305,3217,8193,2602,7016,74,251,1987,5140,2061,5391
250020,202305,1927,4509,1425,3639,89,151,1047,2672,1136,2823
250030,202305,8502,20357,7430,18809,1148,2874,4909,12361,6057,15235
250040,202305,5718,14530,4999,13333,867,2206,2901,7686,3768,9892
250050,202305,4461,10385,3940,9741,184,454,3206,8033,3390,8487
250053,202305,1539,3880,1384,3650,132,282,944,2485,1076,2767
250057,202305,902,2433,820,2315,14,53,747,2096,761,2149
250060,202305,7468,16615,6578,15341,592,1356,4891,11309,5483,12665
250070,202305,4825,11749,4003,10402,46,196,3246,8083,3292,8279
250073,202305,966,2235,784,1945,10,35,629,1515,639,1550
250077,202305,3185,6709,2507,5697,38,110,2138,4694,2176,4804
250080,202305,7370,14153,6122,12694,65,184,5635,11500,5700,11684
250090,202305,4705,8824,4152,8159,62,123,3684,7048,3746,7171
250100,202305,4068,11036,3692,10399,277,700,2759,7647,3036,8347
250110,202305,5990,14696,5442,13952,381,1093,4142,10397,4523,11490
250115,202305,930,1902,708,1590,13,41,573,1233,586,1274
250120,202305,2156,5673,1921,5306,26,120,1558,4142,1584,4262
250130,202305,7427,15589,6390,14230,49,206,5720,12348,5769,12554
250135,202305,1649,3883,1418,3507,197,547,980,2308,1177,2855
250140,202305,2760,7103,2506,6800,198,586,1958,5403,2156,5989
250150,202305,5645,15668,5090,14792,203,703,4055,11455,4258,12158
250153,202305,1617,3902,1359,3526,72,152,1050,2708,1122,2860
250157,202305,2641,6048,2333,5584,70,186,1949,4549,2019,4735
250160,202305,4403,9725,3696,8768,78,203,3167,7398,3245,7601
250170,202305,2213,5189,1978,4863,43,141,1656,3948,1699,4089
250180,202305,31160,60404,27074,55396,1722,3942,21565,42182,23287,46124
250190,202305,5140,11830,4369,10763,464,1084,3018,7242,3482,8326
250200,202305,3171,5917,2711,5351,35,73,2459,4708,2494,4781
250205,202305,981,2758,809,2472,20,87,624,1874,644,1961
250210,202305,1706,4586,1500,4258,106,352,1117,3076,1223,3428
250215,202305,1875,4657,1608,4292,91,268,936,2507,1027,2775
250220,202305,802,1988,629,1721,22,86,451,1158,473,1244
250230,202305,1915,3915,1380,3162,21,50,1102,2436,1123,2486
250240,202305,3788,8188,3366,7554,37,146,2995,6518,3032,6664
250250,202305,5902,13699,5198,12776,409,655,4046,10488,4455,11143
250260,202305,1838,4754,1539,4225,75,202,1160,3179,1235,3381
250270,202305,1395,3794,1289,3668,96,287,884,2656,980,2943
250280,202305,4868,10325,4347,9671,286,484,3385,7696,3671,8180
250290,202305,2299,4674,1934,4160,34,77,1643,3398,1677,3475
250300,202305,7367,15676,6621,14795,255,741,5519,11934,5774,12675
250310,202305,1472,3769,1202,3293,63,144,871,2359,934,2503
250320,202305,18327,33749,16220,31405,199,509,15000,28363,15199,28872
250330,202305,3186,7204,2705,6557,65,233,2347,5462,2412,5695
250340,202305,1536,3192,1320,2908,20,44,1186,2585,1206,2629
250350,202305,4535,11782,3903,10692,322,707,2883,8151,3205,8858
250355,202305,2738,6387,2440,6038,18,72,2265,5572,2283,5644
250360,202305,2140,4942,1909,4645,117,351,1536,3558,1653,3909
250370,202305,20657,41127,17898,37267,272,809,16000,32127,16272,32936
250375,202305,1543,3273,1218,2898,22,42,1085,2636,1107,2678
250380,202305,2189,4558,2035,4384,51,153,1828,3808,1879,3961
250390,202305,2351,5144,2021,4653,130,302,1580,3601,1710,3903
250400,202305,91302,205058,71220,175776,22172,58623,21018,49979,43190,108602
250403,202305,2940,5967,2612,5613,53,252,2280,4586,2333,4838
250407,202305,1877,3709,1349,2963,148,253,883,2051,1031,2304
250410,202305,849,1976,738,1802,24,67,610,1431,634,1498
250415,202305,2436,5648,2141,5225,31,103,1885,4485,1916,4588
250420,202305,1729,3544,1553,3314,11,26,1448,3038,1459,3064
250430,202305,9389,18397,8146,16827,288,594,6984,13955,7272,14549
250435,202305,1952,4913,1488,4156,68,220,1084,2911,1152,3131
250440,202305,5242,12703,4580,11838,112,256,3985,10200,4097,10456
250450,202305,2178,4968,1807,4484,93,178,1424,3607,1517,3785
250460,202305,9707,23312,8470,21561,579,1603,6518,16265,7097,17868
250470,202305,2183,4559,1836,4044,64,139,1530,3245,1594,3384
250480,202305,4617,11216,3890,10306,147,333,3241,8627,3388,8960
250485,202305,848,1748,634,1458,69,109,419,959,488,1068
250490,202305,6927,13423,6198,12618,104,293,5589,11045,5693,11338
250500,202305,2438,5987,2132,5482,54,167,1739,4355,1793,4522
250510,202305,7073,14583,6157,13379,261,360,5107,11264,5368,11624
250520,202305,2198,5327,1887,4914,75,220,1489,3768,1564,3988
250523,202305,2689,5655,2390,5248,189,435,1847,3920,2036,4355
250527,202305,2109,4499,1917,4289,19,52,1743,3856,1762,3908
250530,202305,804,1851,696,1699,17,46,567,1344,584,1390
250535,202305,1633,4180,1464,3898,28,105,1203,3077,1231,3182
250540,202305,3977,7309,3445,6748,408,450,2775,5770,3183,6220
250550,202305,925,2706,806,2488,50,164,553,1670,603,1834
250560,202305,2052,5008,1756,4585,62,198,1440,3656,1502,3854
250570,202305,3288,8577,2816,7762,166,503,2114,5753,2280,6256
250580,202305,1247,2938,1108,2757,68,202,889,2143,957,2345
250590,202305,1261,2618,1154,2482,29,72,1034,2158,1063,2230
250600,202305,9047,22157,7536,20060,320,850,5775,15074,6095,15924
250610,202305,3391,8686,3022,8144,137,428,2414,6451,2551,6879
250620,202305,1124,2358,939,2083,47,117,750,1596,797,1713
250625,202305,2700,7118,2426,6684,52,239,2091,5623,2143,5862
250630,202305,15338,33665,13078,30220,1154,2925,9500,20834,10654,23759
250640,202305,4524,10410,4038,9795,84,300,3484,8246,3568,8546
250650,202305,1294,2726,1006,2345,14,61,850,1926,864,1987
250660,202305,1868,4140,1469,3564,40,90,1196,2780,1236,2870
250670,202305,2954,7669,2675,7202,45,176,2333,6093,2378,6269
250680,202305,7509,14386,6823,13622,39,152,6418,12491,6457,12643
250690,202305,8740,17047,7425,15520,151,299,6458,13272,6609,13571
250700,202305,5578,13980,4916,12939,747,2014,3213,8221,3960,10235
250710,202305,5158,13457,4468,12517,442,1213,3112,8737,3554,9950
250720,202305,3413,8168,3040,7657,69,255,2618,6446,2687,6701
250730,202305,5416,12242,4790,11431,249,655,4010,9303,4259,9958
250740,202305,2458,5385,2044,4851,131,277,1564,3722,1695,3999
250750,202305,164169,341311,143283,313333,8929,22092,112072,234124,121001,256216
250760,202305,3658,6843,3290,6341,58,134,3034,5709,3092,5843
250770,202305,4852,13109,4311,12383,591,1501,2869,8511,3460,10012
250780,202305,2263,5132,1932,4595,53,139,1609,3726,1662,3865
250790,202305,3129,7969,2765,7445,101,381,2241,5785,2342,6166
250800,202305,2928,6812,2547,6222,108,220,2083,5021,2191,5241
250810,202305,1756,3819,1471,3432,164,257,1082,2676,1246,2933
250820,202305,2564,5832,2363,5607,47,164,2137,4985,2184,5149
250830,202305,7343,19499,6061,17064,250,880,4320,11512,4570,12392
250840,202305,859,2512,764,2348,36,129,566,1756,602,1885
250850,202305,2161,5522,1897,5080,27,122,1548,4019,1575,4141
250855,202305,1407,3346,1253,3135,47,137,1043,2524,1090,2661
250860,202305,4272,11089,3534,9899,492,1444,2011,5413,2503,6857
250870,202305,1252,2941,1057,2648,64,147,792,1972,856,2119
250880,202305,1914,4359,1594,3884,137,323,1187,2849,1324,3172
250890,202305,14706,29917,12925,27701,280,1005,11330,23025,11610,24030
250900,202305,3943,8999,3462,8229,83,248,2969,6831,3052,7079
250905,202305,3059,7477,2819,7183,52,180,2545,6421,2597,6601
250910,202305,9064,17234,7862,15934,80,242,7174,14280,7254,14522
250915,202305,2612,5248,1932,4517,30,53,1699,3970,1729,4023
250920,202305,4755,10027,4291,9389,345,667,3448,7407,3793,8074
250930,202305,2785,6766,2462,6360,170,556,1912,4741,2082,5297
250933,202305,1490,3886,1310,3585,47,168,1012,2677,1059,2845
250937,202305,956,2234,807,2013,25,80,667,1644,692,1724
250939,202305,2486,5438,2174,5037,45,119,1826,4134,1871,4253
250940,202305,4704,10937,4075,10120,63,176,3571,8763,3634,8939
250950,202305,2002,4751,1625,4240,56,178,1265,3202,1321,3380
250960,202305,1351,3416,1197,3167,29,118,994,2521,1023,2639
250970,202305,11227,24554,9660,22093,414,884,7852,17578,8266,18462
250980,202305,2833,6632,2566,6274,24,104,2241,5311,2265,5415
250990,202305,2552,6794,2170,6144,116,377,1623,4456,1739,4833
251000,202305,2288,5886,1891,5220,46,153,1522,4158,1568,4311
251010,202305,2983,7343,2627,6827,40,174,2281,5788,2321,5962
251020,202305,1861,4595,1662,4294,31,133,1442,3621,1473,3754
251030,202305,1209,2908,1001,2563,53,147,673,1694,726,1841
251040,202305,2159,5286,1870,4846,25,103,1613,4096,1638,4199
251050,202305,1136,3005,954,2648,48,171,667,1730,715,1901
251060,202305,1361,2699,990,2211,35,80,723,1605,758,1685
251065,202305,547,1396,414,1141,13,41,288,758,301,799
251070,202305,894,1957,746,1757,13,46,624,1398,637,1444
251080,202305,26502,56865,22128,50643,3887,8898,12697,29147,16584,38045
251090,202305,3445,8748,2893,7856,65,182,2377,6312,2442,6494
251100,202305,937,2710,804,2449,30,95,595,1707,625,1802
251110,202305,2225,5117,1852,4443,156,353,1361,3182,1517,3535
251120,202305,9843,22427,8395,20638,438,1235,6489,15444,6927,16679
251130,202305,5991,10159,5376,9484,44,100,5104,8871,5148,8971
251140,202305,4771,12264,4207,11445,147,482,3298,8863,3445,9345
251150,202305,3395,8493,3086,8037,56,267,2625,6628,2681,6895
251160,202305,2926,6837,2574,6317,25,117,2325,5575,2350,5692
251170,202305,2264,4859,2016,4555,33,85,1830,4036,1863,4121
251180,202305,3339,7558,2787,6819,306,621,1865,4717,2171,5338
251190,202305,6911,13522,6301,12844,60,179,5795,11430,5855,11609
251200,202305,5578,13514,4931,12680,165,382,4152,10744,4317,11126
251203,202305,1239,3499,1080,3151,63,204,720,1999,783,2203
251207,202305,1324,3189,1009,2679,24,92,687,1751,711,1843
251210,202305,9747,21632,8011,19227,674,1307,5571,13786,6245,15093
251220,202305,1635,3365,1192,2778,87,198,905,2092,992,2290
251230,202305,5591,14091,4837,12747,138,416,3821,9750,3959,10166
251240,202305,4403,11415,3715,10225,325,814,2429,6745,2754,7559
251250,202305,14919,33821,13060,30827,963,2437,9850,22230,10813,24667
251260,202305,646,1484,567,1358,15,58,456,1030,471,1088
251270,202305,5455,14243,4898,13483,280,697,3855,10833,4135,11530
251272,202305,1726,3853,1604,3706,40,148,1442,3208,1482,3356
251274,202305,1001,2565,788,2193,71,233,443,1196,514,1429
251275,202305,1957,4087,1627,3610,93,229,1324,2822,1417,3051
251276,202305,1600,3914,1382,3620,37,141,1111,2797,1148,2938
251278,202305,806,1873,703,1708,39,97,555,1321,594,1418
251280,202305,3380,6929,3103,6572,58,174,2806,5752,2864,5926
251290,202305,10243,17906,9399,16958,306,635,8429,14825,8735,15460
251300,202305,1005,2564,877,2365,17,65,732,1943,749,2008
251310,202305,3406,8429,2926,7693,42,190,2445,6234,2487,6424
251315,202305,2224,6076,2009,5683,110,289,1561,4349,1671,4638
251320,202305,1916,4529,1510,3850,45,175,1162,2830,1207,3005
251330,202305,2559,5171,2069,4591,33,76,1800,3962,1833,4038
251335,202305,1374,3360,1225,3148,18,83,1102,2761,1120,2844
251340,202305,4561,9585,3682,8449,158,368,2907,6506,3065,6874
251350,202305,1308,3283,1177,3078,57,115,940,2465,997,2580
251360,202305,2234,5358,1740,4636,26,74,1366,3550,1392,3624
251365,202305,938,2229,677,1746,23,52,510,1302,533,1354
251370,202305,35464,80498,30731,74196,5422,12804,17431,42708,22853,55512
251380,202305,1870,3978,1622,3613,51,119,1391,3031,1442,3150
251385,202305,923,2148,706,1773,27,70,501,1187,528,1257
251390,202305,9625,21958,8583,20456,748,1769,6328,14789,7076,16558
251392,202305,1230,2984,1024,2669,42,115,800,2070,842,2185
251394,202305,818,2087,671,1838,69,184,435,1142,504,1326
251396,202305,848,2091,711,1854,31,101,499,1229,530,1330
251398,202305,1195,2817,834,2189,24,77,589,1469,613,1546
251400,202305,1762,3407,1430,2974,75,124,1131,2282,1206,2406
251410,202305,1898,3836,1501,3259,14,54,1271,2610,1285,2664
251420,202305,2525,5616,2070,5085,53,167,1692,4022,1745,4189
251430,202305,1799,4759,1610,4448,62,188,1333,3635,1395,3823
251440,202305,1291,3132,1064,2755,73,145,770,2028,843,2173
251445,202305,2071,4854,1887,4612,34,113,1635,3874,1669,3987
251450,202305,5650,14005,5059,13135,53,184,4394,11172,4447,11356
251455,202305,1018,2704,917,2532,31,103,737,1980,768,2083
251460,202305,1172,2886,941,2503,89,241,656,1729,745,1970
251465,202305,611,1504,505,1325,10,41,389,965,399,1006
251470,202305,1342,3461,1009,2795,144,445,500,1240,644,1685
251480,202305,1265,2930,961,2431,15,53,726,1732,741,1785
251490,202305,2364,5385,1962,4846,144,252,1489,3682,1633,3934
251500,202305,2647,5956,2378,5596,107,244,1953,4475,2060,4719
251510,202305,3110,8535,2589,7559,131,408,1764,4975,1895,5383
251520,202305,1180,2804,899,2320,62,133,588,1465,650,1598
251530,202305,18906,38253,15795,34501,195,774,14097,29863,14292,30637
251540,202305,3607,9220,3187,8510,90,356,2615,6716,2705,7072
251550,202305,5319,9959,4436,8906,126,212,3801,7514,3927,7726
251560,202305,652,1815,577,1706,50,190,421,1165,471,1355
251570,202305,1089,2785,894,2403,20,98,699,1802,719,1900
251580,202305,2811,5416,2467,4933,29,105,2160,4071,2189,4176
251590,202305,1968,4164,1687,3835,67,159,1435,3161,1502,3320
251593,202305,1142,3072,1022,2878,102,315,680,1871,782,2186
251597,202305,2778,6311,2516,5982,14,63,2324,5417,2338,5480
251600,202305,7590,18656,6621,17216,296,834,5364,13701,5660,14535
251610,202305,4182,10082,3634,9111,434,1014,2541,6252,2975,7266
251615,202305,1672,3528,1334,3043,22,53,1128,2479,1150,2532
251620,202305,24190,47357,19334,41561,223,443,16895,36217,17118,36660
251630,202305,6374,12525,5226,10954,299,672,4146,8244,4445,8916
251640,202305,2638,6266,2362,5878,23,97,2119,5166,2142,5263
251650,202305,5096,11373,4402,10481,123,299,3757,8759,3880,9058
251660,202305,4392,11122,3870,10248,61,258,3260,8332,3321,8590
251670,202305,5828,12494,5227,11721,55,218,4833,10552,4888,10770
251675,202305,1127,2341,1023,2211,39,104,902,1905,941,2009
251680,202305,3128,7107,2661,6508,112,201,2147,5282,2259,5483
251690,202305,3863,9704,3314,8810,139,382,2505,6581,2644,6963
251700,202305,2778,6700,2321,6092,47,190,1944,4892,1991,5082
251710,202305,951,2180,686,1690,44,132,445,987,489,1119
251720,202305,1524,3858,1222,3361,29,109,941,2479,970,2588
251740,202305,794,1927,651,1687,32,100,500,1250,532,1350
260005,202305,38344,72238,32629,65165,1882,3840,26338,50864,28220,54704
260010,202305,12552,29255,10447,25971,693,1844,6699,15928,7392,17772
260020,202305,8390,16707,6866,14647,73,269,5913,12213,5986,12482
260030,202305,10067,19640,8611,17674,76,272,7699,15250,7775,15522
260040,202305,8693,19639,7447,18013,433,1105,5580,13386,6013,14491
260050,202305,17802,37679,15449,35047,240,622,14448,32538,14688,33160
260060,202305,5184,10973,4458,9918,407,691,3278,7572,3685,8263
260070,202305,14587,29045,12725,26546,196,673,11106,22161,11302,22834
260080,202305,8425,15961,7419,14731,176,329,6431,12449,6607,12778
260090,202305,6735,14356,6007,13432,475,908,4719,10624,5194,11532
260100,202305,4007,8501,3471,7781,35,147,3105,6752,3140,6899
260105,202305,6247,14488,5609,13660,105,378,4795,11317,4900,11695
260110,202305,25935,65923,23061,61793,1163,3555,18491,48442,19654,51997
260120,202305,19685,42905,16965,39172,1973,4114,11866,27369,13839,31483
260130,202305,4019,8722,3476,7999,81,185,2852,6329,2933,6514
260140,202305,16729,31408,14773,29111,439,902,12882,24773,13321,25675
260150,202305,4541,8699,4075,8142,108,206,3668,7277,3776,7483
260160,202305,9140,17578,8069,16325,137,274,7427,14878,7564,15152
260170,202305,27292,54880,23634,50071,1248,2782,19131,39378,20379,42160
260180,202305,4338,9784,3681,8885,73,259,3153,7443,3226,7702
260190,202305,26886,43804,23248,39694,181,365,21491,35762,21672,36127
260200,202305,13433,28636,11732,26471,480,923,10295,23165,10775,24088
260210,202305,13357,33449,11459,30521,409,1199,9252,24359,9661,25558
260220,202305,15160,28419,14059,27085,325,556,12636,23930,12961,24486
260230,202305,16326,30428,14365,28042,322,592,12524,23928,12846,24520
260240,202305,3408,8742,2937,7913,63,252,2357,6150,2420,6402
260250,202305,2929,6357,2497,5722,104,247,1992,4411,2096,4658
260260,202305,17718,38944,15791,36341,1283,2601,11997,28086,13280,30687
260270,202305,6331,11709,5676,10995,74,203,5183,9811,5257,10014
260280,202305,16377,39008,14952,37008,316,1174,13415,32224,13731,33398
260290,202305,55305,122099,48414,112809,4325,10672,35224,79444,39549,90116
260300,202305,13330,28325,11564,25893,296,819,9988,21771,10284,22590
260310,202305,8191,16317,7416,15395,390,645,6271,13068,6661,13713
260320,202305,8786,23131,7371,20875,136,481,6091,16990,6227,17471
260330,202305,2940,8059,2464,7143,55,202,1958,5512,2013,5714
260340,202305,2673,6015,2344,5545,38,143,2065,4690,2103,4833
260345,202305,38325,82159,33041,75064,3148,7577,22819,49135,25967,56712
260350,202305,7929,14202,6884,13058,24,94,6434,11940,6458,12034
260360,202305,2920,6742,2544,6090,90,260,1833,4196,1923,4456
260370,202305,6875,16348,5856,14710,177,538,4752,11403,4929,11941
260380,202305,6061,15511,5190,14126,225,559,4005,10845,4230,11404
260390,202305,5606,15030,4477,12874,240,657,2971,8365,3211,9022
260392,202305,5021,12155,4544,11574,47,270,4038,10132,4085,10402
260400,202305,27932,51898,24668,47754,370,1042,21348,39033,21718,40075
260410,202305,104591,221026,85146,194811,16188,38900,42936,97148,59124,136048
260415,202305,6000,12701,5118,11505,32,124,4555,9959,4587,10083
260420,202305,16646,28009,14516,25702,59,194,13932,24292,13991,24486
260430,202305,3200,9119,2706,8183,269,869,1686,4990,1955,5859
260440,202305,5294,10692,4750,10020,35,110,4391,9094,4426,9204
260450,202305,6905,15447,6202,14544,362,673,5181,12297,5543,12970
260460,202305,6962,16910,6023,15414,421,1253,4266,10310,4687,11563
260470,202305,6152,12791,5265,11800,145,294,4596,10591,4741,10885
260480,202305,4502,10377,3841,9448,332,896,2742,6616,3074,7512
260490,202305,7034,13214,6176,12105,43,138,5741,11005,5784,11143
260500,202305,7430,16290,6418,14907,614,1320,4469,10380,5083,11700
260510,202305,14118,27440,12273,24920,155,474,11095,21890,11250,22364
260515,202305,5593,12827,4437,10811,94,277,3345,7578,3439,7855
260520,202305,20069,40707,17822,37900,1065,2283,14646,30375,15711,32658
260530,202305,12675,29322,10951,26858,93,426,9869,23582,9962,24008
260540,202305,9749,17292,8812,16183,113,233,8239,14915,8352,15148
260545,202305,176,448,117,329,25,78,42,93,67,171
260550,202305,3801,9238,3051,7987,194,649,2048,4977,2242,5626
260560,202305,6843,15577,5670,13838,148,444,4785,11353,4933,11797
260570,202305,11488,23093,10151,21454,188,539,9104,18683,9292,19222
260580,202305,6410,11881,5921,11267,46,77,5521,10366,5567,10443
260590,202305,9612,16690,8432,15401,92,243,7750,13827,7842,14070
260600,202305,43956,94259,37396,84879,1324,3607,30370,65571,31694,69178
260610,202305,9600,22086,8431,20588,380,1041,6590,15820,6970,16861
260620,202305,28085,55408,25257,51810,1243,3345,20885,40488,22128,43833
260630,202305,2798,6708,2340,5994,60,161,1927,4803,1987,4964
260640,202305,33079,60112,28574,55053,1350,2395,24182,45982,25532,48377
260650,202305,7632,16996,6193,15235,455,821,5117,12646,5572,13467
260660,202305,9516,19777,8458,18497,278,722,7642,16404,7920,17126
260670,202305,2781,6283,2284,5478,82,244,1791,4089,1873,4333
260680,202305,39741,80867,34154,73502,2284,5008,26090,53842,28374,58850
260690,202305,4179,9468,3435,8367,77,267,2760,6506,2837,6773
260700,202305,9395,18843,8809,18217,65,190,8564,17646,8629,17836
260710,202305,1645,3827,1358,3398,52,177,1083,2629,1135,2806
260720,202305,39418,76562,34471,70730,1791,4090,28616,57069,30407,61159
260730,202305,10143,24819,8852,23058,213,714,7700,19605,7913,20319
260740,202305,1625,3890,1314,3383,23,95,1097,2774,1120,2869
260750,202305,9688,21009,7677,18587,214,378,6758,16752,6972,17130
260760,202305,8624,16433,7614,15267,122,345,6906,13515,7028,13860
260765,202305,10604,25700,9374,24048,738,2051,6742,16775,7480,18826
260770,202305,4809,10544,3938,9185,103,321,3211,7225,3314,7546
260775,202305,7602,16721,6720,15409,176,571,5548,11982,5724,12553
260780,202305,4672,11736,4109,10826,361,1149,2682,6492,3043,7641
260790,202305,194757,360838,168071,327690,20305,41053,120824,226580,141129,267633
260795,202305,4563,8662,3933,7885,161,381,3336,6498,3497,6879
260800,202305,7937,14246,7232,13336,409,595,6242,11370,6651,11965
260805,202305,4682,10729,4108,9832,142,438,3384,7745,3526,8183
260810,202305,8185,18800,7191,17077,291,778,5778,13089,6069,13867
260820,202305,6073,11344,5470,10687,79,214,4897,9460,4976,9674
260825,202305,3499,9224,3090,8560,127,403,2413,6550,2540,6953
260830,202305,5263,13325,4456,12006,512,1160,3035,8339,3547,9499
260840,202305,5796,11874,5194,11105,236,465,4557,9633,4793,10098
260845,202305,5642,12734,5003,11724,205,602,4014,8947,4219,9549
260850,202305,6032,14148,5069,12501,445,1115,3400,7921,3845,9036
260860,202305,4044,10349,3465,9324,192,549,2725,7141,2917,7690
260870,202305,5659,11021,4976,10201,136,255,4403,8940,4539,9195
260875,202305,10720,20953,8826,18391,682,1376,6444,13295,7126,14671
260880,202305,14202,31335,12585,28911,334,821,10844,24257,11178,25078
260890,202305,16714,36244,14495,33043,1457,3360,9587,21439,11044,24799
260900,202305,6847,17026,5738,15493,612,1693,3526,9357,4138,11050
260910,202305,4284,9505,3782,8817,176,387,2996,6886,3172,7273
260915,202305,7254,15045,6647,14348,36,103,6305,13458,6341,13561
260920,202305,4360,8259,3765,7637,114,192,3370,6791,3484,6983
260930,202305,5096,12857,4322,11593,174,601,3429,8854,3603,9455
260940,202305,19668,39142,17225,35860,1278,2752,13359,26869,14637,29621
260950,202305,9519,21052,7874,18493,374,1050,5640,12240,6014,13290
260960,202305,118601,212784,102177,193054,7721,15243,79207,142849,86928,158092
260970,202305,6889,15699,6004,14595,391,698,4517,11167,4908,11865
260980,202305,5908,14094,5184,13219,75,190,4730,12072,4805,12262
260990,202305,20506,50375,17391,46167,784,2345,13766,35717,14550,38062
261000,202305,21349,41243,18232,37409,641,1524,15350,30354,15991,31878
261010,202305,2663,5920,2309,5449,99,250,1981,4625,2080,4875
261020,202305,8486,18599,7536,17145,318,752,6217,13608,6535,14360
261030,202305,5027,12601,4408,11582,115,394,3572,8996,3687,9390
261040,202305,6654,16252,5486,14242,167,540,4350,10786,4517,11326
261050,202305,9861,21619,8966,20372,195,403,7652,17118,7847,17521
261060,202305,18858,39930,16497,37177,390,995,14043,30879,14433,31874
261070,202305,95248,181591,81184,163777,7894,15944,59701,116749,67595,132693
261080,202305,8998,17897,8170,16915,83,188,7734,15862,7817,16050
261090,202305,25990,49680,23280,46285,760,1424,20357,39828,21117,41252
261100,202305,11100,25660,9676,23659,575,1397,7478,17874,8053,19271
261110,202305,98282,229903,83920,205682,10224,27279,53417,124992,63641,152271
261120,202305,4910,9902,4328,9119,112,246,3763,7690,3875,7936
261130,202305,9738,19467,8650,18065,203,404,7549,15517,7752,15921
261140,202305,4923,9459,4342,8715,298,544,3379,6734,3677,7278
261150,202305,7020,14728,6245,13677,229,447,5331,11515,5560,11962
261153,202305,2326,6166,1896,5388,83,247,1337,3717,1420,3964
261160,202305,315287,627523,265627,563865,71420,153254,112010,242406,183430,395660
261170,202305,9878,18682,8602,17056,243,476,7555,14497,7798,14973
261180,202305,11669,25016,10306,23334,484,1044,8163,18210,8647,19254
261190,202305,6627,14801,5968,13833,140,551,5089,11209,5229,11760
261200,202305,4398,8489,3812,7740,146,305,3215,6361,3361,6666
261210,202305,2239,4848,1952,4466,136,206,1583,3645,1719,3851
261220,202305,18893,43387,16301,39320,1436,3674,11547,26337,12983,30011
261230,202305,4657,11482,3907,10490,39,152,3325,8847,3364,8999
261240,202305,7907,15192,7100,14091,207,397,6294,12210,6501,12607
261245,202305,4789,11200,3898,9753,69,286,3204,7589,3273,7875
261247,202305,3743,9779,3117,8715,317,858,2063,5755,2380,6613
261250,202305,38393,70906,34158,66112,3602,7098,26974,51826,30576,58924
261255,202305,4845,12535,3866,10754,165,572,2904,7791,3069,8363
261260,202305,20342,39714,18236,37152,292,809,17089,34067,17381,34876
261270,202305,6700,12368,5966,11526,212,392,5345,10136,5557,10528
261280,202305,3223,7626,2807,6984,119,393,2249,5323,2368,5716
261290,202305,3664,7827,3109,7224,99,267,2577,5990,2676,6257
261300,202305,17328,38530,14958,35023,407,1285,12206,27066,12613,28351
261310,202305,12666,26336,11028,24197,976,2137,8292,17680,9268,19817
261320,202305,7430,17978,6506,16544,112,305,5517,13705,5629,14010
261330,202305,7999,15642,7268,14740,173,425,6549,12997,6722,13422
261340,202305,7639,15144,6945,14330,206,429,6329,12835,6535,13264
261350,202305,10184,26839,8891,24710,340,922,6857,18838,7197,19760
261360,202305,11105,21678,9564,19571,423,887,7833,15460,8256,16347
261370,202305,32800,69550,28238,63709,2357,5579,20846,45415,23203,50994
261380,202305,5583,13285,4831,12118,511,1258,3359,8381,3870,9639
261390,202305,21337,52971,17951,47871,1400,4086,12416,31956,13816,36042
261400,202305,6275,15244,5458,13799,212,710,4362,10398,4574,11108
261410,202305,12494,25882,10397,22910,277,776,8863,18627,9140,19403
261420,202305,10771,25609,9807,24509,601,1728,7933,19503,8534,21231
261430,202305,5508,11090,4799,10090,29,110,4390,8919,4419,9029
261440,202305,1653,4442,1353,3903,50,223,976,2665,1026,2888
261450,202305,18913,42152,16741,39083,672,1538,13518,31252,14190,32790
261460,202305,9589,22346,8161,20231,275,689,6607,16185,6882,16874
261470,202305,4597,10221,3991,9371,52,193,3389,7726,3441,7919
261480,202305,6819,17385,5811,15789,248,877,4547,11837,4795,12714
261485,202305,7068,16838,6229,15621,423,1239,4777,11560,5200,12799
261500,202305,8682,18584,7576,17125,711,1293,5356,12535,6067,13828
261510,202305,2169,5772,1897,5337,72,250,1464,4071,1536,4321
261520,202305,2922,7501,2605,6937,143,412,1914,4894,2057,5306
261530,202305,15246,37740,12599,33492,762,2643,8047,19531,8809,22174
261540,202305,12140,29829,11172,28539,3002,6939,5448,15536,8450,22475
261550,202305,4621,10633,4050,9770,244,664,3026,6961,3270,7625
261560,202305,11945,26851,10620,25067,334,939,9011,20695,9345,21634
261570,202305,4450,10707,3473,9093,304,844,2347,5894,2651,6738
261580,202305,9120,19391,8076,18049,59,267,7559,16592,7618,16859
261590,202305,3361,7231,2799,6421,68,228,2318,5082,2386,5310
261600,202305,7654,14566,6644,13214,148,314,5724,10924,5872,11238
261610,202305,2683,6933,2172,6011,243,684,1293,3575,1536,4259
261618,202305,3588,6781,3182,6263,66,179,2814,5335,2880,5514
261620,202305,6082,14116,5605,13466,637,1373,4123,10272,4760,11645
261630,202305,7256,18323,6235,16450,493,1430,4068,10086,4561,11516
261640,202305,48974,92869,42436,85200,2216,3570,33744,68107,35960,71677
261650,202305,5431,10914,4646,10003,234,452,3859,8273,4093,8725
270010,202305,5065,15064,4355,13887,153,736,3401,10474,3554,11210
270020,202305,5114,10488,4496,9743,121,441,3973,8163,4094,8604
270030,202305,45006,107592,38822,98347,2548,6845,30281,74904,32829,81749
270040,202305,12045,28455,10287,26349,680,1868,8171,20749,8851,22617
270050,202305,6648,13590,5749,12593,139,328,5321,11573,5460,11901
270060,202305,2747,6356,2337,5852,166,421,1845,4546,2011,4967
270070,202305,6521,14301,5706,13236,85,331,5121,11448,5206,11779
270080,202305,1718,4098,1400,3615,100,251,1049,2650,1149,2901
270090,202305,2226,5699,2022,5364,32,129,1801,4684,1833,4813
270100,202305,8799,16272,7756,14949,162,354,6998,13154,7160,13508
270110,202305,3921,8380,3258,7608,219,362,2591,6305,2810,6667
270120,202305,2990,7435,2644,6973,89,256,2164,5652,2253,5908
270130,202305,6023,13741,5208,12780,147,461,4492,10828,4639,11289
270135,202305,2383,5024,2055,4668,25,111,1899,4245,1924,4356
270140,202305,10213,22737,8257,20114,393,1137,6406,14860,6799,15997
270150,202305,3892,8746,3611,8383,19,60,3467,8011,3486,8071
270160,202305,6104,15477,5317,14502,169,595,4781,12872,4950,13467
270170,202305,3735,9947,3136,9087,202,800,2222,6062,2424,6862
270180,202305,2849,7528,2548,7142,40,210,2258,6171,2298,6381
270190,202305,3045,6031,2807,5763,31,82,2654,5367,2685,5449
270200,202305,3179,8355,2730,7622,472,1172,1660,4803,2132,5975
270210,202305,7051,14235,6189,13255,96,272,5772,12176,5868,12448
270220,202305,2069,4465,1708,3987,126,317,1311,2916,1437,3233
270230,202305,12217,29267,10492,26765,1002,2756,7875,19555,8877,22311
270235,202305,7312,19892,6464,18587,279,808,5308,15090,5587,15898
270240,202305,14040,33375,11602,29979,1064,3001,8437,21158,9501,24159
270250,202305,4157,8220,3762,7706,154,297,3356,6779,3510,7076
270255,202305,5136,13208,4127,11503,154,490,3251,8803,3405,9293
270260,202305,6392,17631,5814,16685,91,414,5084,14323,5175,14737
270270,202305,1196,2855,1003,2630,130,322,730,1908,860,2230
270280,202305,4475,9593,3581,8529,287,565,2666,6576,2953,7141
270290,202305,9530,26495,8661,25179,172,730,7758,22265,7930,22995
270300,202305,4824,11403,3848,10334,226,523,3084,8420,3310,8943
270310,202305,7905,20069,6802,18449,164,549,5693,15231,5857,15780
270320,202305,6490,17262,5573,15620,239,813,4203,11195,4442,12008
270330,202305,5192,14217,4555,13334,190,795,3825,10984,4015,11779
270340,202305,1943,4585,1657,4179,93,176,1389,3529,1482,3705
270350,202305,2246,4559,1836,4088,151,286,1340,3075,1491,3361
270360,202305,4240,8049,3895,7669,41,101,3747,7312,3788,7413
270370,202305,1581,4445,1427,4171,32,149,1214,3491,1246,3640
270375,202305,4806,8636,4239,8038,17,46,4094,7705,4111,7751
270380,202305,6864,15752,5777,14465,630,1431,4294,10999,4924,12430
270390,202305,1477,3218,1178,2873,13,72,1012,2446,1025,2518
270400,202305,7654,18120,6354,16206,320,874,4818,11929,5138,12803
270410,202305,6021,15000,5279,13945,136,466,4572,11891,4708,12357
270420,202305,8249,19212,7568,18283,183,640,6806,15986,6989,16626
270430,202305,211439,428250,171823,378957,20460,46676,111499,237415,131959,284091
270440,202305,5592,13449,4880,12543,131,405,4288,10980,4419,11385
270450,202305,11132,23169,9996,21852,504,882,8445,18711,8949,19593
270460,202305,4655,9221,3964,8386,232,371,3464,7409,3696,7780
270470,202305,14543,34981,12735,32531,688,2012,10293,25694,10981,27706
270480,202305,3696,8380,3066,7517,188,524,2527,6016,2715,6540
270490,202305,1053,2642,927,2490,37,109,768,2024,805,2133
270500,202305,5787,15419,5254,14543,346,913,4188,11531,4534,12444
270510,202305,7665,16767,6502,15349,318,930,5255,11909,5573,12839
270520,202305,4887,12049,3920,10599,747,2094,1917,5204,2664,7298
270530,202305,1604,4166,1363,3796,95,241,943,2656,1038,2897
270540,202305,2696,6460,2278,5936,72,221,1975,5055,2047,5276
270550,202305,7724,17887,6126,16126,646,1570,4388,11832,5034,13402
270560,202305,3553,7977,2994,7257,151,458,2449,5772,2600,6230
270570,202305,6838,14334,6019,13239,565,1362,4901,10383,5466,11745
270580,202305,2889,6959,2629,6619,105,293,2297,5692,2402,5985
270590,202305,1686,4641,1568,4468,17,68,1462,4159,1479,4227
270600,202305,3313,8840,3032,8423,72,234,2678,7348,2750,7582
270610,202305,4281,10162,3816,9562,166,349,3321,8324,3487,8673
270620,202305,1402,3850,1272,3629,41,129,1072,2983,1113,3112
270630,202305,23764,48467,20915,44744,698,1895,18320,37891,19018,39786
270640,202305,6655,16593,5488,14781,136,529,4474,11760,4610,12289
270642,202305,3078,8627,2715,8043,207,663,1984,5694,2191,6357
270644,202305,4762,10501,4002,9536,306,722,3160,7445,3466,8167
270650,202305,4521,10468,4018,9840,268,808,3382,8090,3650,8898
270660,202305,2324,5147,2047,4786,87,206,1623,3718,1710,3924
270670,202305,23294,44883,19961,40873,722,1539,17331,34533,18053,36072
270680,202305,7767,14413,7123,13724,294,406,6558,12787,6852,13193
270690,202305,12582,26987,10346,24111,234,717,8743,19758,8977,20475
270700,202305,679,1782,600,1659,72,210,421,1122,493,1332
270710,202305,6965,18275,6097,16981,420,1230,4745,13010,5165,14240
270720,202305,4457,11057,3984,10303,97,307,3522,8907,3619,9214
270730,202305,9428,18917,8178,17611,964,1229,6168,14527,7132,15756
270740,202305,2729,6677,2412,6303,80,263,2032,5235,2112,5498
270750,202305,6754,15288,6015,14343,95,384,5476,12740,5571,13124
270760,202305,3981,9626,3326,8753,54,230,2837,7303,2891,7533
270770,202305,29093,64039,24033,57621,3349,8104,15754,37130,19103,45234
270780,202305,2483,5325,2304,5098,55,151,2122,4632,2177,4783
270790,202305,2145,4914,1841,4536,125,305,1499,3637,1624,3942
270800,202305,14576,32408,13158,30525,552,1354,11047,25215,11599,26569
270810,202305,4126,9835,3286,8632,255,693,2458,6345,2713,7038
270820,202305,1888,5088,1634,4717,56,219,1330,3769,1386,3988
270830,202305,6107,13283,5056,12022,258,633,4105,9629,4363,10262
270840,202305,9776,26334,8515,24406,393,1648,6884,18919,7277,20567
270850,202305,10815,21852,9527,20411,682,1580,8041,17066,8723,18646
270860,202305,17671,35336,14163,31406,550,1273,11831,25761,12381,27034
270870,202305,2756,7166,2204,6235,216,622,1424,3964,1640,4586
270880,202305,9228,25133,8247,23642,186,732,6789,19001,6975,19733
270890,202305,4226,10249,3597,9355,543,1398,2030,5177,2573,6575
270895,202305,4705,11009,4217,10409,131,365,3712,9020,3843,9385
270900,202305,1860,4357,1428,3706,22,75,1189,3000,1211,3075
270910,202305,5322,13190,4640,12247,287,633,3814,10031,4101,10664
270915,202305,11301,28253,9227,25035,870,2799,6266,16071,7136,18870
270920,202305,7248,18181,6311,16838,120,426,5395,14021,5515,14447
270930,202305,21937,44399,17571,39458,2189,4535,12614,28935,14803,33470
270940,202305,7212,17266,6075,15989,167,699,4966,12601,5133,13300
280010,202305,687,1818,539,1524,18,78,375,958,393,1036
280020,202305,6502,13788,5521,12334,436,1002,4200,9015,4636,10017
280030,202305,125804,244294,105836,217640,17645,36318,63351,126912,80996,163230
280040,202305,3724,8525,3252,7868,175,494,2522,5856,2697,6350
280050,202305,5131,13059,4273,11654,964,2628,2102,5659,3066,8287
280060,202305,9726,20681,7952,18160,1089,2749,5023,11008,6112,13757
280067,202305,8873,18230,7627,16405,676,1071,5618,12079,6294,13150
280070,202305,2111,5741,1940,5479,122,402,1525,4166,1647,4568
280100,202305,5348,11943,4537,10745,623,1329,2830,6935,3453,8264
280110,202305,1971,4138,1698,3759,24,68,1554,3360,1578,3428
280120,202305,9793,23439,8719,21823,1197,2614,6074,15549,7271,18163
280130,202305,10478,21935,9139,20163,671,1533,7146,15479,7817,17012
280140,202305,7562,14629,6734,13505,709,1155,5062,10372,5771,11527
280150,202305,4808,10946,4157,10030,576,1186,2814,6787,3390,7973
280160,202305,1606,3850,1371,3494,144,390,942,2275,1086,2665
280170,202305,7237,15017,6502,14111,199,452,5613,11903,5812,12355
280190,202305,2082,3413,1903,3191,33,95,1789,2912,1822,3007
280200,202305,1503,3575,1249,3211,82,270,900,2182,982,2452
280210,202305,22254,46527,19361,42612,2359,5165,13002,27826,15361,32991
280220,202305,2030,4558,1754,4206,108,252,1394,3340,1502,3592
280230,202305,4999,11379,4046,9974,256,501,2807,6911,3063,7412
280240,202305,3850,9140,3415,8512,32,161,2973,7177,3005,7338
280250,202305,1279,2419,1057,2125,58,135,843,1606,901,1741
280260,202305,3076,5989,2724,5562,43,96,2524,5109,2567,5205
280270,202305,3034,7037,2666,6538,112,335,2304,5487,2416,5822
280280,202305,4691,12307,4158,11554,577,1371,2868,8210,3445,9581
280290,202305,27666,58965,23773,53626,2696,6456,14808,33495,17504,39951
280300,202305,16527,31662,14450,29443,1114,1537,11484,24486,12598,26023
280310,202305,1669,3784,1392,3352,46,122,1113,2575,1159,2697
280320,202305,11414,25805,9932,23683,1049,2457,7241,16587,8290,19044
280330,202305,5488,12213,4583,10945,366,831,3320,7755,3686,8586
280340,202305,6371,11844,5368,10746,221,330,4718,9477,4939,9807
280350,202305,40120,73590,35642,67873,1411,2871,30380,55887,31791,58758
280360,202305,7020,17220,5982,15618,644,1846,3819,9704,4463,11550
280370,202305,2870,5938,2331,5085,183,340,1705,3657,1888,3997
280380,202305,1286,2947,1084,2671,95,216,767,1878,862,2094
280390,202305,5122,10149,4329,8994,275,451,3534,7293,3809,7744
280400,202305,5136,10587,4470,9748,425,830,3408,7406,3833,8236
280410,202305,3484,8120,2937,7266,351,902,1830,4272,2181,5174
280420,202305,5525,12267,4958,11586,120,289,4468,10432,4588,10721
280430,202305,2945,5830,2636,5437,69,190,2332,4660,2401,4850
280440,202305,5522,12103,4897,11235,273,633,4110,9161,4383,9794
280445,202305,2678,6352,2412,5926,108,222,1871,4475,1979,4697
280450,202305,11974,26661,10424,24583,2370,5614,5321,12787,7691,18401
280460,202305,8662,17718,7868,16665,471,1125,6608,13563,7079,14688
280470,202305,1985,4940,1640,4311,147,425,1183,2963,1330,3388
280480,202305,64549,130182,56340,119270,5880,13170,40153,81873,46033,95043
280490,202305,4100,10760,3472,9675,204,600,2518,6738,2722,7338
280500,202305,1281,2593,1068,2335,29,82,895,1950,924,2032
280510,202305,4474,7520,3984,6927,61,150,3689,6198,3750,6348
280520,202305,2319,4761,2042,4399,170,297,1552,3341,1722,3638
280530,202305,2797,6359,2438,5880,118,287,1954,4619,2072,4906
280540,202305,10241,24516,9219,23091,405,992,7840,19486,8245,20478
280550,202305,8149,16421,6862,14667,160,527,5834,11863,5994,12390
280560,202305,9129,21324,8506,20462,127,391,7674,18138,7801,18529
280570,202305,8635,17528,7258,15873,311,742,5835,12360,6146,13102
280580,202305,7673,16055,6833,14924,512,933,5494,11891,6006,12824
280590,202305,3332,7002,2823,6385,167,442,2125,4575,2292,5017
280600,202305,5219,11126,4619,10264,503,943,3293,7303,3796,8246
280610,202305,3463,6856,3102,6414,138,328,2665,5309,2803,5637
280620,202305,7701,15691,6631,14373,538,823,4915,11020,5453,11843
280630,202305,5122,11363,4721,10863,446,869,3628,8527,4074,9396
280640,202305,3019,6571,2636,6157,81,177,2380,5551,2461,5728
280650,202305,1416,3367,1188,3028,126,308,803,1980,929,2288
280660,202305,4772,8900,4202,8250,265,484,3584,6945,3849,7429
280670,202305,25598,52491,22205,48155,3678,7800,14029,30228,17707,38028
280680,202305,3537,7435,3040,6766,302,542,2106,4836,2408,5378
280690,202305,1288,2554,1093,2313,47,118,898,1833,945,1951
280700,202305,1452,3000,1246,2720,29,69,1046,2216,1075,2285
280710,202305,18792,36086,16270,33280,1002,1533,13969,28777,14971,30310
280720,202305,3125,6190,2550,5522,33,76,2144,4611,2177,4687
280730,202305,1243,2849,1057,2573,116,272,711,1693,827,1965
280740,202305,21327,39987,18601,36312,975,2142,15274,28528,16249,30670
280750,202305,4063,10228,3479,9256,299,791,2440,6374,2739,7165
280760,202305,9110,19216,7787,17495,755,1524,5691,12749,6446,14273
290010,202305,3692,6730,2558,5074,26,53,2253,4296,2279,4349
290020,202305,7440,15099,6824,14384,492,755,5739,12300,6231,13055
290030,202305,5499,11052,4538,9945,360,689,3502,7815,3862,8504
290035,202305,6182,11689,5262,10519,242,409,4325,8559,4567,8968
290040,202305,7112,12137,6198,11082,270,375,5463,9745,5733,10120
290050,202305,2493,7109,2130,6403,149,482,1483,4330,1632,4812
290060,202305,1887,3588,1394,2934,169,383,1015,2048,1184,2431
290070,202305,52646,99206,45643,90389,3225,6049,35536,68541,38761,74590
290080,202305,8453,19225,7368,17718,826,2078,5276,12502,6102,14580
290090,202305,2723,4323,2047,3603,29,60,1908,3304,1937,3364
290100,202305,12011,27369,9753,24153,1794,4279,4888,12545,6682,16824
290110,202305,6831,15497,5836,13914,882,1965,3400,8054,4282,10019
290115,202305,4813,12810,4120,11633,376,1091,3166,8868,3542,9959
290120,202305,8195,17340,6947,15646,212,546,5955,13059,6167,13605
290130,202305,5528,11517,4299,9941,297,576,3041,7274,3338,7850
290135,202305,5681,11439,4652,9789,233,548,3712,7339,3945,7887
290140,202305,5227,12077,4084,10584,205,489,3327,8677,3532,9166
290150,202305,4189,7779,3658,7194,152,364,3128,5957,3280,6321
290160,202305,4479,8511,3984,7849,219,354,3364,6569,3583,6923
290170,202305,4624,9213,4110,8667,140,270,3638,7666,3778,7936
290180,202305,3585,8438,3060,7626,73,238,2605,6307,2678,6545
290190,202305,6185,12958,5577,12194,116,316,4924,10559,5040,10875
290195,202305,3320,6689,2654,5843,169,326,2183,4815,2352,5141
290200,202305,4940,12285,3885,10489,250,558,2728,7358,2978,7916
290205,202305,4530,9629,4013,8886,180,419,3311,7179,3491,7598
290210,202305,17842,39469,15806,36517,1589,3150,11988,28038,13577,31188
290220,202305,4168,7688,3725,7178,96,229,3318,6213,3414,6442
290225,202305,3737,6560,2952,5753,43,122,2731,5167,2774,5289
290230,202305,3870,7434,3553,7084,179,259,2945,6029,3124,6288
290240,202305,5109,10072,4243,9042,108,283,3727,7772,3835,8055
290250,202305,5051,12047,4154,10779,161,377,3452,9087,3613,9464
290260,202305,6495,13843,5572,12548,269,687,4683,10198,4952,10885
290265,202305,3745,10228,3069,8983,332,1051,1918,5450,2250,6501
290270,202305,13065,39241,11930,37354,881,2787,9091,28535,9972,31322
290280,202305,7313,20154,6310,18209,627,2048,4205,11596,4832,13644
290290,202305,11700,30804,9357,26682,1122,3421,5717,15736,6839,19157
290300,202305,4920,12025,3691,9805,219,619,2623,6719,2842,7338
290310,202305,2823,4921,2345,4379,19,58,2202,4027,2221,4085
290320,202305,37496,82961,30713,73323,5472,13456,17821,41421,23293,54877
290323,202305,4603,11137,3855,9914,155,405,2993,7629,3148,8034
290327,202305,5084,12798,4281,11301,412,999,2850,7391,3262,8390
290330,202305,3047,4936,2526,4381,18,20,2365,4093,2383,4113
290340,202305,7805,15932,6295,14169,438,954,5091,11372,5529,12326
290350,202305,5676,14316,4749,12778,289,893,3459,9059,3748,9952
290360,202305,6626,13710,5568,12280,69,191,4924,10633,4993,10824
290370,202305,5633,12345,4108,10334,236,602,2843,7081,3079,7683
290380,202305,7230,15315,6046,13746,178,302,5158,11768,5336,12070
290390,202305,18823,46969,15647,41941,1490,4009,10856,28681,12346,32690
290395,202305,3538,8639,2824,7454,74,262,2226,5704,2300,5966
290400,202305,4485,10977,3631,9625,172,536,2735,7001,2907,7537
290405,202305,5439,14000,4577,12528,524,1373,2971,8277,3495,9650
290410,202305,6691,15791,5143,13457,185,690,3944,9914,4129,10604
290420,202305,3719,9014,3017,7968,127,332,2300,6036,2427,6368
290430,202305,4540,9631,3800,8590,155,436,3109,6694,3264,7130
290440,202305,3442,7623,2510,6186,175,388,1783,4405,1958,4793
290450,202305,5345,10016,4366,8677,81,207,3916,7478,3997,7685
290460,202305,15377,39365,12632,34445,2856,8065,4886,12990,7742,21055
290470,202305,5943,11747,4619,10028,399,896,3216,6743,3615,7639
290475,202305,7975,19746,6605,17539,90,410,5577,14445,5667,14855
290480,202305,2268,4831,1861,4248,75,234,1418,3014,1493,3248
290485,202305,5631,14154,4925,13172,242,709,3951,10534,4193,11243
290490,202305,11916,23309,10895,22009,480,945,9157,18236,9637,19181
290500,202305,5048,13540,3950,11385,801,2499,1513,4138,2314,6637
290510,202305,4427,9137,3747,8283,107,235,3286,7286,3393,7521
290515,202305,4159,10251,3623,9506,28,89,3283,8638,3311,8727
290520,202305,15027,37111,11626,30766,579,1832,7934,19371,8513,21203
290530,202305,5820,14940,4902,13500,96,378,4162,11301,4258,11679
290540,202305,4891,10918,4499,10492,181,471,4019,9346,4200,9817
290550,202305,5228,11495,4586,10738,53,106,4225,9963,4278,10069
290560,202305,7479,17236,5874,14935,595,1706,3699,8798,4294,10504
290570,202305,74487,155991,67227,146888,5482,13126,53406,113077,58888,126203
290580,202305,11300,25657,9914,23823,946,2071,7382,18070,8328,20141
290590,202305,8289,23026,6928,20749,161,548,5658,16968,5819,17516
290600,202305,22966,56907,19848,52041,1272,3513,15584,40040,16856,43553
290610,202305,2901,8148,2292,6992,101,327,1618,4841,1719,5168
290620,202305,7183,18809,6256,17363,443,1165,4961,13780,5404,14945
290630,202305,13084,24855,10963,22273,778,1605,8870,17807,9648,19412
290640,202305,3307,7131,2612,6185,252,494,1795,4416,2047,4910
290650,202305,23868,45012,22013,42944,811,1854,20015,38282,20826,40136
290660,202305,4498,10519,3563,8988,190,547,2539,6309,2729,6856
290670,202305,10725,21047,9460,19365,200,530,8409,16795,8609,17325
290680,202305,13543,31906,11228,28617,225,859,9423,23374,9648,24233
290682,202305,6725,13557,5854,12460,483,677,4360,10042,4843,10719
290685,202305,4216,8621,3117,7076,488,1003,1763,4145,2251,5148
290687,202305,10273,21611,8650,19230,1250,2579,5544,12472,6794,15051
290689,202305,3351,8164,2569,6871,366,953,1601,4284,1967,5237
290690,202305,6950,15879,5758,14206,410,1022,4237,10212,4647,11234
290700,202305,3865,7737,3445,7241,75,187,3062,6323,3137,6510
290710,202305,11146,25082,9566,22981,197,596,8453,19958,8650,20554
290720,202305,25689,57900,23016,53975,1616,3301,18094,41798,19710,45099
290730,202305,8742,18293,7424,16754,582,1081,5285,12300,5867,13381
290740,202305,1335,3040,1013,2550,53,114,833,2073,886,2187
290750,202305,17651,34047,15170,30474,349,881,12758,24046,13107,24927
290755,202305,2328,6054,1876,5279,149,365,1281,3649,1430,4014
290760,202305,4426,11447,3711,10218,193,457,2648,7411,2841,7868
290770,202305,3902,8815,3633,8509,72,183,3281,7656,3353,7839
290780,202305,9309,20951,7892,19010,431,843,5894,14244,6325,15087
290790,202305,6260,14778,5399,13561,309,775,4417,11068,4726,11843
290800,202305,8157,14532,6049,12127,457,757,4439,9026,4896,9783
290810,202305,6851,14689,5581,12904,223,543,4368,9966,4591,10509
290820,202305,6635,14715,5693,13288,306,677,4073,9252,4379,9929
290830,202305,5108,11430,4500,10422,116,409,3596,7726,3712,8135
290840,202305,22439,52343,19011,47158,2096,4426,12289,32011,14385,36437
290850,202305,11403,20564,9888,18921,617,999,8148,15396,8765,16395
290860,202305,7946,18692,6987,17573,388,831,5893,15098,6281,15929
290870,202305,5787,14171,4452,11733,385,909,2919,7603,3304,8512
290880,202305,1681,3674,1329,3227,215,477,739,1934,954,2411
290890,202305,12160,21122,10704,19518,339,590,9662,17483,10001,18073
290900,202305,2715,6641,2102,5594,204,523,1257,3281,1461,3804
290910,202305,6166,12735,4728,10656,43,108,4121,9144,4164,9252
290920,202305,6363,13637,5480,12591,145,207,4671,11276,4816,11483
290930,202305,8529,21842,6834,18947,309,1023,5034,13530,5343,14553
290940,202305,4057,10366,3324,9232,194,612,2538,6884,2732,7496
290950,202305,1690,3785,1374,3335,125,295,879,2151,1004,2446
290960,202305,7425,15962,6598,14965,310,572,5524,12500,5834,13072
290970,202305,3600,10083,2964,8901,148,513,2230,6597,2378,7110
290980,202305,18274,36937,15964,33633,863,2019,11715,23300,12578,25319
290990,202305,11963,27675,10576,25616,350,1112,8853,20622,9203,21734
291000,202305,3921,8864,3075,7839,165,428,2466,6330,2631,6758
291005,202305,21655,45786,19241,42806,1070,2337,15870,34678,16940,37015
291010,202305,3501,9902,2773,8361,157,516,1788,5187,1945,5703
291020,202305,1521,3405,1243,2963,30,93,914,2006,944,2099
291030,202305,3076,6469,2286,5241,236,492,1403,3119,1639,3611
291040,202305,6368,15329,5167,13674,272,749,3971,10528,4243,11277
291050,202305,14561,28393,12919,26238,1573,3021,9449,18927,11022,21948
291060,202305,11027,23858,9718,22215,1032,2119,7285,16664,8317,18783
291070,202305,22552,48151,19274,43301,355,1079,16825,36577,17180,37656
291072,202305,35808,76291,27817,64249,4136,9627,16114,35847,20250,45474
291075,202305,6379,14193,5752,13246,99,282,4796,10582,4895,10864
291077,202305,1974,4692,1524,3932,105,195,1043,2704,1148,2899
291080,202305,170803,356130,139966,315593,28311,65122,70673,155172,98984,220294
291085,202305,6694,14983,5461,13136,256,694,4450,10445,4706,11139
291090,202305,2564,4315,1908,3595,42,72,1641,3007,1683,3079
291100,202305,3892,7208,2834,5953,132,251,2242,4634,2374,4885
291110,202305,6943,19141,5835,17321,392,1369,4341,12505,4733,13874
291120,202305,10246,20411,8888,18784,581,1188,7049,14743,7630,15931
291125,202305,2816,4347,2152,3611,85,130,1881,3118,1966,3248
291130,202305,3804,9608,2814,7799,85,294,2167,5742,2252,6036
291140,202305,5724,13763,4112,10923,776,1829,2237,5974,3013,7803
291150,202305,3399,5819,2711,5073,84,126,2503,4675,2587,4801
291160,202305,6071,14951,5013,13434,665,1807,3043,7888,3708,9695
291165,202305,2395,6104,1742,4858,25,115,1198,3186,1223,3301
291170,202305,27263,61696,22772,54508,1776,4349,15089,34262,16865,38611
291180,202305,9617,16581,7643,14136,324,607,6677,12053,7001,12660
291185,202305,4270,9138,3787,8463,214,441,3037,6742,3251,7183
291190,202305,9305,19821,7808,17977,333,732,6052,14128,6385,14860
291200,202305,3229,8110,2385,6539,88,312,1605,4102,1693,4414
291210,202305,9531,16938,7203,14337,398,692,5711,11306,6109,11998
291220,202305,6088,14142,5440,13203,573,1343,3720,8886,4293,10229
291230,202305,6041,10208,4955,9048,70,111,4628,8388,4698,8499
291240,202305,4989,11567,4262,10402,90,240,3693,8861,3783,9101
291250,202305,3789,10291,2954,8792,216,605,1763,5346,1979,5951
291260,202305,1814,3629,1479,3206,34,65,1222,2666,1256,2731
291270,202305,6795,14825,5331,12872,694,1571,3643,8988,4337,10559
291280,202305,3393,7345,2541,6113,171,418,1771,4057,1942,4475
291290,202305,6569,15556,5083,13339,502,1376,3358,8564,3860,9940
291300,202305,4670,10991,3749,9520,259,595,2714,6800,2973,7395
291310,202305,6281,14503,5458,13173,142,391,4723,11143,4865,11534
291320,202305,7848,18857,6192,16189,1370,3472,3200,8487,4570,11959
291330,202305,2232,5149,1810,4468,67,190,1376,3291,1443,3481
291340,202305,5050,11638,4023,10011,224,480,2704,6646,2928,7126
291345,202305,3559,8754,3164,8184,196,564,2529,6484,2725,7048
291350,202305,8515,17752,6885,15743,247,600,5717,12823,5964,13423
291360,202305,55152,104557,44996,92934,5966,11977,29579,61768,35545,73745
291370,202305,10078,23779,8892,21996,860,2215,6491,15465,7351,17680
291380,202305,5893,11558,5279,10783,109,303,4771,9520,4880,9823
291390,202305,16654,30415,13171,26575,797,1351,11054,22131,11851,23482
291400,202305,20585,41300,17258,36549,1837,3702,11901,25128,13738,28830
291410,202305,3542,8316,2800,7086,59,202,2098,5102,2157,5304
291420,202305,2228,4834,1774,4286,19,58,1535,3657,1554,3715
291430,202305,3073,7607,2628,6879,137,415,2046,5157,2183,5572
291440,202305,8036,19805,6868,18035,537,1336,5013,13400,5550,14736
291450,202305,13872,25058,11513,22412,312,463,10260,20114,10572,20577
291460,202305,22794,48730,19951,44674,2091,4357,14384,31575,16475,35932
291465,202305,10461,22755,8453,20434,290,962,7178,16882,7468,17844
291470,202305,25847,46795,22300,42779,1314,2230,17800,33947,19114,36177
291480,202305,54806,107076,44228,92789,5146,11041,27263,54743,32409,65784
291490,202305,9246,17885,8308,16862,317,689,7482,15020,7799,15709
291500,202305,6748,12794,5776,11601,163,376,5307,10567,5470,10943
291510,202305,5825,11197,4535,9584,71,195,4016,8277,4087,8472
291520,202305,5530,11174,4295,9652,250,572,3492,7719,3742,8291
291530,202305,2771,5632,2059,4720,212,471,1416,3282,1628,3753
291535,202305,4675,11258,3914,10009,209,474,3135,8059,3344,8533
291540,202305,2628,5016,1911,4151,71,151,1621,3508,1692,3659
291550,202305,8140,14788,6548,12878,518,890,4899,9497,5417,10387
291560,202305,21461,46708,16461,40210,4123,9979,7268,18227,11391,28206
291570,202305,2884,5728,2229,4991,77,180,1947,4355,2024,4535
291580,202305,7683,17154,6093,15150,395,1060,4535,10998,4930,12058
291590,202305,3482,6339,3104,5911,68,182,2867,5306,2935,5488
291600,202305,6724,13576,5227,11440,511,1253,3502,7392,4013,8645
291610,202305,8663,16639,7741,15601,700,982,6166,12872,6866,13854
291620,202305,3525,6974,2753,6126,231,430,2029,4598,2260,5028
291630,202305,4293,7840,3356,6722,600,881,2363,5027,2963,5908
291640,202305,22651,45425,17858,39054,1476,3374,11715,24305,13191,27679
291650,202305,12669,25406,11333,23874,882,1237,9337,20329,10219,21566
291660,202305,2333,5123,1753,4267,134,387,1190,2677,1324,3064
291670,202305,2389,5697,1957,5065,243,550,1252,3364,1495,3914
291680,202305,4953,10717,4063,9553,691,1650,2398,5681,3089,7331
291685,202305,5593,12649,4519,11140,313,671,3318,8158,3631,8829
291690,202305,5484,9710,4074,7877,164,322,3535,6628,3699,6950
291700,202305,11784,27393,10436,25332,318,986,9030,21272,9348,22258
291710,202305,6679,13060,5247,11199,360,758,4005,8228,4365,8986
291720,202305,5273,14293,4365,12619,1015,3013,2201,6256,3216,9269
291730,202305,9895,18302,8574,16656,408,844,7361,14098,7769,14942
291733,202305,3535,7903,2919,7073,119,223,2174,5461,2293,5684
291735,202305,3101,7831,2340,6481,61,175,1627,4489,1688,4664
291740,202305,4890,11393,3248,8419,105,229,2265,5750,2370,5979
291750,202305,27237,55669,22978,49624,3211,6094,15197,33062,18408,39156
291760,202305,13591,34069,10747,29800,3484,11349,2418,5920,5902,17269
291770,202305,9387,21963,7728,19163,422,1265,5885,13762,6307,15027
291780,202305,6426,14395,5840,13625,181,446,5034,11516,5215,11962
291790,202305,3743,8095,3455,7759,430,661,2520,5947,2950,6608
291800,202305,44971,93060,36516,81647,4615,10860,23075,48837,27690,59697
291810,202305,13282,27433,11464,25311,560,963,9433,21188,9993,22151
291820,202305,4794,10917,4189,10139,136,329,3428,8204,3564,8533
291830,202305,6023,11381,4961,10059,384,530,3868,7956,4252,8486
291835,202305,7734,20906,6170,18099,868,2535,3821,11259,4689,13794
291840,202305,66250,152935,58256,141212,6953,17454,40888,97196,47841,114650
291845,202305,4223,8144,3532,7340,289,468,2823,6042,3112,6510
291850,202305,5525,12876,4719,11697,122,301,4033,9976,4155,10277
291855,202305,2845,4627,2362,4113,37,58,2222,3843,2259,3901
291860,202305,2539,6234,1746,4747,50,141,1158,3038,1208,3179
291870,202305,1499,3460,994,2606,58,164,658,1677,716,1841
291875,202305,3463,9551,2962,8537,71,290,2189,6032,2260,6322
291880,202305,6768,16435,5680,14737,362,856,4288,11273,4650,12129
291890,202305,2094,3756,1395,2950,218,448,876,1807,1094,2255
291900,202305,1640,3414,1262,2851,40,92,1016,2197,1056,2289
291905,202305,2534,6210,2077,5499,110,351,1522,3855,1632,4206
291910,202305,4520,8394,3913,7694,85,180,3497,6803,3582,6983
291915,202305,8712,22003,7107,19383,257,657,5248,14649,5505,15306
291920,202305,45861,97430,40751,90915,1960,5371,33219,70992,35179,76363
291930,202305,3392,7387,2870,6691,331,707,2038,4816,2369,5523
291940,202305,4456,10286,3041,8031,293,730,1822,4723,2115,5453
291950,202305,10827,30277,9107,27202,544,1634,6075,18055,6619,19689
291955,202305,26255,55701,23558,52309,1621,3728,18733,40933,20354,44661
291960,202305,4703,9362,3981,8471,318,510,3139,6881,3457,7391
291970,202305,6125,12444,5230,11389,211,492,4226,9041,4437,9533
291980,202305,12164,30566,9951,27028,988,2550,6670,18253,7658,20803
291990,202305,2755,6215,2296,5665,43,160,2082,5045,2125,5205
291992,202305,5745,11455,5071,10578,183,411,4312,8660,4495,9071
291995,202305,2828,6253,2348,5554,84,253,1949,4467,2033,4720
292000,202305,3364,6610,2832,6007,98,233,2429,5079,2527,5312
292010,202305,7137,14128,5906,12372,103,336,5140,10396,5243,10732
292020,202305,5723,13685,4940,12458,136,491,4117,9938,4253,10429
292030,202305,2592,6548,2226,5930,204,577,1460,3762,1664,4339
292040,202305,5697,12017,4582,10496,157,356,3828,8650,3985,9006
292045,202305,5554,10870,4514,9440,21,56,4245,8828,4266,8884
292050,202305,7725,19009,6274,16617,291,892,4329,11048,4620,11940
292060,202305,16257,30677,15087,29303,557,970,13425,25570,13982,26540
292070,202305,8745,17418,7798,16321,580,1159,6587,13715,7167,14874
292080,202305,4715,8762,3954,7832,45,139,3691,7195,3736,7334
292090,202305,5172,9972,3689,8166,202,502,2950,6476,3152,6978
292100,202305,16344,34422,14006,31465,2201,4976,8572,19160,10773,24136
292105,202305,3948,9101,3438,8404,49,162,2878,6959,2927,7121
292110,202305,8267,16217,6107,13386,876,2013,3955,8448,4831,10461
292120,202305,8695,19318,7230,16977,842,1736,4886,11448,5728,13184
292130,202305,4040,8588,3317,7694,252,607,2419,5476,2671,6083
292140,202305,7145,13761,6081,12308,193,405,5396,10734,5589,11139
292145,202305,3210,7622,2705,6840,157,287,2038,5274,2195,5561
292150,202305,19884,42999,17216,38897,378,984,14863,32517,15241,33501
292160,202305,3480,7334,2651,6320,24,82,2103,5254,2127,5336
292170,202305,10541,24980,8790,22260,608,1748,6508,15926,7116,17674
292180,202305,3367,8507,2587,7102,203,582,1625,4275,1828,4857
292190,202305,3753,8447,3170,7620,321,779,2175,5214,2496,5993
292200,202305,11606,25492,8853,21668,2111,5381,3938,9670,6049,15051
292205,202305,4629,11108,4056,10298,109,287,3486,8844,3595,9131
292210,202305,8253,15627,6939,14038,102,295,6473,12854,6575,13149
292220,202305,2765,5554,2366,4987,195,393,1725,3480,1920,3873
292225,202305,3754,9737,3269,9033,71,270,2813,7629,2884,7899
292230,202305,10777,22354,9416,20571,333,873,7886,16765,8219,17638
292240,202305,6179,15528,5238,13866,363,936,3694,9716,4057,10652
292250,202305,7675,16707,6847,15577,379,888,5469,12133,5848,13021
292260,202305,4150,9647,3619,8992,71,198,3178,7852,3249,8050
292265,202305,4535,10364,3782,9216,68,263,3228,7610,3296,7873
292270,202305,6089,11176,5063,9982,201,333,4276,8316,4477,8649
292273,202305,3396,6544,2739,5754,153,269,1985,4372,2138,4641
292275,202305,2206,4871,1842,4402,51,146,1539,3586,1590,3732
292280,202305,3332,6776,2691,6038,112,193,2283,5199,2395,5392
292285,202305,3102,6367,2483,5552,131,232,2005,4552,2136,4784
292290,202305,9134,20198,7360,17747,262,618,6128,14583,6390,15201
292300,202305,12976,28890,10310,25232,1702,4212,6055,14837,7757,19049
292303,202305,4198,9267,3636,8438,65,149,3230,7364,3295,7513
292305,202305,2772,6518,2517,6170,74,206,2232,5395,2306,5601
292310,202305,8448,17902,7400,16640,159,461,6512,14282,6671,14743
292320,202305,6864,16411,5553,14274,186,525,4368,10970,4554,11495
292330,202305,3955,6650,3349,5988,164,240,2826,5114,2990,5354
292335,202305,6171,14195,5428,13110,327,769,4432,10703,4759,11472
292340,202305,6242,16095,5099,13939,399,992,3525,9577,3924,10569
292350,202305,3415,7781,2908,7113,156,410,2392,5779,2548,6189
292360,202305,5964,14098,4976,12550,277,733,3665,9044,3942,9777
292370,202305,13486,26986,11683,24662,83,312,11081,22998,11164,23310
292380,202305,8212,20153,7326,18662,467,1236,5699,14170,6166,15406
292390,202305,5835,9282,4687,7995,124,207,4268,7229,4392,7436
292400,202305,29627,70366,25528,64345,2685,6591,17741,44254,20426,50845
292405,202305,5507,11735,4604,10365,156,345,3616,8243,3772,8588
292410,202305,3091,5681,2702,5232,104,171,2390,4622,2494,4793
292420,202305,6224,11931,5568,11060,139,245,5053,9860,5192,10105
292430,202305,5955,15870,4489,13234,346,1102,3021,8677,3367,9779
292440,202305,11487,29159,10530,27809,124,570,9548,24828,9672,25398
292450,202305,4944,12445,3749,10227,101,284,2898,7754,2999,8038
292460,202305,7931,16165,6799,14537,160,431,5993,12434,6153,12865
292465,202305,3085,6908,2616,6322,114,236,1790,4560,1904,4796
292467,202305,2643,6097,2354,5719,305,622,1665,4275,1970,4897
292470,202305,3322,7904,2527,6678,178,459,1754,4631,1932,5090
292480,202305,8146,14990,6895,13519,193,370,6250,12163,6443,12533
292490,202305,3443,6541,2848,5799,68,153,2459,4865,2527,5018
292500,202305,9002,19715,7237,17082,394,869,5442,12530,5836,13399
292510,202305,17363,39036,13840,33748,1325,2955,9578,23269,10903,26224
292520,202305,9235,20318,8171,18804,415,1104,6583,14677,6998,15781
292525,202305,8134,16267,6836,14784,145,339,6146,13217,6291,13556
292530,202305,46491,103793,37741,90666,7483,19313,19881,45805,27364,65118
292540,202305,5192,8566,4250,7577,156,234,3819,6839,3975,7073
292550,202305,10391,24927,8206,22297,737,1856,5564,15947,6301,17803
292560,202305,5569,12293,4610,10984,179,533,3554,8112,3733,8645
292570,202305,4500,10271,3763,9043,64,237,3183,7311,3247,7548
292575,202305,8141,20973,7438,20006,1298,3471,4936,13425,6234,16896
292580,202305,9665,19869,8110,17715,452,658,6774,14818,7226,15476
292590,202305,8850,20978,7471,18578,349,1055,6129,14750,6478,15805
292593,202305,3511,7712,2751,6458,93,225,2230,5119,2323,5344
292595,202305,6843,15488,6026,14490,310,622,4977,12177,5287,12799
292600,202305,13781,32339,11901,29624,725,1623,9341,23278,10066,24901
292610,202305,5594,12074,4741,10748,166,364,3866,8554,4032,8918
292620,202305,8293,18488,6971,16901,124,316,6352,15354,6476,15670
292630,202305,11534,23843,9332,20483,1224,3043,6222,12834,7446,15877
292640,202305,9647,24745,8034,22059,492,1348,5478,15034,5970,16382
292650,202305,5038,11320,4486,10596,64,220,4108,9548,4172,9768
292660,202305,12910,32178,11143,29636,608,1478,8452,22660,9060,24138
292665,202305,2411,6267,2032,5767,126,299,1566,4583,1692,4882
292670,202305,3992,10201,3146,8671,290,909,2031,5334,2321,6243
292680,202305,4606,10875,3754,9468,97,244,2923,7140,3020,7384
292690,202305,2821,6839,1991,5513,234,618,1215,3433,1449,4051
292700,202305,12912,29385,11100,26759,690,1421,8326,19902,9016,21323
292710,202305,4308,9022,4049,8717,118,191,3818,8249,3936,8440
292720,202305,10508,21619,8954,19834,498,964,6830,15601,7328,16565
292730,202305,6914,13091,6231,12167,315,513,5312,10233,5627,10746
292740,202305,531984,1037038,478483,966708,51500,106982,347856,678855,399356,785837
292750,202305,9133,18789,7844,17169,313,619,6635,14430,6948,15049
292760,202305,4716,11811,4062,10705,191,545,3107,8002,3298,8547
292770,202305,9613,20633,8014,18504,1066,2513,5519,12741,6585,15254
292780,202305,2539,4337,1911,3607,52,119,1631,2911,1683,3030
292790,202305,4669,8598,3535,7376,307,563,2770,5854,3077,6417
292800,202305,14715,31160,12772,28363,1042,2101,9769,21784,10811,23885
292805,202305,4560,9078,3721,8064,137,310,3147,6663,3284,6973
292810,202305,16876,32509,14015,28478,432,1139,11968,23018,12400,24157
292820,202305,7932,20540,5939,17201,540,1714,4020,11323,4560,13037
292830,202305,3578,7356,3124,6830,165,343,2559,5690,2724,6033
292840,202305,12617,25262,10963,23162,162,451,10014,20637,10176,21088
292850,202305,3167,7198,2702,6570,231,530,1905,4544,2136,5074
292860,202305,22661,42182,20345,39359,427,1061,17992,33712,18419,34773
292870,202305,29209,59574,25315,54289,2116,4314,17753,36652,19869,40966
292880,202305,13596,34033,11412,30594,461,1554,8165,20718,8626,22272
292890,202305,10930,23382,9745,21792,239,725,8516,18412,8755,19137
292895,202305,4122,7441,3278,6242,244,393,2647,5027,2891,5420
292900,202305,3710,8011,3340,7517,54,194,2829,6079,2883,6273
292905,202305,5392,12160,4345,10601,224,606,3319,7762,3543,8368
292910,202305,7021,15312,6215,14284,191,386,5098,11477,5289,11863
292920,202305,12436,28563,11400,27129,366,1076,9767,22619,10133,23695
292925,202305,6170,16072,5065,14027,460,1041,3402,9476,3862,10517
292930,202305,8723,22336,7454,19976,1066,2879,4145,10771,5211,13650
292935,202305,3375,6072,2759,5396,27,91,2536,4879,2563,4970
292937,202305,3290,7654,2722,6888,264,715,1405,3987,1669,4702
292940,202305,3632,8038,2954,7042,502,1098,1786,4370,2288,5468
292950,202305,11069,25757,9659,23726,606,1429,7221,17321,7827,18750
292960,202305,6815,14132,5714,12637,217,403,4626,10061,4843,10464
292970,202305,4921,12002,4369,11246,123,321,3636,9435,3759,9756
292975,202305,5226,10226,4728,9663,101,232,4346,8775,4447,9007
292980,202305,4787,9026,4058,8038,55,155,3652,7041,3707,7196
292990,202305,13799,34148,11501,30362,434,1351,8976,22818,9410,24169
293000,202305,3228,6996,2696,6174,164,333,2037,4694,2201,5027
293010,202305,23525,51284,19239,45124,2709,6661,12082,27702,14791,34363
293015,202305,10355,27877,8256,24049,729,2132,5564,16184,6293,18316
293020,202305,12652,29863,11570,28379,164,524,10563,25650,10727,26174
293030,202305,6236,14770,4824,12640,406,757,3150,8643,3556,9400
293040,202305,5308,11971,4235,10507,133,342,3517,8631,3650,8973
293050,202305,32124,62411,28375,57215,2022,4008,22075,43149,24097,47157
293060,202305,4602,10811,3699,9216,238,637,2675,6382,2913,7019
293070,202305,42845,80857,38464,75523,2387,4907,31091,59106,33478,64013
293075,202305,4401,11779,3815,10875,68,325,3280,9287,3348,9612
293076,202305,4133,8786,3757,8351,105,184,3339,7498,3444,7682
293077,202305,8105,18988,6630,16796,1049,2304,3771,10209,4820,12513
293080,202305,5283,13931,4469,12513,85,339,3686,10067,3771,10406
293090,202305,3707,9975,2870,8551,226,688,1950,5711,2176,6399
293100,202305,7116,16690,5758,14420,380,814,4376,10928,4756,11742
293105,202305,4616,13062,3923,11732,275,817,2699,8047,2974,8864
293110,202305,3163,6433,2668,5747,139,284,2141,4538,2280,4822
293120,202305,6498,13342,5968,12647,531,759,4803,10545,5334,11304
293130,202305,4425,10398,3866,9694,125,391,3381,8322,3506,8713
293135,202305,39432,84949,29496,71395,5920,15800,11543,26709,17463,42509
293140,202305,3605,6009,3193,5543,109,148,2840,4869,2949,5017
293150,202305,6180,16303,5117,14394,499,1410,3382,9260,3881,10670
293160,202305,5097,10298,4553,9689,565,732,3517,8166,4082,8898
293170,202305,6761,10872,5748,9721,103,227,5098,8369,5201,8596
293180,202305,5618,13361,4669,11753,114,339,3815,9304,3929,9643
293190,202305,21110,42071,18801,38960,124,490,17387,35047,17511,35537
293200,202305,11667,22922,9657,19986,632,980,7874,16300,8506,17280
293210,202305,6751,14726,5752,13312,614,1260,4133,9680,4747,10940
293220,202305,7461,14991,5721,12340,819,1693,3777,7855,4596,9548
293230,202305,5932,11486,4560,9834,427,777,3367,7377,3794,8154
293240,202305,5426,12168,4464,10706,208,375,3337,8320,3545,8695
293245,202305,4847,11294,4398,10672,289,706,3548,8417,3837,9123
293250,202305,6934,14759,5662,13018,499,1201,4162,9331,4661,10532
293260,202305,5958,13142,4867,11541,169,316,3589,8601,3758,8917
293270,202305,9261,17469,7577,15692,569,682,6165,13515,6734,14197
293280,202305,5640,12371,4931,11426,318,685,3970,9155,4288,9840
293290,202305,21925,52354,19462,48686,1834,4711,13992,34305,15826,39016
293300,202305,8420,16855,7244,15194,748,1465,5315,10845,6063,12310
293305,202305,5561,11061,4601,9893,53,133,4180,8912,4233,9045
293310,202305,2725,6007,2300,5368,33,116,1927,4354,1960,4470
293315,202305,5708,10869,4802,9660,475,687,3810,7808,4285,8495
293317,202305,3424,7054,3052,6526,396,658,2129,4660,2525,5318
293320,202305,17974,33946,16136,31956,189,470,14907,28923,15096,29393
293325,202305,2310,4878,1783,4231,197,467,1191,2782,1388,3249
293330,202305,99825,226685,82671,199520,10670,28151,49581,111285,60251,139436
293340,202305,2633,6536,2149,5723,191,487,1456,3848,1647,4335
293345,202305,4757,10821,3833,9497,866,2028,1968,5431,2834,7459
293350,202305,7158,17420,6234,16256,306,710,5229,13821,5535,14531
293360,202305,19410,40369,16668,36884,569,1177,14527,32286,15096,33463
310010,202305,1201,2477,858,2040,123,332,383,787,506,1119
310020,202305,4045,9485,3056,7814,512,1432,1326,3050,1838,4482
310030,202305,2399,6030,1951,5281,262,773,1289,3333,1551,4106
310040,202305,1028,2400,807,2030,81,260,475,1051,556,1311
310050,202305,2069,5073,1739,4581,158,503,1149,2888,1307,3391
310060,202305,3792,9114,3098,8152,195,604,2101,5502,2296,6106
310070,202305,422,933,331,812,17,39,232,563,249,602
310080,202305,884,2244,674,1886,99,321,327,855,426,1176
310090,202305,6642,13946,5533,12312,212,589,4494,9572,4706,10161
310100,202305,4699,10488,3912,9334,110,391,3344,7691,3454,8082
310110,202305,5919,13872,4689,11839,627,1810,2868,6793,3495,8603
310120,202305,834,1853,560,1456,94,305,269,583,363,888
310130,202305,540,1226,466,1113,31,101,355,793,386,894
310140,202305,456,1158,356,1015,79,254,164,403,243,657
310150,202305,8082,17734,6182,14597,516,1528,3784,7987,4300,9515
310160,202305,13464,29415,10532,24962,2034,5240,5056,10997,7090,16237
310163,202305,1498,4050,1148,3384,273,904,329,793,602,1697
310170,202305,12334,26565,10186,23461,1023,2358,7214,16220,8237,18578
310180,202305,2510,5373,1853,4368,219,574,1188,2665,1407,3239
310190,202305,3309,8620,2633,7490,607,1904,563,1427,1170,3331
310200,202305,2457,6276,1870,5300,505,1581,723,1806,1228,3387
310205,202305,1450,3580,1176,3189,150,418,758,2069,908,2487
310210,202305,2890,7053,2344,6074,138,347,1655,4143,1793,4490
310220,202305,1425,3560,1042,2853,92,299,636,1620,728,1919
310230,202305,2981,6895,2498,6084,368,973,1497,3410,1865,4383
310240,202305,1300,3309,1091,2978,93,293,694,1803,787,2096
310250,202305,1532,3218,1293,2874,39,106,1055,2255,1094,2361
310260,202305,4823,11461,3295,8691,769,2385,1099,2271,1868,4656
310270,202305,3573,6818,2926,6016,118,268,2427,4928,2545,5196
310280,202305,3611,6971,2824,5930,174,444,2100,4053,2274,4497
310285,202305,2217,6213,1832,5521,214,693,1082,3235,1296,3928
310290,202305,2064,4868,1747,4316,210,609,1105,2444,1315,3053
310300,202305,2108,5249,1602,4380,178,586,828,1958,1006,2544
310310,202305,406,858,285,669,55,137,146,312,201,449
310320,202305,584,1356,401,1053,32,93,217,536,249,629
310330,202305,622,1364,359,894,64,157,140,322,204,479
310340,202305,10245,23268,8011,19566,1083,2597,4155,9912,5238,12509
310350,202305,17405,38865,12745,31541,1910,5361,6747,15206,8657,20567
310360,202305,801,1544,676,1392,28,77,493,947,521,1024
310370,202305,1474,4231,1262,3874,290,963,419,1328,709,2291
310375,202305,1063,2408,765,1989,250,648,252,637,502,1285
310380,202305,433,960,256,705,20,59,132,339,152,398
310390,202305,748,2035,615,1780,95,293,289,773,384,1066
310400,202305,16155,36180,12274,30322,1190,3310,7835,18179,9025,21489
310410,202305,1296,3424,830,2453,96,324,337,843,433,1167
310420,202305,6187,14935,4706,12346,600,1728,2431,5748,3031,7476
310430,202305,2170,5409,1559,4349,281,837,685,1614,966,2451
310440,202305,804,1860,546,1420,87,212,249,595,336,807
310445,202305,1627,4131,1273,3450,94,241,903,2369,997,2610
310450,202305,5989,12549,4592,10445,280,821,3517,7487,3797,8308
310460,202305,2146,5258,1604,4298,266,733,426,964,692,1697
310470,202305,4022,8457,3167,7343,563,1205,1879,4467,2442,5672
310480,202305,1241,2897,940,2413,104,340,556,1281,660,1621
310490,202305,3682,8886,2884,7605,434,1275,1496,3601,1930,4876
310500,202305,1882,4388,1532,3850,235,617,946,2279,1181,2896
310510,202305,3046,6993,2295,5687,417,1131,1022,2354,1439,3485
310520,202305,1439,3389,966,2487,147,421,425,1035,572,1456
310530,202305,1059,2543,767,2050,98,312,293,627,391,939
310540,202305,3462,9178,2842,7993,554,1720,1218,3086,1772,4806
310550,202305,1532,3367,1122,2705,101,281,688,1506,789,1787
310560,202305,21734,51251,16280,41688,1802,5450,8610,18857,10412,24307
310570,202305,1557,3254,1224,2835,55,162,1034,2306,1089,2468
310590,202305,5346,12368,4281,10455,276,807,2650,5798,2926,6605
310600,202305,1771,4500,1455,3898,170,469,792,1957,962,2426
310610,202305,591,1520,375,1137,91,297,79,208,170,505
310620,202305,301353,669294,235297,555874,24185,67980,142094,297595,166279,365575
310630,202305,5828,14350,4415,11641,580,1570,2548,6350,3128,7920
310640,202305,2008,4458,1623,3855,122,403,1188,2546,1310,2949
310650,202305,2873,6982,2108,5608,139,418,1260,3157,1399,3575
310660,202305,1768,4051,1438,3598,26,68,1244,3078,1270,3146
310665,202305,1736,3733,1473,3397,49,151,1184,2686,1233,2837
310670,202305,86524,191984,72871,170160,7472,19448,49446,107835,56918,127283
310680,202305,971,2021,819,1803,20,71,672,1397,692,1468
310690,202305,3246,6713,2439,5575,277,643,1642,3562,1919,4205
310700,202305,662,1231,518,1052,10,24,438,864,448,888
310710,202305,7944,20287,5815,17007,1396,4562,900,2299,2296,6861
310720,202305,1479,2985,1194,2626,47,143,911,1909,958,2052
310730,202305,12944,29492,11034,26674,586,1704,8247,18823,8833,20527
310740,202305,8871,21428,6912,17917,856,2611,3638,8312,4494,10923
310750,202305,1710,3632,1317,3073,170,446,746,1528,916,1974
310760,202305,882,1976,626,1576,75,158,396,1004,471,1162
310770,202305,1343,3329,951,2697,133,444,459,1124,592,1568
310780,202305,5017,10520,4055,9164,342,805,2843,6296,3185,7101
310790,202305,2306,6628,1976,5962,425,1460,484,1180,909,2640
310800,202305,2819,7849,2052,6285,457,1581,128,288,585,1869
310810,202305,1898,4003,1568,3510,120,284,1128,2418,1248,2702
310820,202305,1475,3384,896,2435,167,450,268,676,435,1126
310825,202305,3234,7953,2584,6971,41,197,2152,5539,2193,5736
310830,202305,2755,6631,2122,5580,394,1152,1037,2428,1431,3580
310840,202305,2797,6877,2146,5813,447,1355,713,1634,1160,2989
310850,202305,1589,3905,1301,3486,56,201,930,2342,986,2543
310855,202305,4143,9594,3301,8310,282,705,2335,5710,2617,6415
310860,202305,8307,21330,6826,18748,912,2298,3958,11019,4870,13317
310870,202305,1143,2516,927,2218,56,137,669,1526,725,1663
310880,202305,1065,2911,796,2352,97,293,416,1186,513,1479
310890,202305,2668,7137,1809,5456,344,1110,252,625,596,1735
310900,202305,5351,13739,4109,11273,775,2360,1766,4252,2541,6612
310910,202305,2746,6151,1864,4781,287,815,486,1073,773,1888
310920,202305,2281,5347,1754,4584,246,734,1089,2692,1335,3426
310925,202305,1344,3034,1059,2603,55,151,774,1793,829,1944
310930,202305,6926,16026,4664,12576,924,2594,2107,5817,3031,8411
310940,202305,8524,17744,6960,15557,288,775,5451,11631,5739,12406
310945,202305,1768,3959,1331,3266,166,460,760,1712,926,2172
310950,202305,2260,6214,1459,4498,253,902,379,883,632,1785
310960,202305,800,2092,494,1443,79,256,141,373,220,629
310970,202305,1420,3983,1035,3218,254,817,190,537,444,1354
310980,202305,412,897,250,621,26,78,126,275,152,353
310990,202305,1857,4341,1520,3824,179,533,919,2087,1098,2620
311000,202305,5263,12947,4143,11089,783,2277,2204,5436,2987,7713
311010,202305,1205,2899,994,2565,238,643,485,1229,723,1872
311020,202305,1443,3313,956,2493,67,200,553,1338,620,1538
311030,202305,2338,5282,1725,4323,462,1328,687,1529,1149,2857
311040,202305,357,1014,273,836,74,261,61,158,135,419
311050,202305,3873,8667,2995,7384,460,1357,1584,3514,2044,4871
311060,202305,4620,10574,3488,8677,447,1279,1693,3711,2140,4990
311070,202305,3141,6886,2289,5622,326,975,1219,2680,1545,3655
311080,202305,1426,2802,1122,2382,39,110,879,1736,918,1846
311090,202305,2856,7985,2367,7157,576,1820,690,2020,1266,3840
311100,202305,3109,7975,2093,6108,401,1309,584,1425,985,2734
311110,202305,4499,9055,2401,5891,563,1394,386,881,949,2275
311115,202305,1788,3344,1494,2973,35,93,1144,2356,1179,2449
311120,202305,9123,21500,7081,18011,1081,3068,3214,6962,4295,10030
311130,202305,2290,5571,1782,4851,200,668,1037,2608,1237,3276
311140,202305,1982,4502,1506,3847,251,645,852,2126,1103,2771
311150,202305,1721,4976,1406,4388,215,735,726,2118,941,2853
311160,202305,5176,13189,3814,10798,658,2135,1607,4124,2265,6259
311170,202305,1182,2762,984,2513,83,226,591,1578,674,1804
311180,202305,1846,3840,1263,3005,196,458,658,1473,854,1931
311190,202305,1019,2679,768,2180,110,347,336,809,446,1156
311200,202305,2922,6977,2191,5677,428,1188,901,1957,1329,3145
311205,202305,1126,2950,891,2531,46,143,559,1486,605,1629
311210,202305,1269,3348,1133,3160,132,325,790,2298,922,2623
311220,202305,1091,2392,969,2189,29,92,779,1619,808,1711
311230,202305,9583,26349,7143,21433,1551,4841,2324,6923,3875,11764
311240,202305,1475,3262,1189,2872,163,470,722,1568,885,2038
311250,202305,1708,4262,1344,3667,253,734,570,1381,823,2115
311260,202305,3201,7249,2102,5428,294,838,997,2236,1291,3074
311265,202305,1708,3621,1259,2941,57,166,959,2114,1016,2280
311270,202305,3687,9642,3150,8810,208,792,2171,5687,2379,6479
311280,202305,1541,3705,978,2677,237,696,263,608,500,1304
311290,202305,2183,6108,1963,5697,136,414,1269,3597,1405,4011
311300,202305,5331,13010,4451,11599,204,642,3596,9091,3800,9733
311310,202305,650,1641,545,1457,43,116,338,860,381,976
311320,202305,3905,10614,3171,8986,383,1192,1562,3877,1945,5069
311330,202305,7883,16978,6056,14260,834,2150,2811,6575,3645,8725
311340,202305,13597,33992,10932,29523,2432,6973,3577,8934,6009,15907
311350,202305,2809,6343,2008,4949,296,807,882,1817,1178,2624
311360,202305,1409,3134,1029,2631,276,750,451,1130,727,1880
311370,202305,5605,12558,4146,10277,559,1606,2194,4912,2753,6518
311380,202305,476,1371,370,1157,51,176,192,574,243,750
311390,202305,2078,5737,1698,5216,606,1966,396,1043,1002,3009
311400,202305,2059,5017,1509,4037,263,769,510,1071,773,1840
311410,202305,2348,6403,1917,5677,279,925,868,2359,1147,3284
311420,202305,2032,5258,1548,4407,330,1018,496,1151,826,2169
311430,202305,5650,13559,3840,10167,578,1644,1587,3853,2165,5497
311440,202305,3857,9750,2898,8102,841,2700,501,1023,1342,3723
311450,202305,3135,8356,1995,5941,506,1726,456,1026,962,2752
311455,202305,1312,2759,960,2267,95,237,597,1339,692,1576
311460,202305,751,2057,488,1505,92,325,111,266,203,591
311470,202305,604,1696,410,1305,94,352,65,165,159,517
311480,202305,1457,2929,1214,2587,93,192,969,2017,1062,2209
311490,202305,343,932,262,768,50,186,117,282,167,468
311500,202305,638,1433,502,1233,62,184,298,681,360,865
311510,202305,4465,9740,3282,7917,387,1058,1863,4028,2250,5086
311520,202305,832,2008,723,1827,63,182,455,1116,518,1298
311530,202305,11542,24342,8204,19398,2050,5695,2695,5439,4745,11134
311535,202305,1197,2860,866,2252,129,377,418,973,547,1350
311540,202305,667,1757,587,1630,87,263,393,1067,480,1330
311545,202305,2448,6244,2090,5680,108,333,1622,4308,1730,4641
311547,202305,2195,4277,1898,3883,60,130,1625,3238,1685,3368
311550,202305,3625,8769,2951,7672,480,1419,1348,3043,1828,4462
311560,202305,364,730,229,525,36,93,75,142,111,235
311570,202305,1577,3384,1091,2722,78,208,736,1874,814,2082
311580,202305,2711,4797,1950,3902,199,396,1346,2580,1545,2976
311590,202305,771,1792,647,1626,64,196,418,991,482,1187
311600,202305,1760,4035,1456,3625,183,540,998,2381,1181,2921
311610,202305,2789,7351,2190,6275,141,461,1435,3887,1576,4348
311615,202305,4535,10237,3718,8987,132,424,3036,7015,3168,7439
311620,202305,717,1764,538,1473,67,208,294,742,361,950
311630,202305,1583,4032,1228,3299,126,346,701,1816,827,2162
311640,202305,959,2309,764,2006,111,320,430,1048,541,1368
311650,202305,2294,5099,1813,4386,253,651,1044,2383,1297,3034
311660,202305,4014,10362,3022,8509,403,1317,980,2131,1383,3448
311670,202305,2035,4500,1533,3677,196,506,802,1798,998,2304
311680,202305,2844,6650,2167,5554,144,364,1547,3927,1691,4291
311690,202305,766,1477,563,1213,51,114,364,783,415,897
311700,202305,2463,5288,1877,4464,30,110,1559,3542,1589,3652
311710,202305,1924,5127,1431,4242,389,1289,401,1075,790,2364
311720,202305,525,1422,428,1249,58,190,246,694,304,884
311730,202305,5740,12825,4140,10061,812,2261,2105,4552,2917,6813
311740,202305,1186,2899,966,2583,70,179,714,1955,784,2134
311750,202305,4862,12863,3911,11147,360,1194,2471,6487,2831,7681
311760,202305,920,2324,710,1930,112,381,292,590,404,971
311770,202305,2719,6916,2147,5974,488,1433,725,1805,1213,3238
311780,202305,1888,4813,1446,4033,304,913,525,1264,829,2177
311783,202305,2853,6482,2328,5675,45,169,1914,4444,1959,4613
311787,202305,998,2631,753,2123,119,375,284,652,403,1027
311790,202305,1877,4831,1317,3770,268,856,316,744,584,1600
311800,202305,6611,17799,5216,15032,1189,3541,1033,2336,2222,5877
311810,202305,1240,3028,1047,2729,56,175,814,2004,870,2179
311820,202305,1265,2660,978,2242,76,190,690,1485,766,1675
311830,202305,11464,29315,8605,23603,2449,7092,1697,4263,4146,11355
311840,202305,4898,10747,3899,9389,331,841,2772,6644,3103,7485
311850,202305,429,978,343,840,15,56,241,537,256,593
311860,202305,99566,217108,79894,185179,8396,22288,51755,110144,60151,132432
311870,202305,2239,5483,1615,4468,256,841,691,1652,947,2493
311880,202305,7524,17639,6337,15997,494,1191,4563,11624,5057,12815
311890,202305,2335,4704,1881,4102,59,189,1487,3015,1546,3204
311900,202305,788,1887,589,1618,109,289,288,805,397,1094
311910,202305,5299,12042,4279,10688,753,2072,2366,5562,3119,7634
311920,202305,2653,5889,2185,5236,144,340,1543,3641,1687,3981
311930,202305,6138,12320,4734,10464,823,2099,2713,5398,3536,7497
311940,202305,19438,45887,14301,36808,2149,5931,6257,14549,8406,20480
311950,202305,2932,6773,2193,5527,199,536,1320,3277,1519,3813
311960,202305,580,1346,442,1134,56,167,197,437,253,604
311970,202305,482,1458,361,1176,65,246,82,211,147,457
311980,202305,566,1386,301,893,38,122,108,282,146,404
311990,202305,622,1428,423,1122,68,220,180,397,248,617
311995,202305,1177,3141,603,1853,54,192,89,170,143,362
312000,202305,970,2029,752,1726,41,99,564,1248,605,1347
312010,202305,1408,3148,1143,2775,60,158,765,1771,825,1929
312015,202305,1637,3999,1417,3666,65,224,1130,2824,1195,3048
312020,202305,2348,6443,1619,4807,280,873,404,1007,684,1880
312030,202305,2671,5250,2251,4757,74,209,2009,4154,2083,4363
312040,202305,1037,2807,757,2258,122,366,324,886,446,1252
312050,202305,1494,4144,1234,3691,238,877,426,1098,664,1975
312060,202305,1170,2688,797,2154,200,576,263,665,463,1241
312070,202305,1120,2909,765,2161,35,121,485,1262,520,1383
312080,202305,3651,7972,2934,6947,161,435,2065,4453,2226,4888
312083,202305,1357,2777,1084,2395,51,143,886,1862,937,2005
312087,202305,3056,6737,2496,5913,102,275,2014,4662,2116,4937
312090,202305,14922,34253,11940,29702,1214,3653,7254,16389,8468,20042
312100,202305,2068,5033,1601,4258,105,356,1006,2402,1111,2758
312110,202305,1224,3459,1015,3039,163,608,497,1299,660,1907
312120,202305,1326,3332,918,2633,240,797,276,640,516,1437
312125,202305,2531,5530,2142,5009,112,280,1729,3922,1841,4202
312130,202305,1492,3140,1116,2551,73,213,673,1313,746,1526
312140,202305,952,2513,770,2158,205,607,304,751,509,1358
312150,202305,695,1663,565,1409,43,119,382,872,425,991
312160,202305,12207,28407,9553,23929,1127,3302,5120,11403,6247,14705
312170,202305,1061,2463,818,2040,61,173,523,1235,584,1408
312180,202305,1721,4040,1413,3540,163,440,828,1930,991,2370
312190,202305,1013,2416,792,2050,88,260,411,956,499,1216
312200,202305,5695,13863,4453,11938,986,3094,2246,5307,3232,8401
312210,202305,1766,3253,1370,2732,83,177,1107,2107,1190,2284
312220,202305,1975,5397,1680,4895,174,544,1098,3166,1272,3710
312230,202305,26740,60539,19814,48866,3859,10749,7354,14913,11213,25662
312235,202305,2735,5614,2249,4976,256,468,1645,3572,1901,4040
312240,202305,973,2789,754,2383,158,512,230,670,388,1182
312245,202305,4010,7461,3497,6777,47,122,3239,6141,3286,6263
312247,202305,1229,2588,860,2051,110,268,510,1146,620,1414
312250,202305,1096,2707,705,1966,91,280,249,629,340,909
312260,202305,1250,2912,1023,2509,64,161,805,1878,869,2039
312270,202305,926,2274,699,1832,29,106,444,1025,473,1131
312280,202305,525,1456,446,1320,106,357,172,440,278,797
312290,202305,1214,3147,1024,2849,207,666,381,931,588,1597
312300,202305,1499,3993,1108,3140,255,782,277,623,532,1405
312310,202305,1265,3402,992,2852,125,436,532,1394,657,1830
312320,202305,2642,6014,1893,4744,329,853,633,1380,962,2233
312330,202305,1175,2918,956,2535,161,498,549,1324,710,1822
312340,202305,287,678,210,556,30,105,119,268,149,373
312350,202305,286,563,213,480,15,44,144,282,159,326
312352,202305,1768,5150,1574,4799,299,986,728,2362,1027,3348
312360,202305,4499,11358,3394,9359,678,2052,1439,3490,2117,5542
312370,202305,2598,5785,2060,4977,248,706,1274,2835,1522,3541
312380,202305,2597,5233,2121,4600,25,73,1819,3788,1844,3861
312385,202305,1492,3666,1192,3140,409,1124,306,803,715,1927
312390,202305,2410,6176,1791,5014,279,887,507,1168,786,2055
312400,202305,3812,9868,3282,9068,1186,3624,577,1500,1763,5124
312410,202305,20051,45637,16567,40281,2030,5248,10681,24646,12711,29894
312420,202305,5000,12025,4027,10505,876,2618,1821,4364,2697,6982
312430,202305,11126,24060,9198,20938,355,1039,7159,15336,7514,16375
312440,202305,1343,3786,1137,3417,588,1862,196,540,784,2402
312450,202305,1682,4438,1289,3762,363,1136,445,1268,808,2404
312460,202305,607,1312,445,1087,23,64,301,705,324,769
312470,202305,563,1282,368,959,56,166,125,257,181,423
312480,202305,1248,2931,955,2501,91,276,529,1300,620,1576
312490,202305,3345,6594,2641,5649,227,537,1599,3190,1826,3727
312500,202305,1342,2811,1154,2569,55,164,911,1951,966,2115
312510,202305,6684,16239,4478,12033,820,2197,1321,3153,2141,5350
312520,202305,460,1042,359,888,60,178,225,519,285,697
312530,202305,930,1878,775,1698,61,137,588,1270,649,1407
312540,202305,1817,4487,1281,3483,159,431,699,1786,858,2217
312550,202305,987,2269,710,1755,45,120,443,988,488,1108
312560,202305,2198,5179,1671,4352,99,272,1174,2994,1273,3266
312570,202305,3375,7085,2559,6053,429,1049,1317,3030,1746,4079
312580,202305,800,1978,523,1411,51,154,267,636,318,790
312590,202305,1813,4739,1428,3972,204,638,739,1841,943,2479
312595,202305,2647,6656,2178,5967,358,944,1130,3303,1488,4247
312600,202305,1600,3691,1090,2639,184,529,376,839,560,1368
312610,202305,8855,20848,6030,15785,1138,3290,1869,4085,3007,7375
312620,202305,3045,6748,2321,5762,61,251,1923,4634,1984,4885
312630,202305,399,1023,298,851,61,211,115,286,176,497
312640,202305,615,1577,497,1391,74,235,261,658,335,893
312650,202305,2506,5554,1760,4243,61,198,1302,2886,1363,3084
312660,202305,1624,3467,1290,2943,109,271,917,1967,1026,2238
312670,202305,7513,15694,6311,13906,131,530,5243,10782,5374,11312
312675,202305,1407,3242,1191,2951,85,229,897,2143,982,2372
312680,202305,1958,4209,1779,3971,33,128,1619,3484,1652,3612
312690,202305,3648,6816,2765,5718,200,363,2151,4366,2351,4729
312695,202305,1265,2882,1077,2605,51,92,902,2166,953,2258
312700,202305,2543,6236,1806,4936,212,672,976,2431,1188,3103
312705,202305,2089,3785,1836,3466,16,47,1744,3251,1760,3298
312707,202305,1646,4175,1161,3350,47,204,756,1982,803,2186
312710,202305,9319,20162,6249,15523,1688,4300,1777,4424,3465,8724
312720,202305,1268,3068,1031,2698,111,297,666,1648,777,1945
312730,202305,1890,4124,1377,3439,125,317,892,2171,1017,2488
312733,202305,1540,3772,1166,3099,48,161,772,1865,820,2026
312735,202305,985,2281,748,1852,62,180,480,1074,542,1254
312737,202305,997,2014,731,1646,64,162,519,1117,583,1279
312738,202305,1027,2295,713,1769,75,217,445,983,520,1200
312740,202305,499,1264,335,969,81,244,83,184,164,428
312750,202305,1737,4453,1263,3605,168,543,545,1403,713,1946
312760,202305,2201,5896,1617,4766,282,846,577,1560,859,2406
312770,202305,56449,125015,37614,93740,6316,17719,15658,35096,21974,52815
312780,202305,3268,8174,2723,7259,447,1184,1524,3957,1971,5141
312790,202305,285,645,146,414,7,20,35,66,42,86
312800,202305,7413,17406,5987,14940,487,1543,3932,8959,4419,10502
312810,202305,1903,4822,1294,3802,398,1291,392,992,790,2283
312820,202305,2083,4936,1695,4309,120,300,1197,2993,1317,3293
312825,202305,1916,3651,1605,3256,42,92,1369,2716,1411,2808
312830,202305,3354,8535,2294,6556,584,1768,717,1751,1301,3519
312840,202305,1785,4146,1397,3520,169,477,727,1645,896,2122
312850,202305,1425,2683,1089,2242,23,75,829,1510,852,1585
312860,202305,1197,2943,858,2389,241,689,262,643,503,1332
312870,202305,7421,18277,4886,13693,829,2531,1470,3607,2299,6138
312880,202305,1886,4162,1492,3541,259,577,761,1803,1020,2380
312890,202305,2862,6210,2145,5112,166,383,1301,2918,1467,3301
312900,202305,1645,3758,1296,3254,371,1014,556,1315,927,2329
312910,202305,1735,3072,1086,2242,162,308,600,1229,762,1537
312920,202305,1155,2862,821,2322,132,452,259,570,391,1022
312930,202305,3028,6595,2238,5437,352,913,1168,2805,1520,3718
312940,202305,1203,2943,954,2594,90,294,499,1237,589,1531
312950,202305,4196,9083,3090,7479,454,1245,1805,4002,2259,5247
312960,202305,2128,5015,1742,4440,136,318,1234,3214,1370,3532
312965,202305,1977,4761,1588,4143,176,434,995,2605,1171,3039
312970,202305,2084,5123,1676,4510,194,686,985,2378,1179,3064
312980,202305,32746,80928,26703,70331,5295,14706,11555,28305,16850,43011
312990,202305,636,1443,420,1095,78,237,176,418,254,655
313000,202305,603,1532,460,1292,29,121,290,719,319,840
313005,202305,2927,7575,2402,6727,131,371,1726,4705,1857,5076
313010,202305,7556,18213,6188,16081,953,2834,3639,8878,4592,11712
313020,202305,1268,3498,995,2986,208,678,190,449,398,1127
313030,202305,1456,3002,1038,2427,105,262,732,1620,837,1882
313040,202305,1103,2999,931,2681,54,214,577,1549,631,1763
313050,202305,2218,5662,1593,4701,267,896,386,974,653,1870
313055,202305,2231,5496,1902,4991,729,2162,796,1868,1525,4030
313060,202305,1292,2947,943,2351,185,554,235,474,420,1028
313065,202305,2100,5063,1867,4693,24,104,1615,3906,1639,4010
313070,202305,1056,2604,830,2236,111,332,405,1006,516,1338
313080,202305,480,1207,364,1008,68,223,143,321,211,544
313090,202305,6910,15522,5629,13596,265,671,4054,9486,4319,10157
313100,202305,1568,3713,1309,3338,61,211,960,2314,1021,2525
313110,202305,1863,4485,1304,3489,154,455,649,1570,803,2025
313115,202305,3487,8590,2813,7396,269,851,1667,3884,1936,4735
313120,202305,4395,9787,3244,8254,388,1075,2027,5066,2415,6141
313130,202305,40987,94122,31438,77911,3456,9671,18403,41661,21859,51332
313140,202305,990,1916,685,1530,58,140,510,1113,568,1253
313150,202305,1714,4473,1243,3612,350,1163,180,397,530,1560
313160,202305,1808,3999,1350,3335,43,110,1024,2423,1067,2533
313170,202305,14334,37036,10899,30397,1786,5417,4293,10490,6079,15907
313180,202305,3115,7145,2394,5759,179,450,1672,3833,1851,4283
313190,202305,5781,14683,4400,12122,800,2425,1830,4402,2630,6827
313200,202305,1378,3097,1177,2765,31,86,973,2196,1004,2282
313210,202305,5328,12167,4408,10804,406,1135,3049,7043,3455,8178
313220,202305,2419,5816,1656,4361,251,723,756,1681,1007,2404
313230,202305,3390,8390,2764,7565,52,184,2237,6100,2289,6284
313240,202305,14262,31578,10525,25906,1192,3488,5914,13170,7106,16658
313250,202305,7757,20386,5967,16764,1175,3554,2670,6886,3845,10440
313260,202305,999,2248,697,1795,68,248,381,827,449,1075
313270,202305,8287,16261,7022,14651,611,1276,5618,11546,6229,12822
313280,202305,572,1385,394,1064,48,150,184,451,232,601
313290,202305,1276,3793,1015,3317,250,920,359,1086,609,2006
313300,202305,2305,5718,1782,4824,370,1090,646,1545,1016,2635
313310,202305,1880,4998,1529,4275,288,871,478,1069,766,1940
313320,202305,2394,5761,1761,4785,399,1184,570,1521,969,2705
313330,202305,5218,11837,3798,9725,290,828,2453,6077,2743,6905
313340,202305,2157,4345,1685,3723,128,323,1243,2581,1371,2904
313350,202305,3715,9271,2541,6849,335,1028,1135,2573,1470,3601
313360,202305,2160,4805,1517,3803,264,773,804,1795,1068,2568
313370,202305,2044,4990,1528,4038,343,978,551,1218,894,2196
313375,202305,2278,5536,1483,4116,285,874,401,925,686,1799
313380,202305,8383,19257,6409,15773,1023,2977,3148,6646,4171,9623
313390,202305,971,2702,838,2470,47,196,588,1650,635,1846
313400,202305,4656,10124,3484,8410,156,433,2597,6018,2753,6451
313410,202305,1780,4055,1328,3336,326,835,726,1726,1052,2561
313420,202305,19832,41325,11639,28411,2677,7263,3280,7035,5957,14298
313430,202305,1572,3503,1334,3095,62,234,1043,2211,1105,2445
313440,202305,9205,16953,7028,14357,179,458,5758,11315,5937,11773
313450,202305,891,2232,634,1745,113,355,223,477,336,832
313460,202305,2958,7507,2429,6684,429,1318,1137,2967,1566,4285
313470,202305,3351,7539,2749,6687,150,406,2147,5097,2297,5503
313480,202305,1431,3739,899,2643,111,334,383,1011,494,1345
313490,202305,3831,9299,2164,6188,396,1203,532,1316,928,2519
313500,202305,717,1676,484,1256,79,180,202,478,281,658
313505,202305,13172,29757,11270,27192,546,1294,8992,21387,9538,22681
313507,202305,1609,3692,1282,3199,51,180,979,2321,1030,2501
313510,202305,19576,46313,15343,38567,1500,4112,8931,20462,10431,24574
313520,202305,19854,45120,16311,39582,703,2074,12867,29792,13570,31866
313530,202305,720,1992,528,1592,77,277,212,539,289,816
313535,202305,2745,6998,2173,5933,263,695,1281,3391,1544,4086
313540,202305,1098,2814,841,2281,110,352,407,954,517,1306
313545,202305,1359,4033,1142,3620,174,585,539,1617,713,2202
313550,202305,2639,6748,2185,5798,246,704,1473,3800,1719,4504
313560,202305,3693,5910,2897,4983,36,58,2584,4378,2620,4436
313570,202305,1188,3052,941,2635,213,637,408,1020,621,1657
313580,202305,7715,15989,6225,13699,334,886,4629,9510,4963,10396
313590,202305,1434,3402,1149,3000,242,666,594,1570,836,2236
313600,202305,5490,11447,4741,10390,114,331,4237,8999,4351,9330
313610,202305,1200,2734,988,2377,87,241,637,1398,724,1639
313620,202305,7101,17020,5890,14953,577,1745,3870,9205,4447,10950
313630,202305,10889,24294,8221,20392,831,2467,5087,11807,5918,14274
313640,202305,1639,3049,1184,2486,100,247,875,1790,975,2037
313650,202305,1931,5386,1529,4691,163,534,891,2735,1054,3269
313652,202305,1099,2776,953,2511,79,245,679,1676,758,1921
313655,202305,1453,3071,1154,2711,64,158,884,2027,948,2185
313657,202305,1295,3089,1018,2638,41,168,734,1737,775,1905
313660,202305,1526,3457,1241,3014,85,300,905,2013,990,2313
313665,202305,7303,16718,5898,14343,607,1708,3809,8462,4416,10170
313670,202305,72048,160298,51651,127687,6921,18772,26697,60594,33618,79366
313680,202305,1361,3108,1080,2662,52,147,720,1651,772,1798
313690,202305,1213,3319,909,2738,182,619,195,501,377,1120
313695,202305,2111,5089,1588,4240,139,362,1027,2773,1166,3135
313700,202305,3472,9610,3007,8991,246,792,2376,7109,2622,7901
313710,202305,1741,3640,1259,3002,159,468,767,1717,926,2185
313720,202305,8183,20298,6161,16299,855,2489,3007,7037,3862,9526
313730,202305,1667,3247,1254,2710,69,128,850,1808,919,1936
313740,202305,2033,6671,1729,5959,368,1431,462,1366,830,2797
313750,202305,2957,6837,2417,6013,336,998,1498,3395,1834,4393
313753,202305,2499,5757,1680,4425,443,1287,456,1084,899,2371
313760,202305,7920,19792,6361,16960,1028,3147,3130,7411,4158,10558
313770,202305,5040,12910,4004,11251,808,2221,2401,6858,3209,9079
313780,202305,5049,11874,3738,9907,768,2035,1179,3007,1947,5042
313790,202305,759,1944,621,1671,74,219,382,972,456,1191
313800,202305,1652,3443,1199,2808,123,324,675,1437,798,1761
313810,202305,2301,4762,1842,4113,89,247,1494,3182,1583,3429
313820,202305,21267,50581,14471,36812,2458,6465,4550,10249,7008,16714
313830,202305,497,1333,371,1078,68,226,140,364,208,590
313835,202305,1154,2811,843,2310,76,246,445,1092,521,1338
313840,202305,10467,24445,8256,21084,1912,5162,2386,5772,4298,10934
313850,202305,1229,2609,982,2276,171,422,526,1096,697,1518
313860,202305,3645,8459,2776,7020,406,1102,1381,3140,1787,4242
313862,202305,1382,2924,764,2008,56,168,392,979,448,1147
313865,202305,3231,7366,2679,6538,74,232,2086,4819,2160,5051
313867,202305,1693,4856,1359,4212,336,1077,548,1716,884,2793
313868,202305,2035,5524,1621,4784,70,270,1214,3406,1284,3676
313870,202305,1328,3135,904,2385,141,394,366,841,507,1235
313880,202305,2835,6570,2194,5534,350,1071,1084,2281,1434,3352
313890,202305,2913,5184,2240,4335,58,131,1826,3380,1884,3511
313900,202305,6892,17419,4899,13563,1290,3773,1426,3312,2716,7085
313910,202305,951,2521,719,2091,146,449,187,490,333,939
313920,202305,3456,9124,2845,7987,550,1609,1378,3806,1928,5415
313925,202305,1948,4386,1562,3747,210,441,952,2221,1162,2662
313930,202305,6404,15317,5078,13253,446,1100,3321,8573,3767,9673
313940,202305,12598,33609,9896,29241,2302,7514,2150,6655,4452,14169
313950,202305,6949,13472,5456,11612,290,707,4027,8238,4317,8945
313960,202305,7080,15482,4863,11933,684,1951,2208,4717,2892,6668
313970,202305,2019,4650,1706,4140,53,143,1202,2739,1255,2882
313980,202305,1801,4309,1333,3617,261,776,542,1362,803,2138
313990,202305,2810,7209,2184,6073,366,1254,1224,2966,1590,4220
314000,202305,13399,30003,10661,25418,727,2129,6928,15695,7655,17824
314010,202305,1627,3552,1285,3080,92,255,924,2095,1016,2350
314015,202305,3035,7348,2470,6384,276,864,1482,3430,1758,4294
314020,202305,667,1616,418,1214,153,536,23,58,176,594
314030,202305,1038,2644,761,2119,115,341,310,801,425,1142
314040,202305,757,1922,645,1732,79,261,387,982,466,1243
314050,202305,2640,6089,2012,5037,130,375,1318,3005,1448,3380
314053,202305,2605,6596,2073,5625,337,885,1200,3327,1537,4212
314055,202305,2897,6332,2435,5713,73,206,2018,4728,2091,4934
314060,202305,1584,3729,1150,3014,42,129,824,2077,866,2206
314070,202305,6229,14725,5162,12960,773,2050,2917,6883,3690,8933
314080,202305,2461,5917,1830,4847,171,503,899,2120,1070,2623
314085,202305,2858,6944,2271,6092,258,741,1443,3826,1701,4567
314090,202305,6226,14563,5315,13287,590,1589,3319,8391,3909,9980
314100,202305,3510,7885,2716,6798,88,238,2009,4992,2097,5230
314110,202305,6282,15782,5122,13682,746,2177,2579,6165,3325,8342
314120,202305,826,1809,410,1089,74,222,162,377,236,599
314130,202305,850,2012,637,1622,20,71,462,1097,482,1168
314140,202305,5645,13592,4500,11623,535,1476,2513,6119,3048,7595
314150,202305,1723,3953,1227,3134,161,439,711,1745,872,2184
314160,202305,2901,6555,2025,5110,217,554,803,1911,1020,2465
314170,202305,1156,2832,907,2355,71,210,590,1373,661,1583
314180,202305,6685,16438,5181,14014,725,2020,2491,6572,3216,8592
314190,202305,751,1731,595,1504,72,238,347,776,419,1014
314200,202305,3661,9147,3034,8162,296,798,1915,5036,2211,5834
314210,202305,2376,5621,1846,4709,322,876,608,1394,930,2270
314220,202305,2186,5320,1704,4591,283,898,755,1810,1038,2708
314225,202305,1232,3246,973,2766,152,457,537,1435,689,1892
314230,202305,1082,2614,846,2257,144,416,428,1056,572,1472
314240,202305,1341,3379,1053,2941,232,672,440,1224,672,1896
314250,202305,509,1370,330,997,50,158,122,328,172,486
314260,202305,1337,3192,1072,2844,400,1135,287,662,687,1797
314270,202305,4018,9885,3257,8673,92,262,2456,6393,2548,6655
314280,202305,4373,9412,3110,7599,344,967,1854,4191,2198,5158
314290,202305,5541,12505,4753,11208,243,640,3575,8037,3818,8677
314300,202305,2416,6327,1579,4587,378,1209,407,947,785,2156
314310,202305,4432,10924,3133,8747,891,2895,380,792,1271,3687
314315,202305,1212,3319,953,2795,69,240,654,1797,723,2037
314320,202305,4206,10106,2974,7891,464,1467,1289,2992,1753,4459
314330,202305,70705,182217,54919,155239,13467,38881,15167,41149,28634,80030
314340,202305,3367,7773,2393,6128,426,1339,1069,2244,1495,3583
314345,202305,2003,4801,1644,4206,140,342,1164,2876,1304,3218
314350,202305,1219,3146,744,2189,118,361,156,316,274,677
314360,202305,689,1803,431,1277,66,191,129,336,195,527
314370,202305,918,2069,740,1827,75,197,504,1183,579,1380
314380,202305,1499,3777,1093,3083,260,813,352,915,612,1728
314390,202305,19822,44188,14201,34969,2113,5909,6471,13631,8584,19540
314400,202305,4740,13076,3676,11048,1287,4129,940,2819,2227,6948
314410,202305,3685,9698,2583,7501,636,2212,478,1094,1114,3306
314420,202305,948,2129,670,1710,25,87,435,1034,460,1121
314430,202305,9775,20870,7041,16705,1062,2707,3390,7517,4452,10224
314435,202305,2281,5538,1772,4753,347,968,834,2112,1181,3080
314437,202305,1102,2488,831,2073,67,187,572,1357,639,1544
314440,202305,747,1973,551,1611,122,432,174,398,296,830
314450,202305,1780,4206,1430,3611,199,553,775,1764,974,2317
314460,202305,4273,11489,3346,9658,751,2434,1372,3409,2123,5843
314465,202305,2823,6984,2286,6016,108,278,1717,4327,1825,4605
314467,202305,1193,2805,960,2431,151,454,585,1397,736,1851
314470,202305,2907,7336,2417,6461,491,1424,1120,2661,1611,4085
314480,202305,11282,27863,8688,22826,1305,3796,4024,9284,5329,13080
314490,202305,1294,3033,936,2406,90,259,587,1406,677,1665
314500,202305,2418,5373,1662,4280,499,1254,355,894,854,2148
314505,202305,2859,5618,2380,4997,148,244,1839,3806,1987,4050
314510,202305,2681,6576,2020,5653,677,2216,573,1422,1250,3638
314520,202305,10046,26976,8137,23427,1810,5558,1885,4873,3695,10431
314530,202305,6682,17886,5888,16492,423,1338,4287,11497,4710,12835
314535,202305,3532,7411,2901,6535,160,395,2344,5180,2504,5575
314537,202305,1456,3671,1133,3138,85,218,730,1946,815,2164
314540,202305,521,1181,381,977,19,56,213,497,232,553
314545,202305,2299,4816,2043,4517,81,223,1613,3549,1694,3772
314550,202305,911,2021,599,1491,63,198,297,637,360,835
314560,202305,6174,15898,4739,13069,602,1943,2287,5364,2889,7307
314570,202305,411,1064,310,898,53,172,139,378,192,550
314580,202305,619,1624,464,1326,109,329,145,401,254,730
314585,202305,911,2475,689,2027,58,211,339,901,397,1112
314587,202305,2778,6651,2188,5748,768,2130,934,2246,1702,4376
314590,202305,5452,13053,4217,10915,548,1585,2097,4907,2645,6492
314600,202305,2260,5754,1484,4328,324,1071,189,477,513,1548
314610,202305,12061,27639,9555,23731,1155,3418,4822,11638,5977,15056
314620,202305,3062,6045,2493,5351,170,292,1948,4245,2118,4537
314625,202305,1995,4365,1677,3935,46,185,1445,3254,1491,3439
314630,202305,6043,13719,4837,12051,198,573,3773,9191,3971,9764
314640,202305,1058,2029,826,1695,29,86,655,1235,684,1321
314650,202305,1001,2220,708,1759,83,242,395,855,478,1097
314655,202305,1809,4467,1282,3579,217,538,616,1742,833,2280
314660,202305,446,863,347,713,12,33,270,511,282,544
314670,202305,1878,3897,1306,3095,42,126,908,2037,950,2163
314675,202305,2019,4649,1721,4184,116,279,1314,3132,1430,3411
314690,202305,2556,6452,1965,5554,538,1585,642,1744,1180,3329
314700,202305,14820,36318,10487,28721,1628,4894,4776,12046,6404,16940
314710,202305,9888,25193,7553,20384,1191,3500,3009,7018,4200,10518
314720,202305,2927,7968,2102,6320,458,1542,380,906,838,2448
314730,202305,3140,7520,2212,5811,393,1169,830,1829,1223,2998
314740,202305,4045,10151,3214,8784,615,1862,1561,3867,2176,5729
314750,202305,368,883,291,730,30,96,178,386,208,482
314760,202305,2366,6286,1518,4495,259,860,409,865,668,1725
314770,202305,1289,3515,718,2165,100,297,140,372,240,669
314780,202305,446,1024,317,819,30,84,193,464,223,548
314790,202305,15302,37029,11385,30335,2103,6276,4777,11595,6880,17871
314795,202305,1832,4161,1541,3710,71,197,1199,2757,1270,2954
314800,202305,14779,34832,10377,27237,1754,5124,4231,9585,5985,14709
314810,202305,13539,32254,10407,27180,2545,7027,4125,10005,6670,17032
314820,202305,1536,3371,1203,2901,77,228,775,1754,852,1982
314830,202305,2231,5470,1833,4833,157,429,1173,2890,1330,3319
314840,202305,1084,2946,873,2572,80,307,596,1637,676,1944
314850,202305,3406,5683,2866,5043,38,77,2649,4615,2687,4692
314860,202305,4148,10105,3454,8981,136,485,2602,6446,2738,6931
314870,202305,8603,16644,6698,14413,288,614,5112,11116,5400,11730
314875,202305,2197,6006,1918,5601,265,711,1266,3745,1531,4456
314880,202305,935,2128,708,1767,52,146,427,1009,479,1155
314890,202305,619,1735,445,1345,66,229,203,523,269,752
314900,202305,1129,2436,869,2036,110,300,506,1080,616,1380
314910,202305,1994,5285,1517,4515,298,1081,667,1762,965,2843
314915,202305,2550,6721,2045,5864,218,611,1216,3465,1434,4076
314920,202305,701,1556,523,1314,31,93,378,938,409,1031
314930,202305,8190,20473,6531,17484,1117,3397,2992,6979,4109,10376
314940,202305,524,1120,421,971,44,119,259,557,303,676
314950,202305,848,1904,579,1489,63,226,315,716,378,942
314960,202305,1175,2544,932,2160,85,196,624,1402,709,1598
314970,202305,1493,4016,1156,3387,215,712,457,1137,672,1849
314980,202305,2759,6310,2304,5665,240,605,1648,3971,1888,4576
314990,202305,3434,9087,2413,6890,416,1225,663,1615,1079,2840
314995,202305,2098,5138,1611,4287,84,291,1025,2476,1109,2767
315000,202305,1297,2979,920,2405,98,285,595,1489,693,1774
315010,202305,505,1227,403,1080,34,111,257,648,291,759
315015,202305,3078,7423,2694,6838,265,833,1904,4568,2169,5401
315020,202305,957,2527,690,2023,63,201,331,844,394,1045
315030,202305,849,1988,587,1543,193,492,138,318,331,810
315040,202305,1235,2854,1038,2551,149,421,668,1529,817,1950
315050,202305,1401,3299,1029,2735,97,296,484,1197,581,1493
315053,202305,1508,3414,1113,2767,145,333,618,1483,763,1816
315057,202305,2257,5632,1765,4838,161,377,1110,3242,1271,3619
315060,202305,892,2383,655,1906,121,384,194,511,315,895
315070,202305,1141,2189,870,1828,95,241,637,1218,732,1459
315080,202305,4187,9774,3112,7862,150,423,2239,5335,2389,5758
315090,202305,1011,2701,768,2271,116,372,365,954,481,1326
315100,202305,1764,4729,1209,3552,184,611,507,1271,691,1882
315110,202305,2855,6040,2094,4954,180,420,1195,2750,1375,3170
315120,202305,15807,33485,11715,27486,1377,3209,6783,15498,8160,18707
315130,202305,2285,5509,1949,4975,207,617,1072,2420,1279,3037
315140,202305,4134,10215,3382,8970,573,1671,1891,4642,2464,6313
315150,202305,5663,13407,4065,10794,718,2097,1778,4395,2496,6492
315160,202305,2527,5481,1804,4384,267,714,1048,2402,1315,3116
315170,202305,1766,5143,1262,3998,245,842,362,1038,607,1880
315180,202305,22323,51165,13482,35441,1993,5846,4852,10771,6845,16617
315190,202305,2676,5465,2061,4665,283,610,1450,3309,1733,3919
315200,202305,5905,14449,4521,12208,1384,4035,1547,3719,2931,7754
315210,202305,10556,25445,7639,19837,861,2496,3648,8119,4509,10615
315213,202305,1235,3014,1084,2798,24,81,898,2241,922,2322
315217,202305,3237,8256,2393,6834,399,1310,1320,3490,1719,4800
315220,202305,10729,26393,8321,22423,740,1788,4382,11914,5122,13702
315230,202305,3625,7068,2998,6257,158,266,2195,4516,2353,4782
315240,202305,3094,7837,2510,6875,640,1879,1071,2785,1711,4664
315250,202305,19484,47193,14926,39078,2352,6880,6911,15968,9263,22848
315260,202305,1152,2877,731,2084,131,380,166,383,297,763
315270,202305,1242,3179,1000,2769,139,454,486,1127,625,1581
315280,202305,4072,9351,2785,7147,742,2024,861,2020,1603,4044
315290,202305,1487,3360,991,2603,185,554,426,991,611,1545
315300,202305,797,1793,581,1487,37,106,399,973,436,1079
315310,202305,1596,3595,1200,2930,80,254,834,1816,914,2070
315320,202305,746,2022,544,1629,82,253,204,546,286,799
315330,202305,869,2569,543,1764,68,250,220,608,288,858
315340,202305,3357,7738,2325,6153,606,1619,773,1981,1379,3600
315350,202305,2377,5217,2015,4699,153,408,1563,3495,1716,3903
315360,202305,2117,5544,1678,4731,222,659,772,1977,994,2636
315370,202305,768,1856,609,1600,86,257,287,667,373,924
315380,202305,290,751,196,566,34,105,25,46,59,151
315390,202305,1575,3975,1299,3523,134,457,768,1839,902,2296
315400,202305,5008,12007,4018,10379,513,1469,2337,5656,2850,7125
315410,202305,2773,5815,1951,4584,402,1114,511,1060,913,2174
315415,202305,1831,4666,1481,4100,438,1438,260,597,698,2035
315420,202305,1856,4805,1378,3975,345,1069,346,832,691,1901
315430,202305,4302,9808,3015,7920,520,1532,1365,3365,1885,4897
315440,202305,1255,2916,989,2513,105,299,616,1435,721,1734
315445,202305,2821,5444,2110,4504,123,246,1668,3519,1791,3765
315450,202305,2649,6556,2143,5741,211,599,1413,3598,1624,4197
315460,202305,60914,142984,51819,128166,4986,14868,34517,78219,39503,93087
315470,202305,833,2120,591,1584,58,164,285,675,343,839
315480,202305,1940,4774,1397,3685,199,567,678,1587,877,2154
315490,202305,3508,8108,2453,6442,430,1203,880,2120,1310,3323
315500,202305,646,1565,416,1108,19,49,254,610,273,659
315510,202305,1690,3671,1379,3228,19,94,1168,2537,1187,2631
315520,202305,1367,3036,1158,2735,44,100,963,2203,1007,2303
315530,202305,1035,2263,879,2013,62,181,681,1431,743,1612
315540,202305,2074,4932,1375,3664,139,452,607,1425,746,1877
315550,202305,2218,5583,1566,4418,272,902,518,1399,790,2301
315560,202305,8117,21037,7031,19207,534,1373,5075,13695,5609,15068
315570,202305,3095,7100,2195,5542,338,1041,1147,2443,1485,3484
315580,202305,4125,8565,3237,7260,406,1048,1531,3066,1937,4114
315590,202305,1613,2964,1358,2604,40,149,1137,1964,1177,2113
315600,202305,3018,8219,2133,6557,571,1716,788,2553,1359,4269
315610,202305,1215,2772,905,2251,112,367,479,997,591,1364
315620,202305,652,1574,486,1323,33,105,260,696,293,801
315630,202305,1510,3630,1161,2989,177,485,558,1293,735,1778
315640,202305,499,1103,397,977,34,92,262,608,296,700
315645,202305,1157,2789,853,2335,160,479,293,720,453,1199
315650,202305,2257,4485,1827,3896,85,192,1460,3023,1545,3215
315660,202305,2499,5943,1879,4859,253,671,1008,2503,1261,3174
315670,202305,20994,49823,16650,42275,3051,8180,8256,19414,11307,27594
315680,202305,3838,9587,2873,7931,419,1282,1458,3791,1877,5073
315690,202305,4803,11074,3033,8111,631,1645,850,2389,1481,4034
315700,202305,10838,25969,8343,21296,789,2262,4860,11295,5649,13557
315710,202305,2097,4602,1516,3768,88,233,991,2317,1079,2550
315720,202305,5541,13321,4581,11731,213,732,3295,7855,3508,8587
315725,202305,2861,6511,2275,5652,262,616,1479,3808,1741,4424
315727,202305,777,1795,578,1475,73,219,297,688,370,907
315730,202305,738,2000,617,1769,130,386,235,593,365,979
315733,202305,1875,4284,1484,3691,261,681,688,1570,949,2251
315737,202305,1431,3478,1046,2765,34,110,737,1839,771,1949
315740,202305,1051,2670,870,2319,79,258,588,1430,667,1688
315750,202305,1584,3593,1208,3068,101,242,761,1970,862,2212
315760,202305,1480,3023,1204,2668,30,93,1002,2133,1032,2226
315765,202305,2495,5229,2069,4709,27,97,1870,4215,1897,4312
315770,202305,1496,3826,1230,3459,409,1244,328,922,737,2166
315780,202305,40019,96946,33903,86305,2443,7375,22472,53092,24915,60467
315790,202305,4235,11916,3599,10770,341,994,2083,6539,2424,7533
315800,202305,1644,4714,1276,3913,160,604,588,1520,748,2124
315810,202305,1735,3645,1428,3177,58,164,1153,2446,1211,2610
315820,202305,3640,7865,2978,6984,298,668,2087,4848,2385,5516
315830,202305,1528,4127,1054,3091,117,388,296,669,413,1057
315840,202305,1083,2374,781,1900,68,176,421,901,489,1077
315850,202305,1439,3701,1146,3223,181,556,593,1580,774,2136
315860,202305,682,1726,520,1465,100,313,175,411,275,724
315870,202305,558,1396,451,1233,28,84,320,828,348,912
315880,202305,1392,3106,1026,2508,123,354,530,1092,653,1446
315890,202305,2193,5525,1817,5028,604,1881,618,1610,1222,3491
315895,202305,7941,19693,5985,16101,718,2181,2799,6758,3517,8939
315900,202305,1084,2622,912,2385,148,411,504,1233,652,1644
315910,202305,782,1754,683,1619,45,134,562,1300,607,1434
315920,202305,1592,3737,980,2625,154,542,394,863,548,1405
315930,202305,1406,2823,998,2285,71,170,603,1303,674,1473
315935,202305,1434,3753,1138,3217,202,610,536,1460,738,2070
315940,202305,718,1734,575,1535,81,238,311,768,392,1006
315950,202305,1567,3770,1353,3442,150,411,1003,2538,1153,2949
315960,202305,6584,17162,4538,13148,1003,3187,863,1806,1866,4993
315970,202305,679,1705,560,1546,75,223,361,990,436,1213
315980,202305,5165,10559,3161,7340,538,1354,1608,3317,2146,4671
315990,202305,4264,10003,3347,8481,520,1387,1686,3922,2206,5309
316000,202305,981,2068,781,1790,70,201,501,1040,571,1241
316010,202305,826,2193,639,1840,98,294,264,624,362,918
316020,202305,1133,2795,930,2453,84,275,603,1478,687,1753
316030,202305,3306,8065,2530,6756,377,1035,1435,3895,1812,4930
316040,202305,3238,8620,2239,6766,376,1296,602,1470,978,2766
316045,202305,2785,5694,2568,5426,168,255,2239,4837,2407,5092
316050,202305,525,1246,394,1030,34,90,243,571,277,661
316060,202305,879,1838,646,1533,31,94,478,1069,509,1163
316070,202305,7488,18007,6136,15567,1033,2633,3002,7148,4035,9781
316080,202305,1034,2794,828,2401,162,510,357,931,519,1441
316090,202305,658,1593,548,1373,47,142,340,760,387,902
316095,202305,1515,4291,1119,3361,260,839,369,984,629,1823
316100,202305,3028,7734,2202,6086,367,1178,938,2278,1305,3456
316105,202305,870,2063,662,1735,46,127,415,1097,461,1224
316110,202305,18366,42646,15257,37740,925,2871,11441,26622,12366,29493
316120,202305,1515,3765,989,2718,160,496,328,710,488,1206
316130,202305,1525,3152,1033,2380,97,267,620,1279,717,1546
316140,202305,1274,3156,788,2244,158,466,252,654,410,1120
316150,202305,2690,5654,2119,4795,193,486,1206,2524,1399,3010
316160,202305,1196,2815,963,2434,41,152,696,1680,737,1832
316165,202305,1067,2298,862,2020,91,235,574,1269,665,1504
316170,202305,1800,3621,1433,3115,69,202,1086,2178,1155,2380
316180,202305,2003,5109,1395,3949,268,818,463,1125,731,1943
316190,202305,3280,8639,1939,5578,227,710,850,2046,1077,2756
316200,202305,4722,11498,3846,10104,573,1752,2016,4812,2589,6564
316210,202305,7171,19010,5271,14867,1689,5114,545,1300,2234,6414
316220,202305,898,2513,629,2007,127,434,123,364,250,798
316225,202305,1993,4071,1511,3344,59,210,1167,2340,1226,2550
316230,202305,614,1441,481,1231,111,311,245,585,356,896
316240,202305,6842,17355,5976,15816,432,1274,4421,11259,4853,12533
316245,202305,3859,10708,3434,10025,212,894,2523,6880,2735,7774
316250,202305,14502,31590,11172,26288,1990,5087,4881,10765,6871,15852
316255,202305,3528,9292,3025,8445,222,637,2145,5988,2367,6625
316257,202305,1935,3970,1468,3276,151,329,1042,2251,1193,2580
316260,202305,3344,6604,2643,5578,272,526,1729,3584,2001,4110
316265,202305,1317,3196,1030,2719,24,64,739,1869,763,1933
316270,202305,4697,12640,3982,11205,550,1679,2224,5750,2774,7429
316280,202305,3755,8910,3115,7811,378,1010,1771,4207,2149,5217
316290,202305,5076,12182,3927,10107,495,1345,1662,3857,2157,5202
316292,202305,7782,18620,6364,16437,734,2153,4175,10164,4909,12317
316294,202305,1174,3230,906,2771,192,675,283,746,475,1421
316295,202305,4609,11472,3825,10181,308,1002,2495,6132,2803,7134
316300,202305,1353,3156,1094,2800,58,177,818,1993,876,2170
316310,202305,891,2346,685,1942,143,469,215,550,358,1019
316320,202305,825,2139,642,1865,116,377,131,331,247,708
316330,202305,1296,2973,1016,2541,56,162,774,1867,830,2029
316340,202305,1253,3024,995,2566,115,349,607,1427,722,1776
316350,202305,1779,4111,1533,3707,169,429,1097,2540,1266,2969
316360,202305,787,1890,654,1692,81,213,469,1244,550,1457
316370,202305,7620,17478,5844,14530,669,2053,3196,6742,3865,8795
316380,202305,2155,4468,1770,3937,91,192,1340,2916,1431,3108
316390,202305,916,2279,675,1888,251,798,145,330,396,1128
316400,202305,1529,3961,979,2900,121,398,332,834,453,1232
316410,202305,1529,3430,1292,3068,33,101,1086,2484,1119,2585
316420,202305,2281,5540,1910,5016,44,156,1523,3835,1567,3991
316430,202305,1149,2734,795,2149,133,411,333,798,466,1209
316440,202305,1049,3014,839,2666,159,560,219,641,378,1201
316443,202305,698,1774,492,1392,108,370,164,404,272,774
316447,202305,2727,5886,2314,5289,102,168,1987,4503,2089,4671
316450,202305,2521,6623,1872,5386,233,726,1069,2941,1302,3667
316460,202305,1710,4075,1422,3630,118,340,918,2174,1036,2514
316470,202305,9337,23985,7163,19892,1086,3359,3162,7659,4248,11018
316480,202305,280,641,235,586,34,96,133,299,167,395
316490,202305,410,1060,287,829,53,175,96,227,149,402
316500,202305,1694,4654,1189,3554,234,763,355,899,589,1662
316510,202305,972,2822,807,2517,134,430,380,1163,514,1593
316520,202305,1671,3685,1230,2919,215,555,466,928,681,1483
316530,202305,1482,3337,1131,2746,103,347,712,1515,815,1862
316540,202305,1362,3052,1092,2684,193,560,463,1011,656,1571
316550,202305,1836,4397,1554,3940,54,174,1295,3195,1349,3369
316553,202305,6218,16182,4636,12790,627,1953,2193,5155,2820,7108
316555,202305,3292,8473,2837,7891,100,397,2376,6443,2476,6840
316556,202305,673,1434,515,1172,39,85,301,583,340,668
316557,202305,1519,4106,1298,3758,448,1390,489,1332,937,2722
316560,202305,498,1397,352,1117,59,215,82,215,141,430
316570,202305,1800,4538,1474,3992,367,903,463,1365,830,2268
316580,202305,448,943,304,710,42,105,115,231,157,336
316590,202305,1581,3580,1103,2719,121,263,665,1527,786,1790
316600,202305,1251,3174,1092,2885,169,510,686,1662,855,2172
316610,202305,769,1998,617,1753,66,198,374,1013,440,1211
316620,202305,2869,6337,2474,5761,185,400,1940,4454,2125,4854
316630,202305,1828,5022,1583,4571,466,1319,610,1979,1076,3298
316640,202305,222,544,172,452,37,110,67,150,104,260
316650,202305,1413,3484,1147,3086,91,254,768,1984,859,2238
316660,202305,198,470,107,279,10,28,41,90,51,118
316670,202305,2014,4596,1513,3857,415,1108,457,1048,872,2156
316680,202305,2912,6898,2193,5574,205,562,1441,3524,1646,4086
316690,202305,1629,4375,1179,3508,221,704,194,421,415,1125
316695,202305,1172,3105,939,2714,23,82,640,1762,663,1844
316700,202305,656,1117,568,1019,15,36,508,882,523,918
316710,202305,4426,11905,3594,10314,445,1487,2083,5424,2528,6911
316720,202305,29219,70646,23353,60325,3488,9983,12280,28926,15768,38909
316730,202305,687,1475,549,1272,56,134,317,662,373,796
316740,202305,1084,2638,958,2465,164,463,631,1590,795,2053
316750,202305,509,1286,377,1065,78,239,164,421,242,660
316760,202305,4914,13509,4171,12209,1402,4683,1580,4402,2982,9085
316770,202305,1895,3828,1440,3224,47,125,1136,2521,1183,2646
316780,202305,743,1991,602,1747,207,670,104,216,311,886
316790,202305,898,2221,675,1814,121,351,183,463,304,814
316800,202305,8385,20783,6693,18015,976,2837,3292,8318,4268,11155
316805,202305,1505,2755,1239,2447,32,88,1068,2043,1100,2131
316810,202305,949,2314,757,1993,86,249,541,1386,627,1635
316820,202305,479,937,298,660,17,52,199,396,216,448
316830,202305,1138,2588,869,2165,98,258,528,1252,626,1510
316840,202305,3724,8115,3037,7114,126,384,2436,5398,2562,5782
316850,202305,2901,6289,2217,5213,193,559,1442,3080,1635,3639
316860,202305,29678,65395,23237,56023,3124,8892,12632,28197,15756,37089
316870,202305,11243,26684,8660,22127,989,2987,4803,10804,5792,13791
316880,202305,1462,3379,1254,3100,160,456,770,1750,930,2206
316890,202305,1393,2977,914,2377,120,389,568,1354,688,1743
316900,202305,3518,8159,2772,6874,451,1224,1330,2921,1781,4145
316905,202305,594,1613,483,1417,240,716,101,311,341,1027
316910,202305,1253,3032,884,2407,216,640,205,492,421,1132
316920,202305,2466,5040,1903,4243,272,641,1264,2603,1536,3244
316930,202305,12090,30253,9694,26336,2057,6146,3927,9552,5984,15698
316935,202305,5569,13222,4208,10857,713,2045,1993,4601,2706,6646
316940,202305,7675,20219,6198,17503,1118,3415,2731,6801,3849,10216
316950,202305,2492,4934,1970,4258,97,206,1657,3488,1754,3694
316960,202305,6792,13280,5008,11020,390,949,3645,7781,4035,8730
316970,202305,5379,12851,4414,11249,725,2018,2119,4804,2844,6822
316980,202305,1135,2880,862,2443,240,755,349,892,589,1647
316990,202305,16684,40076,12646,32527,3065,8408,3110,6756,6175,15164
317000,202305,3324,7974,2941,7499,159,363,2432,6197,2591,6560
317005,202305,3190,8091,2514,6804,436,1308,1245,3094,1681,4402
317010,202305,37723,82362,27695,67377,4222,11474,15618,35612,19840,47086
317020,202305,96245,212746,63920,159042,12619,34206,23691,52163,36310,86369
317030,202305,808,1955,653,1735,14,48,481,1232,495,1280
317040,202305,14371,33388,9922,26107,2589,7372,2438,6384,5027,13756
317043,202305,1183,2256,888,1883,39,81,713,1497,752,1578
317047,202305,1359,2887,966,2275,54,146,676,1497,730,1643
317050,202305,1448,4221,1062,3332,173,578,376,948,549,1526
317052,202305,3004,7036,2385,6117,244,708,1574,3773,1818,4481
317057,202305,2837,5222,2213,4362,33,108,1858,3435,1891,3543
317060,202305,594,1492,360,1030,75,235,116,289,191,524
317065,202305,1328,3491,1121,3096,76,263,729,1812,805,2075
317070,202305,10803,27484,8806,23922,1372,4369,4372,10572,5744,14941
317075,202305,1383,3121,1114,2716,190,471,641,1455,831,1926
317080,202305,8400,17880,6477,14858,1260,3100,3150,6876,4410,9976
317090,202305,5810,14675,5069,13547,417,1024,3673,9797,4090,10821
317100,202305,3141,6979,2188,5495,471,1255,927,2135,1398,3390
317103,202305,3080,6483,2618,5866,162,436,2124,4559,2286,4995
317107,202305,1816,4202,1364,3392,52,162,910,1924,962,2086
317110,202305,823,1788,495,1281,97,282,206,486,303,768
317115,202305,1384,3531,1140,3120,158,480,655,1746,813,2226
317120,202305,25249,58407,20953,51683,1630,4832,13969,31782,15599,36614
317130,202305,14207,30691,10278,24358,1512,3897,4302,9645,5814,13542
317140,202305,1178,2554,890,2107,95,232,590,1354,685,1586
317150,202305,1297,2610,1007,2229,24,82,873,1849,897,1931
317160,202305,4067,9200,2667,6924,282,702,1286,3531,1568,4233
317170,202305,2553,5761,2028,4852,92,282,1417,3005,1509,3287
317180,202305,2232,6313,1637,5004,314,1016,308,852,622,1868
317190,202305,1322,3309,994,2771,190,585,467,1196,657,1781
317200,202305,8163,19868,6141,16093,1318,3629,1541,3516,2859,7145
317210,202305,1526,3228,1192,2800,46,144,850,1945,896,2089
317220,202305,420,1031,363,948,64,201,215,497,279,698
320010,202305,5933,16057,4484,13156,851,2782,1860,5177,2711,7959
320013,202305,2564,6349,1813,4973,333,990,805,2192,1138,3182
320016,202305,3501,8316,2721,7102,257,701,1770,4502,2027,5203
320020,202305,6251,14175,4869,11872,676,1952,2725,6120,3401,8072
320030,202305,2288,5671,1515,4153,229,706,693,1653,922,2359
320035,202305,2439,5844,2041,5217,351,1039,1190,2892,1541,3931
320040,202305,5752,14491,4804,12895,689,1986,2591,6466,3280,8452
320050,202305,2374,4842,2000,4312,201,574,1370,2671,1571,3245
320060,202305,19100,47248,14220,38014,2706,7770,6230,15081,8936,22851
320070,202305,2436,5818,1880,4821,205,670,1008,2242,1213,2912
320080,202305,7082,16506,5089,12799,859,2318,2301,5187,3160,7505
320090,202305,10285,25488,7083,19328,1510,4522,2465,5873,3975,10395
320100,202305,4437,10091,3670,8879,477,1387,2356,5340,2833,6727
320110,202305,3148,6333,2267,5066,351,830,1345,2707,1696,3537
320115,202305,2767,7934,2382,7292,849,2703,777,2436,1626,5139
320120,202305,34282,77899,25372,63049,3439,9408,13039,29321,16478,38729
320130,202305,77587,181044,64068,158839,8219,22457,39091,90752,47310,113209
320140,202305,5307,12901,3947,10358,686,2031,1842,4325,2528,6356
320150,202305,18685,43906,13280,34560,3274,9610,2146,4281,5420,13891
320160,202305,8387,20596,6288,16945,885,2660,3235,8163,4120,10823
320170,202305,2298,5904,1655,4724,451,1328,511,1550,962,2878
320180,202305,932,2677,732,2286,232,819,147,389,379,1208
320190,202305,4037,11496,2967,9265,629,2210,569,1476,1198,3686
320200,202305,1680,4248,1152,3301,254,791,304,835,558,1626
320210,202305,5742,13181,4484,11146,747,1997,2341,5376,3088,7373
320220,202305,4765,10820,3569,8914,739,1922,1567,3640,2306,5562
320225,202305,1950,5435,1324,4085,374,1296,292,830,666,2126
320230,202305,7221,17242,5519,14525,1424,3936,1435,3858,2859,7794
320240,202305,22430,52046,17209,44149,4585,13083,4914,11536,9499,24619
320245,202305,4102,11196,2982,8830,780,2479,327,840,1107,3319
320250,202305,3813,8949,2575,6396,399,1091,1278,2718,1677,3809
320255,202305,2785,7405,2392,6737,399,1203,1549,4334,1948,5537
320260,202305,1789,4656,1172,3436,305,902,286,733,591,1635
320265,202305,2913,8288,2109,6604,724,2482,214,578,938,3060
320270,202305,2852,7210,2139,5922,578,1795,644,1653,1222,3448
320280,202305,11395,25641,9494,22718,1037,2886,6577,14710,7614,17596
320290,202305,1641,4549,1098,3328,273,920,288,810,561,1730
320300,202305,5682,14976,4558,12927,1311,4195,1410,3697,2721,7892
320305,202305,6999,17484,5338,14494,933,2852,2593,6507,3526,9359
320310,202305,2693,6580,1958,5138,354,1036,858,1963,1212,2999
320313,202305,3207,7208,2200,5429,424,1183,814,1640,1238,2823
320316,202305,1969,5113,1475,4286,240,704,772,2248,1012,2952
320320,202305,27516,67231,20608,55922,5268,15298,6426,16665,11694,31963
320330,202305,3573,8584,2823,7376,436,1164,1605,4149,2041,5313
320332,202305,11058,25962,8985,22603,1815,4895,4785,11333,6600,16228
320334,202305,2557,6504,1709,4911,288,991,399,863,687,1854
320335,202305,2374,6236,1576,4541,326,1111,472,1168,798,2279
320340,202305,7356,15231,6136,13536,463,1135,4336,9270,4799,10405
320350,202305,6699,14590,4790,11376,541,1440,2676,5749,3217,7189
320360,202305,1711,4048,1223,3154,157,434,596,1415,753,1849
320370,202305,3694,9971,2902,8372,787,2600,1041,2693,1828,5293
320380,202305,4002,8686,3405,7732,244,735,2532,5258,2776,5993
320390,202305,10311,24426,7717,19604,1587,4294,3106,7133,4693,11427
320400,202305,3990,10451,2948,8329,836,2605,1026,2659,1862,5264
320405,202305,6754,15649,5153,12997,766,2068,2751,6538,3517,8606
320410,202305,5853,14129,4499,12038,865,2332,2062,5495,2927,7827
320420,202305,5616,12426,4352,10546,1024,2696,1746,3975,2770,6671
320425,202305,2701,5721,2085,4764,145,367,1448,3061,1593,3428
320430,202305,3925,9114,3119,7781,437,1152,1888,4463,2325,5615
320435,202305,3064,8583,2512,7490,888,2924,758,2251,1646,5175
320440,202305,1907,4771,1444,3908,262,801,630,1462,892,2263
320450,202305,2761,6633,2249,5769,316,1016,1344,3043,1660,4059
320455,202305,5787,16251,4045,12434,969,3351,996,2557,1965,5908
320460,202305,2619,7139,1941,5800,580,1950,525,1360,1105,3310
320465,202305,2042,5243,1465,4156,392,1199,551,1540,943,2739
320470,202305,5565,13471,4148,10836,796,2313,1412,3203,2208,5516
320480,202305,3318,7039,2644,5989,336,801,1771,3780,2107,4581
320490,202305,34377,77631,25831,63742,4961,12287,11399,27624,16360,39911
320495,202305,1785,4472,1300,3550,310,985,195,346,505,1331
320500,202305,91428,211773,74485,184019,9069,25281,46356,105988,55425,131269
320501,202305,6225,16235,4517,13135,1235,3893,1075,2908,2310,6801
320503,202305,3325,8716,2290,6702,642,2073,615,1571,1257,3644
320506,202305,3653,9855,2751,7953,760,2419,671,1618,1431,4037
320510,202305,15986,37896,12615,32340,2091,5456,6443,15919,8534,21375
320515,202305,2320,5851,1721,4663,505,1473,498,1228,1003,2701
320517,202305,2924,7785,2392,6781,684,2118,927,2523,1611,4641
320520,202305,63730,144289,50822,123753,7591,20504,26021,58676,33612,79180
320530,202305,47527,107227,38634,92985,2828,8524,26334,57589,29162,66113
330010,202305,37666,82188,31987,73475,2464,6597,23911,52038,26375,58635
330015,202305,2384,4948,1848,4126,246,670,1146,2338,1392,3008
330020,202305,31552,67063,27109,60786,2679,6913,20220,43438,22899,50351
330022,202305,2563,6371,1958,5379,412,1198,741,1944,1153,3142
330023,202305,9707,20372,7910,17717,1093,2750,5098,10636,6191,13386
330025,202305,10343,20881,7325,16265,1123,2801,3725,7448,4848,10249
330030,202305,15791,34981,12681,30305,1006,2902,8845,19508,9851,22410
330040,202305,25706,56930,21809,50850,936,2838,16986,36957,17922,39795
330045,202305,146162,275451,126977,252223,5421,11984,109379,211384,114800,223368
330050,202305,4833,10645,3958,9323,611,1788,2501,5197,3112,6985
330060,202305,8519,18738,6251,15101,1148,3205,2531,5442,3679,8647
330070,202305,45281,94200,38510,85070,4537,10807,26666,57270,31203,68077
330080,202305,14882,30232,12815,27448,1609,3483,9103,19102,10712,22585
330090,202305,4522,8409,3407,6961,322,553,2326,4829,2648,5382
330093,202305,4134,8511,3202,7273,216,573,2562,5598,2778,6171
330095,202305,2006,4838,1574,4089,168,493,944,2229,1112,2722
330100,202305,107128,233043,95793,217554,5049,13316,77495,169825,82544,183141
330110,202305,3288,7621,2749,6774,271,816,1918,4373,2189,5189
330115,202305,3923,8282,2776,6518,463,1219,1558,3272,2021,4491
330120,202305,4792,9120,3833,7964,164,430,3091,6058,3255,6488
330130,202305,7939,18253,6690,16462,881,2310,4360,10288,5241,12598
330140,202305,6161,12102,5223,10901,199,581,4473,8891,4672,9472
330150,202305,3649,8214,2904,7085,507,1335,1585,3674,2092,5009
330160,202305,2269,5229,1812,4476,293,867,1056,2302,1349,3169
330170,202305,233036,446043,202694,407369,22086,47333,153531,299954,175617,347287
330180,202305,3150,6126,2655,5465,94,270,2178,4227,2272,4497
330185,202305,17382,33785,15018,30811,488,1375,13129,25879,13617,27254
330187,202305,8490,17571,6739,14936,904,2237,4420,9076,5324,11313
330190,202305,67905,131050,59730,120351,2537,6188,50297,97594,52834,103782
330200,202305,28509,59197,24206,53836,2945,6895,17598,38259,20543,45154
330205,202305,3024,6667,2302,5552,172,492,1555,3437,1727,3929
330210,202305,4596,9872,3411,8028,449,1167,1956,4178,2405,5345
330220,202305,20695,43896,15816,36338,2531,6557,8186,16769,10717,23326
330225,202305,6315,13788,5042,11947,351,967,3550,7944,3901,8911
330227,202305,29012,57446,25800,53553,519,1497,23406,47134,23925,48631
330230,202305,2499,5277,1676,4132,171,443,792,1900,963,2343
330240,202305,41733,89901,35986,81365,3327,8568,26341,56612,29668,65180
330245,202305,2254,5117,1400,3662,283,819,590,1332,873,2151
330250,202305,71391,142470,62243,130061,6200,14130,47088,95037,53288,109167
330260,202305,9800,19441,8070,17207,427,1082,6566,13487,6993,14569
330270,202305,48213,102085,32240,76731,4022,10705,17421,38013,21443,48718
330280,202305,4069,8493,3249,7268,228,616,2314,4741,2542,5357
330285,202305,45761,86922,38851,77593,1524,3961,32931,62443,34455,66404
330290,202305,6845,13040,5699,11606,305,893,4719,8982,5024,9875
330300,202305,8279,16553,6269,13856,462,1135,4660,9853,5122,10988
330310,202305,3819,7837,2948,6541,138,362,2239,4700,2377,5062
330320,202305,27370,53811,22455,47733,2785,5756,16489,34296,19274,40052
330330,202305,77340,146071,64880,130081,4821,10522,51154,98636,55975,109158
330340,202305,28754,59497,22575,50577,2930,7943,13647,27446,16577,35389
330350,202305,253587,470468,220777,431761,8830,19049,194667,371725,203497,390774
330360,202305,11184,22050,9949,20576,398,765,8775,17895,9173,18660
330370,202305,8224,19240,6597,16688,1174,3349,3395,7941,4569,11290
330380,202305,10607,22590,8757,19613,570,1653,6601,13752,7171,15405
330385,202305,6276,14623,5192,13074,907,2617,2745,6447,3652,9064
330390,202305,53346,114836,42740,98062,3760,10782,29931,62545,33691,73327
330395,202305,5118,10512,4293,9504,141,436,3505,7371,3646,7807
330400,202305,5081,11392,4287,10173,215,701,3304,7227,3519,7928
330410,202305,4812,10305,3712,8594,410,1187,2613,5517,3023,6704
330411,202305,3976,9469,3239,8266,185,597,2270,5360,2455,5957
330412,202305,2478,5701,2077,5114,166,491,1467,3347,1633,3838
330414,202305,35412,76129,30034,68899,2148,5477,23291,51612,25439,57089
330415,202305,6361,15106,4796,12504,480,1398,2827,6900,3307,8298
330420,202305,18495,40752,14255,34226,1555,4282,8652,18923,10207,23205
330430,202305,16049,30205,13948,27527,477,1155,11907,22518,12384,23673
330440,202305,4285,9581,3284,7891,332,948,2252,4956,2584,5904
330450,202305,2078,4934,1668,4288,130,379,1054,2526,1184,2905
330452,202305,30618,65213,25710,58182,2047,5765,19382,41158,21429,46923
330455,202305,1084769,2076711,932385,1873897,91012,197658,699909,1356915,790921,1554573
330460,202305,1734,4035,1375,3520,215,604,746,1849,961,2453
330470,202305,8746,18393,6442,15049,1480,3866,2615,5614,4095,9480
330475,202305,13512,29360,11214,26400,1484,3994,7544,17015,9028,21009
330480,202305,7944,17750,6826,16164,595,1546,4760,10629,5355,12175
330490,202305,174748,342997,149062,309688,12187,26904,114629,230801,126816,257705
330500,202305,12100,25294,10277,22903,617,1570,8013,17248,8630,18818
330510,202305,73661,151976,61160,135462,5296,13090,46856,99571,52152,112661
330513,202305,1826,4005,1483,3557,228,600,831,1910,1059,2510
330515,202305,3947,9116,3205,8069,516,1493,1609,3662,2125,5155
330520,202305,21437,46030,18348,41654,1599,4322,13216,28383,14815,32705
330530,202305,2225,4848,1611,3912,310,829,759,1784,1069,2613
330540,202305,4376,9982,3470,8540,701,1847,1755,4068,2456,5915
330550,202305,29542,57328,21706,46195,2832,6608,13642,27282,16474,33890
330555,202305,31725,54613,27340,49509,1002,2104,23646,42017,24648,44121
330560,202305,5637,12440,4663,10976,655,1612,3011,6769,3666,8381
330570,202305,4437,9860,3920,9181,541,1515,2746,6183,3287,7698
330575,202305,9235,19157,8187,17457,325,907,6962,13994,7287,14901
330580,202305,34675,75050,29392,66623,4028,9702,18553,39046,22581,48748
330590,202305,2154,4798,1828,4383,250,574,1164,2835,1414,3409
330600,202305,19228,41849,16171,37228,943,2734,11869,25422,12812,28156
330610,202305,14397,31119,12042,27556,1146,2992,8500,18226,9646,21218
330615,202305,3021,6915,2518,6270,446,983,1609,4162,2055,5145
330620,202305,6424,15079,5272,13284,790,2258,3122,7306,3912,9564
330630,202305,45869,95649,36027,80621,1469,4418,27922,58203,29391,62621
350010,202305,3047,7277,1961,5180,353,1008,509,1067,862,2075
350020,202305,831,2047,527,1470,78,222,188,453,266,675
350030,202305,4991,12222,4082,10752,863,2592,2094,4993,2957,7585
350040,202305,979,2586,621,1856,88,316,200,437,288,753
350050,202305,1983,4450,1379,3495,230,690,467,895,697,1585
350055,202305,1256,2777,1024,2439,150,399,598,1286,748,1685
350060,202305,416,912,221,530,45,118,92,200,137,318
350070,202305,4472,10683,3185,8435,492,1469,1411,3213,1903,4682
350075,202305,864,2233,660,1871,202,596,125,353,327,949
350080,202305,866,2105,578,1565,50,164,305,710,355,874
350090,202305,807,1601,545,1229,70,192,334,667,404,859
350100,202305,3425,7871,2564,6494,153,526,1742,3969,1895,4495
350110,202305,665,1437,503,1179,14,38,371,817,385,855
350115,202305,1409,3858,1174,3422,193,640,552,1414,745,2054
350120,202305,699,1538,401,1047,45,127,195,470,240,597
350130,202305,4496,10712,3633,9221,449,1262,2105,4750,2554,6012
350140,202305,893,2233,642,1794,46,167,381,959,427,1126
350150,202305,586,1641,467,1422,101,345,142,354,243,699
350160,202305,16276,38051,12295,30847,1667,4725,7416,17096,9083,21821
350170,202305,3880,9481,3331,8379,565,1514,1874,4227,2439,5741
350180,202305,1248,2771,825,2056,89,249,468,1051,557,1300
350190,202305,5071,12920,3899,10299,485,1578,2334,5260,2819,6838
350200,202305,716,1679,563,1418,47,129,356,821,403,950
350210,202305,8753,18331,6449,14773,434,1275,4652,9756,5086,11031
350220,202305,4139,10331,3024,8268,548,1637,1350,3225,1898,4862
350230,202305,1491,3340,1176,2915,148,461,710,1641,858,2102
350240,202305,782,2066,471,1364,85,242,118,287,203,529
350250,202305,4755,11737,3702,10088,982,2781,1092,2868,2074,5649
350260,202305,1072,2327,681,1695,89,242,383,856,472,1098
350270,202305,5740,13566,4630,11621,611,1685,2679,6160,3290,7845
350275,202305,4015,9299,3382,8398,219,720,2589,6021,2808,6741
350280,202305,24945,53141,17332,41248,2467,6440,9201,19874,11668,26314
350290,202305,4647,11622,3392,9190,637,1913,1421,3308,2058,5221
350300,202305,965,2130,722,1747,94,267,479,1051,573,1318
350310,202305,1261,3209,991,2721,136,420,479,1176,615,1596
350315,202305,837,1835,557,1411,30,111,336,729,366,840
350320,202305,23100,54306,18229,46010,3119,8828,9312,20991,12431,29819
350330,202305,18384,40996,14135,33553,1222,3366,9822,21467,11044,24833
350335,202305,466,1225,343,994,38,123,148,412,186,535
350340,202305,1708,4164,1109,2991,147,475,538,1256,685,1731
350350,202305,900,2079,740,1903,126,315,435,1127,561,1442
350360,202305,1555,3977,1297,3498,222,669,614,1533,836,2202
350370,202305,938,2102,685,1663,188,443,266,581,454,1024
350380,202305,6409,16364,4822,13165,1097,3161,1725,4240,2822,7401
350390,202305,15574,36098,12285,30730,1577,4443,7569,17334,9146,21777
350395,202305,495,1181,267,760,29,83,96,237,125,320
350400,202305,11399,26140,8376,21136,2140,5851,2697,6213,4837,12064
350410,202305,14459,36695,11164,30806,2224,6767,4493,11343,6717,18110
350420,202305,1565,3700,1116,2891,204,532,372,793,576,1325
350430,202305,847,2030,666,1761,111,353,359,831,470,1184
350440,202305,2775,6183,2228,5335,176,509,1494,3260,1670,3769
350450,202305,9789,24446,7894,21270,1610,4976,3813,9128,5423,14104
350460,202305,3162,7472,2087,5518,313,917,999,2317,1312,3234
350470,202305,336,749,263,640,9,24,199,460,208,484
350480,202305,1175,2782,756,2061,196,590,139,301,335,891
350490,202305,2639,5963,1950,4940,282,842,1003,2175,1285,3017
350500,202305,803,1995,572,1599,95,295,217,541,312,836
350510,202305,1592,3593,1243,3024,119,315,780,1751,899,2066
350520,202305,3205,8525,2565,7406,361,1152,1208,3160,1569,4312
350530,202305,4166,9541,3230,7845,256,768,2074,4498,2330,5266
350535,202305,1943,4646,1636,4223,245,696,1028,2529,1273,3225
350540,202305,2629,5279,2029,4460,249,715,1424,2765,1673,3480
350550,202305,13229,29605,9737,23880,1026,2966,5843,12818,6869,15784
350560,202305,6258,13966,5346,12612,234,735,4239,9414,4473,10149
350570,202305,42915,104722,35400,91750,5843,16665,19097,45765,24940,62430
350580,202305,2829,6826,1874,5104,540,1566,465,958,1005,2524
350590,202305,6964,16840,5442,13702,727,2142,3373,7611,4100,9753
350600,202305,43997,96847,29343,72320,4742,13248,13902,30241,18644,43489
350610,202305,9694,23727,7392,19402,843,2534,4358,10341,5201,12875
350620,202305,507,1223,343,959,40,118,190,489,230,607
350630,202305,2338,4939,1700,3915,100,279,1225,2573,1325,2852
350635,202305,15572,33009,12349,28238,1234,3116,8808,19035,10042,22151
350640,202305,1127,2857,641,1839,106,324,182,440,288,764
350650,202305,11438,28011,8617,22852,1605,4672,3733,8785,5338,13457
350660,202305,6482,14795,5139,12739,704,1685,3174,7732,3878,9417
350670,202305,2432,5984,1826,4929,321,932,927,2370,1248,3302
350680,202305,1544,3759,1059,2888,141,416,522,1259,663,1675
350690,202305,1917,4559,1424,3703,253,731,728,1751,981,2482
350700,202305,7101,16050,5647,13897,1176,3389,3078,6786,4254,10175
350710,202305,4115,9615,3475,8613,595,1750,1922,4282,2517,6032
350715,202305,891,2389,758,2158,167,554,365,877,532,1431
350720,202305,216,497,154,403,26,75,47,100,73,175
350730,202305,817,2213,631,1856,51,174,339,902,390,1076
350740,202305,2091,5066,1465,3842,241,691,500,1144,741,1835
350745,202305,785,1905,497,1375,41,145,258,634,299,779
350750,202305,15818,37324,12901,32608,2261,6513,6347,14442,8608,20955
350760,202305,24658,53571,19033,44396,2527,7099,11360,23544,13887,30643
350770,202305,1347,2984,912,2273,94,266,576,1310,670,1576
350775,202305,927,1941,626,1497,83,214,337,748,420,962
350780,202305,3027,6768,2252,5723,581,1401,829,2282,1410,3683
350790,202305,2643,6500,1719,4862,409,1188,394,880,803,2068
350800,202305,4619,11621,3941,10524,499,1432,2481,6216,2980,7648
350810,202305,3748,8174,2831,6833,657,1672,1245,2785,1902,4457
350820,202305,1215,2609,765,1800,55,153,489,1042,544,1195
350830,202305,1090,2652,652,1775,116,341,226,474,342,815
350840,202305,4474,12196,3508,10467,695,2296,1489,3954,2184,6250
350850,202305,11291,27674,9082,23848,1479,4226,4999,12157,6478,16383
350860,202305,5294,12023,4601,11077,501,1323,3163,7373,3664,8696
350870,202305,3470,8635,2585,7248,490,1409,1205,3223,1695,4632
350880,202305,2134,5234,1774,4587,460,1282,775,1734,1235,3016
350890,202305,631,1543,423,1140,72,191,142,333,214,524
350900,202305,13139,31154,9755,24613,1503,4169,5441,12333,6944,16502
350910,202305,1224,2591,1025,2310,99,226,755,1657,854,1883
350920,202305,17208,39139,14536,34839,823,2308,11236,25520,12059,27828
350925,202305,5734,13621,4364,11398,704,2140,2407,5493,3111,7633
350930,202305,1861,4464,1292,3403,94,260,708,1751,802,2011
350940,202305,3706,8296,3050,7318,272,763,2215,4945,2487,5708
350945,202305,1241,3115,922,2517,182,508,379,932,561,1440
350950,202305,135074,308984,107364,260084,13631,36650,66290,148661,79921,185311
350960,202305,9961,23572,7866,19860,1203,3434,4198,9448,5401,12882
350970,202305,5176,13104,3923,10881,1019,3254,1291,2753,2310,6007
350980,202305,1017,2318,852,2051,127,354,534,1165,661,1519
350990,202305,2856,6664,2297,5814,517,1539,1167,2651,1684,4190
350995,202305,1122,3032,1024,2850,69,247,713,1855,782,2102
351000,202305,3887,9970,2466,7068,520,1613,660,1731,1180,3344
351010,202305,519,1209,322,848,54,163,154,372,208,535
351015,202305,1305,3501,1077,3058,207,658,451,1093,658,1751
351020,202305,10920,26213,8439,21984,1625,4555,4206,9912,5831,14467
351030,202305,4120,10932,3288,9324,642,2074,1523,3899,2165,5973
351040,202305,7732,16336,6490,14502,309,868,5283,11176,5592,12044
351050,202305,23551,53208,18585,45867,3187,8581,10259,23650,13446,32231
351060,202305,67869,152712,53566,129448,4747,13207,37380,85133,42127,98340
351070,202305,1939,4434,1171,3182,322,938,224,518,546,1456
351080,202305,3710,8094,2856,7067,380,1096,1781,4118,2161,5214
351090,202305,437,1077,337,914,62,168,138,354,200,522
351100,202305,3662,8961,2443,6557,443,1304,873,2155,1316,3459
351110,202305,7561,18193,5669,14873,987,2912,2855,6795,3842,9707
351120,202305,1009,2369,662,1732,123,358,233,504,356,862
351130,202305,1530,3980,723,2129,136,440,154,372,290,812
351140,202305,2937,7341,2272,6203,519,1576,910,2152,1429,3728
351150,202305,3798,9846,2673,7662,460,1486,889,2230,1349,3716
351160,202305,1880,5236,1339,4062,249,808,245,595,494,1403
351170,202305,2175,5088,1892,4627,142,445,1376,3084,1518,3529
351190,202305,1268,3260,902,2574,205,615,236,600,441,1215
351200,202305,1961,4549,1481,3834,175,505,854,2014,1029,2519
351210,202305,1910,4270,1326,3301,91,282,852,1920,943,2202
351220,202305,5033,11753,4373,10735,534,1278,2878,6830,3412,8108
351230,202305,2952,6847,2306,5795,423,1190,1097,2398,1520,3588
351240,202305,3007,7476,1661,4718,337,988,274,626,611,1614
351250,202305,1289,3276,770,2200,115,333,255,667,370,1000
351260,202305,1014,2324,719,1822,151,383,273,644,424,1027
351270,202305,679,1684,494,1337,58,171,246,545,304,716
351280,202305,5019,12204,3804,9993,871,2419,1370,3280,2241,5699
351290,202305,1971,4259,1389,3317,120,339,1018,2280,1138,2619
351300,202305,30735,74465,23369,61374,4267,12186,11597,27983,15864,40169
351310,202305,5180,11298,4076,9542,251,681,2993,6555,3244,7236
351320,202305,1028,2775,724,2195,132,418,183,476,315,894
351330,202305,370,912,239,668,24,81,103,239,127,320
351340,202305,11047,24629,9442,21920,1727,4679,5897,12128,7624,16807
351350,202305,17926,40060,15063,35334,1127,3158,11572,25383,12699,28541
351360,202305,5153,11890,4306,10692,792,2330,2284,5034,3076,7364
351370,202305,2597,6699,1708,4927,392,1237,354,802,746,2039
351380,202305,62451,135821,46361,109891,4829,12821,30375,67351,35204,80172
351385,202305,478,1197,199,589,29,84,79,219,108,303
351390,202305,1857,4151,1322,3445,82,254,1076,2717,1158,2971
351400,202305,1562,3859,1283,3341,257,642,639,1596,896,2238
351410,202305,3445,8574,2653,7133,513,1485,1153,2839,1666,4324
351420,202305,617,1387,395,1023,70,176,216,526,286,702
351430,202305,1324,3041,1112,2713,112,288,783,1810,895,2098
351440,202305,4792,11381,3391,8726,595,1636,1199,2551,1794,4187
351450,202305,2218,5359,1532,4148,300,988,502,1064,802,2052
351460,202305,1343,3132,1116,2802,184,479,676,1613,860,2092
351470,202305,1563,3616,1240,3101,94,267,799,1859,893,2126
351480,202305,3124,8033,2516,7073,461,1460,1211,3098,1672,4558
351490,202305,2974,7337,2591,6695,99,349,2064,5122,2163,5471
351492,202305,482,1119,411,987,9,25,334,763,343,788
351495,202305,288,707,235,611,25,54,142,351,167,405
351500,202305,60043,128132,47797,109220,6237,15644,32033,68305,38270,83949
351510,202305,18460,39932,14091,32772,1536,4088,9304,20271,10840,24359
351512,202305,585,1465,405,1087,76,211,126,300,202,511
351515,202305,4099,9142,2645,6621,539,1446,645,1601,1184,3047
351518,202305,2527,6196,1751,4829,318,974,675,1575,993,2549
351519,202305,772,1983,469,1393,111,367,102,244,213,611
351520,202305,1360,3151,706,1956,71,238,340,824,411,1062
351530,202305,436,1047,272,728,42,119,124,263,166,382
351535,202305,2044,4763,1474,3790,243,681,636,1504,879,2185
351540,202305,3501,7756,2422,5967,262,760,1275,2748,1537,3508
351550,202305,9748,22180,6976,17444,944,2542,3799,8567,4743,11109
351560,202305,699,1856,556,1587,102,316,223,591,325,907
351565,202305,352,855,271,726,43,147,120,269,163,416
351570,202305,31724,74136,25553,63010,2072,5952,17658,40582,19730,46534
351580,202305,279,685,165,485,22,62,59,183,81,245
351590,202305,534,1171,283,741,21,59,148,346,169,405
351600,202305,1642,4094,1286,3421,218,604,581,1394,799,1998
351610,202305,854,1870,556,1370,55,141,308,696,363,837
351620,202305,31861,77540,24497,65828,3723,11574,11766,28423,15489,39997
351630,202305,38897,88935,32199,78490,2676,7648,23242,53081,25918,60729
351640,202305,27461,61754,22474,53766,1560,4499,16465,36812,18025,41311
351650,202305,467,1224,224,689,41,138,46,115,87,253
351660,202305,764,2010,528,1523,94,299,136,337,230,636
351670,202305,8018,20054,5390,14405,1127,2997,2302,5483,3429,8480
351680,202305,528,1368,356,1034,63,171,111,292,174,463
351685,202305,617,1568,486,1364,89,243,194,468,283,711
351690,202305,1499,3566,899,2444,120,393,362,841,482,1234
351700,202305,1756,3927,1313,3210,213,595,747,1636,960,2231
351710,202305,1014,2405,762,1962,62,200,440,980,502,1180
351720,202305,1965,4722,1449,3827,259,699,666,1629,925,2328
351730,202305,1310,2976,1075,2639,87,242,679,1528,766,1770
351740,202305,4192,9611,3457,8420,475,1308,2106,4698,2581,6006
351750,202305,2474,6024,1585,4336,216,633,809,2019,1025,2652
351760,202305,4231,10478,3295,8791,596,1873,1513,3551,2109,5424
351770,202305,2709,6465,2207,5593,582,1470,1119,2649,1701,4119
351780,202305,1402,3272,830,2194,99,290,354,858,453,1148
351790,202305,2009,4333,1525,3650,279,629,867,2051,1146,2680
351800,202305,558,1233,289,745,38,107,111,231,149,338
351810,202305,1455,3458,1207,3104,321,940,538,1248,859,2188
351820,202305,4081,9851,3140,8181,655,1902,1252,2813,1907,4715
351830,202305,6755,15242,5228,12819,406,1213,3573,8023,3979,9236
351840,202305,12730,31212,10228,26829,969,2946,6701,16110,7670,19056
351850,202305,1846,4850,1213,3618,218,751,347,795,565,1546
351860,202305,3550,9156,2810,7912,777,2420,1217,3080,1994,5500
351870,202305,39022,89096,31198,76690,6140,15948,15679,37086,21819,53034
351880,202305,233141,508864,187755,436732,26030,72694,122004,258083,148034,330777
351885,202305,1365,3032,1137,2712,47,148,863,1929,910,2077
351890,202305,1036,2493,656,1873,118,382,165,397,283,779
351900,202305,1629,3963,1236,3381,120,335,788,2100,908,2435
351905,202305,807,2113,627,1751,80,240,282,680,362,920
351907,202305,30981,73335,24643,62560,2817,8239,15703,36824,18520,45063
351910,202305,2307,5266,1699,4149,163,484,1024,2157,1187,2641
351920,202305,1143,2715,890,2270,157,439,367,827,524,1266
351925,202305,1302,3121,1027,2661,95,301,608,1438,703,1739
351930,202305,5965,13074,5424,12233,670,1634,4122,8960,4792,10594
351940,202305,1426,3397,1056,2764,200,548,415,1061,615,1609
351950,202305,2088,4101,1621,3472,86,232,1194,2382,1280,2614
351960,202305,7315,16769,5670,14089,1365,3630,2350,5214,3715,8844
351970,202305,14710,34178,12450,30711,1411,4393,8681,19667,10092,24060
351980,202305,1406,3133,928,2351,143,408,431,965,574,1373
351990,202305,1814,3977,1370,3360,64,227,772,1656,836,1883
352000,202305,3662,8893,3141,7902,277,851,2175,5017,2452,5868
352010,202305,3086,7365,2424,6335,711,1930,643,1641,1354,3571
352020,202305,2234,5257,1778,4487,277,791,986,2276,1263,3067
352030,202305,8258,18528,6771,16184,859,2440,4436,9775,5295,12215
352040,202305,6001,13867,4441,11137,794,2210,1818,3986,2612,6196
352042,202305,5019,10686,3608,8594,398,1067,2378,5411,2776,6478
352044,202305,2652,6535,1598,4579,265,855,346,747,611,1602
352050,202305,17808,43731,12628,33985,3627,10531,2830,6062,6457,16593
352060,202305,1001,2394,772,2016,158,443,364,855,522,1298
352070,202305,1186,2360,823,1876,85,203,458,950,543,1153
352080,202305,550,1309,343,926,41,116,121,270,162,386
352090,202305,2030,5255,1691,4658,209,679,901,2169,1110,2848
352100,202305,5053,12868,3971,10913,774,2412,1719,4299,2493,6711
352110,202305,983,2460,740,1994,160,449,324,765,484,1214
352115,202305,617,1576,506,1425,148,481,223,542,371,1023
352120,202305,1087,2801,857,2366,82,238,543,1370,625,1608
352130,202305,2473,6551,1577,4355,210,601,702,1712,912,2313
352140,202305,1802,4406,1359,3548,266,684,580,1435,846,2119
352150,202305,1094,2650,821,2194,122,360,499,1254,621,1614
352160,202305,1227,2791,878,2235,91,266,434,1031,525,1297
352170,202305,3769,9379,2891,7637,501,1543,1307,2951,1808,4494
352180,202305,3552,8899,2796,7615,595,1760,1136,2808,1731,4568
352190,202305,2181,4985,1782,4385,345,903,951,2269,1296,3172
352200,202305,424,1244,309,1004,48,170,112,327,160,497
352210,202305,31912,63687,26182,56103,1411,3564,21379,43908,22790,47472
352215,202305,801,1973,600,1610,118,334,289,728,407,1062
352220,202305,38573,81753,30258,68522,3866,10208,19777,40340,23643,50548
352230,202305,20533,52798,16370,45408,4298,13123,6143,14757,10441,27880
352240,202305,14008,32930,11105,28344,2266,6442,5842,13441,8108,19883
352250,202305,34516,87421,28560,77899,3945,11825,18463,48040,22408,59865
352260,202305,6539,15161,4707,11626,839,2342,2398,5082,3237,7424
352265,202305,1126,2987,987,2788,201,597,495,1325,696,1922
352270,202305,2766,7092,2208,6025,419,1245,971,2388,1390,3633
352280,202305,3145,6892,2415,5823,389,1068,1331,2866,1720,3934
352290,202305,2035,5071,1657,4395,219,644,925,2201,1144,2845
352300,202305,1201,2843,771,1990,82,231,412,956,494,1187
352310,202305,57766,137363,46330,119388,7414,19980,28798,71619,36212,91599
352320,202305,9043,20460,7245,17419,940,2615,4486,9517,5426,12132
352330,202305,3482,7692,2813,6774,259,829,1928,4219,2187,5048
352340,202305,10661,25468,8253,21175,1291,3785,4433,10102,5724,13887
352350,202305,3354,8072,2761,6921,139,403,2026,4832,2165,5235
352360,202305,2023,4713,1645,4071,158,420,1110,2532,1268,2952
352370,202305,1328,3350,1124,3008,56,170,836,2148,892,2318
352380,202305,1255,2944,953,2460,202,548,337,792,539,1340
352390,202305,19241,44129,14218,35349,2142,6116,8385,18869,10527,24985
352400,202305,4989,12916,3923,10936,960,2915,1340,3271,2300,6186
352410,202305,5041,11237,3976,9561,503,1297,2415,5452,2918,6749
352420,202305,1060,2514,774,2043,137,368,331,786,468,1154
352430,202305,11812,25101,9181,20948,1193,3164,5467,11458,6660,14622
352440,202305,25833,63689,20213,53527,4786,13316,7243,18038,12029,31354
352450,202305,1011,2376,587,1665,91,295,252,618,343,913
352460,202305,3491,8718,2623,7226,476,1472,1198,2983,1674,4455
352470,202305,3908,9524,3144,8325,279,888,2041,4939,2320,5827
352480,202305,5959,12915,4126,9856,596,1671,2100,4346,2696,6017
352490,202305,1090,2723,871,2378,174,514,348,886,522,1400
352500,202305,15137,35796,10629,27947,3738,11308,2087,3446,5825,14754
352510,202305,6178,14599,5025,12660,557,1532,3422,8141,3979,9673
352520,202305,3767,9300,2954,7956,543,1647,1563,3770,2106,5417
352530,202305,15657,36319,11420,28818,2481,7100,4186,8617,6667,15717
352540,202305,726,1854,544,1503,72,200,287,727,359,927
352550,202305,1393,3428,939,2643,192,652,344,785,536,1437
352560,202305,851,2021,724,1808,47,157,523,1197,570,1354
352570,202305,2777,7136,1857,5429,483,1614,282,479,765,2093
352580,202305,977,2194,830,1967,106,300,556,1200,662,1500
352585,202305,484,1256,351,1014,37,134,149,344,186,478
352590,202305,16131,39575,12235,32836,2253,6893,6662,16146,8915,23039
352600,202305,2551,6088,2084,5308,319,914,1269,2894,1588,3808
352610,202305,3871,9174,3009,7836,467,1416,1502,3533,1969,4949
352620,202305,7824,17307,6017,14778,1409,3601,2792,6650,4201,10251
352630,202305,1036,2332,797,2016,134,388,377,879,511,1267
352640,202305,4417,10175,3338,8270,298,843,2127,4764,2425,5607
352650,202305,701,1848,459,1357,75,230,176,461,251,691
352660,202305,1454,3727,1205,3272,97,339,813,2013,910,2352
352670,202305,13974,33089,10583,26750,1991,5517,5099,11432,7090,16949
352680,202305,4423,11738,3281,9306,705,2359,1529,3492,2234,5851
352690,202305,34366,79556,27940,69291,1316,4057,20952,48974,22268,53031
352700,202305,1057,2491,804,2087,104,282,411,977,515,1259
352710,202305,7200,16997,5417,13998,1529,4418,2156,4868,3685,9286
352720,202305,13445,30302,11179,26475,1560,4201,6726,14586,8286,18787
352725,202305,656,1429,382,987,20,59,230,527,250,586
352730,202305,5283,14602,4733,13439,658,2117,2359,5593,3017,7710
352740,202305,3010,6795,2304,5773,323,924,1145,2621,1468,3545
352750,202305,527,1235,341,934,39,126,150,358,189,484
352760,202305,1860,4612,1486,3992,197,558,834,2122,1031,2680
352770,202305,1194,2849,859,2269,114,327,460,1124,574,1451
352780,202305,814,2154,560,1628,141,383,155,439,296,822
352790,202305,511,1241,384,996,61,155,156,343,217,498
352800,202305,1731,4715,1222,3649,230,742,252,539,482,1281
352810,202305,2159,4736,1673,3903,191,475,1172,2595,1363,3070
352820,202305,542,1430,409,1208,86,265,101,255,187,520
352830,202305,682,1629,345,965,42,117,105,244,147,361
352840,202305,4985,12845,4089,11294,950,2863,1770,4569,2720,7432
352850,202305,17628,37505,13378,31115,2327,6210,7707,16115,10034,22325
352860,202305,1507,3797,1150,3161,219,624,443,1137,662,1761
352870,202305,1024,2487,720,1860,81,230,428,1031,509,1261
352880,202305,2114,4731,1540,3751,263,680,660,1407,923,2087
352885,202305,460,1143,365,978,46,152,229,568,275,720
352890,202305,881,1894,614,1395,61,152,407,813,468,965
352900,202305,25460,60391,17984,46723,3040,8249,7291,17425,10331,25674
352910,202305,458,1139,259,755,20,65,107,273,127,338
352920,202305,3531,8218,2811,7014,148,468,2095,4891,2243,5359
352930,202305,7663,18183,6023,15056,952,2782,3103,6685,4055,9467
352940,202305,36338,87193,29867,74885,4445,12359,18188,42279,22633,54638
352950,202305,689,1745,447,1306,91,295,139,331,230,626
352960,202305,917,2252,557,1523,83,253,183,387,266,640
352965,202305,276,719,191,560,43,119,57,160,100,279
352970,202305,5125,9486,4324,8347,120,294,3785,6975,3905,7269
352980,202305,1919,4281,1520,3735,395,1044,778,1793,1173,2837
352990,202305,5767,13383,4441,11304,799,2194,2384,5775,3183,7969
353000,202305,552,1389,308,873,41,129,110,270,151,399
353010,202305,3491,7851,2487,6105,422,1208,1218,2652,1640,3860
353020,202305,3999,9588,2589,6876,397,1230,1065,2503,1462,3733
353030,202305,6167,14545,4345,11548,1052,3039,1248,3015,2300,6054
353040,202305,954,2055,724,1702,76,203,490,1059,566,1262
353050,202305,6710,17250,4944,13794,874,2731,2527,6512,3401,9243
353060,202305,67325,151982,56561,135660,3539,10490,43263,97690,46802,108180
353070,202305,14926,37445,11394,30348,1964,5770,5480,12897,7444,18667
353080,202305,6636,15962,4808,12598,1006,2974,2005,4418,3011,7392
353090,202305,739,2022,601,1771,61,196,323,889,384,1085
353100,202305,385,929,163,473,30,97,49,103,79,200
353110,202305,10788,24765,8803,22076,2032,5157,4412,11355,6444,16512
353120,202305,652,1520,505,1297,73,237,260,561,333,798
353130,202305,3967,8656,2790,6656,629,1690,1295,2646,1924,4336
353140,202305,4095,8881,3185,7486,444,1269,1965,4176,2409,5445
353150,202305,2204,5054,1659,4179,329,884,743,1711,1072,2595
353160,202305,801,1924,550,1496,65,196,245,569,310,765
353170,202305,874,2037,695,1778,79,241,407,978,486,1219
353180,202305,12802,29739,10092,25124,2410,6567,4464,10080,6874,16647
353190,202305,4592,11032,3552,9095,454,1290,2015,4697,2469,5987
353200,202305,2212,5486,1466,4094,205,657,598,1462,803,2119
353205,202305,617,1602,518,1391,47,149,308,722,355,871
353210,202305,1154,2267,779,1688,29,76,602,1206,631,1282
353215,202305,488,1207,386,1033,55,172,166,385,221,557
353220,202305,959,2450,670,1892,116,334,225,556,341,890
353230,202305,1069,2745,846,2388,208,664,204,520,412,1184
353240,202305,3309,7787,2772,6997,393,1137,1696,4001,2089,5138
353250,202305,1748,3529,1258,2790,149,354,800,1686,949,2040
353260,202305,1471,3184,851,2204,185,546,350,795,535,1341
353270,202305,1090,2480,887,2139,100,284,550,1186,650,1470
353280,202305,948,2314,710,1940,145,418,265,692,410,1110
353282,202305,2149,5515,1741,4781,168,534,1022,2566,1190,3100
353284,202305,450,1027,253,668,20,64,109,235,129,299
353286,202305,198,499,115,354,25,72,17,46,42,118
353290,202305,1627,3979,938,2599,183,489,238,597,421,1086
353300,202305,2813,6893,2093,5546,402,1170,926,2085,1328,3255
353310,202305,502,1129,395,957,27,86,271,585,298,671
353320,202305,814,2023,662,1762,54,175,393,945,447,1120
353325,202305,1016,2600,750,2080,122,354,352,877,474,1231
353330,202305,813,1863,536,1384,72,202,264,592,336,794
353340,202305,4536,11218,3626,9554,606,1876,1935,4467,2541,6343
353350,202305,5744,12830,4336,10472,1112,2884,1283,2642,2395,5526
353360,202305,897,2288,755,2031,74,246,483,1202,557,1448
353370,202305,783,2045,654,1847,72,221,402,1099,474,1320
353380,202305,398,994,311,836,43,145,178,413,221,558
353390,202305,8339,19242,6362,16090,595,1777,3916,9084,4511,10861
353400,202305,751,1822,594,1562,112,347,265,529,377,876
353410,202305,676,1626,506,1312,172,467,188,412,360,879
353420,202305,628,1480,451,1161,77,209,120,248,197,457
353430,202305,2942,7428,2340,6379,507,1459,1040,2644,1547,4103
353440,202305,106060,252286,81735,206228,10796,30872,50339,115402,61135,146274
353450,202305,488,1140,351,920,45,121,172,415,217,536
353460,202305,4207,10495,2998,8219,615,1944,714,1535,1329,3479
353470,202305,12195,28854,9175,23586,1630,4697,4201,9495,5831,14192
353475,202305,2041,4719,1404,3581,179,525,677,1467,856,1992
353480,202305,2047,4666,1734,4227,107,327,1258,2851,1365,3178
353490,202305,1367,3246,1044,2706,124,349,575,1347,699,1696
353500,202305,1588,3544,1182,2896,258,701,587,1297,845,1998
353510,202305,1323,3404,978,2672,174,508,392,898,566,1406
353520,202305,1334,3220,875,2425,148,446,343,788,491,1234
353530,202305,3264,7527,2715,6597,314,888,1731,3816,2045,4704
353540,202305,2856,6835,2355,6099,394,1118,1370,3315,1764,4433
353550,202305,8120,18092,6547,15586,972,2490,3984,8750,4956,11240
353560,202305,3017,7360,2424,6510,707,2087,820,1822,1527,3909
353570,202305,811,2030,530,1509,92,294,197,485,289,779
353580,202305,3173,7554,2560,6468,476,1176,1410,3425,1886,4601
353590,202305,926,2169,708,1839,116,309,362,878,478,1187
353600,202305,1964,4667,1442,3783,207,582,693,1711,900,2293
353610,202305,1053,2777,789,2257,128,409,351,895,479,1304
353620,202305,3783,8858,2722,7212,643,1775,807,1874,1450,3649
353625,202305,798,1832,458,1226,51,172,251,601,302,773
353630,202305,2074,5451,1784,4919,254,779,1019,2533,1273,3312
353640,202305,1812,4268,1409,3576,189,486,894,2149,1083,2635
353650,202305,9042,22684,7255,19617,1043,3135,4084,10166,5127,13301
353657,202305,464,1149,355,978,38,126,156,387,194,513
353660,202305,1742,3350,1246,2712,164,405,861,1769,1025,2174
353670,202305,5737,14238,4522,11980,863,2675,2124,4896,2987,7571
353680,202305,907,2109,679,1792,110,326,389,941,499,1267
353690,202305,527,1353,258,752,27,82,67,154,94,236
353700,202305,2892,6596,2380,5841,229,602,1594,3716,1823,4318
353710,202305,5336,11514,4095,9535,683,1627,2259,4555,2942,6182
353715,202305,526,1320,320,904,27,92,140,341,167,433
353720,202305,2468,5940,1944,5119,404,1159,843,2099,1247,3258
353730,202305,6750,15653,5393,13376,749,2189,3310,7470,4059,9659
353740,202305,2797,6688,2126,5531,400,1148,1002,2309,1402,3457
353750,202305,1152,3173,868,2664,226,732,189,537,415,1269
353760,202305,19583,39075,15539,33922,3005,7208,8701,18182,11706,25390
353770,202305,816,2179,451,1400,61,240,60,148,121,388
353780,202305,9104,21305,7521,18556,1298,3629,4249,9633,5547,13262
353790,202305,3635,9880,2762,8191,638,2105,605,1417,1243,3522
353800,202305,24730,58162,20647,52022,2915,7885,12683,30248,15598,38133
353810,202305,1595,3865,1147,2961,201,528,468,1137,669,1665
353820,202305,2331,5638,1660,4450,483,1292,448,1041,931,2333
353830,202305,767,1784,584,1520,82,250,305,713,387,963
353850,202305,2032,4967,1591,4212,281,780,741,1800,1022,2580
353860,202305,3678,8882,2833,7514,666,2109,1297,2878,1963,4987
353870,202305,39570,95208,29720,77296,4626,13044,14195,32889,18821,45933
353880,202305,3949,9629,3232,8333,233,740,2172,5121,2405,5861
353890,202305,4263,8081,3005,6272,217,551,2121,3937,2338,4488
353900,202305,940,2419,723,2010,97,308,307,751,404,1059
353910,202305,4184,9677,3607,8822,300,842,2635,6228,2935,7070
353920,202305,2610,6465,1917,5239,568,1733,440,891,1008,2624
353930,202305,7256,17157,5320,13622,1007,2864,2344,5232,3351,8096
353940,202305,1689,4437,1233,3541,233,728,469,1159,702,1887
353950,202305,4518,10906,3491,9087,1018,2847,1024,2339,2042,5186
353960,202305,946,2305,656,1797,156,430,122,291,278,721
353970,202305,882,1829,702,1576,61,171,530,1115,591,1286
353980,202305,23386,51533,18462,43656,782,2428,14422,31841,15204,34269
353990,202305,1263,2750,928,2212,163,435,533,1162,696,1597
354000,202305,3209,7333,1962,5026,322,887,781,1727,1103,2614
354010,202305,416,1001,317,848,59,192,186,463,245,655
354020,202305,5289,12414,4212,10449,877,2375,1862,4064,2739,6439
354025,202305,881,2260,602,1724,108,344,155,380,263,724
354030,202305,636,1371,357,901,58,152,168,378,226,530
354040,202305,977,2039,677,1602,46,136,474,1033,520,1169
354050,202305,1355,3522,960,2867,196,651,364,1014,560,1665
354060,202305,5477,13555,4132,10841,636,1921,2180,4955,2816,6876
354070,202305,5352,12392,3795,9520,644,1772,1714,3749,2358,5521
354075,202305,3719,9246,3077,8194,568,1704,1765,4246,2333,5950
354080,202305,1920,4878,1367,3847,196,581,646,1620,842,2201
354085,202305,516,966,411,836,2,7,309,576,311,583
354090,202305,2246,5538,1946,4943,107,311,1512,3637,1619,3948
354100,202305,32463,79616,24489,66584,4742,14343,11988,29994,16730,44337
354105,202305,1469,3494,1067,2801,158,482,547,1275,705,1757
354110,202305,602,1530,472,1310,76,240,218,556,294,796
354120,202305,1812,4486,1220,3269,249,712,442,1012,691,1724
354130,202305,7734,18330,5393,13962,1494,4031,1288,2771,2782,6802
354140,202305,24885,57678,18862,46967,2827,7790,9968,22028,12795,29818
354150,202305,3539,7806,2829,6759,753,1835,879,2056,1632,3891
354160,202305,3564,9206,3000,8207,701,2081,1340,3362,2041,5443
354165,202305,945,2462,763,2120,85,301,487,1211,572,1512
354170,202305,2594,6487,2081,5588,361,1099,947,2177,1308,3276
354180,202305,563,1438,443,1203,42,128,247,604,289,732
354190,202305,1949,5025,1427,4016,86,303,810,2073,896,2376
354200,202305,1147,2614,874,2178,111,324,521,1167,632,1491
354210,202305,1394,3298,1110,2836,112,321,686,1587,798,1908
354220,202305,4063,9729,3072,7930,609,1690,1342,3128,1951,4818
354230,202305,1021,2298,833,2064,45,138,616,1463,661,1601
354240,202305,2366,6033,1660,4625,316,924,640,1515,956,2439
354250,202305,811,1933,575,1541,138,365,201,502,339,867
354260,202305,11849,26933,9458,23137,1495,3947,4738,10885,6233,14832
354270,202305,1258,3336,1043,2939,158,485,524,1302,682,1787
354280,202305,1034,2297,857,2028,46,139,629,1335,675,1474
354290,202305,1257,3525,1042,3102,144,459,590,1676,734,2135
354300,202305,4248,11312,3554,10105,947,2739,1601,4347,2548,7086
354310,202305,1045,2648,906,2427,141,434,551,1364,692,1798
354320,202305,1167,2590,800,2012,136,358,381,812,517,1170
354323,202305,560,1247,369,913,51,139,185,410,236,549
354325,202305,1699,4794,1058,3286,198,625,173,450,371,1075
354330,202305,13189,29961,9767,23657,1219,3260,5860,12916,7079,16176
354340,202305,55576,126927,42334,105251,6702,18145,23705,55389,30407,73534
354350,202305,1482,3367,1212,2934,142,450,775,1647,917,2097
354360,202305,806,1774,534,1364,129,345,188,429,317,774
354370,202305,1255,3164,1044,2848,165,482,626,1602,791,2084
354380,202305,670,1657,493,1377,73,255,191,452,264,707
354390,202305,20189,44397,14634,35131,2103,5627,8278,17984,10381,23611
354400,202305,2084,6005,1610,5000,295,997,523,1504,818,2501
354410,202305,9456,21267,7471,17902,1122,3053,4371,9520,5493,12573
354420,202305,1838,4421,1324,3474,189,555,668,1544,857,2099
354425,202305,3701,8133,2744,6544,473,1174,1522,3434,1995,4608
354430,202305,2277,5261,1777,4490,154,459,1161,2690,1315,3149
354440,202305,748,1802,513,1349,64,186,263,615,327,801
354450,202305,636,1581,359,1058,46,147,125,285,171,432
354460,202305,984,2367,668,1836,184,580,180,396,364,976
354470,202305,501,1269,309,867,29,95,110,241,139,336
354480,202305,1772,3701,1224,2829,91,261,818,1717,909,1978
354490,202305,1033,2769,795,2277,174,491,350,925,524,1416
354500,202305,3039,7502,2409,6466,631,1817,841,2028,1472,3845
354510,202305,933,2387,746,2059,86,275,403,968,489,1243
354515,202305,561,1485,380,1113,69,202,122,319,191,521
354520,202305,10911,26635,8292,21544,1091,3254,4779,11100,5870,14354
354530,202305,6848,16761,5596,14551,1469,3868,2209,5386,3678,9254
354540,202305,1591,3830,1182,3131,202,588,536,1317,738,1905
354550,202305,720,1803,585,1565,79,241,302,718,381,959
354560,202305,2770,6197,1542,4000,182,468,859,2048,1041,2516
354570,202305,1129,2659,518,1453,98,283,71,174,169,457
354580,202305,11129,27747,7984,21914,1211,3743,4283,10758,5494,14501
354600,202305,2654,6553,2048,5450,349,964,1092,2734,1441,3698
354610,202305,576,1441,318,913,33,98,149,387,182,485
354620,202305,620,1626,397,1195,38,140,193,519,231,659
354625,202305,377,994,227,701,27,91,70,185,97,276
354630,202305,3295,8389,2751,7427,833,2310,798,1951,1631,4261
354640,202305,5139,12711,4043,10661,522,1625,2217,5225,2739,6850
354650,202305,1110,2635,911,2317,233,541,423,1045,656,1586
354660,202305,4414,9753,2706,7095,356,1100,1175,2731,1531,3831
354670,202305,1546,3854,1125,3041,234,690,390,896,624,1586
354680,202305,8462,19007,6872,16574,1123,2952,4118,9403,5241,12355
354690,202305,678,1896,487,1492,79,255,197,530,276,785
354700,202305,1198,2842,868,2224,106,304,488,1137,594,1441
354710,202305,601,1481,404,1113,44,127,183,441,227,568
354720,202305,381,842,198,514,69,165,54,130,123,295
354730,202305,15057,39090,12107,33724,1797,5497,7136,18638,8933,24135
354740,202305,386,991,178,527,41,124,27,59,68,183
354750,202305,3156,7535,2193,5727,334,985,971,2184,1305,3169
354760,202305,2904,6916,2178,5693,453,1304,843,1905,1296,3209
354765,202305,431,1086,210,616,21,76,70,153,91,229
354770,202305,3153,7218,2395,5881,494,1337,1116,2431,1610,3768
354780,202305,85638,187812,68179,156193,4507,12727,49901,104396,54408,117123
354790,202305,1163,2950,906,2546,80,252,554,1477,634,1729
354800,202305,3531,8364,2627,6844,596,1663,1013,2333,1609,3996
354805,202305,1837,3955,1407,3348,103,272,975,2114,1078,2386
354810,202305,676,1896,419,1376,84,318,117,334,201,652
354820,202305,1210,3235,871,2599,183,567,250,617,433,1184
354830,202305,680,1530,400,1030,88,259,148,301,236,560
354840,202305,1064,2589,655,1749,50,155,364,856,414,1011
354850,202305,30544,68506,23079,56324,1988,5973,15907,35528,17895,41501
354860,202305,1983,4917,1357,3747,189,600,580,1407,769,2007
354870,202305,93623,208881,74864,176509,5975,16572,51932,112257,57907,128829
354880,202305,8253,19160,4879,12366,635,1848,2293,4622,2928,6470
354890,202305,25222,56104,20469,48273,2637,7210,12271,26804,14908,34014
354900,202305,472,1116,314,862,81,233,103,245,184,478
354910,202305,7970,19329,5173,14474,1131,3380,1541,3691,2672,7071
354920,202305,591,1520,321,977,47,157,70,165,117,322
354925,202305,334,896,193,612,20,57,41,111,61,168
354930,202305,445,1028,310,787,34,93,169,378,203,471
354940,202305,3543,9379,2771,7760,778,2314,1080,2579,1858,4893
354950,202305,2002,4478,1693,4092,116,369,1232,2764,1348,3133
354960,202305,1062,2587,758,2090,86,301,363,884,449,1185
354970,202305,5733,14051,4626,12293,348,1191,3274,8134,3622,9325
354980,202305,47928,104695,34883,83253,4106,11524,22716,49234,26822,60758
354990,202305,106562,236525,79148,189639,5403,16032,54967,120023,60370,136055
354995,202305,4466,8404,3545,7220,169,410,2896,5662,3065,6072
355000,202305,1931,4404,1477,3727,240,714,735,1635,975,2349
355010,202305,5329,13076,3682,9784,1212,3162,888,2186,2100,5348
355020,202305,4092,10968,3275,9613,819,2715,1204,3059,2023,5774
355030,202305,1783124,4024361,1372353,3280869,193258,513522,776038,1680937,969296,2194459
355040,202305,4712,10078,3741,8798,432,1134,2734,6148,3166,7282
355050,202305,1452,3083,1071,2557,273,661,388,849,661,1510
355060,202305,9146,22300,7102,18739,1155,3465,3851,9220,5006,12685
355070,202305,14754,33150,12427,29543,1462,4075,8258,18073,9720,22148
355080,202305,1246,3250,818,2488,202,644,136,339,338,983
355090,202305,1788,4389,1463,3854,255,748,803,1895,1058,2643
355100,202305,43525,98045,37159,88704,3821,10389,26907,60878,30728,71267
355110,202305,1235,3132,907,2665,171,526,61,148,232,674
355120,202305,917,2215,653,1833,84,268,320,826,404,1094
355130,202305,1084,2166,637,1393,26,70,459,893,485,963
355140,202305,3003,5505,2608,4981,83,216,2301,4223,2384,4439
355150,202305,6580,15174,5460,13357,638,1762,3569,8213,4207,9975
355160,202305,3121,7711,2259,6257,496,1463,713,1756,1209,3219
355170,202305,16244,36814,13114,31809,2110,5751,7649,17238,9759,22989
355180,202305,3725,8501,2822,7192,602,1793,1389,3188,1991,4981
355190,202305,2420,5916,1945,5183,811,2284,469,1312,1280,3596
355200,202305,1153,3135,991,2888,281,944,352,915,633,1859
355210,202305,4188,10243,3276,8460,871,2285,1266,3030,2137,5315
355220,202305,72689,169502,60379,147548,7785,22105,36882,81293,44667,103398
355230,202305,1565,3719,869,2355,150,454,348,767,498,1221
355240,202305,32954,79593,24720,64602,2735,8082,15403,37132,18138,45214
355250,202305,55110,131454,43504,109983,9649,25668,21448,49930,31097,75598
355255,202305,807,1876,452,1249,47,136,185,439,232,575
355260,202305,2009,4270,1531,3555,119,358,1078,2292,1197,2650
355270,202305,1596,4239,1311,3723,351,1004,511,1354,862,2358
355280,202305,44127,100245,33439,81850,4183,11332,19636,44286,23819,55618
355290,202305,1203,2941,972,2579,209,550,463,1130,672,1680
355300,202305,1845,4793,1556,4285,273,831,709,1713,982,2544
355310,202305,1169,2884,886,2410,121,358,498,1276,619,1634
355320,202305,699,1731,537,1432,116,360,217,464,333,824
355330,202305,4051,9236,3245,7905,167,491,2457,5596,2624,6087
355340,202305,5303,11066,4093,9507,841,2055,1798,4277,2639,6332
355350,202305,1795,4547,1420,3874,274,862,644,1562,918,2424
355360,202305,1629,3748,1285,3235,175,491,707,1535,882,2026
355365,202305,432,988,229,655,38,107,75,179,113,286
355370,202305,7440,17109,5982,14930,1312,2986,2906,7436,4218,10422
355380,202305,3872,9361,2977,7809,580,1667,1114,2481,1694,4148
355385,202305,1773,4193,1450,3705,124,376,908,2094,1032,2470
355390,202305,993,2516,740,2015,117,339,357,839,474,1178
355395,202305,2248,6017,1625,4799,277,920,644,1634,921,2554
355400,202305,12958,33086,10712,28936,2278,6986,4784,11327,7062,18313
355410,202305,32264,80920,22779,62263,4418,13341,9290,22868,13708,36209
355420,202305,751,2196,633,1976,138,488,196,555,334,1043
355430,202305,4711,10933,3774,9338,630,1731,2110,4910,2740,6641
355440,202305,867,2154,559,1580,91,271,144,334,235,605
355450,202305,4768,11193,3397,8678,462,1315,1749,3903,2211,5218
355460,202305,591,1374,411,1085,43,131,187,454,230,585
355465,202305,559,1311,449,1143,70,180,272,674,342,854
355470,202305,1405,3322,855,2281,235,694,304,719,539,1413
355475,202305,436,944,358,842,22,62,262,578,284,640
355480,202305,5477,13874,4385,12196,670,2138,2668,7050,3338,9188
355490,202305,1115,2819,665,1937,74,246,302,772,376,1018
355495,202305,1216,2943,894,2445,118,402,426,1008,544,1410
355500,202305,9123,21184,6386,16241,857,2564,3091,6808,3948,9372
355510,202305,1784,4117,1216,3162,205,563,540,1219,745,1782
355520,202305,379,862,188,537,35,114,32,83,67,197
355530,202305,377,799,169,424,11,35,94,205,105,240
355535,202305,678,1686,544,1472,116,363,258,586,374,949
355540,202305,17909,38874,15392,35497,1515,3885,11355,25110,12870,28995
355550,202305,846,2266,734,2074,86,281,436,1113,522,1394
355560,202305,1418,3456,821,2342,176,561,35,105,211,666
355570,202305,378,922,214,590,51,152,77,190,128,342
355580,202305,1474,3386,879,2313,167,465,174,399,341,864
355590,202305,200,499,155,428,14,43,87,221,101,264
355600,202305,1696,4040,1126,3031,173,500,316,728,489,1228
355610,202305,2593,5901,1802,4564,327,875,943,2155,1270,3030
355620,202305,6538,15742,5168,13302,574,1826,3129,7176,3703,9002
355630,202305,3402,8286,2501,6630,303,856,1497,3609,1800,4465
355635,202305,1293,3378,946,2720,141,441,361,901,502,1342
355640,202305,4546,11612,3089,8903,839,2439,491,1409,1330,3848
355645,202305,4757,12223,3511,10052,545,1765,1852,4901,2397,6666
355650,202305,10669,25498,8800,22387,1723,4642,4489,10487,6212,15129
355660,202305,1671,4177,1090,3173,172,508,171,440,343,948
355670,202305,5927,14237,4408,11172,583,1776,2283,4909,2866,6685
355680,202305,3153,8308,1729,5176,454,1499,145,358,599,1857
355690,202305,921,2508,639,1989,206,654,18,35,224,689
355695,202305,317,808,204,591,19,64,37,71,56,135
355700,202305,11780,29178,10076,25910,1263,3723,6268,14747,7531,18470
355710,202305,13265,29185,9489,22421,1361,3708,5044,10198,6405,13906
355715,202305,597,1523,350,990,88,252,91,225,179,477
355720,202305,1896,4643,1504,4006,267,795,801,1935,1068,2730
355730,202305,1382,3373,1119,2953,100,302,668,1620,768,1922
410010,202305,1485,3895,1142,3201,251,725,252,619,503,1344
410020,202305,1401,3644,1037,2908,294,804,260,660,554,1464
410030,202305,2143,5185,1809,4698,270,744,948,2396,1218,3140
410040,202305,19157,47967,14450,39595,3111,9189,4683,11536,7794,20725
410045,202305,881,2253,655,1798,141,405,164,389,305,794
410050,202305,2584,6375,1922,5288,348,1081,618,1501,966,2582
410060,202305,2528,6539,2050,5716,527,1646,601,1469,1128,3115
410070,202305,2440,5735,1768,4575,333,948,667,1486,1000,2434
410080,202305,1684,4216,1216,3441,269,789,257,646,526,1435
410090,202305,1413,3104,1138,2723,268,615,391,1034,659,1649
410100,202305,2600,6835,1758,5040,275,876,119,302,394,1178
410105,202305,713,1604,481,1192,29,94,289,607,318,701
410110,202305,3974,8922,2971,7260,411,1105,1651,3633,2062,4738
410115,202305,661,1619,488,1316,61,195,183,401,244,596
410120,202305,4186,9687,3654,8889,714,1568,2252,5477,2966,7045
410130,202305,1653,3917,1467,3610,189,497,917,2163,1106,2660
410140,202305,21973,49948,15057,38194,2906,7967,5023,11288,7929,19255
410150,202305,19464,43737,11346,28852,1951,5533,3983,8499,5934,14032
410160,202305,3676,9597,3007,8436,692,2191,1074,2735,1766,4926
410165,202305,753,1935,578,1568,86,267,272,670,358,937
410170,202305,3659,8829,2252,5966,404,1121,435,966,839,2087
410180,202305,22436,56838,17743,47904,3145,9347,8536,20384,11681,29731
410185,202305,575,1530,425,1199,80,252,166,396,246,648
410190,202305,2724,6402,1941,5058,397,1073,433,934,830,2007
410200,202305,7101,15182,4075,10236,882,2340,768,1640,1650,3980
410210,202305,3767,9012,2411,6697,388,1211,760,1740,1148,2951
410220,202305,757,1858,476,1270,105,294,171,391,276,685
410230,202305,2598,6364,1926,5089,299,901,805,1774,1104,2675
410240,202305,6234,15473,4431,12226,884,2879,726,1654,1610,4533
410250,202305,2826,6385,2067,5215,259,677,922,2199,1181,2876
410260,202305,2437,5546,1596,4052,329,892,787,1783,1116,2675
410270,202305,618,1518,449,1223,61,195,191,431,252,626
410275,202305,716,1845,495,1407,91,291,187,468,278,759
410280,202305,2848,6984,1977,5384,280,866,867,2033,1147,2899
410290,202305,4004,10296,2793,7931,1035,2905,605,1659,1640,4564
410300,202305,822,1912,666,1663,81,251,338,715,419,966
410302,202305,398,941,250,688,31,94,111,282,142,376
410304,202305,1837,3984,1567,3577,182,439,939,2126,1121,2565
410305,202305,2091,4649,1513,3821,179,505,979,2319,1158,2824
410310,202305,4008,9148,3313,8006,247,803,2293,5056,2540,5859
410315,202305,853,1854,593,1461,156,399,183,418,339,817
410320,202305,1138,3038,739,2258,86,291,106,270,192,561
410322,202305,756,1939,389,1096,47,130,127,278,174,408
410330,202305,1743,4001,1251,3156,221,564,405,904,626,1468
410335,202305,1015,2545,772,2122,144,405,245,593,389,998
410337,202305,977,2300,688,1768,88,246,242,526,330,772
410340,202305,547,1434,376,1038,28,95,159,327,187,422
410345,202305,3393,8325,2213,5969,534,1485,828,1966,1362,3451
410347,202305,949,2308,716,1914,110,289,189,484,299,773
410350,202305,2016,4603,1441,3702,143,426,821,1850,964,2276
410360,202305,4788,11555,3558,9414,687,1931,1003,2463,1690,4394
410370,202305,18152,45459,12148,32020,1477,4462,5285,11489,6762,15951
410380,202305,2184,4965,1472,3729,193,542,509,1128,702,1670
410390,202305,3464,7646,2428,6032,501,1516,1009,2072,1510,3588
410395,202305,1078,2863,845,2423,191,544,294,859,485,1403
410400,202305,10186,23049,7946,19253,827,2359,5146,11216,5973,13575
410405,202305,1132,2462,784,1962,104,299,405,919,509,1218
410410,202305,2003,4720,1749,4321,134,391,1162,2820,1296,3211
410420,202305,15928,38829,12286,32198,2055,5958,5700,13135,7755,19093
410425,202305,4814,12106,3384,9339,623,1807,1216,2979,1839,4786
410430,202305,16719,38641,12024,30613,1892,5326,4780,10797,6672,16123
410440,202305,3006,7685,2609,6984,424,1277,1441,3575,1865,4852
410442,202305,3102,8347,2430,7010,663,2005,561,1520,1224,3525
410445,202305,2728,7171,1872,5547,397,1315,224,699,621,2014
410450,202305,1938,4500,1446,3781,281,756,436,1054,717,1810
410460,202305,3205,7213,2279,5668,324,896,1117,2407,1441,3303
410465,202305,3750,9861,2843,8222,649,1908,745,1818,1394,3726
410470,202305,3003,7622,2164,6235,718,2361,155,393,873,2754
410480,202305,51860,116673,30759,81726,4683,13942,9576,21342,14259,35284
410490,202305,14829,37103,11010,29657,1839,5414,5096,12115,6935,17529
410500,202305,2187,5298,1447,3928,274,741,269,554,543,1295
410510,202305,2172,5056,1564,4043,332,845,494,1230,826,2075
410520,202305,3812,10651,3410,9938,1098,3463,1299,3593,2397,7056
410530,202305,1817,4271,900,2430,119,361,254,529,373,890
410540,202305,3497,8603,2499,6763,446,1344,1086,2599,1532,3943
410550,202305,9497,23692,6733,18146,1146,3493,2111,4581,3257,8074
410560,202305,1849,4462,1367,3551,294,850,365,778,659,1628
410570,202305,3345,8225,2370,6562,858,2738,232,538,1090,3276
410580,202305,38227,89800,29229,74311,4613,13075,15064,34700,19677,47775
410590,202305,2132,5492,1439,3979,205,603,387,847,592,1450
410600,202305,2258,5424,1787,4593,370,969,708,1707,1078,2676
410610,202305,847,1997,645,1653,59,165,329,741,388,906
410620,202305,3653,8950,2656,6953,668,1882,749,1704,1417,3586
410630,202305,3056,7319,2072,5501,418,1326,443,843,861,2169
410640,202305,6360,13970,4481,10828,1031,2713,759,1756,1790,4469
410645,202305,1756,3989,1470,3647,132,371,1134,2782,1266,3153
410650,202305,3290,8190,2273,6222,482,1365,897,2195,1379,3560
410655,202305,1053,2403,697,1786,112,321,257,567,369,888
410657,202305,697,1784,468,1312,63,199,202,454,265,653
410660,202305,4612,10648,2869,7228,460,1259,1077,2331,1537,3590
410670,202305,1208,2881,740,2010,126,356,254,580,380,936
410680,202305,2937,8151,2033,6026,550,1635,468,1348,1018,2983
410685,202305,632,1545,453,1232,119,352,178,431,297,783
410690,202305,180693,409870,130435,321565,20921,58641,57493,121974,78414,180615
410700,202305,2986,7136,2475,6366,603,1649,909,2118,1512,3767
410710,202305,1101,2622,709,1903,186,546,261,584,447,1130
410712,202305,811,2048,674,1811,112,313,358,919,470,1232
410715,202305,1055,2819,679,2022,84,285,286,766,370,1051
410720,202305,4912,11252,4035,9878,576,1774,1492,3339,2068,5113
410725,202305,1428,3289,895,2368,198,572,194,417,392,989
410730,202305,1095,2587,719,1884,103,324,155,381,258,705
410740,202305,1029,2715,795,2294,58,200,434,1231,492,1431
410750,202305,2437,5445,1908,4568,309,747,864,1921,1173,2668
410752,202305,484,1118,260,708,98,254,47,111,145,365
410753,202305,424,1129,305,905,47,151,91,226,138,377
410754,202305,1403,3216,1147,2854,91,233,840,2085,931,2318
410755,202305,652,1580,482,1294,56,169,232,547,288,716
410760,202305,4449,10842,3117,8515,827,2719,724,1741,1551,4460
410765,202305,23966,59039,19180,50666,3921,11612,6640,14769,10561,26381
410770,202305,1233,2779,859,2180,97,223,409,1015,506,1238
410773,202305,1617,3865,1368,3465,301,820,711,1634,1012,2454
410775,202305,2062,4207,1825,3901,42,107,1446,2919,1488,3026
410780,202305,720,1704,510,1330,90,251,166,388,256,639
410785,202305,994,2208,715,1778,108,318,325,740,433,1058
410790,202305,1381,3732,1130,3285,231,754,183,429,414,1183
410800,202305,4240,8415,3437,7304,67,202,2403,4793,2470,4995
410810,202305,551,1370,406,1118,46,143,193,469,239,612
410820,202305,1221,3182,688,1903,146,423,139,288,285,711
410830,202305,58620,127054,42725,101547,6792,18357,21774,46432,28566,64789
410832,202305,1346,3284,1097,2871,109,323,672,1600,781,1923
410840,202305,11418,26808,6655,17957,1506,4283,1502,3140,3008,7423
410845,202305,1482,3137,1200,2752,126,342,775,1626,901,1968
410850,202305,2623,6698,2251,6066,455,1375,1039,2566,1494,3941
410855,202305,858,2020,540,1413,68,214,248,526,316,740
410860,202305,6084,13046,4865,11121,199,640,3533,7348,3732,7988
410865,202305,1757,4516,1489,4061,224,655,805,2233,1029,2888
410870,202305,1434,3556,1134,3046,155,451,594,1503,749,1954
410880,202305,5892,14558,4013,11260,692,1949,598,1782,1290,3731
410890,202305,1457,3630,1189,3152,232,593,574,1422,806,2015
410895,202305,1195,3477,992,3039,334,1138,239,609,573,1747
410900,202305,1038,2624,692,2003,109,328,132,273,241,601
410910,202305,536,1169,340,827,16,45,190,408,206,453
410920,202305,1145,2507,876,2103,89,251,500,1116,589,1367
410930,202305,2132,5079,1486,4030,362,1104,234,518,596,1622
410940,202305,31769,78678,23725,64779,4878,15086,9590,23481,14468,38567
410950,202305,2431,6124,2172,5716,222,556,1606,4127,1828,4683
410960,202305,10963,24321,7873,19523,2346,6612,2730,5979,5076,12591
410965,202305,1354,3280,843,2322,124,380,344,842,468,1222
410970,202305,5296,13268,3795,10380,947,3083,683,1395,1630,4478
410975,202305,1829,4067,1312,3235,224,594,546,1230,770,1824
410980,202305,9588,21987,6346,16400,695,2053,3193,7235,3888,9288
410990,202305,1857,4009,1298,3203,233,658,634,1454,867,2112
411000,202305,840,2173,602,1744,102,321,188,476,290,797
411005,202305,568,1333,363,951,47,126,138,300,185,426
411007,202305,3112,7581,2314,6249,466,1407,802,1860,1268,3267
411010,202305,5861,15383,4366,12501,1172,3535,871,2026,2043,5561
411020,202305,2855,7348,2372,6586,644,1906,701,1826,1345,3732
411030,202305,852,2011,605,1546,70,199,258,564,328,763
411040,202305,1259,2992,679,1809,126,344,188,413,314,757
411050,202305,2443,7050,1931,6047,407,1401,311,766,718,2167
411060,202305,2840,6950,1892,5122,339,981,648,1419,987,2400
411065,202305,476,1146,279,765,31,97,102,254,133,351
411070,202305,9843,22420,7842,19247,1232,3452,4127,9145,5359,12597
411080,202305,2537,6129,2019,5264,497,1487,632,1436,1129,2923
411090,202305,956,2473,582,1719,85,297,140,332,225,629
411095,202305,2938,6615,1752,4609,258,679,270,568,528,1247
411100,202305,1477,3571,999,2717,149,507,359,867,508,1374
411110,202305,761,1914,367,1089,34,97,32,55,66,152
411120,202305,2136,5100,1698,4388,275,869,840,1893,1115,2762
411125,202305,6805,17833,5956,16405,1767,5130,2077,5562,3844,10692
411130,202305,908,2247,626,1715,165,440,177,495,342,935
411140,202305,2607,7447,2090,6373,531,1701,538,1635,1069,3336
411150,202305,4955,11675,3324,8563,705,1935,316,616,1021,2551
411155,202305,1345,3055,942,2354,133,387,485,991,618,1378
411160,202305,481,1036,313,780,46,130,81,201,127,331
411170,202305,1001,2616,736,2100,147,464,324,856,471,1320
411180,202305,6878,15973,5612,13842,812,2311,3131,6911,3943,9222
411190,202305,2708,6487,2093,5426,280,816,968,2183,1248,2999
411200,202305,6258,15408,4882,13009,986,3071,1677,3589,2663,6660
411210,202305,4428,9428,3209,7406,390,1074,1549,3132,1939,4206
411220,202305,1214,2805,839,2164,154,430,321,726,475,1156
411230,202305,1019,2541,759,2064,161,458,221,536,382,994
411240,202305,1878,4158,1369,3355,275,733,475,1041,750,1774
411250,202305,2787,6774,2030,5495,471,1400,531,1234,1002,2634
411260,202305,396,955,259,696,43,142,113,258,156,400
411270,202305,2427,6018,1812,4882,271,795,855,2016,1126,2811
411275,202305,2018,4135,1473,3304,156,441,913,1801,1069,2242
411280,202305,1862,4635,1364,3725,309,904,456,1071,765,1975
411290,202305,1010,2446,678,1810,78,254,349,851,427,1105
411295,202305,1587,3780,1174,3056,222,586,491,1149,713,1735
411300,202305,1194,2884,748,2047,86,259,260,548,346,807
411310,202305,1171,2418,923,2079,168,421,495,1009,663,1430
411320,202305,7250,16621,5539,13721,837,2322,2779,5936,3616,8258
411325,202305,1862,4636,1524,4042,268,731,855,2279,1123,3010
411330,202305,3892,9656,2949,8103,756,2342,855,2126,1611,4468
411340,202305,982,2507,587,1691,89,267,175,431,264,698
411342,202305,1256,2907,678,1777,142,418,242,513,384,931
411345,202305,1468,3416,1086,2761,67,185,735,1798,802,1983
411350,202305,3701,9288,2441,6850,613,1877,316,736,929,2613
411360,202305,925,2096,665,1671,98,293,290,619,388,912
411370,202305,73899,170269,55097,139695,4650,13995,32492,74076,37142,88071
411373,202305,1708,3958,1364,3445,210,583,557,1359,767,1942
411375,202305,1335,3124,903,2353,139,356,294,661,433,1017
411380,202305,1402,3018,955,2199,41,113,623,1279,664,1392
411390,202305,1896,4675,1471,3821,239,715,607,1288,846,2003
411400,202305,2916,6571,2212,5383,256,718,1210,2639,1466,3357
411410,202305,3732,9799,2799,7911,714,2175,657,1576,1371,3751
411420,202305,5121,11861,2769,7647,407,1260,499,956,906,2216
411430,202305,5145,12212,3922,10062,769,2226,1421,3039,2190,5265
411435,202305,532,1332,297,849,45,134,54,116,99,250
411440,202305,3293,8178,2506,6756,614,1752,707,1652,1321,3404
411450,202305,3051,7527,2404,6460,380,1012,1302,3476,1682,4488
411460,202305,5581,13565,3688,10141,536,1739,990,2183,1526,3922
411470,202305,1111,2511,870,2119,81,271,536,1164,617,1435
411480,202305,6953,16895,4967,13270,973,3018,1517,3425,2490,6443
411490,202305,2079,4808,1620,4143,198,604,812,1861,1010,2465
411500,202305,1676,4141,1207,3214,221,664,293,588,514,1252
411510,202305,2784,6292,2139,5267,358,1045,588,1357,946,2402
411520,202305,46016,105471,27894,71205,3406,10208,12662,27542,16068,37750
411530,202305,1125,2703,625,1777,92,281,122,305,214,586
411535,202305,634,1762,422,1311,45,147,122,329,167,476
411540,202305,3250,7268,2337,5686,174,463,1421,3245,1595,3708
411545,202305,1048,2801,896,2522,80,247,572,1570,652,1817
411550,202305,850,1965,641,1594,111,294,222,480,333,774
411560,202305,2346,6166,1285,3864,192,605,93,206,285,811
411570,202305,9543,20597,6872,16678,1584,4205,2363,5198,3947,9403
411573,202305,938,2322,766,2027,105,351,432,1010,537,1361
411575,202305,2510,6135,1852,4965,347,1003,614,1490,961,2493
411580,202305,5349,12375,3265,8947,450,1371,537,1073,987,2444
411585,202305,710,2010,373,1195,52,159,40,106,92,265
411590,202305,589,1448,434,1154,46,143,237,557,283,700
411600,202305,421,969,278,743,45,116,112,250,157,366
411605,202305,1944,4166,1278,3179,157,455,600,1491,757,1946
411610,202305,3582,7248,2618,5669,67,214,2000,3941,2067,4155
411620,202305,3739,8705,3049,7667,623,1607,1358,3403,1981,5010
411630,202305,1076,2543,711,1886,105,351,315,704,420,1055
411640,202305,559,1403,376,1020,49,139,132,294,181,433
411650,202305,241,643,160,481,28,85,48,115,76,200
411660,202305,1043,2512,729,1931,110,308,249,549,359,857
411670,202305,1877,4132,1275,3115,135,348,724,1597,859,1945
411680,202305,1690,4160,1248,3346,239,686,442,1044,681,1730
411690,202305,4996,11678,3698,9535,783,2078,1223,3032,2006,5110
411695,202305,787,2172,548,1595,41,129,250,666,291,795
411700,202305,1979,4790,1368,3666,325,910,333,789,658,1699
411705,202305,3078,7568,2566,6729,418,1183,1573,4042,1991,5225
411710,202305,2581,6104,1839,4784,373,1036,589,1301,962,2337
411720,202305,1255,2938,879,2275,126,317,292,680,418,997
411721,202305,1192,2820,868,2241,168,442,257,591,425,1033
411722,202305,1207,3180,724,2098,120,364,257,615,377,979
411725,202305,1561,4161,1024,3119,262,905,218,573,480,1478
411727,202305,1766,4565,1155,3336,231,701,137,236,368,937
411729,202305,724,1757,420,1195,89,300,91,180,180,480
411730,202305,6817,16360,5225,13434,1187,3423,2025,4785,3212,8208
411740,202305,570,1411,324,931,83,221,62,150,145,371
411745,202305,959,2564,668,1957,101,319,136,317,237,636
411750,202305,8285,19807,6211,16087,859,2434,3044,7342,3903,9776
411760,202305,9314,22038,7032,18499,2256,6230,1458,3837,3714,10067
411770,202305,3878,10372,2931,8446,660,2027,644,1605,1304,3632
411780,202305,3161,8185,2623,7284,726,2099,719,2082,1445,4181
411790,202305,3953,8814,2537,6425,361,1038,1031,2176,1392,3214
411800,202305,1413,3813,1058,3001,209,647,275,629,484,1276
411810,202305,1877,4526,1376,3591,239,638,501,1154,740,1792
411820,202305,22048,51989,18871,46951,4395,11208,10011,23994,14406,35202
411830,202305,573,1398,393,1056,65,176,73,163,138,339
411840,202305,15940,38693,11224,29690,1764,5113,4305,9700,6069,14813
411845,202305,783,2068,486,1438,89,281,109,263,198,544
411850,202305,10059,23964,7124,19063,1963,5720,1200,2474,3163,8194
411860,202305,932,2418,695,1951,150,414,135,349,285,763
411870,202305,719,1899,533,1532,138,463,106,213,244,676
411880,202305,2949,6452,2119,5170,381,983,924,2033,1305,3016
411885,202305,1274,3171,920,2549,133,407,235,535,368,942
411890,202305,1815,4538,1363,3782,238,710,169,444,407,1154
411900,202305,1047,2668,644,1854,182,539,65,173,247,712
411910,202305,1405,3837,1000,3026,194,690,335,866,529,1556
411915,202305,20547,46991,14722,36629,2237,6190,6584,14251,8821,20441
411920,202305,1465,3810,1209,3386,310,984,454,1118,764,2102
411925,202305,600,1462,410,1109,99,263,182,452,281,715
411930,202305,6362,17121,5415,15527,2732,8195,580,1791,3312,9986
411940,202305,4080,10732,3245,9138,789,2298,1139,2821,1928,5119
411950,202305,19983,48315,16886,43451,2059,6206,10668,25491,12727,31697
411960,202305,7322,17775,5802,15071,1167,3345,2273,5148,3440,8493
411965,202305,636,1617,441,1224,76,214,189,459,265,673
411970,202305,1436,2918,1117,2505,229,435,503,1310,732,1745
411980,202305,2062,4429,1542,3662,354,821,653,1478,1007,2299
411990,202305,50020,120313,34703,93864,6441,19174,14534,35441,20975,54615
411995,202305,6384,14213,4919,12041,1429,3936,1474,3279,2903,7215
412000,202305,2442,5052,1793,3991,44,132,1389,2834,1433,2966
412010,202305,757,2089,496,1517,56,199,133,302,189,501
412015,202305,606,1589,491,1375,104,314,226,618,330,932
412020,202305,562,1496,354,1076,53,175,109,289,162,464
412030,202305,768,1996,599,1705,105,278,265,707,370,985
412033,202305,1121,2747,791,2148,90,252,336,804,426,1056
412035,202305,848,2158,536,1587,116,346,213,588,329,934
412040,202305,861,2133,569,1569,93,265,176,382,269,647
412050,202305,1735,4118,1207,3212,337,1017,201,485,538,1502
412060,202305,8896,23150,7212,19958,1979,6277,1956,4745,3935,11022
412065,202305,745,1863,524,1447,94,290,141,333,235,623
412070,202305,1648,3843,1270,3179,135,400,627,1307,762,1707
412080,202305,3422,8095,2586,6567,319,913,1418,3070,1737,3983
412085,202305,403,976,177,534,21,76,47,113,68,189
412090,202305,8015,18417,5923,15014,1297,3685,2582,6192,3879,9877
412100,202305,2312,5681,1654,4591,493,1512,335,944,828,2456
412110,202305,1153,2866,688,1955,82,236,188,438,270,674
412120,202305,2875,7305,2257,6265,493,1529,667,1592,1160,3121
412125,202305,966,2544,591,1748,90,251,142,388,232,639
412130,202305,949,2239,629,1678,134,369,133,321,267,690
412135,202305,649,1651,340,995,41,136,142,354,183,490
412140,202305,2455,5608,1764,4445,317,849,423,1010,740,1859
412150,202305,3332,7879,2807,6991,625,1688,1335,2909,1960,4597
412160,202305,1135,3327,548,1760,43,149,37,65,80,214
412170,202305,5724,13897,4791,12482,953,2698,2304,5350,3257,8048
412175,202305,1594,4235,1314,3727,305,908,436,1168,741,2076
412180,202305,2067,5315,1535,4349,246,789,559,1415,805,2204
412190,202305,3831,9155,2727,7210,339,1019,1128,2692,1467,3711
412200,202305,2397,6328,1599,4561,438,1360,292,724,730,2084
412210,202305,785,1787,515,1355,70,213,241,570,311,783
412215,202305,4064,10015,2866,7750,612,1777,1231,3268,1843,5045
412217,202305,1241,2857,1021,2485,13,50,790,1768,803,1818
412220,202305,7563,20302,6062,17575,1414,4137,1465,4031,2879,8168
412230,202305,3453,9124,2664,7718,411,1387,572,1360,983,2747
412240,202305,10090,24696,6819,18651,1280,3865,2172,4960,3452,8825
412250,202305,2344,5672,1691,4478,424,1193,304,635,728,1828
412260,202305,1656,3946,1264,3213,221,575,428,957,649,1532
412265,202305,1290,3036,1012,2591,130,373,628,1491,758,1864
412270,202305,1356,3484,934,2628,117,381,401,957,518,1338
412280,202305,520,1350,394,1128,91,248,82,213,173,461
412290,202305,1287,2980,975,2475,168,451,379,887,547,1338
412300,202305,2264,5313,1688,4390,324,906,546,1220,870,2126
412310,202305,773,2128,559,1695,99,346,157,406,256,752
412320,202305,874,2123,537,1465,54,195,181,445,235,640
412330,202305,1949,4768,1293,3593,245,740,331,843,576,1583
412340,202305,1508,3792,1044,2924,156,474,124,318,280,792
412350,202305,3769,9474,2546,7116,450,1424,720,1675,1170,3099
412360,202305,352,835,266,687,6,21,194,469,200,490
412370,202305,1467,3609,983,2723,195,566,224,564,419,1130
412380,202305,1800,4685,1310,3750,325,1026,80,227,405,1253
412382,202305,609,1424,414,1116,44,150,213,469,257,619
412385,202305,2873,6842,2293,5816,694,1750,764,2000,1458,3750
412390,202305,3022,6899,2351,5821,441,1157,704,1627,1145,2784
412395,202305,926,2303,670,1790,92,248,335,828,427,1076
412400,202305,1143,2752,815,2157,142,398,264,593,406,991
412402,202305,2986,6857,2086,5429,455,1177,641,1616,1096,2793
412405,202305,3693,9362,2495,7207,720,2069,416,1098,1136,3167
412410,202305,8110,19712,6060,16496,1136,3561,2015,4947,3151,8508
412420,202305,638,1499,409,1063,44,123,161,369,205,492
412430,202305,635,1542,358,992,59,158,128,335,187,493
412440,202305,3654,8807,2636,7105,588,1638,784,2016,1372,3654
412450,202305,657,1781,436,1288,51,157,50,96,101,253
412460,202305,1444,3277,1110,2743,213,580,474,1100,687,1680
412470,202305,1931,5440,1611,4794,395,1315,451,1176,846,2491
412480,202305,1747,3999,1189,2935,210,574,468,994,678,1568
412490,202305,1609,3637,1247,3050,80,234,745,1625,825,1859
412500,202305,2503,5831,1865,4728,316,875,616,1328,932,2203
412510,202305,2283,6375,1643,4907,420,1369,248,543,668,1912
412520,202305,1691,4054,1080,2894,196,524,144,334,340,858
412530,202305,858,2156,602,1676,119,319,134,328,253,647
412535,202305,964,2430,583,1668,97,305,69,127,166,432
412540,202305,1240,3088,849,2406,163,571,152,354,315,925
412545,202305,858,2084,588,1575,107,310,205,507,312,817
412550,202305,47501,115164,35689,93311,5187,15089,17291,39871,22478,54960
412555,202305,351,845,236,619,27,95,75,137,102,232
412560,202305,6753,17318,5048,13792,1278,3899,930,2098,2208,5997
412570,202305,5484,12657,3376,8894,601,1801,736,1529,1337,3330
412575,202305,1419,3207,1133,2748,334,784,470,1055,804,1839
412580,202305,1939,4473,1390,3543,137,384,763,1719,900,2103
412590,202305,550,1379,308,877,65,197,41,86,106,283
412600,202305,2114,4904,1697,4171,101,327,1130,2512,1231,2839
412610,202305,1014,2549,738,1993,112,301,302,701,414,1002
412620,202305,1597,3772,1277,3291,251,689,562,1317,813,2006
412625,202305,11881,29482,8249,22762,1661,4977,1450,3254,3111,8231
412627,202305,1351,3543,975,2822,250,821,211,537,461,1358
412630,202305,3278,9015,2337,7087,396,1309,524,1357,920,2666
412635,202305,593,1450,374,1058,59,174,111,252,170,426
412640,202305,1188,3000,695,1973,101,285,123,264,224,549
412650,202305,2049,5196,1638,4411,273,826,637,1509,910,2335
412660,202305,3513,8178,2514,6369,308,879,1003,2201,1311,3080
412665,202305,523,1222,396,1012,76,206,152,358,228,564
412667,202305,2045,5107,1479,4033,251,792,567,1414,818,2206
412670,202305,1155,2477,807,1942,135,394,357,718,492,1112
412680,202305,2628,6498,1804,5050,228,750,519,1162,747,1912
412690,202305,1407,3340,984,2566,187,548,354,767,541,1315
412700,202305,2147,5283,1816,4735,413,1167,808,1920,1221,3087
412710,202305,6599,17541,4959,14335,857,2712,1340,3053,2197,5765
412720,202305,1647,4370,1343,3792,223,671,387,838,610,1509
412730,202305,3394,8105,2586,6653,401,1218,1205,2682,1606,3900
412740,202305,2462,6391,1715,5015,312,1025,302,800,614,1825
412750,202305,4820,11873,3894,10423,552,1666,2103,5149,2655,6815
412760,202305,3954,9526,3284,8451,644,1887,1741,4127,2385,6014
412770,202305,15095,37116,8822,25453,1144,3618,2167,5104,3311,8722
412780,202305,1566,3750,1136,3007,282,836,341,740,623,1576
412785,202305,2706,5798,1921,4571,285,735,1219,2706,1504,3441
412788,202305,1722,4483,1389,3927,393,1147,488,1256,881,2403
412790,202305,1685,4086,1119,3070,196,624,448,1006,644,1630
412795,202305,1479,3554,863,2435,164,455,201,522,365,977
412796,202305,2688,7178,2290,6520,543,1642,659,1669,1202,3311
412800,202305,5235,11323,3884,9061,386,1149,2216,4408,2602,5557
412810,202305,16877,39665,11662,29951,1369,4008,5261,11611,6630,15619
412820,202305,7731,19782,5563,15651,1477,4430,1409,3708,2886,8138
412830,202305,415,1102,326,931,40,105,98,248,138,353
412840,202305,2465,5202,1803,4041,156,445,1176,2299,1332,2744
412850,202305,3361,8089,2549,6822,302,975,1317,3093,1619,4068
412853,202305,1969,4357,1665,3901,219,606,971,1977,1190,2583
412855,202305,1658,4011,878,2428,114,341,198,419,312,760
412860,202305,944,2209,615,1680,111,331,250,588,361,919
412862,202305,779,1881,525,1452,103,288,220,546,323,834
412863,202305,1596,4264,1398,3903,290,932,684,1686,974,2618
412865,202305,777,2014,589,1639,142,418,122,300,264,718
412870,202305,1195,2852,877,2353,273,816,222,553,495,1369
412880,202305,1176,2987,834,2405,179,536,285,752,464,1288
420005,202305,563,1549,331,995,42,130,156,446,198,576
420010,202305,3674,8449,2582,6621,172,487,1884,4753,2056,5240
420020,202305,515,1513,389,1209,81,280,120,292,201,572
420030,202305,161,530,116,415,36,137,25,77,61,214
420040,202305,722,2102,449,1492,76,284,32,75,108,359
420050,202305,963,2275,670,1677,122,335,382,829,504,1164
420055,202305,220,602,134,405,20,67,57,152,77,219
420060,202305,277,722,218,594,32,93,113,280,145,373
420070,202305,1092,2980,872,2544,173,567,469,1271,642,1838
420075,202305,96,255,54,155,7,19,23,52,30,71
420080,202305,522,1443,368,1074,72,221,82,194,154,415
420090,202305,559,1601,365,1164,84,294,90,214,174,508
420100,202305,1827,4101,1498,3577,107,249,1101,2605,1208,2854
420110,202305,379,1115,312,964,50,172,153,441,203,613
420120,202305,837,2183,598,1694,80,246,277,688,357,934
420125,202305,469,1355,310,970,60,198,91,228,151,426
420127,202305,394,1036,190,577,23,79,74,212,97,291
420130,202305,6513,16910,4977,14223,1038,3408,1990,4767,3028,8175
420140,202305,6128,15218,4812,12988,1330,4052,1291,3000,2621,7052
420150,202305,865,2164,687,1878,63,202,381,982,444,1184
420160,202305,258,622,123,347,19,61,44,110,63,171
420165,202305,218,627,142,443,21,78,41,96,62,174
420170,202305,448,1245,364,1054,38,130,208,531,246,661
420180,202305,177,546,101,364,21,92,26,82,47,174
420190,202305,257,714,163,489,29,88,45,125,74,213
420195,202305,2621,6334,2073,5456,428,1316,1085,2579,1513,3895
420200,202305,10601,23567,7102,17333,925,2554,3420,6928,4345,9482
420205,202305,2794,6853,1962,5255,274,809,1008,2485,1282,3294
420207,202305,2925,6973,1966,5242,394,1178,799,1849,1193,3027
420208,202305,449,1212,286,892,98,324,64,143,162,467
420209,202305,224,662,138,419,21,79,70,178,91,257
420210,202305,5976,14395,4431,11705,714,2129,2316,5594,3030,7723
420213,202305,984,2726,801,2331,164,515,298,825,462,1340
420215,202305,299,822,219,647,54,165,65,178,119,343
420220,202305,443,1258,309,981,51,189,123,323,174,512
420230,202305,8186,19944,6473,16833,857,2532,3677,8643,4534,11175
420240,202305,20743,53971,14238,39527,1880,6016,6508,14996,8388,21012
420243,202305,630,1467,506,1249,85,226,318,757,403,983
420245,202305,2744,6410,2137,5383,209,626,1338,3065,1547,3691
420250,202305,880,1921,782,1792,49,158,632,1365,681,1523
420253,202305,559,1304,416,1087,52,139,250,630,302,769
420257,202305,212,519,150,412,31,109,73,188,104,297
420260,202305,1585,3699,1213,3202,99,314,895,2289,994,2603
420270,202305,765,1913,382,1003,45,123,175,408,220,531
420280,202305,2037,5375,1629,4528,233,762,775,1930,1008,2692
420285,202305,195,539,110,332,20,64,24,51,44,115
420287,202305,574,1253,410,1024,69,193,194,449,263,642
420290,202305,7381,19204,6007,16391,903,2876,3486,8509,4389,11385
420300,202305,10290,27266,6185,17911,1192,3650,1944,4801,3136,8451
420310,202305,929,2054,586,1477,57,167,268,606,325,773
420315,202305,1158,3001,768,2237,96,310,385,1019,481,1329
420320,202305,8750,22027,6746,18890,1931,5810,1974,5120,3905,10930
420325,202305,415,1145,308,927,44,154,112,274,156,428
420330,202305,1380,3800,902,2759,174,559,255,701,429,1260
420340,202305,1648,3843,1279,3199,289,790,564,1216,853,2006
420350,202305,1769,3908,1399,3294,148,368,985,2239,1133,2607
420360,202305,3755,9885,2156,6524,366,1194,205,539,571,1733
420370,202305,1827,4336,1517,3815,113,372,1127,2641,1240,3013
420380,202305,5762,14223,4140,11173,776,2389,1881,4552,2657,6941
420390,202305,1437,3507,1048,2754,185,516,344,627,529,1143
420395,202305,1697,4421,1239,3585,188,605,243,517,431,1122
420400,202305,1530,3802,1118,3032,141,434,633,1582,774,2016
420410,202305,756,1867,556,1468,80,224,305,777,385,1001
420415,202305,444,1177,323,905,62,206,149,381,211,587
420417,202305,780,2178,599,1779,138,389,263,818,401,1207
420419,202305,162,525,123,423,42,155,10,40,52,195
420420,202305,20275,49736,14240,38446,3752,11409,4557,10511,8309,21920
420425,202305,804,2127,579,1660,60,195,287,765,347,960
420430,202305,4407,11069,2940,8106,478,1529,1263,2956,1741,4485
420435,202305,452,1127,278,817,63,188,138,389,201,577
420440,202305,1052,2596,723,1903,249,613,207,521,456,1134
420445,202305,283,668,184,488,33,97,54,104,87,201
420450,202305,1130,3093,864,2539,165,559,346,856,511,1415
420455,202305,2707,6084,2035,5077,561,1385,751,1906,1312,3291
420460,202305,13153,32158,10425,27334,1502,4587,5861,13941,7363,18528
420470,202305,868,2205,488,1326,86,275,157,330,243,605
420475,202305,89,231,40,127,6,24,14,41,20,65
420480,202305,7255,17085,4940,13168,950,2689,2068,5220,3018,7909
420490,202305,504,1353,353,1001,54,175,160,410,214,585
420500,202305,1709,4387,1172,3432,222,784,537,1386,759,2170
420510,202305,162,458,116,353,20,73,38,81,58,154
420515,202305,174,495,131,394,21,75,42,95,63,170
420517,202305,916,2171,773,1918,101,266,462,1097,563,1363
420519,202305,372,956,273,796,38,117,127,359,165,476
420520,202305,347,901,191,613,27,99,5,9,32,108
420530,202305,946,2795,671,2161,128,476,209,547,337,1023
420535,202305,276,768,108,345,13,44,28,66,41,110
420540,202305,54733,123541,39793,98646,5496,15969,17569,36487,23065,52456
420543,202305,317,864,234,680,33,112,94,236,127,348
420545,202305,2068,5887,1586,4811,308,1038,644,1710,952,2748
420550,202305,5602,13541,3687,10085,647,1902,1499,3749,2146,5651
420555,202305,425,1154,298,893,38,140,154,403,192,543
420560,202305,548,1191,399,995,61,162,219,537,280,699
420570,202305,4176,9818,3197,8129,528,1519,1722,4015,2250,5534
420580,202305,2267,6091,1617,4933,392,1317,461,1281,853,2598
420590,202305,4175,10733,2781,7798,473,1506,841,1866,1314,3372
420600,202305,1810,4534,1500,3986,128,465,1006,2453,1134,2918
420610,202305,780,2001,536,1517,111,304,247,664,358,968
420620,202305,1091,2686,791,2192,137,404,305,777,442,1181
420630,202305,1448,4116,1036,3133,174,589,453,1228,627,1817
420640,202305,600,1601,311,978,64,203,14,27,78,230
420650,202305,4769,11680,3334,8868,492,1482,1478,3245,1970,4727
420660,202305,575,1411,356,957,59,159,64,140,123,299
420665,202305,917,2227,632,1725,129,404,253,552,382,956
420670,202305,1535,4204,919,2856,102,377,179,408,281,785
420675,202305,276,687,179,526,16,60,109,292,125,352
420680,202305,334,741,200,552,20,80,116,278,136,358
420690,202305,1231,3335,836,2433,131,392,288,686,419,1078
420700,202305,4258,10477,3371,8939,272,836,2321,5797,2593,6633
420710,202305,1481,3977,1245,3487,170,576,703,1679,873,2255
420720,202305,1720,4344,1336,3658,207,650,796,1994,1003,2644
420730,202305,4872,11821,3859,10132,703,2108,1863,4386,2566,6494
420740,202305,520,1454,319,991,76,268,83,231,159,499
420750,202305,2910,7975,2042,6020,356,1252,770,1952,1126,3204
420757,202305,146,375,74,238,9,26,33,103,42,129
420760,202305,464,1282,254,739,47,135,79,187,126,322
420765,202305,772,2070,397,1188,67,227,192,532,259,759
420768,202305,1799,4540,1497,3985,199,521,1040,2740,1239,3261
420770,202305,287,835,136,477,14,58,19,33,33,91
420775,202305,374,958,233,697,42,132,86,233,128,365
420780,202305,1258,3360,796,2314,157,453,132,340,289,793
420785,202305,288,708,208,539,13,40,102,204,115,244
420790,202305,1438,3826,1135,3197,228,810,640,1545,868,2355
420800,202305,981,2252,656,1678,181,481,314,742,495,1223
420810,202305,1869,5170,1545,4549,381,1313,702,1777,1083,3090
420820,202305,18740,44774,14432,37840,2089,6139,7647,18374,9736,24513
420830,202305,6769,16486,5132,13644,987,2953,2169,5280,3156,8233
420840,202305,767,2305,427,1450,70,275,43,118,113,393
420845,202305,3949,9529,2833,7645,543,1755,1246,3057,1789,4812
420850,202305,1322,3812,963,2935,183,630,328,784,511,1414
420860,202305,469,1214,301,902,91,289,80,197,171,486
420870,202305,1011,2692,710,2081,145,465,239,630,384,1095
420880,202305,1574,4368,1279,3810,296,1000,515,1345,811,2345
420890,202305,10210,26393,6607,19065,1019,3238,2218,5399,3237,8637
420895,202305,248,691,158,472,22,69,74,200,96,269
420900,202305,2225,5218,1330,3656,174,589,582,1313,756,1902
420910,202305,47035,116372,34256,93623,5448,17092,15630,36561,21078,53653
420915,202305,578,1967,472,1705,85,336,218,768,303,1104
420917,202305,608,1476,296,751,44,91,163,407,207,498
420920,202305,113,297,48,150,8,31,6,11,14,42
420930,202305,24175,56241,18375,46441,2564,7524,10310,23400,12874,30924
420940,202305,4863,11264,3303,8673,697,2112,1027,2044,1724,4156
420945,202305,260,786,145,451,21,81,61,161,82,242
420950,202305,530,1404,356,1030,62,200,108,264,170,464
420960,202305,1403,3290,1028,2686,174,515,442,996,616,1511
420970,202305,2855,7285,1972,5668,410,1214,588,1714,998,2928
420980,202305,311,1020,252,875,81,302,41,119,122,421
420985,202305,473,1241,274,844,54,178,69,172,123,350
420990,202305,474,1353,308,967,55,178,66,161,121,339
421000,202305,738,2138,505,1607,116,383,96,231,212,614
421003,202305,529,1277,187,543,18,48,16,36,34,84
421005,202305,137,393,99,303,16,54,38,118,54,172
421010,202305,5002,12308,3689,9954,633,2048,1532,3319,2165,5367
421020,202305,501,1495,407,1295,61,232,211,610,272,842
421030,202305,1347,3525,1043,2919,215,669,399,1002,614,1671
421040,202305,848,2008,520,1450,61,191,313,809,374,1000
421050,202305,1573,4091,1062,2919,193,587,370,788,563,1375
421055,202305,180,509,123,378,19,68,56,149,75,217
421060,202305,945,2535,684,1976,129,423,301,744,430,1167
421070,202305,863,2360,538,1579,104,326,237,608,341,934
421080,202305,647,1761,510,1500,86,304,212,544,298,848
421085,202305,395,1091,187,611,19,61,31,76,50,137
421090,202305,377,949,229,626,15,54,101,225,116,279
421100,202305,1095,2337,526,1434,79,232,119,277,198,509
421105,202305,2003,5033,1468,4030,313,914,548,1393,861,2307
421110,202305,1666,3955,1409,3587,138,431,933,2283,1071,2714
421120,202305,1431,4046,1049,3231,142,496,362,930,504,1426
421125,202305,508,1225,370,932,86,231,151,338,237,569
421130,202305,8842,23029,7497,20480,1422,4318,3960,9973,5382,14291
421140,202305,437,1139,303,874,80,225,105,280,185,505
421145,202305,459,1226,343,987,105,317,85,199,190,516
421150,202305,983,2635,696,2011,126,410,284,677,410,1087
421160,202305,858,2215,688,1875,87,282,429,1042,516,1324
421165,202305,296,829,186,545,30,89,56,127,86,216
421170,202305,1562,3853,1370,3565,119,324,1018,2611,1137,2935
421175,202305,1386,3469,854,2529,182,597,334,908,516,1505
421180,202305,506,1235,302,833,38,125,151,339,189,464
421185,202305,398,967,289,759,50,140,132,285,182,425
421187,202305,305,933,193,653,39,118,63,218,102,336
421189,202305,524,1387,393,1140,68,227,153,376,221,603
421190,202305,19503,48782,15014,40161,2591,7898,7137,16781,9728,24679
421200,202305,1037,2617,796,2151,103,339,451,1136,554,1475
421205,202305,317,805,249,688,56,150,102,278,158,428
421210,202305,1388,3357,797,2303,195,544,233,620,428,1164
421220,202305,1780,4820,1411,4091,361,1133,454,1177,815,2310
421223,202305,533,1287,371,1003,66,208,205,508,271,716
421225,202305,1413,3681,1242,3411,136,462,861,2269,997,2731
421227,202305,886,2357,596,1758,128,406,235,666,363,1072
421230,202305,810,2056,587,1652,115,371,241,625,356,996
421240,202305,348,976,169,564,23,109,48,114,71,223
421250,202305,3483,8317,2664,6980,420,1124,1608,4003,2028,5127
421260,202305,337,1037,98,308,18,61,11,25,29,86
421265,202305,1273,2817,1087,2567,97,214,868,2029,965,2243
421270,202305,474,1228,251,795,63,213,86,261,149,474
421280,202305,3606,8768,2812,7475,463,1411,1459,3539,1922,4950
421290,202305,1427,3708,733,2063,120,344,124,285,244,629
421300,202305,422,1115,220,681,33,112,36,95,69,207
421310,202305,306,812,209,603,77,234,67,171,144,405
421315,202305,424,1091,260,740,57,174,81,201,138,375
421320,202305,789,2397,444,1428,42,135,60,95,102,230
421330,202305,778,2151,513,1565,108,341,145,385,253,726
421335,202305,529,1508,419,1289,59,207,216,630,275,837
421340,202305,1793,4773,1286,3872,221,727,536,1493,757,2220
421350,202305,2231,5293,1534,4162,318,895,549,1415,867,2310
421360,202305,2700,6848,1671,4800,451,1534,495,994,946,2528
421370,202305,970,2959,633,2086,118,427,176,472,294,899
421380,202305,1093,2536,959,2331,83,266,680,1550,763,1816
421390,202305,198,521,92,297,28,97,22,61,50,158
421400,202305,832,2114,579,1626,111,336,256,642,367,978
421410,202305,243,628,137,418,35,101,25,79,60,180
421415,202305,246,654,181,504,24,73,63,152,87,225
421420,202305,757,1991,558,1551,82,250,270,664,352,914
421430,202305,125,367,85,265,13,45,16,33,29,78
421440,202305,879,2274,562,1659,112,345,232,634,344,979
421450,202305,525,1556,365,1187,45,147,30,113,75,260
421460,202305,388,1182,220,779,9,32,19,40,28,72
421470,202305,486,1323,354,1078,52,157,96,287,148,444
421480,202305,4192,10655,3095,8432,430,1396,1432,3423,1862,4819
421490,202305,147,443,94,309,12,54,26,68,38,122
421500,202305,3185,8531,2339,6804,466,1579,802,1884,1268,3463
421505,202305,416,1044,347,938,37,118,213,555,250,673
421507,202305,540,1348,336,926,65,183,121,298,186,481
421510,202305,578,1520,400,1119,65,219,171,370,236,589
421520,202305,570,1483,335,931,57,156,101,231,158,387
421530,202305,413,1206,255,846,42,177,50,113,92,290
421535,202305,570,1426,369,1004,54,161,199,489,253,650
421540,202305,474,1078,289,782,36,113,103,260,139,373
421545,202305,873,2443,679,2084,136,470,305,832,441,1302
421550,202305,2868,7190,2226,6051,393,1179,1088,2731,1481,3910
421555,202305,285,787,88,275,15,49,16,32,31,81
421560,202305,128,402,80,269,13,49,23,65,36,114
421565,202305,1314,3240,987,2699,233,721,427,1043,660,1764
421567,202305,572,1657,446,1315,124,394,129,365,253,759
421568,202305,389,1102,205,649,42,155,57,152,99,307
421569,202305,178,488,91,265,14,47,46,111,60,158
421570,202305,2100,5561,1532,4334,289,922,636,1513,925,2435
421575,202305,407,1145,293,836,36,120,137,337,173,457
421580,202305,6689,17051,4403,12243,650,2032,1852,4317,2502,6349
421590,202305,250,662,194,549,47,147,83,216,130,363
421600,202305,783,1921,531,1407,69,207,236,515,305,722
421605,202305,857,2178,642,1830,120,356,256,692,376,1048
421610,202305,1280,3208,913,2540,192,603,369,950,561,1553
421620,202305,5226,12842,3691,10159,767,2412,1488,3533,2255,5945
421625,202305,169,459,95,275,11,30,31,70,42,100
421630,202305,3708,9285,2462,6941,411,1298,737,1722,1148,3020
421635,202305,578,1478,412,1144,36,123,246,585,282,708
421640,202305,943,2318,705,1960,190,543,332,873,522,1416
421650,202305,3608,8955,2520,7067,503,1588,867,2122,1370,3710
421660,202305,16974,43070,12967,35509,1860,5899,6820,16482,8680,22381
421670,202305,1168,3105,821,2251,153,472,350,831,503,1303
421680,202305,2334,4746,1931,4134,141,377,1489,2944,1630,3321
421690,202305,1931,5348,1379,4215,285,927,346,930,631,1857
421700,202305,766,2188,493,1522,76,264,116,271,192,535
421710,202305,266,804,157,498,19,65,64,188,83,253
421715,202305,216,523,164,400,29,91,100,210,129,301
421720,202305,2662,6942,1644,4744,385,1207,446,1023,831,2230
421725,202305,364,874,211,578,29,86,99,225,128,311
421730,202305,716,2007,479,1366,82,233,205,530,287,763
421740,202305,1085,2879,758,2222,152,466,285,701,437,1167
421750,202305,1248,2902,721,1949,168,506,247,586,415,1092
421755,202305,202,543,110,329,19,61,34,78,53,139
421760,202305,1398,3408,903,2505,169,538,336,801,505,1339
421770,202305,3252,7963,2378,6472,424,1233,908,2232,1332,3465
421775,202305,259,682,159,463,18,53,50,111,68,164
421780,202305,1230,3204,857,2459,146,453,375,931,521,1384
421790,202305,1164,2989,646,1949,142,438,190,497,332,935
421795,202305,312,911,187,570,31,102,49,135,80,237
421800,202305,4018,10372,3043,8526,517,1586,1358,3451,1875,5037
421810,202305,727,1917,516,1516,63,209,250,698,313,907
421820,202305,1488,4027,1041,3002,195,641,339,808,534,1449
421825,202305,2077,4618,1754,4130,120,316,1296,2967,1416,3283
421830,202305,2516,6945,1869,5603,404,1309,434,1216,838,2525
421835,202305,318,732,242,607,30,89,149,354,179,443
421840,202305,487,1468,392,1244,76,278,119,323,195,601
421850,202305,500,1419,288,982,60,201,46,129,106,330
421860,202305,301,775,169,515,22,72,55,125,77,197
421870,202305,7306,17100,5531,13686,714,2165,3287,7036,4001,9201
421875,202305,396,1150,180,551,24,76,36,89,60,165
421880,202305,893,2385,591,1720,116,298,146,396,262,694
421885,202305,376,1019,208,621,35,103,59,158,94,261
421890,202305,1365,3460,1030,2858,150,529,636,1589,786,2118
421895,202305,539,1315,459,1187,46,103,293,789,339,892
421900,202305,1430,3573,1042,2729,147,454,481,1033,628,1487
421910,202305,431,1253,223,750,32,123,48,124,80,247
421915,202305,484,1292,299,862,76,235,55,120,131,355
421917,202305,801,1786,478,1320,131,382,97,259,228,641
421920,202305,521,1489,362,1129,97,313,102,300,199,613
421930,202305,4271,10184,2622,7166,494,1471,876,2037,1370,3508
421935,202305,526,1478,423,1274,98,310,190,544,288,854
421940,202305,429,1194,215,634,35,115,68,165,103,280
421950,202305,4115,10155,2576,7174,474,1455,758,1707,1232,3162
421960,202305,186,447,110,321,14,35,37,95,51,130
421970,202305,2656,6610,1708,4605,327,1013,700,1586,1027,2599
421985,202305,390,1041,276,795,33,97,139,382,172,479
422000,202305,2590,6106,2036,5306,162,508,1408,3575,1570,4083
430003,202305,781,1918,562,1544,87,258,299,787,386,1045
430005,202305,461,1059,359,900,19,63,267,613,286,676
430010,202305,2278,4835,1728,4006,364,824,854,1986,1218,2810
430020,202305,681,1465,517,1232,67,180,318,699,385,879
430030,202305,1231,2689,780,1860,120,296,448,949,568,1245
430040,202305,12128,26444,8007,19843,2148,5769,2272,5001,4420,10770
430045,202305,657,1426,500,1177,29,81,374,837,403,918
430047,202305,284,624,120,314,19,45,39,102,58,147
430050,202305,1031,2433,607,1627,119,315,198,480,317,795
430055,202305,312,705,159,408,15,38,78,176,93,214
430057,202305,112,256,60,164,16,43,14,38,30,81
430060,202305,28449,66919,23265,59092,4054,11163,12785,30911,16839,42074
430063,202305,822,2122,704,1903,150,408,399,1057,549,1465
430064,202305,1401,3488,1043,2844,227,673,499,1272,726,1945
430066,202305,122,261,98,223,7,22,79,173,86,195
430070,202305,679,1704,166,503,26,87,21,41,47,128
430080,202305,1175,2824,660,1777,113,346,307,683,420,1029
430085,202305,1141,2290,700,1633,121,309,299,684,420,993
430087,202305,1142,2641,922,2323,89,268,563,1354,652,1622
430090,202305,548,1370,240,747,52,169,46,118,98,287
430100,202305,1380,3110,835,2112,129,357,338,727,467,1084
430105,202305,1911,4388,1385,3528,180,537,779,1853,959,2390
430107,202305,207,554,109,314,16,45,30,69,46,114
430110,202305,2666,6122,2082,5247,358,988,1023,2408,1381,3396
430120,202305,1478,3828,1097,2951,191,504,496,1243,687,1747
430130,202305,4293,8860,3242,7453,1167,2698,606,1632,1773,4330
430140,202305,1275,3048,931,2463,160,461,447,1109,607,1570
430150,202305,691,1707,389,1116,85,268,105,263,190,531
430155,202305,260,611,118,331,16,46,28,58,44,104
430160,202305,27904,56507,22878,49819,1736,4424,16623,34248,18359,38672
430163,202305,4413,8752,3212,7071,60,201,2659,5598,2719,5799
430165,202305,395,982,160,481,21,61,19,48,40,109
430170,202305,1128,2768,402,1288,88,314,54,108,142,422
430175,202305,1038,2356,896,2098,146,341,553,1253,699,1594
430180,202305,808,1911,594,1535,141,351,242,621,383,972
430185,202305,778,1900,415,1147,100,293,78,181,178,474
430187,202305,1066,2064,810,1769,96,202,559,1214,655,1416
430190,202305,1848,4206,1445,3588,298,748,666,1552,964,2300
430192,202305,132,331,64,180,11,31,19,42,30,73
430195,202305,519,1418,93,284,9,26,18,38,27,64
430200,202305,1375,3557,1112,3088,304,877,241,677,545,1554
430205,202305,683,1322,644,1251,13,30,608,1160,621,1190
430210,202305,9254,22377,5595,14755,770,2193,1620,3323,2390,5516
430215,202305,441,980,270,670,37,108,124,277,161,385
430220,202305,699,1664,260,759,44,129,83,195,127,324
430222,202305,303,753,207,569,41,119,76,188,117,307
430223,202305,348,840,268,707,32,87,147,360,179,447
430225,202305,42,92,33,77,2,3,22,46,24,49
430230,202305,2672,6234,2267,5674,129,355,1821,4466,1950,4821
430235,202305,569,1431,387,1073,60,191,100,212,160,403
430237,202305,650,1316,509,1103,24,71,414,852,438,923
430240,202305,1649,3681,974,2503,140,395,437,975,577,1370
430245,202305,902,2170,751,1905,152,368,419,1105,571,1473
430250,202305,1324,2978,947,2372,293,772,240,541,533,1313
430258,202305,156,395,121,333,12,34,54,146,66,180
430260,202305,876,2021,583,1507,71,205,327,807,398,1012
430265,202305,294,806,204,642,39,127,74,230,113,357
430270,202305,4202,8656,3383,7458,498,1192,2186,4542,2684,5734
430280,202305,6381,13268,4710,10652,733,1773,2484,5252,3217,7025
430290,202305,2719,5567,2239,4993,227,520,1649,3539,1876,4059
430300,202305,13627,29712,10712,25064,1484,3877,6446,13964,7930,17841
430310,202305,18107,41069,13577,33181,1747,4705,7935,17844,9682,22549
430320,202305,1099,2618,648,1772,60,167,350,903,410,1070
430330,202305,750,1750,480,1232,91,236,155,339,246,575
430340,202305,824,1695,577,1324,74,167,395,873,469,1040
430350,202305,11040,24525,8639,20684,1150,3024,5207,11644,6357,14668
430355,202305,425,1125,159,487,34,93,16,35,50,128
430360,202305,1100,2512,672,1797,168,487,179,424,347,911
430367,202305,419,851,284,645,36,109,184,363,220,472
430370,202305,555,1475,231,687,49,149,56,123,105,272
430380,202305,756,1768,411,1158,90,263,111,280,201,543
430390,202305,4396,10074,3019,7718,600,1642,363,671,963,2313
430400,202305,1292,2496,983,2095,131,347,616,1191,747,1538
430410,202305,672,1429,515,1198,47,121,387,863,434,984
430420,202305,3714,8460,2889,6927,385,1108,1770,3746,2155,4854
430430,202305,576,1385,266,768,49,149,43,109,92,258
430435,202305,2322,5236,1672,4110,298,770,826,1941,1124,2711
430440,202305,6464,14759,5437,13158,577,1628,3636,8261,4213,9889
430450,202305,9894,20823,8155,18035,1241,3219,4880,9887,6121,13106
430460,202305,52740,117515,38856,95534,5557,15059,21453,49474,27010,64533
430461,202305,229,579,95,278,16,52,39,97,55,149
430462,202305,375,913,200,576,36,111,61,155,97,266
430463,202305,9316,22263,7071,18226,1373,4050,3470,8261,4843,12311
430465,202305,699,1565,481,1177,71,199,273,639,344,838
430466,202305,6202,13789,5024,12103,789,2108,3002,6615,3791,8723
430467,202305,635,1435,470,1181,48,150,279,642,327,792
430468,202305,1838,4004,1539,3588,86,267,1204,2670,1290,2937
430469,202305,721,1925,148,450,17,50,46,101,63,151
430470,202305,7257,17220,4924,13212,1268,3942,1199,2681,2467,6623
430471,202305,988,2288,846,2062,101,295,607,1370,708,1665
430480,202305,803,2073,526,1508,85,277,175,391,260,668
430485,202305,207,506,106,285,22,52,24,59,46,111
430490,202305,575,1372,327,900,37,113,152,338,189,451
430495,202305,474,1219,325,955,56,179,158,436,214,615
430500,202305,1142,2731,829,2240,270,814,226,514,496,1328
430510,202305,35063,84745,26645,69371,5106,14839,11684,26744,16790,41583
430511,202305,394,1043,146,446,26,81,26,54,52,135
430512,202305,1260,2585,1034,2276,228,545,439,915,667,1460
430513,202305,951,2116,495,1218,73,194,278,599,351,793
430515,202305,474,1173,339,926,48,134,154,393,202,527
430517,202305,1756,4378,1345,3536,256,652,716,1856,972,2508
430520,202305,1595,3799,944,2466,152,402,231,538,383,940
430530,202305,1085,2570,488,1366,89,266,132,333,221,599
430535,202305,4518,10460,3366,8513,492,1335,1704,4046,2196,5381
430537,202305,684,1492,610,1369,80,171,441,961,521,1132
430540,202305,696,1598,425,1145,82,222,196,515,278,737
430543,202305,1331,2253,856,1703,229,448,208,458,437,906
430544,202305,837,2198,558,1592,145,445,168,453,313,898
430545,202305,3054,7069,2385,6101,419,1101,1315,3244,1734,4345
430550,202305,472,1208,332,930,99,257,84,232,183,489
430558,202305,187,406,86,217,2,4,49,114,51,118
430560,202305,352,797,184,525,24,80,57,138,81,218
430570,202305,1000,2264,716,1759,164,495,312,588,476,1083
430580,202305,921,2222,723,1923,179,472,266,747,445,1219
430583,202305,212,510,46,128,6,25,11,15,17,40
430585,202305,244,578,144,373,27,75,46,101,73,176
430587,202305,244,617,185,526,24,76,79,213,103,289
430590,202305,1610,3626,1279,3098,139,349,829,1955,968,2304
430593,202305,39,104,34,89,4,12,15,32,19,44
430595,202305,507,1256,145,440,18,44,21,43,39,87
430597,202305,552,1287,300,802,24,61,99,193,123,254
430600,202305,2346,5812,1056,2896,169,485,197,475,366,960
430605,202305,1656,3897,1215,3154,178,484,556,1352,734,1836
430607,202305,827,1745,562,1296,68,148,325,718,393,866
430610,202305,7503,16033,5396,13031,1422,3966,2168,4594,3590,8560
430613,202305,304,679,92,257,13,34,22,49,35,83
430620,202305,1023,2229,781,1816,146,400,412,807,558,1207
430630,202305,471,1249,174,499,32,96,52,124,84,220
430632,202305,506,1258,221,608,36,105,83,201,119,306
430635,202305,676,1395,504,1100,64,119,348,755,412,874
430637,202305,626,1394,466,1147,48,142,297,665,345,807
430640,202305,1342,3508,943,2704,135,414,352,862,487,1276
430642,202305,433,1131,268,751,47,132,98,252,145,384
430645,202305,192,436,101,256,20,59,32,57,52,116
430650,202305,2219,5454,1696,4635,526,1397,625,1867,1151,3264
430655,202305,394,904,234,585,29,85,137,294,166,379
430660,202305,6629,15009,5130,12693,866,2393,2701,6158,3567,8551
430670,202305,712,1596,509,1249,98,240,228,529,326,769
430673,202305,581,1251,289,752,67,168,105,249,172,417
430675,202305,285,796,66,218,8,28,8,25,16,53
430676,202305,7606,17072,6118,14756,985,2542,3677,8449,4662,10991
430680,202305,1514,3607,1016,2689,322,931,331,652,653,1583
430690,202305,4160,9524,3282,8049,1060,2751,1247,2892,2307,5643
430692,202305,241,668,192,588,12,45,148,445,160,490
430693,202305,1102,2755,701,2004,160,489,158,411,318,900
430695,202305,468,1095,305,761,48,140,166,369,214,509
430697,202305,638,1447,501,1256,66,179,334,817,400,996
430700,202305,10126,23179,6683,17149,1488,4180,1615,3335,3103,7515
430705,202305,425,947,217,583,28,80,83,198,111,278
430710,202305,2509,4325,1694,3302,61,175,1399,2565,1460,2740
430720,202305,938,2150,509,1399,64,194,260,648,324,842
430730,202305,1126,2873,780,2202,130,385,310,800,440,1185
430740,202305,843,2126,463,1312,71,227,155,392,226,619
430745,202305,607,1331,455,1059,55,184,293,567,348,751
430750,202305,2097,4753,1469,3661,343,895,707,1638,1050,2533
430755,202305,567,1290,423,1028,41,118,262,572,303,690
430760,202305,3231,7310,2580,6355,545,1439,1265,2889,1810,4328
430770,202305,9694,21415,7896,18802,950,2529,5101,11514,6051,14043
430780,202305,2708,6254,1938,5007,267,773,1070,2554,1337,3327
430781,202305,812,1898,548,1357,173,458,203,420,376,878
430783,202305,422,916,279,695,67,174,140,329,207,503
430786,202305,42,127,28,97,4,12,7,18,11,30
430790,202305,6074,13650,4664,11319,474,1444,2927,6348,3401,7792
430800,202305,1075,2087,822,1752,48,113,642,1307,690,1420
430805,202305,481,1048,347,798,8,30,283,605,291,635
430807,202305,738,1706,454,1193,70,202,179,394,249,596
430810,202305,889,2038,509,1333,74,214,194,418,268,632
430820,202305,1697,4422,999,2933,179,524,295,748,474,1272
430825,202305,317,717,132,309,21,52,55,112,76,164
430830,202305,2541,5645,2138,4967,125,294,1655,3653,1780,3947
430840,202305,1476,3177,1016,2456,157,384,622,1445,779,1829
430843,202305,234,545,109,297,11,26,37,88,48,114
430845,202305,639,1339,430,999,58,156,250,503,308,659
430850,202305,2954,7205,2077,5648,610,1811,500,1244,1110,3055
430860,202305,1491,3464,836,2222,125,401,349,766,474,1167
430865,202305,730,1658,438,1144,116,337,159,334,275,671
430870,202305,616,1588,284,849,54,160,49,122,103,282
430880,202305,1847,3781,1353,2997,151,406,919,1878,1070,2284
430885,202305,218,542,138,380,15,33,87,239,102,272
430890,202305,1354,3167,873,2368,190,612,90,171,280,783
430900,202305,4274,7943,2978,6187,149,430,2227,4242,2376,4672
430905,202305,1125,2656,789,2055,142,387,314,736,456,1123
430910,202305,2881,7188,2216,5853,349,1094,1025,2278,1374,3372
430912,202305,640,1683,415,1199,77,208,214,628,291,836
430915,202305,616,1637,395,1174,107,337,97,286,204,623
430920,202305,35719,80062,28974,69548,3550,9433,18757,42577,22307,52010
430925,202305,107,225,56,142,7,19,26,65,33,84
430930,202305,15765,33033,12061,27765,1350,3499,7788,16649,9138,20148
430940,202305,1588,3709,1136,2908,236,644,464,1046,700,1690
430950,202305,1022,2030,703,1526,65,189,499,967,564,1156
430955,202305,545,1359,166,457,25,69,50,108,75,177
430957,202305,251,709,223,654,39,107,117,349,156,456
430960,202305,1686,3769,1018,2623,270,725,323,744,593,1469
430965,202305,1962,4081,1570,3507,61,144,1238,2748,1299,2892
430970,202305,430,989,262,692,39,109,121,302,160,411
430975,202305,593,1529,466,1274,88,281,169,400,257,681
430980,202305,530,1156,312,795,45,123,138,303,183,426
430990,202305,703,1768,519,1410,73,217,248,633,321,850
430995,202305,663,1477,483,1203,87,221,259,598,346,819
431000,202305,1715,3854,792,2160,120,333,81,169,201,502
431010,202305,3440,8236,2488,6618,482,1470,964,2155,1446,3625
431020,202305,11186,23017,6880,16402,1140,3148,3265,6700,4405,9848
431030,202305,399,1047,208,650,42,155,26,71,68,226
431033,202305,5252,11544,3735,9166,862,2118,1448,3444,2310,5562
431036,202305,348,766,93,278,9,21,32,82,41,103
431040,202305,1058,2438,737,1913,76,261,455,1062,531,1323
431041,202305,494,1114,343,871,56,143,137,290,193,433
431043,202305,456,1099,316,811,27,90,202,462,229,552
431046,202305,114,285,54,151,7,18,13,30,20,48
431050,202305,1497,3262,1136,2706,198,474,639,1495,837,1969
431053,202305,875,2057,487,1342,106,305,163,359,269,664
431055,202305,749,1682,572,1390,63,156,382,937,445,1093
431057,202305,216,632,144,451,35,119,52,150,87,269
431060,202305,7019,15684,5059,12638,1224,3323,2022,4501,3246,7824
431065,202305,569,1303,377,994,53,155,199,491,252,646
431070,202305,503,1235,301,819,64,182,78,217,142,399
431075,202305,334,804,193,504,34,117,96,194,130,311
431080,202305,807,2074,570,1599,82,246,186,441,268,687
431085,202305,941,2288,487,1303,71,201,204,528,275,729
431087,202305,481,1216,397,1056,53,158,230,577,283,735
431090,202305,464,1047,191,556,30,92,41,114,71,206
431100,202305,5516,10557,4123,8817,423,1028,2866,5755,3289,6783
431110,202305,1772,3781,1305,2970,190,480,740,1510,930,1990
431112,202305,780,1816,645,1587,82,234,418,959,500,1193
431113,202305,664,1534,518,1272,126,316,287,662,413,978
431115,202305,1343,3234,1033,2714,113,392,724,1738,837,2130
431120,202305,3332,7704,2325,5879,534,1534,921,2002,1455,3536
431123,202305,420,1026,264,711,51,121,117,305,168,426
431125,202305,1485,3448,1074,2721,263,687,577,1429,840,2116
431127,202305,287,706,83,241,11,37,19,40,30,77
431130,202305,4133,9286,3300,8041,555,1494,1739,3913,2294,5407
431140,202305,7416,16778,4873,12119,678,1857,2260,4712,2938,6569
431142,202305,809,1776,609,1455,91,227,387,902,478,1129
431150,202305,1250,3030,937,2498,118,352,521,1321,639,1673
431160,202305,832,2034,562,1522,157,451,170,406,327,857
431162,202305,714,1670,516,1314,52,174,315,732,367,906
431164,202305,196,447,58,177,8,26,9,20,17,46
431170,202305,564,1380,425,1122,132,344,91,215,223,559
431171,202305,1178,2315,1000,2104,155,326,761,1580,916,1906
431173,202305,573,1369,411,1139,125,399,112,257,237,656
431175,202305,1616,3493,1012,2470,153,375,483,1107,636,1482
431177,202305,1168,2720,881,2269,177,517,478,1150,655,1667
431179,202305,357,773,133,371,28,80,40,103,68,183
431180,202305,2985,7270,1948,5276,479,1298,482,1109,961,2407
431190,202305,717,1718,315,878,28,81,73,134,101,215
431198,202305,505,1344,418,1177,91,263,175,489,266,752
431200,202305,344,832,113,302,23,54,17,44,40,98
431205,202305,283,716,169,475,47,133,56,150,103,283
431210,202305,797,1722,633,1469,128,316,319,735,447,1051
431213,202305,351,852,254,668,23,68,133,317,156,385
431215,202305,751,1709,392,1070,55,164,179,447,234,611
431217,202305,204,485,143,368,30,84,57,129,87,213
431220,202305,751,1720,484,1243,116,297,233,538,349,835
431225,202305,1980,4077,1537,3396,172,421,1034,2205,1206,2626
431230,202305,920,2272,676,1755,130,396,341,745,471,1141
431235,202305,205,551,35,113,2,4,9,25,11,29
431237,202305,462,1281,336,1022,51,172,166,484,217,656
431238,202305,44,139,37,123,8,34,19,50,27,84
431240,202305,6730,14819,5591,13039,570,1638,3741,8050,4311,9688
431242,202305,388,878,318,746,41,109,186,403,227,512
431244,202305,480,1129,225,576,51,118,73,161,124,279
431245,202305,1544,3369,1011,2486,107,278,479,1065,586,1343
431247,202305,344,791,233,595,36,107,106,237,142,344
431250,202305,2435,5304,1937,4611,408,1001,1034,2405,1442,3406
431260,202305,391,971,246,680,27,97,108,260,135,357
431261,202305,348,932,286,834,26,96,173,456,199,552
431262,202305,331,894,179,556,28,104,84,245,112,349
431265,202305,1902,4258,790,2138,155,451,207,433,362,884
431267,202305,276,652,190,498,28,87,112,266,140,353
431270,202305,3594,7341,1962,4701,531,1309,666,1494,1197,2803
431275,202305,193,496,135,368,22,73,80,190,102,263
431280,202305,325,857,161,492,28,83,42,122,70,205
431290,202305,449,1275,300,937,51,171,49,133,100,304
431295,202305,85,214,37,109,11,31,9,29,20,60
431300,202305,363,937,104,300,15,53,30,64,45,117
431301,202305,315,878,94,300,13,41,11,31,24,72
431303,202305,820,1895,509,1314,36,114,236,502,272,616
431306,202305,2878,6446,1814,4675,254,721,756,1667,1010,2388
431308,202305,50,138,43,120,15,43,14,38,29,81
431310,202305,665,1571,423,1088,78,180,197,478,275,658
431320,202305,814,2107,531,1545,90,294,166,398,256,692
431330,202305,2509,5522,1475,3747,203,583,759,1692,962,2275
431333,202305,243,614,144,411,28,81,36,94,64,175
431335,202305,44,124,29,95,8,25,3,12,11,37
431337,202305,5330,11054,4607,10042,208,644,3892,8040,4100,8684
431339,202305,557,1310,388,1028,93,246,150,383,243,629
431340,202305,24344,54973,18174,44909,2599,7298,9765,21967,12364,29265
431342,202305,475,1041,358,857,52,135,235,547,287,682
431344,202305,437,1069,245,697,42,109,123,340,165,449
431346,202305,262,623,96,284,17,51,29,70,46,121
431349,202305,1235,2606,829,1860,137,352,484,997,621,1349
431350,202305,6201,14089,4957,12163,701,1895,3053,7007,3754,8902
431360,202305,677,1542,364,960,105,302,99,209,204,511
431365,202305,3051,5976,2427,5170,138,367,2019,4116,2157,4483
431370,202305,6608,14061,4854,11362,846,2213,2697,5915,3543,8128
431380,202305,1154,2820,924,2444,212,556,486,1283,698,1839
431390,202305,3314,7588,2239,5818,249,789,1229,2748,1478,3537
431395,202305,2261,4593,1796,3952,189,431,1269,2673,1458,3104
431400,202305,363,966,215,631,40,126,46,114,86,240
431402,202305,1076,2224,804,1823,94,225,513,1098,607,1323
431403,202305,232,619,180,517,44,146,59,142,103,288
431405,202305,7308,17154,5840,14776,1055,3002,2895,6642,3950,9644
431406,202305,708,1795,470,1304,125,328,134,400,259,728
431407,202305,649,1609,429,1167,82,218,173,442,255,660
431410,202305,24803,55677,18401,45402,2384,6984,11099,24571,13483,31555
431413,202305,298,815,77,230,5,13,22,50,27,63
431415,202305,907,2096,616,1610,123,370,246,535,369,905
431417,202305,669,1359,421,963,69,187,212,458,281,645
431420,202305,2121,4263,1615,3605,120,318,1128,2349,1248,2667
431430,202305,675,1615,342,967,55,163,114,283,169,446
431440,202305,49889,102549,39544,87897,6009,15486,23048,45458,29057,60944
431442,202305,201,537,105,323,15,51,13,36,28,87
431445,202305,850,1965,566,1259,18,58,458,900,476,958
431446,202305,329,868,274,768,32,98,151,409,183,507
431447,202305,914,2187,503,1382,87,245,170,454,257,699
431449,202305,966,2225,655,1676,98,253,343,799,441,1052
431450,202305,3131,5513,2509,4690,199,314,1975,3566,2174,3880
431454,202305,52,162,43,140,9,33,22,68,31,101
431455,202305,640,1430,342,859,39,87,155,365,194,452
431460,202305,3971,8272,2649,6061,536,1333,1189,2502,1725,3835
431470,202305,1713,4271,1224,3329,273,808,421,1056,694,1864
431475,202305,300,795,59,194,4,15,7,11,11,26
431477,202305,586,1373,338,903,94,232,113,285,207,517
431478,202305,281,772,61,196,10,32,9,22,19,54
431480,202305,4115,9836,3341,8642,789,2101,1306,3238,2095,5339
431490,202305,176992,364378,140505,310072,7831,22095,108321,223746,116152,245841
431500,202305,567,1312,425,1059,66,161,218,520,284,681
431505,202305,285,624,206,511,23,53,145,358,168,411
431507,202305,340,781,145,411,39,120,24,53,63,173
431510,202305,2085,4952,1424,3685,508,1367,327,810,835,2177
431513,202305,255,539,138,345,32,101,41,66,73,167
431514,202305,152,357,124,313,7,19,80,179,87,198
431515,202305,672,1436,520,1177,116,280,279,602,395,882
431517,202305,86,232,68,195,8,31,31,84,39,115
431520,202305,423,982,177,476,29,92,75,157,104,249
431530,202305,6569,13573,4100,9835,950,2401,1769,3953,2719,6354
431531,202305,263,601,153,405,31,81,50,131,81,212
431532,202305,736,1534,436,1024,78,193,204,463,282,656
431535,202305,348,870,165,469,21,54,37,88,58,142
431540,202305,2282,6093,2037,5758,104,323,1577,4472,1681,4795
431545,202305,431,1005,112,272,13,27,53,118,66,145
431550,202305,2853,6501,2028,5016,261,736,1087,2474,1348,3210
431555,202305,847,1758,496,1187,51,134,278,649,329,783
431560,202305,33078,73778,23304,58821,4347,10977,9803,24323,14150,35300
431570,202305,6897,13517,6016,12287,382,964,4989,9621,5371,10585
431575,202305,479,1045,414,942,75,165,257,546,332,711
431580,202305,820,1954,587,1525,68,218,329,758,397,976
431590,202305,1052,2673,679,1871,172,513,237,566,409,1079
431595,202305,431,1069,279,759,58,177,96,223,154,400
431600,202305,2296,5280,1663,4280,307,906,687,1568,994,2474
431610,202305,1845,4005,1177,2885,210,513,440,1138,650,1651
431620,202305,571,1333,310,781,62,190,170,347,232,537
431630,202305,1563,3624,752,2052,190,564,202,475,392,1039
431640,202305,8843,17837,7392,15955,966,2318,4911,10173,5877,12491
431642,202305,799,1683,506,1173,101,235,236,488,337,723
431643,202305,459,1082,220,592,22,53,83,200,105,253
431645,202305,3081,5337,2463,4582,30,74,2179,3916,2209,3990
431647,202305,367,853,124,356,17,48,15,30,32,78
431650,202305,165,439,122,361,17,51,59,154,76,205
431660,202305,1010,2495,539,1575,94,310,128,321,222,631
431670,202305,1548,3418,933,2334,146,388,462,1030,608,1418
431673,202305,253,637,105,335,14,54,35,90,49,144
431675,202305,430,1051,110,351,12,38,13,27,25,65
431680,202305,12820,28060,9810,23008,1988,5317,4908,10284,6896,15601
431690,202305,35802,78264,26632,62918,4677,12415,14534,31302,19211,43717
431695,202305,274,638,177,464,24,91,99,210,123,301
431697,202305,547,1176,413,972,78,187,230,530,308,717
431700,202305,1850,4023,1441,3348,243,513,745,1734,988,2247
431710,202305,19397,39333,14802,33222,1688,4337,9762,20741,11450,25078
431720,202305,8819,19592,5501,13960,1469,3981,1117,2277,2586,6258
431725,202305,42,107,29,83,6,21,13,33,19,54
431730,202305,5767,12332,3990,9748,750,2034,2011,4435,2761,6469
431740,202305,6420,14353,4428,11173,981,2749,1385,3028,2366,5777
431750,202305,10836,25163,7907,20519,2050,5651,2662,6513,4712,12164
431755,202305,363,944,92,289,13,42,15,41,28,83
431760,202305,6665,14069,4874,11199,556,1580,3015,6152,3571,7732
431770,202305,2621,5348,1994,4503,403,851,1207,2737,1610,3588
431775,202305,267,627,150,405,31,98,46,99,77,197
431780,202305,2650,5899,1764,4369,331,898,562,1274,893,2172
431790,202305,909,2300,638,1773,160,475,243,649,403,1124
431795,202305,310,751,155,450,20,59,36,93,56,152
431800,202305,10259,22559,6848,17419,1966,5892,812,1676,2778,7568
431805,202305,319,801,64,228,1,1,1,1,2,2
431810,202305,3921,8250,2653,6074,424,1098,1496,3090,1920,4188
431820,202305,2722,6436,2124,5549,511,1479,941,2295,1452,3774
431830,202305,10765,22462,7903,18575,2459,6555,1282,2961,3741,9516
431840,202305,3616,8000,2961,7045,479,1241,1815,4159,2294,5400
431842,202305,601,1410,216,609,38,112,36,78,74,190
431843,202305,373,949,249,689,64,193,99,241,163,434
431844,202305,208,552,80,263,17,56,18,57,35,113
431845,202305,584,1386,365,954,30,85,211,534,241,619
431846,202305,373,811,329,751,16,43,291,648,307,691
431848,202305,176,443,101,290,11,35,29,65,40,100
431849,202305,415,1010,71,200,11,33,9,13,20,46
431850,202305,5329,13030,4062,10710,1070,3021,1150,2825,2220,5846
431860,202305,850,1885,475,1170,72,190,287,657,359,847
431861,202305,121,304,77,213,12,43,29,62,41,105
431862,202305,617,1822,507,1629,100,374,240,720,340,1094
431870,202305,31176,69344,25310,60707,2706,7278,16687,37600,19393,44878
431880,202305,5077,11824,3804,9705,557,1679,2041,4765,2598,6444
431890,202305,6154,14192,4010,10261,1170,3085,998,2390,2168,5475
431900,202305,1294,3005,887,2303,166,503,422,925,588,1428
431910,202305,917,2058,363,957,66,186,101,203,167,389
431912,202305,709,1562,569,1336,86,205,364,829,450,1034
431915,202305,1456,3011,1190,2620,72,170,947,2016,1019,2186
431920,202305,1673,3216,1388,2863,38,88,1220,2455,1258,2543
431930,202305,909,2162,631,1679,203,561,213,536,416,1097
431935,202305,96,231,71,189,11,31,14,28,25,59
431936,202305,359,918,209,567,39,112,114,293,153,405
431937,202305,188,459,122,337,31,78,35,89,66,167
431940,202305,3810,8083,2533,5937,215,543,1582,3460,1797,4003
431950,202305,2843,6506,2192,5491,555,1472,859,2019,1414,3491
431960,202305,3746,8389,2830,6830,839,2130,660,1523,1499,3653
431970,202305,518,1260,238,630,41,132,67,131,108,263
431971,202305,95,232,53,151,13,40,16,42,29,82
431973,202305,714,1974,497,1528,48,145,347,1074,395,1219
431975,202305,129,266,47,122,11,32,13,25,24,57
431980,202305,1565,3321,1251,2859,130,379,869,1780,999,2159
431990,202305,8770,18855,6504,15777,430,1264,4443,10235,4873,11499
432000,202305,20390,42296,15788,35595,1864,4912,10628,22203,12492,27115
432010,202305,3575,7696,2446,5970,583,1450,876,1973,1459,3423
432020,202305,1890,4733,1208,3333,400,1173,199,508,599,1681
432023,202305,659,1464,317,827,38,102,140,312,178,414
432026,202305,1247,3054,969,2545,288,768,347,958,635,1726
432030,202305,553,1238,304,808,25,80,175,419,200,499
432032,202305,376,909,265,706,24,78,130,297,154,375
432035,202305,854,2158,710,1915,193,516,308,835,501,1351
432040,202305,1168,2752,548,1550,65,202,233,559,298,761
432045,202305,227,551,131,368,15,49,62,158,77,207
432050,202305,693,1587,518,1303,68,204,268,644,336,848
432055,202305,863,1992,592,1524,186,461,154,413,340,874
432057,202305,183,452,155,391,14,38,104,234,118,272
432060,202305,532,1226,156,477,20,65,28,79,48,144
432065,202305,280,684,223,575,48,135,114,270,162,405
432067,202305,987,2451,836,2143,121,312,502,1254,623,1566
432070,202305,1990,4560,1536,3783,237,675,777,1704,1014,2379
432080,202305,6495,13477,4858,11101,950,2622,2273,4531,3223,7153
432085,202305,485,1238,419,1139,83,249,209,518,292,767
432090,202305,3504,8108,2175,5674,429,1094,948,2232,1377,3326
432100,202305,1130,2664,551,1599,88,269,68,149,156,418
432110,202305,2642,6131,2005,5084,450,1273,632,1337,1082,2610
432120,202305,4708,11384,3859,10063,633,1895,2013,4767,2646,6662
432130,202305,3489,7741,2923,6983,549,1332,1433,3459,1982,4791
432132,202305,334,837,184,510,30,98,93,222,123,320
432135,202305,1231,2551,828,1898,105,242,501,1166,606,1408
432140,202305,2424,5876,2027,5190,258,723,1359,3314,1617,4037
432143,202305,1996,4710,1538,3995,150,432,961,2401,1111,2833
432145,202305,2262,5557,1505,4110,262,804,491,1060,753,1864
432146,202305,163,414,129,366,45,131,28,80,73,211
432147,202305,686,1730,368,1060,120,361,54,147,174,508
432149,202305,605,1335,273,689,32,75,118,266,150,341
432150,202305,5320,11908,4116,10041,888,2488,2050,4351,2938,6839
432160,202305,8599,19322,6631,16472,1647,4372,2620,6158,4267,10530
432162,202305,237,513,43,119,8,24,7,9,15,33
432163,202305,198,462,39,110,1,3,7,14,8,17
432166,202305,809,2034,658,1764,130,371,238,552,368,923
432170,202305,1895,4759,1329,3737,263,782,505,1264,768,2046
432180,202305,3687,8122,1929,4956,267,783,898,1979,1165,2762
432183,202305,503,1289,393,1071,73,240,209,516,282,756
432185,202305,1069,2473,663,1727,137,408,312,725,449,1133
432190,202305,2847,6174,2104,5061,168,517,1448,3161,1616,3678
432195,202305,1228,2957,763,2089,146,415,226,606,372,1021
432200,202305,4706,10455,3683,8920,300,793,2619,6034,2919,6827
432210,202305,506,1174,338,886,48,132,161,369,209,501
432215,202305,785,1985,615,1657,137,368,232,647,369,1015
432218,202305,253,587,125,331,13,41,47,95,60,136
432220,202305,4608,9755,3330,7709,572,1397,1853,4002,2425,5399
432225,202305,203,507,141,397,33,82,48,141,81,223
432230,202305,953,2169,459,1246,76,228,141,310,217,538
432232,202305,573,1331,382,997,65,189,188,435,253,624
432234,202305,316,761,186,500,36,92,53,123,89,215
432235,202305,60,134,35,84,6,17,20,39,26,56
432237,202305,358,840,315,769,17,36,263,636,280,672
432240,202305,21862,46876,16748,40263,1700,4123,11378,26856,13078,30979
432250,202305,9183,22286,7009,18187,1201,3538,3908,9369,5109,12907
432252,202305,563,1287,382,944,48,136,195,429,243,565
432253,202305,1152,2983,809,2185,237,681,185,438,422,1119
432254,202305,685,1583,216,607,28,90,42,84,70,174
432255,202305,123,305,82,225,9,28,38,88,47,116
432260,202305,7538,16940,5724,13807,1086,2932,3001,6461,4087,9393
432270,202305,2927,6936,2398,6043,751,1945,822,2027,1573,3972
432280,202305,1489,3580,824,2327,129,417,239,533,368,950
432285,202305,159,466,33,95,3,6,9,25,12,31
432290,202305,423,1027,277,728,67,211,101,211,168,422
432300,202305,40752,88772,32494,76317,2714,7834,23228,50837,25942,58671
432310,202305,1336,2851,1033,2378,134,278,770,1792,904,2070
432320,202305,186,428,111,296,19,58,40,85,59,143
432330,202305,216,488,93,280,21,61,16,49,37,110
432335,202305,199,564,77,265,6,18,12,31,18,49
432340,202305,401,953,212,601,30,85,82,220,112,305
432345,202305,1120,2032,952,1838,22,51,841,1577,863,1628
432350,202305,370,873,191,553,39,131,61,145,100,276
432360,202305,256,745,54,176,7,25,12,34,19,59
432370,202305,452,1018,241,651,26,76,122,314,148,390
432375,202305,604,1373,419,1019,151,394,106,253,257,647
432377,202305,207,605,48,171,4,14,12,32,16,46
432380,202305,2420,6263,1719,4956,295,950,790,2140,1085,3090
500020,202305,4310,9612,3026,7688,360,1086,1952,4716,2312,5802
500025,202305,1379,3176,916,2348,120,309,497,1215,617,1524
500060,202305,10496,26156,7673,20546,982,2848,4376,11278,5358,14126
500070,202305,6469,14592,4724,11807,881,2422,2247,5377,3128,7799
500080,202305,1882,4331,1202,3171,205,588,488,1144,693,1732
500085,202305,2604,5991,1816,4648,433,1206,719,1667,1152,2873
500090,202305,2455,5941,1724,4771,320,948,463,1351,783,2299
500100,202305,4965,11519,3729,9603,631,1772,1558,3697,2189,5469
500110,202305,13649,30577,9530,24124,2043,5555,4392,10605,6435,16160
500124,202305,2774,6931,2243,6136,371,983,1339,3684,1710,4667
500150,202305,1957,4093,1417,3375,237,612,763,1675,1000,2287
500190,202305,6329,15155,4269,11307,1002,2728,1306,3102,2308,5830
500200,202305,3365,7187,2197,5268,298,766,1191,2599,1489,3365
500210,202305,6396,13482,4669,11308,1284,3339,2313,5331,3597,8670
500215,202305,1778,4476,1272,3635,149,440,666,1877,815,2317
500220,202305,4348,10615,3262,8830,484,1389,1730,4314,2214,5703
500230,202305,2648,5806,2064,5005,322,827,1230,2858,1552,3685
500240,202305,5227,13928,3854,11236,558,1773,1554,4432,2112,6205
500260,202305,3928,7936,2631,6152,269,742,1646,3551,1915,4293
500270,202305,191007,416596,129155,320056,17590,50225,61981,136198,79571,186423
500280,202305,1717,3942,1126,3057,189,490,624,1693,813,2183
500290,202305,4582,10412,2856,7560,475,1483,1057,2424,1532,3907
500295,202305,5350,11859,3671,9064,595,1664,1630,3470,2225,5134
500310,202305,1292,2415,850,1875,145,247,441,969,586,1216
500315,202305,6133,13138,5112,11818,304,778,4277,9634,4581,10412
500320,202305,25785,62933,18311,50859,4506,12160,7589,22082,12095,34242
500325,202305,7828,15864,5677,12975,722,1842,3552,7642,4274,9484
500330,202305,8514,18008,5693,13964,654,1740,3102,7508,3756,9248
500345,202305,2751,6348,1881,4973,361,1006,630,1492,991,2498
500348,202305,2883,6647,2273,5660,251,685,1583,3800,1834,4485
500350,202305,1471,3768,846,2489,113,372,270,681,383,1053
500370,202305,35254,85101,26707,71627,3810,11631,13063,32964,16873,44595
500375,202305,3164,7902,1998,5589,261,799,698,1669,959,2468
500380,202305,4464,10437,3102,8186,870,2303,480,1285,1350,3588
500390,202305,911,1783,568,1381,94,254,369,893,463,1147
500400,202305,2042,4909,1409,3751,233,713,523,1209,756,1922
500410,202305,2927,6431,2062,5201,234,577,1111,2898,1345,3475
500430,202305,3526,8120,2425,6458,404,1084,898,2599,1302,3683
500440,202305,1998,4518,1128,3023,198,555,420,1125,618,1680
500450,202305,2443,5756,1556,4321,317,918,342,926,659,1844
500460,202305,4778,11726,2973,8338,548,1698,555,1418,1103,3116
500470,202305,3614,9021,2434,6760,581,1775,681,1551,1262,3326
500480,202305,2357,6790,1923,6121,204,691,1344,4317,1548,5008
500490,202305,1426,3243,875,2394,178,561,200,513,378,1074
500500,202305,4997,12436,3380,9949,1110,3850,327,932,1437,4782
500510,202305,873,2074,593,1582,71,209,346,823,417,1032
500515,202305,2013,4815,1553,4121,243,674,775,2037,1018,2711
500520,202305,4270,11155,3287,9525,715,2086,1613,4736,2328,6822
500525,202305,1245,3321,983,2932,142,446,537,1550,679,1996
500540,202305,6520,16047,3945,11571,1096,3629,610,1414,1706,5043
500560,202305,7200,17138,5951,15542,365,1031,4771,12408,5136,13439
500568,202305,5757,11802,3733,8784,886,2134,1507,3166,2393,5300
500570,202305,11335,24259,8080,19150,1064,2961,4754,10201,5818,13162
500580,202305,3892,9272,2801,7417,759,2067,1055,2731,1814,4798
500600,202305,4629,10818,3378,8848,827,2265,909,2270,1736,4535
500620,202305,10541,25021,7441,19490,1092,3043,3769,9106,4861,12149
500625,202305,696,1739,494,1366,74,240,214,535,288,775
500627,202305,966,2493,590,1809,113,377,143,394,256,771
500630,202305,9884,20858,5999,14779,1355,3684,1872,4109,3227,7793
500635,202305,3258,9724,2407,8516,366,1164,1453,5713,1819,6877
500640,202305,2151,4339,1506,3518,83,203,1048,2320,1131,2523
500660,202305,27582,62542,18941,50012,5359,14930,6485,16883,11844,31813
500690,202305,3464,8213,2374,6485,840,2550,747,1904,1587,4454
500710,202305,4216,10353,3004,8272,711,2151,782,1987,1493,4138
500720,202305,6354,15206,4249,11780,877,2616,1241,3159,2118,5775
500730,202305,1308,2965,758,2017,162,416,238,617,400,1033
500740,202305,5641,12661,3642,9621,927,2497,1215,3118,2142,5615
500750,202305,1429,3278,1043,2654,142,420,486,1084,628,1504
500755,202305,1402,3399,902,2485,162,490,255,586,417,1076
500769,202305,6483,15178,3600,9948,858,2429,458,1055,1316,3484
500770,202305,1690,4288,1241,3574,234,724,404,1127,638,1851
500780,202305,1589,3801,1038,2840,171,526,243,526,414,1052
500790,202305,9842,24338,7093,19450,1352,4089,2682,6966,4034,11055
500793,202305,2669,6300,1918,5009,400,1112,715,1643,1115,2755
500795,202305,3808,7948,3115,7056,525,1392,2237,4887,2762,6279
500797,202305,1038,2391,722,1827,245,681,209,484,454,1165
500800,202305,4404,9547,2856,7255,692,1972,752,1870,1444,3842
500830,202305,26938,61774,18292,46546,4143,11105,6363,14759,10506,25864
500840,202305,1779,4010,1152,2865,126,324,569,1253,695,1577
510010,202305,2161,4388,1605,3707,209,454,1079,2493,1288,2947
510020,202305,5188,12516,2795,7896,470,1343,730,1861,1200,3204
510025,202305,9515,21569,6349,16645,727,2070,3530,8658,4257,10728
510030,202305,3880,8091,2494,5945,206,518,1253,2929,1459,3447
510035,202305,1331,3424,859,2653,228,715,304,1004,532,1719
510040,202305,3020,6182,2284,5256,318,726,1375,3222,1693,3948
510050,202305,2797,5298,2028,4354,226,587,1466,3001,1692,3588
510060,202305,1935,4690,1334,3594,347,988,286,638,633,1626
510080,202305,1931,4627,1256,3525,209,652,457,1066,666,1718
510100,202305,851,1767,624,1443,67,174,389,815,456,989
510120,202305,327,557,197,409,11,30,154,296,165,326
510125,202305,2611,6250,1971,5234,271,843,844,1952,1115,2795
510130,202305,2074,4724,1488,3844,290,840,740,1756,1030,2596
510140,202305,3686,9292,2568,7761,1100,3611,653,2009,1753,5620
510160,202305,2554,5466,1969,4717,68,177,1753,4178,1821,4355
510170,202305,6270,14793,4841,12586,855,2506,2480,6036,3335,8542
510180,202305,18768,38338,13109,30696,1910,4797,7018,16373,8928,21170
510185,202305,2085,5161,1420,4199,491,1538,452,1489,943,3027
510190,202305,3133,8113,1997,6246,459,1564,516,1569,975,3133
510250,202305,22518,51348,16820,42986,2496,7025,9642,24156,12138,31181
510260,202305,2246,9067,1886,8480,246,1061,1215,6063,1461,7124
510263,202305,5005,13018,3422,9950,638,2012,819,1916,1457,3928
510267,202305,7169,19392,4245,12873,741,2424,813,2044,1554,4468
510268,202305,1543,3821,1054,2994,255,757,218,559,473,1316
510269,202305,1185,3005,782,2274,155,497,321,856,476,1353
510270,202305,3623,9755,2567,7964,433,1468,1012,3041,1445,4509
510279,202305,2253,5454,1299,3746,194,602,395,993,589,1595
510285,202305,1303,3187,829,2362,209,660,260,652,469,1312
510300,202305,5198,11396,3989,9819,285,728,2955,7165,3240,7893
510305,202305,1858,4775,1287,3784,297,881,442,1283,739,2164
510310,202305,1354,3099,982,2512,269,663,364,945,633,1608
510320,202305,5143,11716,3512,9103,789,2318,1048,2366,1837,4684
510325,202305,5341,14548,3666,11346,867,2928,679,1977,1546,4905
510330,202305,3302,8568,2279,6899,623,1995,925,2777,1548,4772
510335,202305,6189,16120,4772,13880,1020,3199,2366,6753,3386,9952
510336,202305,658,1739,486,1484,64,182,274,899,338,1081
510337,202305,1783,4746,1178,3683,413,1399,281,797,694,2196
510340,202305,126758,266091,89322,213893,17248,47867,41311,88870,58559,136737
510343,202305,1550,3432,1066,2689,136,367,586,1396,722,1763
510345,202305,1720,4161,1307,3457,244,711,691,1634,935,2345
510350,202305,3987,9585,2667,7441,777,2234,617,1673,1394,3907
510360,202305,2273,4282,1410,3281,51,105,1046,2515,1097,2620
510370,202305,2239,5850,1745,5121,332,954,998,3041,1330,3995
510380,202305,666,1510,404,1087,54,170,173,438,227,608
510385,202305,1535,4715,1184,4109,106,403,806,2879,912,3282
510390,202305,1818,3995,1278,3368,246,695,792,2048,1038,2743
510395,202305,839,1699,575,1344,44,86,380,900,424,986
510410,202305,6753,16340,5133,13789,697,1919,3296,8826,3993,10745
510420,202305,3329,6064,2341,4781,60,137,1882,3736,1942,3873
510450,202305,629,1424,379,1024,84,231,146,361,230,592
510452,202305,1205,3064,938,2574,145,396,548,1506,693,1902
510454,202305,1467,3543,1020,2805,183,489,555,1627,738,2116
510455,202305,1159,2938,755,2182,154,496,263,674,417,1170
510460,202305,2440,5730,1738,4689,618,1916,499,968,1117,2884
510480,202305,6133,13903,4072,10248,736,2050,1799,3990,2535,6040
510490,202305,2171,4979,1647,4323,228,589,1060,2849,1288,3438
510500,202305,1773,4054,1080,2993,260,774,267,709,527,1483
510510,202305,5045,12971,3501,10403,1053,3451,1004,2869,2057,6320
510515,202305,6753,16427,4753,13057,919,2686,1853,4691,2772,7377
510517,202305,2048,4862,1436,3988,502,1567,456,1132,958,2699
510520,202305,2770,5479,1520,3827,215,576,618,1601,833,2177
510523,202305,1407,3127,1020,2540,173,467,581,1355,754,1822
510525,202305,10692,27631,7837,22159,1604,4859,2729,6972,4333,11831
510530,202305,705,1666,539,1437,37,105,393,1029,430,1134
510550,202305,3199,8437,2445,7172,494,1532,1263,3568,1757,5100
510558,202305,2826,7141,2061,5974,319,867,1007,3092,1326,3959
510560,202305,2442,6561,1571,4861,375,1245,255,797,630,2042
510562,202305,7726,16671,5783,13523,956,2433,2996,6357,3952,8790
510590,202305,4067,9191,3000,7814,327,887,2121,5463,2448,6350
510600,202305,1602,3200,1125,2553,251,722,539,1000,790,1722
510610,202305,3473,7660,2472,6327,332,1000,1508,3693,1840,4693
510615,202305,3546,8321,2496,6706,476,1384,1293,3361,1769,4745
510617,202305,1327,3636,1079,3274,146,462,766,2396,912,2858
510618,202305,1609,3850,1161,3163,217,700,611,1549,828,2249
510619,202305,907,2211,514,1493,114,333,103,220,217,553
510620,202305,1728,3657,834,2266,294,911,80,160,374,1071
510621,202305,1964,4949,1191,3557,291,921,301,771,592,1692
510622,202305,7112,18334,4528,13061,1262,3863,632,1513,1894,5376
510623,202305,3402,7756,2483,6382,523,1444,970,2361,1493,3805
510624,202305,1871,4713,1059,3229,132,465,205,532,337,997
510625,202305,4546,10240,2833,7358,582,1653,938,2345,1520,3998
510626,202305,1623,3865,1119,3086,306,961,265,675,571,1636
510627,202305,807,1936,465,1306,126,381,122,359,248,740
510628,202305,1722,3639,1106,2862,388,1132,360,822,748,1954
510629,202305,2238,5772,1419,4236,334,1110,300,823,634,1933
510630,202305,4210,10742,2744,8223,657,2027,657,2147,1314,4174
510631,202305,728,1587,563,1355,25,55,449,1092,474,1147
510637,202305,4445,9823,3216,8130,932,2645,1054,2457,1986,5102
510642,202305,7231,18156,5656,15941,1046,3351,3218,8704,4264,12055
510645,202305,1238,2358,750,1725,189,423,326,760,515,1183
510650,202305,9642,20911,7531,18599,984,1529,5418,14843,6402,16372
510665,202305,2099,4317,1347,3169,294,660,539,1339,833,1999
510670,202305,489,1035,318,806,39,99,175,441,214,540
510675,202305,8350,21336,5719,16521,1431,4623,1147,2843,2578,7466
510677,202305,2703,6551,1968,5455,344,1025,1120,3030,1464,4055
510680,202305,869,2117,471,1415,84,278,117,296,201,574
510682,202305,2133,5544,1620,4735,474,1549,629,1735,1103,3284
510685,202305,639,1639,473,1339,45,124,276,774,321,898
510700,202305,5334,11685,3740,9442,397,1173,2500,6032,2897,7205
510704,202305,14411,31910,9846,24552,2347,6360,3232,7121,5579,13481
510706,202305,3130,8547,2236,7028,442,1404,937,3099,1379,4503
510710,202305,3717,8532,2359,6104,681,1750,542,1259,1223,3009
510715,202305,795,1607,500,1191,44,115,319,733,363,848
510718,202305,2673,6022,1683,4666,324,919,793,2435,1117,3354
510719,202305,581,1174,344,839,53,149,160,321,213,470
510720,202305,1106,2371,755,1895,158,452,334,746,492,1198
510724,202305,1076,2892,732,2220,99,353,311,838,410,1191
510726,202305,1066,1969,649,1465,67,145,382,843,449,988
510729,202305,726,1599,343,913,44,120,103,269,147,389
510730,202305,3609,8166,2531,6566,474,1429,1281,2946,1755,4375
510735,202305,1669,4288,1377,3859,134,355,1081,3056,1215,3411
510740,202305,1178,2630,808,2009,70,191,513,1141,583,1332
510757,202305,641,1928,500,1690,129,497,209,662,338,1159
510760,202305,56248,118022,35266,86952,7848,21635,11619,24877,19467,46512
510770,202305,5310,10626,3878,8849,220,499,2885,6605,3105,7104
510774,202305,539,1312,383,1080,68,203,211,593,279,796
510775,202305,826,1983,523,1510,116,356,129,346,245,702
510776,202305,972,2346,661,1755,127,365,311,795,438,1160
510777,202305,1710,4302,1226,3672,246,845,686,1916,932,2761
510779,202305,1025,2605,760,2175,101,270,458,1373,559,1643
510780,202305,5453,12317,3956,10187,707,1787,2055,5573,2762,7360
510785,202305,2473,6069,1458,4244,338,1025,449,1257,787,2282
510787,202305,4476,11719,3118,9144,1120,3416,321,832,1441,4248
510788,202305,592,1336,396,1035,65,155,185,531,250,686
510790,202305,25049,61452,16081,45929,3438,10836,1645,4068,5083,14904
510792,202305,14021,36564,9304,27643,2217,7177,2065,5307,4282,12484
510794,202305,1516,3944,1108,3281,317,1041,165,367,482,1408
510795,202305,14214,33414,10159,26716,2253,6573,3716,8692,5969,15265
510800,202305,1837,4674,1290,3767,375,1188,168,361,543,1549
510805,202305,1835,4766,1162,3543,238,762,388,1088,626,1850
510810,202305,829,1593,549,1230,169,335,270,649,439,984
510820,202305,914,1678,549,1224,25,64,380,792,405,856
510830,202305,1070,2427,825,2110,112,319,531,1382,643,1701
510835,202305,737,1592,481,1235,63,181,293,711,356,892
510840,202305,81090,158045,59991,132719,9605,20887,36748,81509,46353,102396
510850,202305,2213,5454,1381,4086,323,1066,105,212,428,1278
510860,202305,3342,8155,2267,6511,807,2504,458,1275,1265,3779
510880,202305,888,2377,634,1931,222,702,106,306,328,1008
510885,202305,783,1826,513,1409,106,272,133,362,239,634
510890,202305,1043,2720,749,2206,219,705,168,447,387,1152
510895,202305,1828,4354,1237,3346,240,757,585,1382,825,2139
520005,202305,4885,11772,3935,10506,1277,3191,1422,4482,2699,7673
520010,202305,3750,9173,2765,7315,615,1807,1115,2537,1730,4344
520013,202305,4509,10563,2940,7757,789,2084,756,2082,1545,4166
520015,202305,618,1469,455,1228,104,270,160,467,264,737
520017,202305,1551,3589,1061,2809,193,584,447,1049,640,1633
520020,202305,699,1238,538,1057,55,104,414,793,469,897
520025,202305,50452,121830,43355,111822,6848,18558,27029,68177,33877,86735
520030,202305,9106,19043,7643,17119,617,1346,5877,12965,6494,14311
520050,202305,520,1183,288,758,60,151,113,295,173,446
520055,202305,2072,4841,1259,3197,212,517,506,1182,718,1699
520060,202305,2456,5795,1679,4496,336,996,432,1098,768,2094
520080,202305,2334,5392,1791,4677,386,969,841,2260,1227,3229
520082,202305,1019,2437,696,1869,154,451,238,645,392,1096
520085,202305,1263,2889,1029,2581,236,599,487,1183,723,1782
520090,202305,1090,1972,822,1688,116,159,628,1362,744,1521
520110,202305,56141,138013,38875,109300,10548,32113,2803,6619,13351,38732
520120,202305,318,701,177,461,28,87,70,157,98,244
520130,202305,4966,10907,3772,9017,783,1953,1516,3423,2299,5376
520140,202305,65576,159690,46378,128087,15292,45615,5480,14804,20772,60419
520145,202305,745,1606,463,1187,105,287,153,344,258,631
520150,202305,884,1999,679,1739,92,225,375,927,467,1152
520160,202305,1099,2506,736,1862,130,316,315,806,445,1122
520170,202305,5793,11703,3891,9321,528,1372,2436,5576,2964,6948
520180,202305,3558,8062,2913,7186,381,1075,1937,4587,2318,5662
520215,202305,2230,4897,1687,4122,187,537,1080,2491,1267,3028
520235,202305,947,1858,626,1430,107,267,389,844,496,1111
520250,202305,2242,5181,1620,4261,648,1905,156,463,804,2368
520260,202305,902,2027,553,1459,110,286,182,469,292,755
520280,202305,1044,2164,825,1858,222,504,367,815,589,1319
520310,202305,1116,2281,762,1776,170,470,359,809,529,1279
520320,202305,2659,6295,1944,5162,280,760,967,2599,1247,3359
520330,202305,6455,15068,5086,12861,790,2301,2961,6929,3751,9230
520340,202305,2785,5679,1674,4111,189,423,810,2089,999,2512
520350,202305,4416,9978,3002,7800,989,2658,800,2092,1789,4750
520355,202305,2265,5808,1701,4764,530,1603,250,612,780,2215
520357,202305,1097,2367,803,1962,64,160,604,1452,668,1612
520360,202305,1004,2314,793,1981,129,383,392,887,521,1270
520380,202305,1680,3988,998,2736,175,469,265,634,440,1103
520390,202305,1420,3181,934,2493,251,774,174,476,425,1250
520393,202305,877,1871,612,1487,89,236,293,647,382,883
520396,202305,1086,2459,915,2198,64,147,629,1446,693,1593
520400,202305,2025,4400,1580,3814,113,276,1135,2753,1248,3029
520410,202305,2730,5588,1938,4439,280,728,1112,2357,1392,3085
520420,202305,456,948,366,813,20,56,274,581,294,637
520425,202305,1897,4379,1065,2814,293,843,202,421,495,1264
520430,202305,3047,6729,1862,4754,368,963,322,694,690,1657
520440,202305,3700,8496,2160,5760,441,1310,448,1110,889,2420
520450,202305,18251,40878,12705,32196,3287,8691,3453,8402,6740,17093
520455,202305,1005,2397,710,1967,197,563,201,575,398,1138
520460,202305,1291,2813,992,2413,247,552,507,1297,754,1849
520465,202305,1092,2346,912,2117,51,147,709,1606,760,1753
520470,202305,3062,6826,2400,6004,776,2137,961,2332,1737,4469
520480,202305,1267,3159,956,2654,218,617,407,1091,625,1708
520485,202305,1900,5220,1560,4689,277,889,854,2498,1131,3387
520490,202305,5496,12895,4237,11030,703,1957,2448,6150,3151,8107
520495,202305,2001,3835,1519,3198,126,279,1117,2304,1243,2583
520500,202305,2232,4984,1683,4072,310,856,859,1849,1169,2705
520505,202305,1185,2222,939,1925,106,176,713,1469,819,1645
520510,202305,12852,29065,9939,24701,1674,4886,5126,11665,6800,16551
520520,202305,1407,3329,1121,2902,312,869,451,1112,763,1981
520530,202305,3248,7822,2330,6262,444,1190,1072,3054,1516,4244
520540,202305,3787,9124,2610,6975,458,1332,883,2063,1341,3395
520545,202305,1860,4185,1424,3537,360,892,546,1321,906,2213
520547,202305,1829,4337,1426,3662,301,759,713,1812,1014,2571
520549,202305,21961,50528,18293,45330,2298,6314,12181,28794,14479,35108
520551,202305,6549,14705,5443,13152,463,1370,4100,9398,4563,10768
520552,202305,1218,2880,959,2507,260,695,417,1137,677,1832
520570,202305,681,1434,431,1053,71,155,196,467,267,622
520580,202305,2868,5730,2084,4840,460,1062,1079,2530,1539,3592
520590,202305,1701,3948,1190,3115,253,686,474,1189,727,1875
520620,202305,12426,28997,10169,25862,1862,5118,5795,14280,7657,19398
520630,202305,1059,2460,767,2010,113,302,321,821,434,1123
520640,202305,2761,6288,2038,5016,523,1326,563,1433,1086,2759
520650,202305,1305,2587,975,2146,213,437,512,1176,725,1613
520660,202305,585,1439,363,1043,82,250,90,262,172,512
520670,202305,1214,2814,990,2488,90,197,679,1671,769,1868
520680,202305,1048,2236,839,1954,132,264,525,1241,657,1505
520690,202305,423,1024,298,799,83,223,90,212,173,435
520710,202305,548,1236,374,948,21,61,227,528,248,589
520725,202305,1645,3719,1114,2841,220,585,468,1155,688,1740
520735,202305,1156,2489,777,1901,244,570,221,540,465,1110
520740,202305,3238,6897,2284,5568,466,1174,1001,2398,1467,3572
520750,202305,920,1908,673,1564,114,258,370,818,484,1076
520753,202305,1603,3824,1222,3183,225,659,595,1403,820,2062
520760,202305,1847,3512,1556,3172,29,64,1435,2921,1464,2985
520780,202305,1966,4346,1456,3632,233,594,736,1783,969,2377
520790,202305,3902,8659,2671,6695,420,982,1400,3663,1820,4645
520800,202305,24068,54727,18914,47197,3547,9026,10363,25804,13910,34830
520810,202305,1419,2894,1063,2478,295,705,473,1162,768,1867
520815,202305,706,2028,520,1633,96,303,152,480,248,783
520830,202305,2165,4357,1584,3664,93,222,1211,2744,1304,2966
520840,202305,3656,8953,2923,7975,798,2376,911,2400,1709,4776
520850,202305,1157,2359,866,1959,166,431,422,899,588,1330
520860,202305,12178,29640,9016,24249,2328,6661,3027,7599,5355,14260
520870,202305,197094,419958,145331,343196,27648,69917,68218,149570,95866,219487
520880,202305,12455,32423,10025,28149,2139,6145,4190,11346,6329,17491
520890,202305,6142,12509,4365,9891,691,1867,2361,4866,3052,6733
520910,202305,5776,13487,3894,10272,899,2511,964,2287,1863,4798
520915,202305,1028,2455,706,1844,136,393,312,748,448,1141
520920,202305,5497,11335,4197,9767,866,1865,2293,5525,3159,7390
520929,202305,772,1711,594,1455,105,204,257,671,362,875
520940,202305,1186,2887,934,2508,94,283,674,1736,768,2019
520945,202305,583,1208,420,988,42,93,246,572,288,665
520960,202305,1422,2916,1097,2472,407,875,382,940,789,1815
520970,202305,4765,11220,3541,9344,1216,3291,743,2038,1959,5329
520980,202305,933,1987,697,1682,100,250,345,783,445,1033
520990,202305,3886,8438,3184,7588,523,1128,2158,5268,2681,6396
520993,202305,1471,3380,989,2492,291,734,300,711,591,1445
520995,202305,3201,7417,2307,6054,573,1666,480,1344,1053,3010
521000,202305,12044,28638,8222,21633,1370,3738,2723,6545,4093,10283
521010,202305,4993,11648,3711,9436,577,1647,1911,4477,2488,6124
521015,202305,961,2205,680,1717,40,110,446,1050,486,1160
521020,202305,5965,13527,3687,9544,870,2316,936,2291,1806,4607
521030,202305,1015,1713,792,1422,21,42,692,1202,713,1244
521040,202305,10738,24565,7929,20239,2088,5438,2301,6018,4389,11456
521056,202305,1298,3177,886,2475,255,699,153,446,408,1145
521060,202305,1230,2968,857,2298,195,573,278,709,473,1282
521080,202305,1263,2590,702,1752,137,347,235,544,372,891
521090,202305,3808,9653,2571,7161,615,1897,262,641,877,2538
521100,202305,2430,4934,1819,4135,246,594,1152,2595,1398,3189
521120,202305,6139,13824,4743,12007,1407,3614,1122,3231,2529,6845
521130,202305,1283,2878,624,1659,70,209,317,823,387,1032
521140,202305,2072,4718,1539,3830,189,482,930,2178,1119,2660
521150,202305,17983,37925,11968,29174,3116,8410,4666,10639,7782,19049
521160,202305,1035,1977,669,1415,67,127,438,872,505,999
521170,202305,1332,2902,969,2339,169,461,411,894,580,1355
521180,202305,10905,25747,8512,21881,1847,5169,3799,9375,5646,14544
521190,202305,14643,34088,9678,26067,2306,6773,2958,7258,5264,14031
521200,202305,871,1988,595,1555,103,281,247,575,350,856
521205,202305,772,1664,598,1405,30,75,466,1044,496,1119
521210,202305,1071,2650,620,1743,170,507,138,296,308,803
521220,202305,4755,10438,3267,8117,837,2401,1288,2759,2125,5160
521225,202305,533,1018,406,880,40,80,305,666,345,746
521230,202305,1827,4216,1517,3805,648,1720,448,1083,1096,2803
521250,202305,47226,107793,38742,96334,8805,23900,20992,49577,29797,73477
521260,202305,653,1358,486,1121,73,198,268,567,341,765
521270,202305,2687,5865,2222,5271,238,517,1587,3850,1825,4367
521280,202305,2230,5515,1682,4650,348,1018,606,1600,954,2618
521290,202305,707,1489,485,1202,50,136,285,656,335,792
521295,202305,1473,2998,1093,2501,190,438,593,1258,783,1696
521300,202305,2272,5127,1735,4336,362,897,874,2181,1236,3078
521305,202305,813,1737,562,1394,53,141,363,863,416,1004
521308,202305,5919,14302,4177,11198,372,1112,2588,6525,2960,7637
521310,202305,13966,32584,9723,25128,2063,5815,3616,8447,5679,14262
521340,202305,529,1109,349,862,31,69,181,420,212,489
521350,202305,2353,5608,1815,4795,124,352,1302,3360,1426,3712
521370,202305,1591,3874,1061,3019,345,1050,155,464,500,1514
521375,202305,2061,5032,1400,3849,285,774,344,976,629,1750
521377,202305,1600,3213,1185,2697,155,300,830,2009,985,2309
521380,202305,8171,20258,5319,15188,916,2838,939,2666,1855,5504
521385,202305,869,1919,650,1639,98,233,345,929,443,1162
521390,202305,886,2141,589,1665,140,466,119,284,259,750
521400,202305,3778,8161,3020,7145,457,1105,1824,4227,2281,5332
521405,202305,1653,4082,1108,3065,134,401,530,1377,664,1778
521410,202305,1141,2475,914,2149,219,461,474,1175,693,1636
521440,202305,1742,3959,1353,3378,406,968,588,1508,994,2476
521450,202305,5336,14399,4028,11894,1059,3211,913,2654,1972,5865
521460,202305,8128,18937,5599,14535,1471,3995,1717,4285,3188,8280
521470,202305,1055,2416,744,1865,139,320,348,828,487,1148
521480,202305,642,1308,448,1005,67,164,244,468,311,632
521483,202305,2798,6296,2060,5206,660,1674,681,1741,1341,3415
521486,202305,2115,4736,1647,4058,148,286,1051,2562,1199,2848
521487,202305,598,1291,450,1100,94,222,259,629,353,851
521490,202305,1031,2493,779,2098,41,144,552,1384,593,1528
521500,202305,2441,5950,1939,5229,226,780,1101,2743,1327,3523
521520,202305,1051,2215,825,1905,113,233,506,1161,619,1394
521523,202305,19069,50079,14851,42326,4600,13508,5530,15064,10130,28572
521525,202305,1308,2896,991,2438,109,332,628,1445,737,1777
521530,202305,2733,6727,1792,4901,354,979,517,1294,871,2273
521540,202305,898,2169,680,1814,175,520,271,660,446,1180
521550,202305,2172,5110,1145,3078,218,621,254,714,472,1335
521560,202305,7341,17019,5341,14260,1562,4341,2037,5595,3599,9936
521565,202305,839,1935,577,1509,109,294,253,635,362,929
521570,202305,5536,13716,3894,10774,857,2585,545,1493,1402,4078
521580,202305,683,1493,446,1098,85,228,179,396,264,624
521590,202305,1103,2221,801,1815,110,265,484,1036,594,1301
521600,202305,547,1308,319,885,58,188,138,324,196,512
521630,202305,2131,4293,1314,3130,424,1053,326,691,750,1744
521640,202305,2411,5377,1557,4070,356,1058,420,981,776,2039
521645,202305,640,1555,355,1031,158,441,21,49,179,490
521680,202305,1767,4356,1391,3766,375,1023,561,1497,936,2520
521690,202305,642,1503,533,1360,83,224,290,718,373,942
521710,202305,4292,9683,2883,7345,523,1467,819,1784,1342,3251
521720,202305,3055,6412,1940,4717,257,677,1031,2413,1288,3090
521730,202305,5322,13112,3815,10592,1033,3212,822,1851,1855,5063
521740,202305,5955,13743,4779,12055,1703,4700,1419,3100,3122,7800
521760,202305,24350,55415,20136,49695,4157,11622,11420,26453,15577,38075
521770,202305,4035,8802,2620,6661,507,1327,565,1401,1072,2728
521800,202305,8991,21265,6415,17178,2069,5688,1628,4766,3697,10454
521805,202305,1413,2764,921,2113,185,386,437,1078,622,1464
521810,202305,935,1996,685,1657,122,298,407,986,529,1284
521830,202305,7632,18520,6253,16403,592,1798,4376,11020,4968,12818
521839,202305,1092,2319,852,1949,80,223,607,1276,687,1499
521850,202305,8938,19359,5749,14515,1857,4751,696,1609,2553,6360
521860,202305,2028,5198,1433,4098,274,858,407,1040,681,1898
521870,202305,910,2291,666,1854,127,400,253,595,380,995
521878,202305,1071,2587,692,1849,67,192,365,896,432,1088
521880,202305,32124,72771,23554,59620,4980,13610,10466,24653,15446,38263
521890,202305,4194,9859,2875,7656,786,2123,739,1823,1525,3946
521900,202305,1749,3868,964,2557,280,643,42,113,322,756
521910,202305,1690,3550,1260,3009,318,742,466,1067,784,1809
521920,202305,687,1603,535,1361,65,203,330,771,395,974
521925,202305,1055,2436,776,2029,165,460,350,871,515,1331
521930,202305,6902,15589,4660,12306,1425,3261,1739,5050,3164,8311
521935,202305,1241,2801,862,2168,100,257,501,1199,601,1456
521940,202305,1601,3315,1102,2614,200,514,590,1339,790,1853
521945,202305,825,1912,561,1456,113,273,269,703,382,976
521950,202305,920,2001,642,1575,117,282,292,705,409,987
521960,202305,811,1948,563,1490,68,217,325,771,393,988
521970,202305,3461,7208,2653,6196,307,647,1847,4408,2154,5055
521971,202305,943,2180,643,1683,153,393,162,395,315,788
521973,202305,2099,5029,1521,4037,214,566,837,2146,1051,2712
521975,202305,17853,40982,14697,36557,2551,6957,8796,20961,11347,27918
521980,202305,2747,6012,2066,5099,153,418,1538,3738,1691,4156
521990,202305,1769,3962,1479,3576,287,746,875,2148,1162,2894
522000,202305,3200,7663,2469,6724,951,2770,734,2062,1685,4832
522005,202305,523,1072,316,784,55,152,111,255,166,407
522010,202305,5992,13879,4253,11022,1011,2756,1408,3421,2419,6177
522015,202305,1331,3188,1010,2706,282,770,389,1005,671,1775
522020,202305,6807,14728,4637,11486,1017,2659,2021,4918,3038,7577
522026,202305,934,2288,630,1740,113,358,201,478,314,836
522028,202305,655,1469,445,1102,67,203,230,500,297,703
522040,202305,4737,9529,3318,7607,518,1294,1876,3883,2394,5177
522045,202305,26886,67598,20508,57155,4769,14188,5357,14103,10126,28291
522050,202305,1504,3564,1088,2867,209,618,469,1068,678,1686
522060,202305,3930,9561,2851,7832,597,1582,1160,3198,1757,4780
522068,202305,2271,4896,1856,4408,147,290,1458,3518,1605,3808
522070,202305,1061,2061,866,1791,29,56,741,1497,770,1553
522100,202305,1122,2599,728,1935,119,330,307,763,426,1093
522108,202305,1449,2938,1147,2534,58,153,905,1907,963,2060
522119,202305,2485,5275,2034,4739,316,658,1256,2962,1572,3620
522130,202305,678,1502,533,1310,38,87,407,1016,445,1103
522140,202305,31967,75338,22748,59292,5115,14224,6746,15845,11861,30069
522145,202305,927,2082,671,1706,152,421,337,818,489,1239
522150,202305,1364,2989,932,2328,218,536,280,690,498,1226
522155,202305,1210,2903,924,2447,148,373,480,1258,628,1631
522157,202305,924,1822,756,1625,48,100,576,1240,624,1340
522160,202305,7845,18496,5273,14127,1380,4027,554,1519,1934,5546
522170,202305,3399,8061,2668,6962,419,1083,1579,4092,1998,5175
522180,202305,912,1945,592,1391,132,312,179,429,311,741
522185,202305,32189,72482,23828,61515,9947,28199,3777,10100,13724,38299
522190,202305,1005,2117,672,1616,123,330,323,677,446,1007
522200,202305,2658,6654,1984,5484,522,1443,709,1936,1231,3379
522205,202305,1986,4541,1456,3746,548,1517,316,710,864,2227
522220,202305,1494,3226,1094,2712,152,378,637,1616,789,1994
522230,202305,1661,3647,1291,3112,174,468,783,1817,957,2285
530010,202305,357303,832350,302783,750628,45225,121139,180351,424490,225576,545629
110001,202304,4765,12378,3206,9472,777,2565,973,2714,1750,5279
110002,202304,17713,41676,12969,33954,3346,9499,3705,9162,7051,18661
110003,202304,894,2455,653,1981,160,514,139,368,299,882
110004,202304,17671,41325,12179,32152,2721,7675,4250,10603,6971,18278
110005,202304,3005,7421,2197,6138,538,1551,680,1917,1218,3468
110006,202304,1801,4762,1128,3414,202,676,214,587,416,1263
110007,202304,1499,3579,940,2637,264,763,183,557,447,1320
110008,202304,4292,9968,3206,8487,658,1544,1763,5245,2421,6789
110009,202304,5515,14283,3575,10823,790,2616,1220,3455,2010,6071
110010,202304,10119,27796,7833,23865,2000,5555,3492,12253,5492,17808
110011,202304,9484,23002,6601,18066,1866,5383,1429,3692,3295,9075
110012,202304,22076,51062,14844,39254,3838,10405,3763,9314,7601,19719
110013,202304,7242,18968,5004,14720,1873,5923,811,2360,2684,8283
110014,202304,4661,11269,3114,8437,539,1575,1400,3631,1939,5206
110015,202304,7518,17691,4904,13060,1108,3364,1455,3119,2563,6483
110018,202304,5679,13303,3619,9751,776,2218,856,2007,1632,4225
110020,202304,117880,246269,90678,210211,19371,46748,47561,109581,66932,156329
110025,202304,5862,13271,4179,10500,664,1885,2182,5130,2846,7015
110026,202304,691,1727,486,1376,122,372,140,410,262,782
110028,202304,9092,21545,5800,15930,1520,4686,591,1528,2111,6214
110029,202304,1929,4463,1190,3240,224,613,473,1268,697,1881
110030,202304,17768,39083,11233,29346,3301,9398,1502,3878,4803,13276
110032,202304,4541,11592,2762,8101,900,2692,462,1387,1362,4079
110033,202304,5760,15622,4365,13078,1347,4139,1454,4570,2801,8709
110034,202304,3822,8591,2569,6810,942,2769,580,1629,1522,4398
110037,202304,1832,5139,1270,4077,361,1211,343,1079,704,2290
110040,202304,3530,9088,2523,7342,683,2167,592,1554,1275,3721
110045,202304,5558,14722,4064,12094,1189,3860,1288,3727,2477,7587
110050,202304,2057,5199,1341,3971,454,1530,147,333,601,1863
110060,202304,1144,3154,748,2251,201,609,158,466,359,1075
110070,202304,1796,5109,1268,3986,359,1228,299,791,658,2019
110080,202304,7956,17724,5956,15054,1393,3670,2847,7330,4240,11000
110090,202304,718,1840,505,1452,125,423,144,384,269,807
110092,202304,1658,4442,1195,3599,297,919,579,1736,876,2655
110094,202304,3437,9287,2536,7625,908,2900,402,1251,1310,4151
110100,202304,2103,5552,1658,4781,620,1885,489,1405,1109,3290
110110,202304,2166,5421,1550,4453,462,1449,276,849,738,2298
110120,202304,1622,4247,1131,3318,291,896,295,834,586,1730
110130,202304,3250,7584,1999,5421,437,1232,231,617,668,1849
110140,202304,3020,7852,2274,6485,487,1543,1029,2772,1516,4315
110143,202304,1704,4344,1246,3556,338,1083,392,1035,730,2118
110145,202304,1116,2738,683,1924,188,522,251,738,439,1260
110146,202304,638,1580,425,1224,136,376,135,421,271,797
110147,202304,952,2249,635,1690,89,267,311,724,400,991
110148,202304,1156,2954,606,1794,133,437,67,137,200,574
110149,202304,4292,10167,2941,8071,1000,2871,657,1864,1657,4735
110150,202304,3010,7354,1945,5656,617,1974,266,810,883,2784
110155,202304,1041,2794,710,2017,144,466,295,742,439,1208
110160,202304,1766,4864,1261,3823,447,1406,186,539,633,1945
110170,202304,2472,5852,1618,4341,267,812,906,2231,1173,3043
110175,202304,2655,6889,1822,5191,339,1071,798,2137,1137,3208
110180,202304,1614,3999,1120,3099,266,793,364,929,630,1722
120001,202304,4308,10852,3482,9633,528,1702,2255,6017,2783,7719
120005,202304,2443,8270,2187,7853,268,971,1604,5905,1872,6876
120010,202304,7583,18052,6730,16917,625,1437,5243,13284,5868,14721
120013,202304,3117,8820,2667,8195,913,2729,1062,3692,1975,6421
120017,202304,3752,8983,3152,8165,439,1094,2069,5632,2508,6726
120020,202304,19620,60004,18144,57477,1307,4507,14344,45217,15651,49724
120025,202304,4604,10322,3817,9435,584,1447,2491,6432,3075,7879
120030,202304,7618,27186,7054,26264,540,2217,5275,20235,5815,22452
120032,202304,2119,8341,1996,8101,102,639,1683,6689,1785,7328
120033,202304,5427,16059,5090,15501,126,559,4491,13437,4617,13996
120034,202304,3626,10764,3151,10005,168,690,2620,8165,2788,8855
120035,202304,5166,15942,4799,15338,252,929,4152,13157,4404,14086
120038,202304,4050,10355,3461,9478,566,1643,2086,5819,2652,7462
120039,202304,2516,9459,2286,8960,125,658,1810,7004,1935,7662
120040,202304,77623,186758,67228,171902,8739,23719,44534,112057,53273,135776
120042,202304,4403,13191,4041,12574,199,768,3351,10277,3550,11045
120043,202304,1814,6393,1530,5980,61,386,1273,4889,1334,5275
120045,202304,7369,16680,6195,15250,627,1633,4603,11327,5230,12960
120050,202304,12330,36286,11397,35005,521,1904,9673,29673,10194,31577
120060,202304,12254,40363,11232,38887,502,2316,9637,33147,10139,35463
120070,202304,4309,11831,3701,11000,670,1881,2235,7094,2905,8975
120080,202304,6957,15985,6243,15014,720,1725,4779,11509,5499,13234
130002,202304,4197,13365,3693,12697,395,1037,2999,10880,3394,11917
130006,202304,3194,9889,2646,9052,581,1854,1547,5800,2128,7654
130008,202304,3262,9829,2797,9181,208,676,2178,7412,2386,8088
130010,202304,5387,12679,4690,11885,155,373,4255,10806,4410,11179
130014,202304,4897,12254,3646,10382,771,2224,1944,5837,2715,8061
130020,202304,3360,11936,2926,11332,152,847,2330,8885,2482,9732
130030,202304,19850,40575,18579,39167,182,474,17832,37258,18014,37732
130040,202304,4959,13334,4082,12239,614,1744,2886,8989,3500,10733
130050,202304,8698,28776,7598,27348,546,1841,6351,23397,6897,25238
130060,202304,8797,31752,7559,30129,381,2141,6378,25007,6759,27148
130063,202304,7831,22683,6955,21682,204,848,6333,19663,6537,20511
130068,202304,4749,13374,3987,12387,234,929,3195,9848,3429,10777
130070,202304,9000,23196,7425,21470,814,1965,5562,16877,6376,18842
130080,202304,9458,27752,8153,26253,400,1159,7028,23048,7428,24207
130083,202304,3570,10065,3114,9510,281,861,2488,7825,2769,8686
130090,202304,5078,12407,4520,11773,92,218,4004,10738,4096,10956
130100,202304,9091,25298,7619,23733,156,425,7011,22123,7167,22548
130110,202304,10959,26166,8960,23689,1805,4287,5516,16050,7321,20337
130115,202304,6228,17030,5392,16070,149,421,4680,14170,4829,14591
130120,202304,20373,56122,18107,53262,1614,5105,15003,44039,16617,49144
130130,202304,7316,19279,5658,17185,681,1986,3992,12880,4673,14866
130140,202304,8924,27143,7817,25873,348,1353,6803,22594,7151,23947
130150,202304,4766,14353,4487,14046,84,393,4156,12993,4240,13386
130160,202304,8047,21450,6984,20159,378,955,6120,17939,6498,18894
130165,202304,4184,13510,3935,13228,159,609,3513,11830,3672,12439
130170,202304,17711,39962,14956,36961,439,1310,13486,33052,13925,34362
130180,202304,5356,15174,5138,14933,39,231,4973,14375,5012,14606
130185,202304,25386,53042,21161,48510,1777,2318,17831,43249,19608,45567
130190,202304,26076,72499,21486,66012,2162,6391,16100,50140,18262,56531
130195,202304,3010,9872,2543,9302,120,513,2138,7921,2258,8434
130200,202304,3787,8865,3104,7979,211,656,2471,6194,2682,6850
130210,202304,1963,6491,1787,6279,170,728,1434,4993,1604,5721
130220,202304,3228,8826,2670,8175,98,305,2365,7361,2463,7666
130230,202304,6232,21809,5458,20783,207,1085,4823,18368,5030,19453
130240,202304,17969,39982,14998,36365,147,682,14005,33446,14152,34128
130250,202304,32278,85206,27726,79944,1743,4312,22818,67761,24561,72073
130255,202304,6156,16292,5245,14795,257,636,4291,12132,4548,12768
130260,202304,479856,1048987,411897,961437,75530,189631,272058,620417,347588,810048
130270,202304,12297,37432,10246,34420,2086,6395,6388,22673,8474,29068
130280,202304,4622,15038,4215,14576,143,545,3885,13481,4028,14026
130290,202304,21723,51571,19680,49201,619,1638,18159,45247,18778,46885
130300,202304,6164,17557,5480,16663,153,661,4705,14169,4858,14830
130310,202304,10811,24922,9580,23478,499,1151,8386,20600,8885,21751
130320,202304,4246,12605,3550,11632,511,1593,2459,8378,2970,9971
130330,202304,5592,15495,4508,14221,233,787,3779,12113,4012,12900
130340,202304,31313,79612,27055,74913,1688,3976,22830,65212,24518,69188
130350,202304,4583,15031,4105,14419,165,755,3579,12564,3744,13319
130353,202304,9887,23528,8076,21198,1340,3277,5292,14527,6632,17804
130356,202304,7024,18963,5968,17409,1214,3473,3464,10595,4678,14068
130360,202304,3649,10763,2867,9779,95,414,2526,8603,2621,9017
130370,202304,6144,24460,5168,23026,780,4134,3061,13743,3841,17877
130380,202304,9671,37639,9082,36776,790,3630,7278,29455,8068,33085
130390,202304,9021,30317,7935,28766,403,1825,7028,25358,7431,27183
130395,202304,3070,8475,2539,7651,177,622,2069,6115,2246,6737
130400,202304,3609,9570,3081,8876,105,324,2730,7882,2835,8206
130406,202304,14552,44802,12392,42141,2846,8726,7809,28210,10655,36936
130410,202304,5504,16705,4759,15603,1304,4337,2566,8816,3870,13153
130420,202304,19227,56187,16311,52596,2232,6868,11567,38538,13799,45406
130423,202304,5388,15350,4669,14495,205,848,4132,12632,4337,13480
130426,202304,3892,12075,3491,11637,73,206,3079,10819,3152,11025
130430,202304,6261,13718,5389,12650,211,491,4828,11209,5039,11700
130440,202304,7257,17174,6268,15995,146,436,5868,14946,6014,15382
140002,202304,3057,8067,2676,7618,261,643,2071,6175,2332,6818
140005,202304,4071,10608,3525,9957,1218,3410,1845,5534,3063,8944
140010,202304,67249,172130,54807,154217,14232,42406,20971,59862,35203,102268
140015,202304,7084,14645,6164,13655,323,639,5528,12402,5851,13041
140017,202304,7219,16364,6315,15265,404,925,5245,12864,5649,13789
140020,202304,6993,17050,6023,15871,566,1539,4489,12003,5055,13542
140023,202304,3511,8877,2826,7948,329,1001,2152,6101,2481,7102
140028,202304,2482,5827,2101,5360,144,372,1636,4208,1780,4580
140030,202304,7840,16075,7148,15296,345,479,6518,14257,6863,14736
140040,202304,3589,12395,3316,12048,109,551,3028,10950,3137,11501
140045,202304,4641,14612,4073,13866,1135,3095,2216,8751,3351,11846
140047,202304,7470,19218,6335,17569,965,2739,4145,11728,5110,14467
140050,202304,2150,5458,1839,5019,327,787,1194,3435,1521,4222
140060,202304,2791,5961,2513,5604,259,497,2095,4741,2354,5238
140070,202304,2477,11619,2392,11475,157,1051,2050,9634,2207,10685
150010,202304,65889,134216,59285,126073,1364,2638,53586,112712,54950,115350
150013,202304,2751,5628,2326,5168,144,245,1976,4472,2120,4717
150020,202304,19087,47830,17535,45756,1766,3628,14025,37901,15791,41529
150030,202304,11453,35731,10380,34491,829,2159,8403,29966,9232,32125
150034,202304,5341,11379,4354,10178,278,594,3620,8568,3898,9162
150040,202304,20139,46917,17797,44344,1117,1494,15754,41128,16871,42622
150050,202304,9911,26437,8976,25233,252,684,8151,23161,8403,23845
150060,202304,30111,72516,24474,64346,3721,9949,15422,40905,19143,50854
150070,202304,10895,30489,9685,29081,227,863,8995,26938,9222,27801
150080,202304,114016,241330,94173,215390,26119,59402,32782,84128,58901,143530
150085,202304,12249,27471,11159,26216,159,358,10561,24861,10720,25219
150090,202304,15875,40025,14795,38366,565,1486,13115,33601,13680,35087
150095,202304,9176,19489,8073,18170,913,1184,6592,15644,7505,16828
150100,202304,3620,11101,3190,10438,200,644,2648,8755,2848,9399
150110,202304,5716,19171,5323,18748,163,595,4946,17680,5109,18275
150120,202304,10027,26621,9258,25704,369,693,8238,23336,8607,24029
150125,202304,1083,2532,802,2144,96,298,518,1355,614,1653
150130,202304,31093,77770,26659,71232,5355,12856,16045,45381,21400,58237
150140,202304,381321,725912,327304,658232,29101,59125,242925,474886,272026,534011
150145,202304,5054,14568,4159,13142,1667,5281,1198,4542,2865,9823
150150,202304,23095,49793,19530,45379,1704,3772,14598,33839,16302,37611
150157,202304,4467,10930,3518,9628,492,1383,2182,6099,2674,7482
150160,202304,5103,10644,4735,10177,406,989,3844,8004,4250,8993
150170,202304,35570,89341,32018,83694,5520,12578,20833,57791,26353,70369
150172,202304,7269,15992,5886,14156,351,881,4662,11142,5013,12023
150175,202304,2546,6178,2165,5586,182,635,1687,4118,1869,4753
150178,202304,15859,33023,12151,28822,1223,1602,9593,24732,10816,26334
150180,202304,36157,90687,32665,86847,2831,4654,26486,76141,29317,80795
150190,202304,9762,23744,8948,22790,126,402,8393,21244,8519,21646
150195,202304,6459,17384,5986,16744,182,623,5463,15184,5645,15807
150200,202304,7359,18469,6654,17676,56,163,6118,16292,6174,16455
150210,202304,41486,105667,39218,102980,1407,3316,35193,93470,36600,96786
150215,202304,13751,35078,11753,31867,2011,5726,7142,19079,9153,24805
150220,202304,17781,41877,15539,38903,877,2070,12038,29861,12915,31931
150230,202304,17779,41614,15856,39066,1248,2632,12302,30709,13550,33341
150240,202304,45092,109050,37957,97639,8166,21560,17725,43592,25891,65152
150250,202304,5336,17450,4995,17082,411,1430,4382,15149,4793,16579
150260,202304,3612,9611,3155,8957,115,348,2657,7498,2772,7846
150270,202304,10947,28052,7763,22460,2244,6776,2143,6280,4387,13056
150275,202304,9696,24226,8886,23188,194,716,7976,20351,8170,21067
150276,202304,2880,7045,2519,6607,297,705,1771,5010,2068,5715
150277,202304,7067,15301,5599,13613,730,1768,3986,9873,4716,11641
150280,202304,9264,29731,8890,29196,698,1782,7420,25447,8118,27229
150285,202304,4372,12737,3794,11798,283,816,2907,9101,3190,9917
150290,202304,13837,32041,12573,30714,509,739,11380,28499,11889,29238
150293,202304,11789,26022,9415,22949,1044,2611,6656,16047,7700,18658
150295,202304,9075,21950,6341,18125,2138,6008,2083,6825,4221,12833
150300,202304,4269,8695,3934,8309,42,107,3733,7834,3775,7941
150304,202304,5420,13955,4536,12614,761,1966,2961,8541,3722,10507
150307,202304,7081,19701,6354,18546,306,857,5091,14875,5397,15732
150309,202304,7921,20176,6356,17695,952,2584,3869,10985,4821,13569
150310,202304,9022,30795,8445,30070,326,1414,7359,26546,7685,27960
150320,202304,11642,27109,10578,25642,989,2239,7894,19231,8883,21470
150330,202304,18991,49813,17480,47813,2488,5282,12048,36234,14536,41516
150340,202304,2975,7969,2610,7465,315,842,1905,5484,2220,6326
150345,202304,11439,27032,10151,25392,408,1138,8910,22082,9318,23220
150350,202304,12902,26075,11554,24378,1004,1613,9648,20684,10652,22297
150360,202304,31408,76859,25508,69511,2543,4806,19287,55145,21830,59951
150370,202304,14221,36466,11731,33182,1594,3812,8296,25054,9890,28866
150375,202304,4887,17675,4451,17068,278,1035,3904,15138,4182,16173
150380,202304,12861,28538,10381,25296,316,908,8803,21132,9119,22040
150390,202304,9567,34050,8450,32210,1962,6342,4997,21092,6959,27434
150400,202304,8152,25344,7705,24642,174,539,6598,21709,6772,22248
150405,202304,11166,25333,9623,23503,851,1450,7574,19296,8425,20746
150410,202304,2363,6360,2004,5807,187,482,1406,4117,1593,4599
150420,202304,58890,141055,46572,123630,10654,29814,22789,61419,33443,91233
150430,202304,10124,25575,9202,24452,695,1332,7761,21081,8456,22413
150440,202304,8464,19726,7633,18672,470,1099,6460,15726,6930,16825
150442,202304,39227,78237,33131,71088,1996,4295,26596,55790,28592,60085
150445,202304,10099,23611,9092,22258,155,416,8393,20412,8548,20828
150450,202304,8032,23922,7505,23259,301,1429,6900,20874,7201,22303
150460,202304,10816,29285,9778,27996,520,1226,8148,24148,8668,25374
150470,202304,25612,60660,22816,57291,464,1621,20685,51110,21149,52731
150475,202304,6899,18620,5831,16981,1026,2666,3702,11349,4728,14015
150480,202304,17685,47171,15985,44791,3901,9607,9732,29742,13633,39349
150490,202304,10090,31089,9061,29655,741,2076,7116,24178,7857,26254
150495,202304,6789,18524,6358,17973,171,666,5805,16245,5976,16911
150497,202304,3338,9399,2649,8237,528,1712,1428,4612,1956,6324
150500,202304,3819,8975,3362,8318,218,567,2644,6359,2862,6926
150503,202304,7110,16751,5141,14272,1739,4308,1910,5921,3649,10229
150506,202304,16674,40816,14325,37722,2409,5807,9742,27144,12151,32951
150510,202304,16060,41582,13991,38280,1124,2880,11078,30323,12202,33203
150520,202304,10265,30863,9811,30330,149,825,9303,28483,9452,29308
150530,202304,15292,45902,13221,42984,1251,3460,10219,34114,11470,37574
150540,202304,6521,14643,5635,13360,353,805,4667,10970,5020,11775
150543,202304,9059,22853,7514,20885,722,2049,5631,15932,6353,17981
150548,202304,12979,34471,11504,32409,544,1469,9921,28146,10465,29615
150549,202304,2340,5851,1950,5306,99,310,1543,4164,1642,4474
150550,202304,25315,66685,20541,59154,5883,17508,7508,22191,13391,39699
150553,202304,48947,121381,37652,102997,10156,28626,15605,42418,25761,71044
150555,202304,2520,5937,1950,5099,184,461,1318,3528,1502,3989
150560,202304,2419,5961,2144,5506,215,537,1463,3731,1678,4268
150563,202304,3289,8665,2655,7560,610,1839,1362,3803,1972,5642
150565,202304,5561,15938,4906,14952,164,546,3884,12056,4048,12602
150570,202304,9897,23255,9059,22169,268,822,8141,19660,8409,20482
150580,202304,14230,48245,12143,45941,1745,5151,9192,37348,10937,42499
150590,202304,10476,30264,8988,28523,306,1055,8074,25803,8380,26858
150600,202304,13049,34190,12098,33048,417,1050,10940,30135,11357,31185
150610,202304,4055,9049,3608,8411,142,407,3104,7037,3246,7444
150611,202304,4067,9581,3516,8830,74,250,3083,7547,3157,7797
150613,202304,18275,45656,13977,38685,2918,8713,6689,17743,9607,26456
150616,202304,4666,11784,3356,9552,655,2028,1560,4233,2215,6261
150618,202304,8981,22534,7319,20002,1082,3199,4502,12159,5584,15358
150619,202304,8013,20436,6540,18406,1012,2535,4344,12760,5356,15295
150620,202304,9609,27614,8411,25617,1892,5371,4570,14667,6462,20038
150630,202304,8979,18715,8240,17833,147,376,7559,16085,7706,16461
150635,202304,6865,16129,5728,14359,712,1627,3765,9527,4477,11154
150640,202304,2530,6708,2286,6400,56,173,2056,5764,2112,5937
150650,202304,15086,36079,13061,33048,3903,9683,5548,14874,9451,24557
150655,202304,6903,17153,6257,16253,100,344,5653,14475,5753,14819
150658,202304,5423,14420,3906,11894,1057,3425,1582,4818,2639,8243
150660,202304,6951,17667,5988,16274,1376,3631,3255,8822,4631,12453
150670,202304,12759,24616,10216,21718,1145,2486,7731,16628,8876,19114
150680,202304,98345,243675,79153,215358,17684,45146,41575,120561,59259,165707
150690,202304,3281,7037,2831,6505,151,278,2424,5672,2575,5950
150700,202304,8659,21624,7708,20463,960,1918,5649,15936,6609,17854
150710,202304,4709,13343,4224,12623,677,1957,2770,8483,3447,10440
150715,202304,6629,15576,5431,13910,341,865,4411,11229,4752,12094
150720,202304,10551,25827,9734,24753,341,1038,8648,21708,8989,22746
150730,202304,16396,43540,13916,39964,2131,6442,9375,27257,11506,33699
150740,202304,4987,12255,4300,11231,506,1062,3116,8414,3622,9476
150745,202304,6956,17048,5568,15082,761,2229,3711,10034,4472,12263
150746,202304,2174,5449,1934,5110,69,179,1602,4159,1671,4338
150747,202304,6740,16356,6005,15336,451,1003,4794,12350,5245,13353
150750,202304,4698,12448,3803,11168,437,1305,2654,8123,3091,9428
150760,202304,14526,37171,13042,35108,2607,6436,8048,22898,10655,29334
150770,202304,8891,26072,8137,25210,270,577,7383,23615,7653,24192
150775,202304,1484,3435,1171,3058,138,402,819,2125,957,2527
150780,202304,6236,16454,5528,15636,273,729,4932,14179,5205,14908
150790,202304,7820,18178,6626,16890,613,1172,4390,13312,5003,14484
150795,202304,21074,53413,18234,49451,3392,9217,11344,31441,14736,40658
150796,202304,5202,10458,4489,9646,216,417,3893,8361,4109,8778
150797,202304,5591,14307,4753,13139,579,1514,3654,10163,4233,11677
150800,202304,18380,49330,16348,46688,3056,8175,10379,31066,13435,39241
150803,202304,10906,24943,10032,23822,274,745,9141,21413,9415,22158
150805,202304,4477,12116,3762,11160,429,1244,2726,8270,3155,9514
150808,202304,8221,21958,6097,18496,2112,7181,850,2628,2962,9809
150810,202304,26865,59742,20688,52362,4933,12233,10569,29279,15502,41512
150812,202304,8252,18714,7348,17381,486,1449,5884,13255,6370,14704
150815,202304,11692,30997,9821,28781,1544,4531,7218,21523,8762,26054
150820,202304,18990,38429,16808,35896,1864,2754,13223,29967,15087,32721
150830,202304,16198,45017,15053,43631,616,1456,13463,39788,14079,41244
150835,202304,4476,11722,3823,10755,421,1216,2711,7577,3132,8793
150840,202304,10673,26404,8718,23437,1218,3679,5411,13990,6629,17669
160005,202304,1837,3834,1614,3578,63,161,1432,3143,1495,3304
160010,202304,2754,6681,2539,6456,22,92,2453,6197,2475,6289
160015,202304,5132,10446,4657,9917,386,694,4085,8815,4471,9509
160020,202304,3221,8232,2773,7647,374,899,1992,5796,2366,6695
160021,202304,1557,5050,1362,4815,66,295,992,3662,1058,3957
160023,202304,1729,5180,1528,4854,282,878,912,3030,1194,3908
160025,202304,2483,6234,2311,6049,79,157,2183,5763,2262,5920
160027,202304,14675,29665,13276,27980,906,1940,11373,23832,12279,25772
160030,202304,114163,265776,95470,242150,17955,43497,56925,151238,74880,194735
160040,202304,7790,22122,6901,20931,550,1539,5798,17871,6348,19410
160050,202304,8115,19228,6838,17622,2449,5490,3370,10022,5819,15512
160053,202304,5503,14019,4819,13094,288,710,3996,11077,4284,11787
160055,202304,2183,4171,2098,4078,34,89,2018,3892,2052,3981
160060,202304,39468,82997,33622,76470,3562,6550,26412,62263,29974,68813
160070,202304,3893,11615,3375,10870,472,1245,2411,8342,2883,9587
160080,202304,4029,10439,3522,9887,54,167,3257,9250,3311,9417
170025,202304,771,1944,455,1356,97,284,118,343,215,627
170030,202304,1371,3779,1009,3118,203,615,366,1166,569,1781
170035,202304,1706,4041,1256,3347,118,340,722,1815,840,2155
170040,202304,2216,5426,1708,4725,268,759,875,2555,1143,3314
170070,202304,2330,4946,1647,4085,113,305,937,2311,1050,2616
170100,202304,2992,7372,2430,6505,347,827,1528,4167,1875,4994
170105,202304,777,2062,490,1500,105,333,150,396,255,729
170110,202304,1285,3335,966,2825,88,341,567,1555,655,1896
170130,202304,1757,4338,1309,3610,116,361,851,2272,967,2633
170190,202304,1858,4359,1473,3786,202,651,913,2192,1115,2843
170200,202304,2393,5265,1573,4004,294,768,595,1413,889,2181
170210,202304,33640,83675,25453,70672,7253,21621,4682,13115,11935,34736
170215,202304,1513,3651,1184,3211,90,311,839,2204,929,2515
170220,202304,6792,19251,5530,17090,2455,7770,1142,4070,3597,11840
170230,202304,1482,3849,1116,3199,246,751,427,1144,673,1895
170240,202304,3568,8120,2872,7067,222,596,2126,5078,2348,5674
170255,202304,4355,11630,3283,9837,588,1864,1593,4711,2181,6575
170270,202304,982,2276,669,1778,84,228,366,926,450,1154
170290,202304,3753,9190,3239,8494,306,572,2459,6757,2765,7329
170300,202304,2589,5850,2097,5150,146,348,1579,3758,1725,4106
170305,202304,791,1972,639,1708,91,240,335,898,426,1138
170307,202304,1315,3619,1103,3265,153,493,705,1976,858,2469
170310,202304,1909,4299,1338,3440,183,504,693,1747,876,2251
170320,202304,1252,3061,917,2533,116,367,537,1459,653,1826
170330,202304,1182,3157,1071,3001,28,119,942,2569,970,2688
170360,202304,692,1592,501,1308,26,82,325,770,351,852
170370,202304,1596,3626,1117,2875,180,515,585,1374,765,1889
170380,202304,2127,5564,1631,4796,143,468,951,2872,1094,3340
170382,202304,588,1571,477,1394,23,91,326,894,349,985
170384,202304,2032,6184,1710,5619,344,1134,928,3023,1272,4157
170386,202304,1123,2897,685,2072,79,287,249,691,328,978
170388,202304,831,2030,609,1682,110,314,315,830,425,1144
170389,202304,960,2760,747,2392,117,405,414,1347,531,1752
170390,202304,2197,4287,1633,3627,41,106,1426,3169,1467,3275
170410,202304,720,1654,521,1330,36,118,351,817,387,935
170460,202304,496,1256,386,1079,55,164,235,648,290,812
170510,202304,1065,2699,767,2201,38,158,498,1288,536,1446
170550,202304,8190,19642,6227,16695,1681,4923,2096,5301,3777,10224
170555,202304,1639,3946,1285,3422,159,380,601,1639,760,2019
170560,202304,1141,2918,879,2549,117,336,488,1456,605,1792
170600,202304,1619,3964,1275,3460,200,483,740,2077,940,2560
170610,202304,1992,4567,1482,3817,127,397,983,2393,1110,2790
170625,202304,517,1254,357,970,53,141,136,333,189,474
170650,202304,1788,4381,1477,3909,138,421,998,2509,1136,2930
170700,202304,4274,11397,3265,9519,689,2107,1404,3879,2093,5986
170710,202304,2046,4377,1552,3706,173,433,1056,2440,1229,2873
170720,202304,2245,4891,1637,3973,139,354,1192,2821,1331,3175
170730,202304,1319,3177,996,2716,124,273,616,1707,740,1980
170740,202304,2386,7002,2034,6391,149,546,1529,4695,1678,5241
170755,202304,1014,2451,706,1962,138,434,320,814,458,1248
170765,202304,1313,3114,946,2549,157,425,466,1205,623,1630
170770,202304,2214,5653,1790,5025,128,382,1327,3645,1455,4027
170820,202304,4718,12259,3587,10391,768,2274,1675,4722,2443,6996
170825,202304,1267,2618,1049,2341,100,226,792,1740,892,1966
170830,202304,1593,3775,1183,3117,326,975,526,1208,852,2183
170900,202304,3637,9771,3140,9102,428,1074,2348,7035,2776,8109
170930,202304,4816,11866,3684,9887,851,2445,1263,3142,2114,5587
170950,202304,13874,35844,9890,28948,2974,9388,1266,3629,4240,13017
170980,202304,622,1416,405,1054,50,143,205,501,255,644
171050,202304,2005,5606,1702,5096,145,457,1280,3880,1425,4337
171070,202304,1588,3978,1356,3654,307,716,659,2081,966,2797
171090,202304,1163,2837,895,2429,163,472,451,1209,614,1681
171110,202304,663,1691,454,1317,62,179,208,559,270,738
171150,202304,1135,2596,689,1870,79,251,389,992,468,1243
171180,202304,831,2166,511,1564,98,283,191,593,289,876
171190,202304,2357,6720,1965,6055,326,1045,1132,3485,1458,4530
171195,202304,980,2747,765,2352,105,392,452,1290,557,1682
171200,202304,731,1897,528,1557,135,451,154,403,289,854
171215,202304,472,1133,376,979,49,147,196,472,245,619
171240,202304,895,2622,687,2265,15,87,471,1500,486,1587
171245,202304,903,2390,686,1978,71,227,365,957,436,1184
171250,202304,1108,2872,769,2290,134,443,311,903,445,1346
171270,202304,580,1839,444,1552,77,322,208,701,285,1023
171280,202304,1031,2782,826,2451,72,220,516,1527,588,1747
171320,202304,4681,12115,3530,10096,777,2279,1293,3647,2070,5926
171330,202304,3497,8670,2612,7187,710,2044,1108,2929,1818,4973
171360,202304,1854,4555,1340,3815,141,383,839,2571,980,2954
171370,202304,810,1917,622,1655,81,236,373,950,454,1186
171380,202304,1646,4122,1358,3726,189,486,897,2568,1086,3054
171395,202304,1193,2820,802,2188,117,341,465,1237,582,1578
171420,202304,2387,5859,1795,4848,337,928,923,2395,1260,3323
171430,202304,1287,3347,1038,2912,94,292,651,1707,745,1999
171488,202304,2968,7456,2290,6388,413,1199,1170,3174,1583,4373
171500,202304,1012,2405,703,1896,90,274,383,997,473,1271
171510,202304,1007,2828,846,2555,75,279,572,1655,647,1934
171515,202304,568,1279,399,1018,37,123,255,587,292,710
171525,202304,853,2071,628,1714,79,240,377,970,456,1210
171550,202304,397,1032,295,894,41,156,140,376,181,532
171570,202304,1298,3397,1090,3053,165,481,646,1802,811,2283
171575,202304,1885,4525,1270,3515,120,345,721,1923,841,2268
171610,202304,7096,18536,5262,15495,1378,4509,1019,3077,2397,7586
171620,202304,3601,7950,3124,7310,164,393,2608,6077,2772,6470
171630,202304,1320,3153,987,2683,152,426,598,1639,750,2065
171650,202304,2707,7110,2044,5985,535,1707,437,1249,972,2956
171660,202304,2711,6224,1939,5042,164,477,1285,3230,1449,3707
171665,202304,1469,3785,1140,3264,270,847,458,1281,728,2128
171670,202304,2170,5289,1624,4392,262,761,748,1915,1010,2676
171700,202304,1344,3404,1012,2814,138,376,574,1553,712,1929
171720,202304,882,2074,664,1745,84,236,437,1133,521,1369
171750,202304,1616,4496,1161,3657,254,813,323,1175,577,1988
171780,202304,1504,3420,1063,2755,106,341,676,1641,782,1982
171790,202304,1613,4817,1299,4180,195,627,673,2123,868,2750
171800,202304,851,2069,655,1788,68,184,379,971,447,1155
171820,202304,14223,36542,10556,30657,2565,8122,2725,7979,5290,16101
171830,202304,1847,5195,1584,4775,380,1069,738,2444,1118,3513
171840,202304,839,2027,622,1683,25,78,374,957,399,1035
171845,202304,811,1797,609,1512,59,175,401,920,460,1095
171850,202304,1214,3194,1035,2853,43,174,835,2199,878,2373
171855,202304,1193,3351,986,2988,108,329,572,1698,680,2027
171865,202304,588,1516,493,1369,70,221,290,743,360,964
171870,202304,919,2316,651,1847,128,379,295,813,423,1192
171875,202304,1732,4119,1431,3677,57,224,1136,2780,1193,3004
171880,202304,1779,4139,1547,3834,56,144,1238,3047,1294,3191
171884,202304,1359,3151,1029,2631,204,496,562,1429,766,1925
171886,202304,1710,4291,1260,3661,335,1084,318,972,653,2056
171888,202304,685,1817,460,1372,40,139,260,723,300,862
171889,202304,510,1460,339,1112,88,310,99,298,187,608
171890,202304,1502,3918,1090,3239,146,471,655,1898,801,2369
171900,202304,669,2026,511,1725,75,218,243,829,318,1047
172000,202304,658,1832,504,1546,95,300,188,564,283,864
172010,202304,1518,4181,1267,3792,132,367,783,2359,915,2726
172015,202304,434,1373,328,1174,58,215,142,485,200,700
172020,202304,3461,8633,2984,8039,316,853,2099,5804,2415,6657
172025,202304,856,2096,612,1717,47,138,425,1150,472,1288
172030,202304,1427,3851,1146,3392,98,336,814,2364,912,2700
172049,202304,1406,3290,922,2609,123,335,474,1369,597,1704
172065,202304,1739,3937,1365,3466,163,326,876,2505,1039,2831
172080,202304,2732,7292,2228,6426,134,432,1492,4204,1626,4636
172085,202304,498,1256,309,877,56,152,101,257,157,409
172090,202304,4930,10567,3923,9257,150,391,3202,7339,3352,7730
172093,202304,533,1474,387,1215,29,126,235,689,264,815
172097,202304,767,1861,503,1417,88,280,175,457,263,737
172100,202304,62832,142787,46982,119032,9000,25444,20502,49680,29502,75124
172110,202304,2047,6348,1757,5924,118,479,1372,4593,1490,5072
172120,202304,6197,16164,4855,14038,532,1611,2945,8376,3477,9987
172125,202304,476,1177,360,993,33,117,197,469,230,586
172130,202304,642,1525,474,1241,19,66,298,702,317,768
172208,202304,2982,6508,2300,5609,195,442,1674,4046,1869,4488
172210,202304,3150,7014,2467,6179,272,607,1621,4222,1893,4829
210005,202304,23555,60504,17633,51260,4840,14884,7069,20641,11909,35525
210010,202304,2643,6530,2424,6278,40,180,2243,5716,2283,5896
210015,202304,3722,10054,3216,9381,141,428,2687,7840,2828,8268
210020,202304,9695,18756,8444,17295,518,705,7467,15566,7985,16271
210030,202304,5307,15960,4824,15223,510,1701,3800,12000,4310,13701
210040,202304,2533,4987,2236,4633,67,186,2030,4110,2097,4296
210043,202304,6749,17423,5702,16003,376,1146,4488,12564,4864,13710
210047,202304,8217,21665,6441,19356,151,589,5552,16624,5703,17213
210050,202304,2956,8016,2379,7001,158,606,1805,5109,1963,5715
210055,202304,2529,6491,2204,6047,57,156,1909,5337,1966,5493
210060,202304,8638,28693,7651,26959,893,3296,5136,18522,6029,21818
210070,202304,8050,18698,7451,17945,106,266,6979,16733,7085,16999
210080,202304,5309,14523,4987,14180,37,200,4658,13189,4695,13389
210083,202304,7221,16565,6112,15369,104,345,5758,14398,5862,14743
210087,202304,3127,8075,2652,7445,115,355,2227,6234,2342,6589
210090,202304,10729,29471,9853,28075,374,987,8542,24275,8916,25262
210095,202304,7305,22484,6611,21551,717,2255,4964,16854,5681,19109
210100,202304,7543,20865,6511,19074,911,2595,4212,12514,5123,15109
210110,202304,3668,9218,3356,8834,48,207,3071,7992,3119,8199
210120,202304,35033,74739,29948,68487,1442,2774,24340,55933,25782,58707
210125,202304,5438,12880,4730,12085,943,1818,3191,8910,4134,10728
210130,202304,4869,11197,3977,10116,65,154,3531,8958,3596,9112
210135,202304,2162,4710,1783,4181,51,111,1560,3632,1611,3743
210140,202304,25493,60719,20100,53683,2830,7450,12632,33939,15462,41389
210150,202304,5556,11842,4852,10902,112,322,4213,9237,4325,9559
210160,202304,26316,58936,22498,54233,1836,3787,17704,43475,19540,47262
210170,202304,21271,53343,19331,50788,2017,4431,14851,40303,16868,44734
210173,202304,2516,8268,2369,8036,93,410,2069,6937,2162,7347
210177,202304,3785,9496,3246,8805,462,1146,2393,6708,2855,7854
210180,202304,1838,4071,1614,3806,34,81,1460,3448,1494,3529
210190,202304,6808,14963,5745,13579,96,245,4981,11601,5077,11846
210193,202304,1580,3989,1357,3651,51,149,1057,2826,1108,2975
210197,202304,2307,6489,2070,6161,167,459,1644,5004,1811,5463
210200,202304,9542,26229,8365,24532,667,2044,6499,19028,7166,21072
210203,202304,8162,21676,6809,19949,562,1603,5272,15854,5834,17457
210207,202304,4491,9961,3673,9020,156,358,3065,7629,3221,7987
210210,202304,8702,24537,7784,23279,129,676,6715,19795,6844,20471
210215,202304,2854,8056,2478,7525,151,611,2027,6074,2178,6685
210220,202304,8405,23157,7917,22496,244,1066,7072,19584,7316,20650
210230,202304,6846,17199,6253,16304,156,397,5701,14844,5857,15241
210232,202304,14064,37863,11640,34378,1600,4686,7866,23929,9466,28615
210235,202304,3967,10718,3454,9990,161,562,2866,8241,3027,8803
210237,202304,4998,10744,4286,9949,54,155,4053,9314,4107,9469
210240,202304,2983,8106,2657,7619,94,257,2156,6166,2250,6423
210250,202304,7217,17738,6533,16886,103,391,6011,15401,6114,15792
210255,202304,3126,8537,2633,7653,318,1007,1637,4571,1955,5578
210260,202304,6268,16602,5414,15373,443,1354,4338,12226,4781,13580
210270,202304,5688,13699,5012,12861,74,336,4541,11492,4615,11828
210275,202304,3917,8988,3336,8294,185,408,2727,6835,2912,7243
210280,202304,7572,17137,6300,15361,139,589,5316,12400,5455,12989
210290,202304,9858,21472,8833,20253,118,329,8363,19053,8481,19382
210300,202304,37486,95355,30671,85676,7187,19731,13805,43147,20992,62878
210310,202304,3559,7923,3082,7286,32,90,2819,6607,2851,6697
210312,202304,3465,7209,3080,6792,23,73,2839,6150,2862,6223
210315,202304,4349,9428,3898,8938,118,264,3619,8299,3737,8563
210317,202304,5142,14191,4668,13627,102,416,4264,12386,4366,12802
210320,202304,33641,70918,31441,68268,238,1092,29799,63555,30037,64647
210325,202304,4065,10539,3332,9533,555,1689,2217,6310,2772,7999
210330,202304,31141,73983,25110,66793,3814,8141,16802,49182,20616,57323
210340,202304,15167,33088,13697,31319,692,1280,11586,27040,12278,28320
210350,202304,11571,27701,10171,25988,131,418,9247,23427,9378,23845
210355,202304,4395,13461,3876,12655,100,472,3248,10545,3348,11017
210360,202304,14738,42142,13121,39621,583,2392,9784,28499,10367,30891
210370,202304,14467,26979,10846,23192,288,442,10034,21728,10322,22170
210375,202304,3801,9622,2764,8055,1020,3155,585,1777,1605,4932
210380,202304,6599,15117,5699,14039,237,646,4945,12052,5182,12698
210390,202304,3839,9642,3586,9282,61,245,3302,8428,3363,8673
210400,202304,5357,13619,4750,12925,271,520,4203,11763,4474,12283
210405,202304,8700,20064,7143,17988,1160,2630,4485,11793,5645,14423
210407,202304,2431,6898,2044,6236,155,445,1529,4711,1684,5156
210408,202304,3208,10346,2966,10035,183,771,2388,8111,2571,8882
210409,202304,4497,13638,4000,12917,218,778,3184,10517,3402,11295
210410,202304,4305,11218,3618,10005,79,323,2995,8028,3074,8351
210420,202304,4486,12950,3951,12021,226,650,3239,9879,3465,10529
210430,202304,2660,6971,2313,6501,202,566,1893,5346,2095,5912
210440,202304,4970,12129,4329,11355,174,375,3867,10192,4041,10567
210450,202304,2634,6991,2265,6473,282,677,1649,4905,1931,5582
210455,202304,5814,13316,4526,11706,1089,2966,2127,5512,3216,8478
210460,202304,3940,10334,3274,9455,117,412,2716,7761,2833,8173
210462,202304,1943,5301,1622,4823,59,173,1273,3801,1332,3974
210465,202304,3110,7998,2684,7423,127,448,2280,6195,2407,6643
210467,202304,7244,18972,6228,17669,790,2081,4681,13683,5471,15764
210470,202304,1984,5225,1591,4688,219,590,1087,3293,1306,3883
210480,202304,19809,52900,16416,48694,2258,4774,11394,37471,13652,42245
210490,202304,3853,8720,3059,7657,89,225,2600,6467,2689,6692
210500,202304,7487,24808,6926,23912,372,1518,5832,20023,6204,21541
210510,202304,8015,20596,7192,19728,113,313,6699,18494,6812,18807
210515,202304,4373,11632,3712,10811,215,634,3063,9048,3278,9682
210520,202304,3013,7951,2717,7567,152,478,2265,6229,2417,6707
210530,202304,66678,150705,52404,130518,10407,27309,23910,61802,34317,89111
210535,202304,4348,11945,3940,11389,146,497,3463,9998,3609,10495
210540,202304,17937,46277,14914,41912,2320,5812,9505,28450,11825,34262
210542,202304,7511,16331,5847,14435,562,1366,4465,11076,5027,12442
210545,202304,2464,7045,2262,6706,49,197,1933,5660,1982,5857
210547,202304,4278,13717,3817,12938,246,797,2943,10218,3189,11015
210550,202304,6741,18929,5189,16470,716,2397,3051,9945,3767,12342
210560,202304,4268,12069,3769,11294,97,349,3221,9523,3318,9872
210565,202304,1764,4635,1439,4192,104,350,1061,3110,1165,3460
210570,202304,12616,31593,11194,29845,264,708,10005,26834,10269,27542
210580,202304,3369,7928,2645,7030,186,467,1935,5365,2121,5832
210590,202304,4733,12949,4043,12081,83,418,3597,10666,3680,11084
210592,202304,3341,8171,3123,7847,35,150,2764,6775,2799,6925
210594,202304,2843,7376,2216,6396,234,629,1508,4496,1742,5125
210596,202304,3433,10312,3020,9624,370,1180,2212,7240,2582,8420
210598,202304,2394,5793,2145,5473,96,269,1872,4757,1968,5026
210600,202304,3506,8888,2816,7904,365,944,1827,5182,2192,6126
210610,202304,3696,8453,3128,7773,57,215,2710,6627,2767,6842
210620,202304,3533,7727,2887,6939,155,325,2432,5806,2587,6131
210630,202304,3693,10515,3284,9827,221,750,2556,7573,2777,8323
210632,202304,7215,16371,6406,15339,185,597,5738,13444,5923,14041
210635,202304,1813,6033,1703,5827,192,602,1281,4501,1473,5103
210637,202304,3113,8762,2606,8055,159,567,2001,6262,2160,6829
210640,202304,5869,16649,5431,16159,56,280,5064,14978,5120,15258
210650,202304,8086,20470,7267,19462,113,398,6484,17316,6597,17714
210660,202304,9296,24220,8368,22775,147,662,7303,19280,7450,19942
210663,202304,3607,8152,3182,7659,352,569,2356,6189,2708,6758
210667,202304,2239,6424,1977,6033,55,176,1700,5282,1755,5458
210670,202304,6842,17112,6157,16090,128,487,5540,14203,5668,14690
210675,202304,6515,14443,5424,13097,753,1588,4004,9981,4757,11569
210680,202304,5761,11690,4895,10698,80,148,4609,10057,4689,10205
210690,202304,11234,25116,9544,23215,269,758,8725,20988,8994,21746
210700,202304,3228,7855,2526,6846,165,423,1926,5255,2091,5678
210710,202304,6331,16343,5566,15365,107,426,5007,13678,5114,14104
210720,202304,3541,10001,3084,9444,100,404,2708,8276,2808,8680
210725,202304,1523,4395,1307,4074,54,175,932,3020,986,3195
210730,202304,1724,3551,1428,3160,57,101,1255,2791,1312,2892
210735,202304,5255,13382,4459,12403,354,857,3587,10404,3941,11261
210740,202304,6093,13831,5209,12830,129,272,4463,10922,4592,11194
210745,202304,4899,11977,4407,11374,64,204,3960,10136,4024,10340
210750,202304,31376,74251,27286,68922,4419,9742,17265,46130,21684,55872
210760,202304,7524,15419,6392,14221,116,201,5967,13451,6083,13652
210770,202304,7377,16271,6308,15059,48,198,5892,13900,5940,14098
210780,202304,8632,23856,7478,22000,530,1570,5836,17111,6366,18681
210790,202304,5136,14041,4520,13217,318,848,3659,11022,3977,11870
210800,202304,5715,13592,4923,12532,68,268,4468,11160,4536,11428
210805,202304,4934,15289,4513,14674,222,750,3740,12249,3962,12999
210810,202304,5774,15023,5177,14278,448,1075,4188,11895,4636,12970
210820,202304,8297,21544,6924,19403,1047,2785,4084,11838,5131,14623
210825,202304,10153,23265,9255,22150,227,655,8531,20194,8758,20849
210830,202304,10534,24265,9537,23079,949,1589,7726,19666,8675,21255
210840,202304,5950,10239,5490,9702,25,109,5242,9034,5267,9143
210845,202304,7216,17181,6333,16202,74,189,6002,15423,6076,15612
210850,202304,8345,21808,6947,19827,485,1377,5587,15988,6072,17365
210860,202304,25325,55535,20972,50342,1177,2474,17228,42420,18405,44894
210870,202304,8804,19224,7013,17206,187,396,6255,15346,6442,15742
210880,202304,4835,12990,4288,12273,224,675,3411,9696,3635,10371
210890,202304,5901,12894,5409,12332,171,439,4907,11022,5078,11461
210900,202304,5671,14897,4450,12801,1639,4741,880,2877,2519,7618
210905,202304,2697,5609,2315,5147,45,73,2177,4847,2222,4920
210910,202304,8628,24348,7145,21993,1165,3562,4291,13314,5456,16876
210920,202304,3653,10187,3257,9660,64,272,2985,8756,3049,9028
210923,202304,2318,5178,1990,4727,97,228,1633,3792,1730,4020
210927,202304,5393,16228,4704,15374,776,2479,2995,10295,3771,12774
210930,202304,3402,8836,2993,8134,82,341,2609,6837,2691,7178
210940,202304,4099,10865,3681,10342,298,1343,3013,7808,3311,9151
210945,202304,9878,22444,8836,21265,776,1289,7141,18013,7917,19302
210950,202304,6342,15676,4910,13677,619,1357,3294,9830,3913,11187
210955,202304,1761,4863,1468,4406,245,715,902,2725,1147,3440
210960,202304,10855,29216,9249,26730,3479,10007,3121,10054,6600,20061
210970,202304,2056,4747,1693,4177,94,265,1421,3374,1515,3639
210975,202304,1981,5514,1790,5230,223,666,1276,3712,1499,4378
210980,202304,12626,24365,11342,23029,177,254,10740,21832,10917,22086
210990,202304,21053,51758,16513,45997,1738,4201,11681,33870,13419,38071
211000,202304,17035,43528,14036,39814,2999,7555,8900,27078,11899,34633
211003,202304,7468,17347,6270,15965,100,385,5571,14132,5671,14517
211010,202304,8227,23403,7445,22444,71,326,6852,20738,6923,21064
211020,202304,10889,25630,9601,24203,197,590,8598,21972,8795,22562
211023,202304,2428,6943,2219,6675,147,413,1800,5420,1947,5833
211027,202304,4684,11424,4396,11003,101,329,4091,10106,4192,10435
211030,202304,4437,11130,3952,10524,407,1039,2936,7962,3343,9001
211040,202304,5168,16459,4733,15727,124,626,4213,13858,4337,14484
211050,202304,10767,24206,9630,22811,123,390,8794,20695,8917,21085
211060,202304,9125,22315,8281,21211,177,609,7451,18773,7628,19382
211065,202304,2950,6732,2469,6147,128,267,2116,5343,2244,5610
211070,202304,10034,26823,8560,24689,363,1141,7261,20845,7624,21986
211080,202304,1545,3713,1223,3233,33,170,953,2330,986,2500
211085,202304,2569,6378,2131,5831,228,458,1633,4748,1861,5206
211090,202304,3631,8956,3302,8591,32,115,3062,7915,3094,8030
211100,202304,8987,18240,8321,17496,49,116,7882,16498,7931,16614
211102,202304,3901,10970,3536,10457,443,1352,2693,7975,3136,9327
211105,202304,2693,7568,2295,6905,122,391,1805,5333,1927,5724
211107,202304,5412,15432,4624,14274,164,546,3717,11930,3881,12476
211110,202304,7638,17637,6114,15435,277,824,5022,12315,5299,13139
211120,202304,60715,131798,50049,119248,8524,18811,31739,78276,40263,97087
211125,202304,2158,5892,1829,5422,38,178,1548,4550,1586,4728
211130,202304,227288,486368,196412,446348,26254,53690,132362,306642,158616,360332
211140,202304,5425,14519,4680,13569,175,529,3919,11452,4094,11981
211150,202304,11404,26745,9563,24464,584,1141,7639,20218,8223,21359
211153,202304,3544,8551,2408,7116,478,1226,1453,4628,1931,5854
211157,202304,1496,4117,1281,3726,109,336,922,2639,1031,2975
211160,202304,6440,14032,5295,12515,133,447,4430,9931,4563,10378
211163,202304,1706,4952,1532,4704,63,205,1280,3991,1343,4196
211167,202304,2058,5216,1891,4999,33,112,1761,4616,1794,4728
211170,202304,8710,16941,8052,16201,60,152,7660,15230,7720,15382
211172,202304,2998,7560,2498,6820,89,293,2025,5324,2114,5617
211174,202304,3373,8480,3055,8139,28,140,2916,7699,2944,7839
211176,202304,4891,12549,3848,11068,289,909,3008,8599,3297,9508
211178,202304,6389,12084,5535,11188,27,98,5353,10722,5380,10820
211180,202304,4879,14253,4442,13633,171,680,3679,11182,3850,11862
211190,202304,3805,9378,3280,8637,32,165,2989,7742,3021,7907
211195,202304,1901,4382,1659,4038,74,159,1447,3529,1521,3688
211200,202304,2447,6685,1923,5849,212,677,1321,3952,1533,4629
211210,202304,7089,19808,6336,18772,536,1576,5003,14920,5539,16496
211220,202304,52521,111528,43987,101126,4099,8882,33622,77065,37721,85947
211223,202304,6183,15025,4992,13443,668,1826,3178,8571,3846,10397
211227,202304,1989,5598,1705,5196,53,186,1413,4327,1466,4513
211230,202304,10110,24617,8685,22671,305,642,7559,19836,7864,20478
211240,202304,12387,27738,11681,26896,134,527,11176,25335,11310,25862
211245,202304,9207,19779,8110,18624,176,398,7687,17566,7863,17964
211250,202304,18220,46589,16475,44026,1370,3651,12946,34457,14316,38108
211260,202304,9733,26673,8377,25134,167,653,7549,22722,7716,23375
211270,202304,11801,32973,10110,30832,394,1449,8331,25534,8725,26983
211280,202304,19182,40313,17226,37965,333,739,15949,34957,16282,35696
211285,202304,2393,6650,2118,6305,187,590,1549,4612,1736,5202
211290,202304,8439,22575,7507,21283,351,1022,6121,17271,6472,18293
211300,202304,8254,22184,7143,20355,484,1453,5402,15129,5886,16582
211400,202304,13768,33908,11228,30483,1566,4038,7407,20966,8973,25004
220005,202304,2344,5253,2138,4989,55,124,1786,4039,1841,4163
220010,202304,1747,4397,1427,3861,74,152,1100,2986,1174,3138
220020,202304,5561,11676,4812,10720,302,617,4122,9090,4424,9707
220025,202304,2719,5313,2323,4749,59,105,1960,3867,2019,3972
220027,202304,1635,3472,1430,3204,26,72,1241,2694,1267,2766
220030,202304,4667,9671,4289,9203,96,242,3832,8028,3928,8270
220040,202304,9782,25947,8493,23633,1632,4233,4833,13850,6465,18083
220045,202304,1920,4824,1590,4325,24,114,1367,3602,1391,3716
220050,202304,6779,14217,5983,13260,62,196,5639,12277,5701,12473
220060,202304,3462,5828,3022,5337,73,108,2840,4996,2913,5104
220070,202304,2793,6417,2268,5675,71,178,1920,4711,1991,4889
220080,202304,862,2211,739,2036,21,76,619,1669,640,1745
220090,202304,2014,4285,1649,3751,58,92,1394,3163,1452,3255
220095,202304,1211,2144,1152,2082,23,40,1077,1935,1100,1975
220100,202304,1669,3968,1327,3467,37,117,1072,2673,1109,2790
220105,202304,2365,6428,2029,5871,175,543,1493,4290,1668,4833
220110,202304,4216,9822,3625,8884,41,159,3234,7787,3275,7946
220115,202304,3438,8652,3140,8268,158,449,2740,7152,2898,7601
220117,202304,1583,3374,1272,2959,20,61,1067,2389,1087,2450
220120,202304,20829,39445,19339,37661,84,267,18420,35304,18504,35571
220130,202304,1319,3098,1097,2799,29,118,970,2397,999,2515
220140,202304,2853,5110,2439,4638,87,153,2170,4184,2257,4337
220150,202304,7768,19452,7015,18232,152,506,5895,14895,6047,15401
220155,202304,1386,3628,1106,3137,26,99,786,2138,812,2237
220157,202304,1309,2753,1095,2448,29,58,894,1955,923,2013
220160,202304,3343,8114,2848,7265,54,188,2333,5727,2387,5915
220170,202304,1800,4376,1500,3947,32,109,1290,3356,1322,3465
220173,202304,2479,6258,1897,5236,47,147,1496,3988,1543,4135
220177,202304,2860,6129,2717,5975,8,26,2676,5859,2684,5885
220180,202304,1378,2812,1143,2440,3,17,963,1915,966,1932
220190,202304,10151,20072,8659,18226,680,1187,6642,14354,7322,15541
220191,202304,1959,5157,1779,4871,147,435,1293,3452,1440,3887
220192,202304,2405,5690,1755,4610,46,141,1413,3643,1459,3784
220194,202304,2223,5261,1922,4779,45,165,1598,3761,1643,3926
220196,202304,2553,5754,2332,5437,20,85,2003,4565,2023,4650
220198,202304,1566,3482,1327,3190,14,27,1209,2934,1223,2961
220200,202304,5948,15554,5217,14565,166,577,4354,12007,4520,12584
220202,202304,2542,6157,2173,5590,30,126,1858,4656,1888,4782
220205,202304,3241,7482,2905,6924,87,239,2481,5742,2568,5981
220207,202304,918,2415,784,2198,86,208,492,1436,578,1644
220208,202304,2105,5837,1696,5103,422,1315,725,2180,1147,3495
220209,202304,1844,4879,1531,4314,41,150,1158,3152,1199,3302
220210,202304,2290,4609,2003,4208,25,69,1759,3576,1784,3645
220211,202304,2019,4172,1839,3943,18,62,1622,3401,1640,3463
220213,202304,2140,4968,1821,4457,32,99,1468,3399,1500,3498
220217,202304,2911,6937,2682,6677,157,226,2378,6138,2535,6364
220220,202304,16525,32677,14344,29660,440,971,12256,24688,12696,25659
220225,202304,1201,2639,975,2359,2,12,925,2213,927,2225
220230,202304,6919,15068,6003,13838,481,912,4972,11584,5453,12496
220240,202304,3888,9594,3142,8348,96,362,2555,6562,2651,6924
220245,202304,2503,4344,1936,3688,9,35,1819,3402,1828,3437
220250,202304,3644,8726,3192,8174,25,94,2984,7586,3009,7680
220253,202304,1978,4787,1655,4308,35,124,1401,3550,1436,3674
220255,202304,2372,4904,2012,4414,42,142,1743,3663,1785,3805
220260,202304,6206,15039,5366,13640,258,644,4349,10954,4607,11598
220265,202304,1850,4762,1685,4544,81,274,1415,3709,1496,3983
220270,202304,7253,20891,6821,20142,201,924,5756,16328,5957,17252
220271,202304,1782,3940,1574,3659,60,136,1352,3099,1412,3235
220272,202304,2047,5321,1765,4819,48,164,1356,3532,1404,3696
220273,202304,1498,3907,1212,3393,64,201,896,2471,960,2672
220275,202304,3140,5948,2567,5198,80,113,2306,4651,2386,4764
220277,202304,2822,5851,2393,5277,90,179,2009,4334,2099,4513
220280,202304,2381,4324,2014,3880,24,42,1835,3472,1859,3514
220285,202304,2029,4037,1755,3707,10,42,1684,3499,1694,3541
220290,202304,8376,20456,6695,18186,617,1471,4667,13194,5284,14665
220300,202304,2273,5924,1782,5286,42,204,1438,4221,1480,4425
220310,202304,3855,8929,3085,8042,53,182,2700,6986,2753,7168
220320,202304,3666,9280,2820,7840,58,262,2268,6035,2326,6297
220323,202304,2048,5043,1587,4323,47,159,1337,3522,1384,3681
220325,202304,1432,3915,1176,3473,32,128,942,2728,974,2856
220327,202304,2007,4847,1771,4485,75,238,1475,3617,1550,3855
220330,202304,6582,12810,5687,11779,87,243,5252,10677,5339,10920
220335,202304,2224,5474,2048,5243,133,239,1702,4443,1835,4682
220340,202304,2052,5129,1545,4274,92,315,964,2547,1056,2862
220342,202304,1478,3656,1320,3435,122,216,1002,2698,1124,2914
220345,202304,3546,7166,2763,6123,19,60,2470,5359,2489,5419
220350,202304,3862,8906,3112,7819,254,588,2153,5350,2407,5938
220360,202304,1592,3553,1220,2958,15,53,1000,2327,1015,2380
220370,202304,10897,26847,9891,25337,447,1112,8319,21110,8766,22222
220375,202304,2050,4764,1817,4489,15,24,1747,4322,1762,4346
220380,202304,1871,3733,1475,3205,26,44,1276,2761,1302,2805
220385,202304,1130,2211,919,1868,3,5,832,1649,835,1654
220390,202304,15800,33171,12678,28833,2126,4943,7147,15898,9273,20841
220400,202304,1819,3873,1391,3232,19,54,1095,2406,1114,2460
220410,202304,1403,3428,1133,2982,29,98,938,2405,967,2503
220415,202304,984,2303,795,1982,22,41,616,1505,638,1546
220420,202304,2155,5663,1731,4851,124,396,1170,3162,1294,3558
220430,202304,3538,7471,3117,6935,38,93,2835,6200,2873,6293
220435,202304,2472,5217,2143,4716,32,91,1837,3899,1869,3990
220440,202304,3946,8930,3365,8131,72,307,2990,6904,3062,7211
220450,202304,3341,7284,2784,6605,52,169,2458,5721,2510,5890
220455,202304,1722,4192,1623,4070,18,59,1494,3751,1512,3810
220460,202304,1390,2778,1270,2615,27,64,1124,2235,1151,2299
220465,202304,2878,7750,2529,7228,189,547,1987,5687,2176,6234
220470,202304,4633,10992,4079,10141,217,427,3128,7726,3345,8153
220480,202304,3151,7451,2473,6450,266,482,1607,4266,1873,4748
220490,202304,2867,6403,2448,5890,28,130,2149,5040,2177,5170
220500,202304,3973,8519,3324,7569,153,272,2553,5698,2706,5970
220510,202304,3225,7523,2629,6543,127,305,2058,5170,2185,5475
220515,202304,2165,4415,1976,4152,65,82,1714,3589,1779,3671
220520,202304,6236,13816,5661,13020,117,262,4866,11084,4983,11346
220525,202304,1648,3530,1376,3211,34,67,1229,2888,1263,2955
220527,202304,1975,4168,1636,3663,66,136,1442,3225,1508,3361
220530,202304,2022,4055,1668,3616,168,345,1248,2806,1416,3151
220535,202304,954,2351,888,2249,27,98,725,1752,752,1850
220540,202304,3815,10616,3492,9990,219,589,2795,7953,3014,8542
220545,202304,1797,4631,1602,4342,85,300,1349,3584,1434,3884
220550,202304,10365,29298,9086,26931,598,1936,6527,18763,7125,20699
220551,202304,1737,4111,1504,3727,20,49,1272,3085,1292,3134
220552,202304,1889,4952,1534,4350,23,112,1236,3341,1259,3453
220553,202304,2577,5037,2170,4522,21,38,1982,4075,2003,4113
220554,202304,1136,2475,885,2113,79,161,639,1501,718,1662
220555,202304,4755,8515,4227,7910,27,68,3818,7119,3845,7187
220556,202304,1532,3826,1295,3427,44,189,950,2332,994,2521
220557,202304,2253,5897,1602,4554,131,411,1145,3124,1276,3535
220558,202304,1764,4021,1415,3550,32,109,1204,2921,1236,3030
220559,202304,2214,4716,1886,4228,87,147,1518,3401,1605,3548
220560,202304,2346,4389,2000,3978,18,36,1886,3715,1904,3751
220570,202304,9831,25054,8774,23498,785,1938,6679,17804,7464,19742
220580,202304,8050,19285,7278,18173,105,296,6471,16037,6576,16333
220585,202304,2495,6870,2057,6065,58,147,1661,4886,1719,5033
220590,202304,1989,4163,1652,3709,102,205,1359,2993,1461,3198
220595,202304,3348,7936,2995,7462,86,296,2545,6171,2631,6467
220600,202304,2228,3758,1936,3431,26,43,1833,3216,1859,3259
220605,202304,1694,4564,1432,4086,20,100,1138,3137,1158,3237
220610,202304,3528,8315,3292,7996,13,72,3118,7490,3131,7562
220620,202304,10806,25825,9879,24589,127,598,9086,22132,9213,22730
220630,202304,424,1122,319,939,30,92,194,538,224,630
220635,202304,2132,5609,1869,5105,61,181,1506,4003,1567,4184
220640,202304,2782,6932,2410,6412,83,288,1931,5036,2014,5324
220650,202304,2943,6546,2516,5920,68,151,2113,4950,2181,5101
220660,202304,3058,8455,2543,7616,69,315,2090,6070,2159,6385
220665,202304,1666,4136,1439,3789,29,127,1253,3195,1282,3322
220667,202304,1894,4986,1731,4719,70,228,1412,3790,1482,4018
220669,202304,1951,5104,1839,4950,31,132,1654,4342,1685,4474
220670,202304,2843,5957,2294,5212,33,85,2018,4495,2051,4580
220672,202304,4097,8954,3415,8136,98,330,3031,7053,3129,7383
220675,202304,1516,3732,1359,3451,91,250,1030,2567,1121,2817
220680,202304,3745,7838,3550,7601,211,319,3140,6806,3351,7125
220690,202304,1853,4345,1583,3946,126,344,1184,2879,1310,3223
220695,202304,1110,2738,996,2546,16,47,836,2100,852,2147
220700,202304,15223,29213,12530,25748,475,1008,10378,20570,10853,21578
220710,202304,1047,2530,755,2050,30,90,563,1467,593,1557
220720,202304,2701,5368,2425,5037,27,75,2168,4384,2195,4459
220730,202304,1690,3841,1463,3496,17,62,1285,2969,1302,3031
220735,202304,1210,2423,936,2022,44,78,710,1493,754,1571
220740,202304,1616,3712,1278,3271,59,136,1036,2670,1095,2806
220750,202304,5278,10882,4656,10080,268,434,4118,9010,4386,9444
220755,202304,1817,3656,1512,3243,37,71,1272,2669,1309,2740
220760,202304,4213,8963,3678,8275,45,151,3467,7739,3512,7890
220770,202304,34385,85552,29632,78010,8189,23020,12286,31732,20475,54752
220775,202304,1753,3535,1562,3308,4,15,1526,3207,1530,3222
220777,202304,1782,4056,1447,3565,42,84,1018,2638,1060,2722
220779,202304,1425,3470,1229,3173,44,128,1017,2581,1061,2709
220780,202304,7235,15483,6443,14386,437,946,5018,11168,5455,12114
220785,202304,1706,3411,1517,3186,17,36,1438,2989,1455,3025
220790,202304,12536,30267,11256,28526,233,780,9722,24195,9955,24975
220793,202304,1175,2608,959,2257,15,27,825,1916,840,1943
220795,202304,1637,3764,1446,3509,28,81,1268,3057,1296,3138
220800,202304,26392,49393,22855,44888,1920,3882,17957,34110,19877,37992
220810,202304,3711,8934,3127,8015,74,163,2545,6581,2619,6744
220820,202304,7360,15238,6497,14055,319,537,5460,11813,5779,12350
220830,202304,9304,20681,8255,19218,447,986,6706,15274,7153,16260
220840,202304,16280,40671,13941,36582,1808,4653,9158,23408,10966,28061
220850,202304,3539,9678,3145,9185,56,263,2799,8159,2855,8422
220855,202304,1046,1967,906,1794,22,57,834,1632,856,1689
220860,202304,1477,2874,1264,2575,26,70,1177,2351,1203,2421
220865,202304,2655,6655,2037,5582,59,229,1509,3945,1568,4174
220870,202304,3987,8803,3307,7949,35,134,3021,7138,3056,7272
220880,202304,8178,14477,7052,13137,180,335,6467,11937,6647,12272
220885,202304,1823,4359,1523,3925,119,299,1196,3073,1315,3372
220887,202304,1988,3617,1660,3198,46,56,1531,2942,1577,2998
220890,202304,1663,4455,1420,4101,52,182,1144,3284,1196,3466
220900,202304,2590,5169,2186,4645,23,62,1963,4083,1986,4145
220910,202304,2185,4666,1857,4201,289,470,1318,3155,1607,3625
220915,202304,1072,2663,839,2268,26,84,610,1548,636,1632
220920,202304,1931,4895,1676,4572,118,293,1366,3773,1484,4066
220930,202304,2389,5011,2017,4525,18,54,1835,4167,1853,4221
220935,202304,1258,3302,976,2718,18,76,662,1734,680,1810
220937,202304,1760,4096,1487,3666,35,109,1187,2826,1222,2935
220940,202304,2271,4744,1852,4077,41,106,1576,3350,1617,3456
220945,202304,584,1792,461,1575,24,124,322,1061,346,1185
220950,202304,1628,3356,1124,2619,7,17,913,2016,920,2033
220955,202304,2035,4335,1678,3766,18,31,1483,3273,1501,3304
220960,202304,884,2083,643,1688,45,156,425,1018,470,1174
220965,202304,2255,5094,1935,4630,15,73,1711,3964,1726,4037
220970,202304,2605,5018,1949,4117,8,26,1721,3507,1729,3533
220975,202304,908,2066,772,1899,12,43,678,1616,690,1659
220980,202304,1569,3571,1395,3343,34,89,1224,2870,1258,2959
220985,202304,1748,3701,1516,3362,99,170,1180,2580,1279,2750
220987,202304,1780,4516,1614,4257,49,164,1357,3520,1406,3684
220990,202304,1934,4796,1713,4477,28,99,1435,3700,1463,3799
220995,202304,1707,3782,1401,3297,13,44,1211,2794,1224,2838
220997,202304,2895,7393,2633,6969,50,188,2333,6010,2383,6198
221000,202304,5856,13371,5075,12306,198,563,4221,10046,4419,10609
221005,202304,1989,4304,1821,4047,25,99,1583,3339,1608,3438
221010,202304,1543,2927,1223,2547,38,54,1067,2192,1105,2246
221020,202304,1792,4920,1602,4614,23,100,1263,3590,1286,3690
221030,202304,2035,4039,1754,3701,21,56,1592,3358,1613,3414
221035,202304,1900,4119,1590,3712,44,62,1378,3241,1422,3303
221037,202304,837,2013,695,1781,9,36,519,1230,528,1266
221038,202304,608,1526,482,1326,35,97,330,881,365,978
221039,202304,989,2423,812,2141,28,95,649,1664,677,1759
221040,202304,5332,13508,4530,12215,259,682,3582,9651,3841,10333
221050,202304,5617,10962,5056,10279,68,192,4659,9350,4727,9542
221060,202304,11823,28022,9774,24741,496,1118,7775,19437,8271,20555
221062,202304,1618,4043,1388,3703,123,272,1060,2876,1183,3148
221063,202304,1506,3474,1315,3202,55,152,1094,2586,1149,2738
221065,202304,3542,7422,3041,6623,18,54,2751,5870,2769,5924
221070,202304,3951,10902,3160,9328,509,1466,1844,5529,2353,6995
221080,202304,4362,9334,3593,8224,50,167,3038,6653,3088,6820
221090,202304,1663,3589,1396,3209,14,34,1222,2733,1236,2767
221093,202304,2042,4533,1832,4202,187,375,1359,3037,1546,3412
221095,202304,1074,2479,885,2220,31,81,716,1773,747,1854
221097,202304,980,2230,740,1838,24,63,565,1329,589,1392
221100,202304,184101,404629,156759,362898,10575,27906,116463,255048,127038,282954
221110,202304,13969,32847,12687,31264,369,813,11233,27583,11602,28396
221120,202304,5984,15170,5340,14243,226,666,4547,12018,4773,12684
221130,202304,7284,15483,5818,12994,1250,2531,3400,7379,4650,9910
221135,202304,2418,5014,2082,4591,96,168,1786,4008,1882,4176
221140,202304,1927,3507,1587,3100,75,111,1372,2671,1447,2782
221150,202304,1350,2987,1011,2441,25,91,796,1810,821,1901
221160,202304,851,1896,779,1805,40,55,614,1430,654,1485
221170,202304,1278,2917,1196,2786,8,19,1109,2539,1117,2558
230010,202304,3598,8473,2900,7299,99,281,2345,5679,2444,5960
230015,202304,4435,11596,3839,10439,224,647,2734,7301,2958,7948
230020,202304,18640,47189,17255,45102,1058,2737,14112,36852,15170,39589
230030,202304,15565,34183,13037,30784,577,1202,10448,24942,11025,26144
230040,202304,5654,12052,4746,10702,55,196,3833,8809,3888,9005
230050,202304,2973,8578,2329,7136,328,1080,1148,3195,1476,4275
230060,202304,2962,6908,2287,5793,34,131,1854,4544,1888,4675
230070,202304,5383,11863,4248,9955,643,1452,2682,6247,3325,7699
230075,202304,11956,31633,10842,29817,581,1859,8754,23443,9335,25302
230080,202304,3694,6770,2848,5730,10,24,2656,5283,2666,5307
230090,202304,5619,11601,4704,10210,153,328,3954,8306,4107,8634
230100,202304,27846,58998,24233,54365,2292,5252,17215,37991,19507,43243
230110,202304,17118,44718,14472,39928,2535,7306,7751,20470,10286,27776
230120,202304,9881,22908,8099,20246,877,2184,5346,13318,6223,15502
230125,202304,3764,8767,3107,7741,62,243,2568,6111,2630,6354
230130,202304,6802,18381,5483,15687,386,1030,3770,10586,4156,11616
230140,202304,4301,11158,3575,9790,109,422,2800,7324,2909,7746
230150,202304,1912,5040,1575,4377,228,609,911,2536,1139,3145
230160,202304,8870,17818,7660,16112,240,462,6615,13601,6855,14063
230170,202304,7381,19100,5970,16349,480,1235,4058,10871,4538,12106
230180,202304,1985,4792,1610,4130,16,63,1318,3231,1334,3294
230185,202304,5662,13199,4663,11660,468,1161,3322,8315,3790,9476
230190,202304,17777,48161,14477,41930,2162,6392,7790,21918,9952,28310
230195,202304,7068,17906,6323,16707,335,894,4844,12649,5179,13543
230200,202304,5801,14526,4801,12732,353,883,3462,8924,3815,9807
230205,202304,5685,13207,4983,12234,477,955,3758,9310,4235,10265
230210,202304,13089,26596,11258,24225,463,976,9200,19262,9663,20238
230220,202304,18963,40648,16675,37533,1059,2358,13496,29771,14555,32129
230230,202304,8727,21673,7905,20176,646,1464,5921,15011,6567,16475
230240,202304,16906,37649,14276,33508,906,1795,11010,25549,11916,27344
230250,202304,11603,27913,10758,26698,808,1963,7752,18708,8560,20671
230260,202304,18458,46433,15851,42092,2271,5873,9728,25386,11999,31259
230270,202304,8648,20808,6643,17307,869,2103,3847,10263,4716,12366
230280,202304,24439,55486,20407,49135,450,1691,16726,37936,17176,39627
230290,202304,6300,14265,5391,12678,250,564,4298,9760,4548,10324
230300,202304,6072,13587,5439,12745,81,233,4810,11209,4891,11442
230310,202304,5714,14486,4653,12572,162,569,3377,8739,3539,9308
230320,202304,9065,23304,7532,20745,246,926,5868,15551,6114,16477
230330,202304,5816,13827,4498,11466,171,518,3394,8263,3565,8781
230340,202304,4626,12834,3987,11598,321,952,2718,7667,3039,8619
230350,202304,23433,53821,20487,49740,1121,3131,15109,35460,16230,38591
230360,202304,3735,8472,2910,7128,155,372,2155,5261,2310,5633
230365,202304,3667,7800,3092,6998,77,221,2726,6071,2803,6292
230370,202304,102227,214797,90428,199078,5108,13143,72534,152154,77642,165297
230380,202304,7415,18287,5889,15558,126,416,4464,11269,4590,11685
230390,202304,4063,10290,3474,9381,80,332,2771,7215,2851,7547
230393,202304,4146,10167,3282,8545,78,357,2677,6563,2755,6920
230395,202304,6850,16835,5773,15064,551,1433,3780,9604,4331,11037
230400,202304,6873,16284,6078,15099,88,373,4969,11735,5057,12108
230410,202304,16032,42677,13303,38000,1165,3295,9088,25753,10253,29048
230420,202304,37620,89061,30945,78252,3276,8667,19469,46886,22745,55553
230423,202304,5363,14270,4754,13171,320,919,3430,9220,3750,10139
230425,202304,7550,19796,6949,18696,760,1978,4835,12861,5595,14839
230426,202304,3231,7464,2332,5840,51,188,1768,4205,1819,4393
230427,202304,2114,5390,1528,4265,136,415,873,2216,1009,2631
230428,202304,12316,29840,10595,27428,1655,4253,6119,15302,7774,19555
230430,202304,5905,15127,4610,12889,195,583,3442,9386,3637,9969
230435,202304,7753,17410,6359,15143,930,2158,3687,8618,4617,10776
230440,202304,614789,1245891,530325,1132024,35723,84675,399015,812145,434738,896820
230445,202304,4829,12034,4001,10689,253,694,2742,6978,2995,7672
230450,202304,4581,11159,3996,10336,205,704,3030,7400,3235,8104
230460,202304,2728,6318,2332,5704,68,231,1971,4679,2039,4910
230465,202304,5036,12220,4223,10744,168,467,3260,7993,3428,8460
230470,202304,14129,39552,12678,36984,848,2810,9400,26416,10248,29226
230480,202304,1854,4546,1517,3980,56,214,1156,2836,1212,3050
230490,202304,3327,8219,2756,7158,222,649,1822,4365,2044,5014
230495,202304,7502,18227,6530,16626,885,2365,4057,9932,4942,12297
230500,202304,11252,32022,9865,29625,510,1538,7733,23219,8243,24757
230510,202304,2151,5160,1698,4328,174,474,1082,2592,1256,3066
230520,202304,5814,13765,5036,12501,419,1004,3690,8914,4109,9918
230523,202304,20526,54059,16049,45254,3706,10177,4167,12132,7873,22309
230526,202304,4785,11411,4055,10289,318,633,2885,7545,3203,8178
230530,202304,6625,18764,5563,16824,1265,3934,2994,9009,4259,12943
230533,202304,6056,11457,4837,9716,64,161,4193,8039,4257,8200
230535,202304,5801,15025,4954,13686,371,1133,3301,8923,3672,10056
230540,202304,18197,44975,15720,41350,272,943,13040,33608,13312,34551
230550,202304,28061,63089,23236,55575,2196,5139,15978,37011,18174,42150
230560,202304,9240,19320,7354,16566,187,357,6217,13947,6404,14304
230565,202304,3677,8928,3090,7897,95,287,2481,6118,2576,6405
230570,202304,4021,9207,3385,8321,62,196,2814,6725,2876,6921
230580,202304,14897,32147,12845,29305,574,1237,10779,24236,11353,25473
230590,202304,11616,28441,9709,25308,758,1854,7055,18128,7813,19982
230600,202304,4582,10160,3616,8602,146,342,2525,5968,2671,6310
230610,202304,8217,19651,7222,18070,513,1293,5658,13954,6171,15247
230620,202304,2625,6004,2084,5058,82,260,1508,3354,1590,3614
230625,202304,12595,29731,10875,26948,2164,5673,5298,12409,7462,18082
230630,202304,14171,35057,12507,32240,1599,3763,8035,20852,9634,24615
230640,202304,32235,88451,29271,83772,1558,5157,23172,64806,24730,69963
230650,202304,6350,14934,5320,13263,204,707,4339,10323,4543,11030
230655,202304,11912,33255,11261,32238,860,2251,9119,26426,9979,28677
230660,202304,7168,18744,5787,16354,173,706,4673,12837,4846,13543
230670,202304,7174,15191,5151,12104,166,421,4119,9327,4285,9748
230680,202304,3402,8149,2749,7070,162,321,1904,4863,2066,5184
230690,202304,8425,22235,7072,19734,562,1605,4417,12251,4979,13856
230700,202304,12903,28074,10252,23516,399,976,8059,17878,8458,18854
230710,202304,8004,22672,6993,20681,662,2002,4599,13170,5261,15172
230720,202304,2283,6053,1899,5403,142,404,1255,3452,1397,3856
230725,202304,5678,14477,5149,13662,351,1089,3655,9263,4006,10352
230730,202304,74936,174085,59359,152406,12956,33701,25196,65494,38152,99195
230740,202304,7203,17967,6020,16118,169,485,4770,12634,4939,13119
230750,202304,10079,23754,8285,20940,141,480,6721,16331,6862,16811
230760,202304,14387,33192,12398,30303,493,1523,9582,22316,10075,23839
230763,202304,5810,13878,4750,12166,106,394,3772,9215,3878,9609
230765,202304,57913,134520,49897,122729,4884,13051,32980,76697,37864,89748
230770,202304,35831,70716,30704,64361,1946,4228,24115,48840,26061,53068
230780,202304,8086,24362,7261,22577,1006,2965,4390,13775,5396,16740
230790,202304,3888,9335,3439,8651,136,428,2717,6518,2853,6946
230800,202304,10755,29204,9354,26579,1099,3300,5736,15422,6835,18722
230810,202304,12832,34827,11412,32555,636,1849,8715,24378,9351,26227
230820,202304,4260,12284,3538,10854,368,1292,2180,6315,2548,7607
230830,202304,9187,21626,7850,19529,329,687,6230,15167,6559,15854
230835,202304,4923,10419,3927,8966,122,289,3228,7139,3350,7428
230837,202304,4781,10747,4337,10061,78,291,3830,8535,3908,8826
230840,202304,11298,29902,9720,27220,819,2336,7066,19549,7885,21885
230850,202304,12320,29815,10436,26575,608,1425,7759,19501,8367,20926
230860,202304,7887,14728,6710,13176,183,300,5982,11531,6165,11831
230870,202304,22445,44212,19297,39399,760,1481,15992,31674,16752,33155
230880,202304,2345,6388,2164,6077,69,285,1690,4537,1759,4822
230890,202304,5546,15438,5012,14554,233,814,3686,10523,3919,11337
230900,202304,4013,9996,3326,8710,129,476,2436,6005,2565,6481
230910,202304,4233,9214,3297,7857,62,232,2785,6465,2847,6697
230920,202304,5698,14146,4518,12209,140,418,3462,9059,3602,9477
230930,202304,8310,20693,6773,18096,485,1349,4583,11897,5068,13246
230940,202304,10102,22080,8705,20142,192,422,7476,17045,7668,17467
230945,202304,7822,19648,6666,17629,420,1056,4742,12153,5162,13209
230950,202304,7659,16630,6768,15450,139,321,5792,13140,5931,13461
230960,202304,15632,40250,13517,36499,2246,6200,6849,17629,9095,23829
230970,202304,19376,44836,16491,40611,1780,4480,10774,25639,12554,30119
230980,202304,4304,9161,3724,8259,312,664,2808,6092,3120,6756
230990,202304,2044,5057,1707,4445,73,264,1259,3065,1332,3329
231000,202304,3350,7620,2631,6332,78,231,2040,4632,2118,4863
231010,202304,4575,8977,3480,7271,43,139,3085,6193,3128,6332
231020,202304,11126,28127,9848,25928,1641,3993,5975,15918,7616,19911
231025,202304,10479,23724,9343,22043,644,1407,7355,17111,7999,18518
231030,202304,8710,23473,6598,19340,879,2543,3782,10993,4661,13536
231040,202304,3767,8735,3227,7830,97,275,2701,6292,2798,6567
231050,202304,14642,32106,12044,27852,506,1330,9542,21169,10048,22499
231060,202304,3544,8528,3124,7909,121,364,2495,6242,2616,6606
231070,202304,9807,24893,8511,22730,796,2089,5782,15113,6578,17202
231080,202304,4535,11410,3743,10134,250,679,2588,6925,2838,7604
231085,202304,8982,18971,7169,16794,259,651,5686,12975,5945,13626
231090,202304,5162,12151,3823,9681,135,448,2686,6373,2821,6821
231095,202304,2615,7207,2042,6019,195,570,1340,3891,1535,4461
231100,202304,3623,9297,2972,8155,163,494,2230,5923,2393,6417
231110,202304,4478,11792,4092,11126,611,1819,2625,6747,3236,8566
231120,202304,2912,7185,2461,6460,108,272,1866,4784,1974,5056
231123,202304,2335,5422,1835,4575,105,266,1291,3142,1396,3408
231126,202304,6604,16037,5361,13829,301,707,3988,10174,4289,10881
231130,202304,30872,62312,25870,56133,1344,3536,20380,41853,21724,45389
231135,202304,4953,12480,4151,11011,170,466,3032,7863,3202,8329
231140,202304,21483,51053,17572,44865,1095,3182,12775,31008,13870,34190
231150,202304,7058,17287,5025,13396,880,2421,1885,4820,2765,7241
231160,202304,8561,21740,7601,20043,855,2220,4980,12913,5835,15133
231170,202304,5590,14129,4675,12522,310,896,3368,8607,3678,9503
231180,202304,19007,46491,15573,40007,2334,5953,8431,20901,10765,26854
231190,202304,5020,12222,3926,10351,94,310,3031,7699,3125,8009
231195,202304,5912,16120,4852,14120,319,1018,3432,9905,3751,10923
231200,202304,10221,24986,8971,22749,147,634,7599,18352,7746,18986
231210,202304,5788,14936,4868,13438,153,616,3913,10400,4066,11016
231220,202304,16146,34845,12880,29284,645,1376,9603,20854,10248,22230
231230,202304,12007,33687,10601,31156,814,2501,7786,22559,8600,25060
231240,202304,14367,38091,12644,35065,1744,4729,7758,21163,9502,25892
231250,202304,2522,5425,1683,3779,68,154,1185,2454,1253,2608
231260,202304,4042,9569,3373,8509,364,792,2298,5876,2662,6668
231270,202304,7740,17418,6288,15130,157,548,4861,11013,5018,11561
231280,202304,2170,5953,1866,5435,153,444,1293,3761,1446,4205
231290,202304,44251,118609,37356,106532,5243,14970,19735,53972,24978,68942
231300,202304,5034,12238,3895,10088,224,668,2658,6519,2882,7187
231310,202304,10388,21716,8246,18129,556,1426,6232,12883,6788,14309
231320,202304,8243,20934,6385,17669,218,531,4909,13482,5127,14013
231325,202304,2881,6707,2194,5629,117,232,1579,4004,1696,4236
231330,202304,13627,33871,11190,29568,1367,3508,7282,19030,8649,22538
231335,202304,6660,15586,5576,13956,150,464,4756,11688,4906,12152
231340,202304,22544,61063,20149,57272,1661,4645,14884,42684,16545,47329
231350,202304,19560,46673,17825,44286,316,962,15913,38975,16229,39937
231355,202304,5304,13787,4722,12773,249,697,3693,9793,3942,10490
231360,202304,9573,25533,8272,23445,434,1355,6491,18058,6925,19413
231370,202304,2418,6078,1920,5221,41,123,1473,3931,1514,4054
231375,202304,4864,13247,4368,12434,173,543,3424,9811,3597,10354
231380,202304,7383,16704,6496,15551,194,392,5438,12920,5632,13312
231390,202304,4043,10647,3594,9922,121,478,2722,7185,2843,7663
231395,202304,5271,13202,4436,11905,342,874,3093,8138,3435,9012
231400,202304,11886,29355,9967,26032,318,1211,7739,19213,8057,20424
231410,202304,20035,49693,18228,47085,813,2046,15289,39211,16102,41257
240010,202304,3027,7103,2359,5980,387,1002,1154,2782,1541,3784
240020,202304,17502,40418,14559,35544,889,2624,10432,24106,11321,26730
240030,202304,4788,8812,4310,8160,79,225,3943,7180,4022,7405
240040,202304,926,2443,756,2146,24,75,505,1359,529,1434
240050,202304,4140,9827,3224,8233,58,156,2493,6150,2551,6306
240060,202304,1791,4157,1402,3491,51,128,1094,2653,1145,2781
240070,202304,3187,7820,2801,7052,229,655,1992,4674,2221,5329
240080,202304,3502,8515,2746,7238,133,403,1918,4871,2051,5274
240090,202304,2765,5755,2279,5013,40,83,1970,4239,2010,4322
240100,202304,13490,27884,10945,23790,230,666,8968,18343,9198,19009
240110,202304,6016,14865,5022,13101,203,658,3760,9264,3963,9922
240120,202304,4067,10264,3382,9326,292,901,2356,6298,2648,7199
240130,202304,4872,8393,3991,7293,28,67,3649,6530,3677,6597
240140,202304,2113,5855,1780,5255,196,660,1085,3036,1281,3696
240145,202304,8361,21084,6767,18389,736,2079,4371,11610,5107,13689
240150,202304,1294,3005,1070,2600,61,181,836,1939,897,2120
240160,202304,1738,4485,1434,3946,42,182,1071,2807,1113,2989
240165,202304,1173,2815,974,2475,24,92,798,1948,822,2040
240170,202304,3439,7919,2890,7005,306,740,1922,4558,2228,5298
240180,202304,3656,9685,2945,8291,633,1765,1352,3901,1985,5666
240185,202304,1708,4591,1508,4247,52,194,1195,3208,1247,3402
240190,202304,1384,3277,1129,2874,45,168,872,2111,917,2279
240200,202304,16160,34149,13089,29352,1639,3728,7968,17037,9607,20765
240210,202304,4253,8552,3508,7388,26,106,3092,6207,3118,6313
240220,202304,8654,23319,7755,21947,540,1806,5885,16272,6425,18078
240230,202304,6933,15607,5484,13300,361,708,3950,9722,4311,10430
240240,202304,2126,5656,1488,4317,235,700,484,1209,719,1909
240250,202304,3736,8243,3223,7497,59,191,2729,6091,2788,6282
240260,202304,19777,50251,17221,46205,5040,13112,7232,21477,12272,34589
240270,202304,3023,7704,2483,6866,116,329,1699,4799,1815,5128
240280,202304,1905,4417,1587,3912,65,149,1241,3007,1306,3156
240290,202304,1323,3441,1101,3005,28,114,759,1869,787,1983
240300,202304,2620,6095,1943,4990,108,297,1218,2977,1326,3274
240310,202304,10281,24690,8178,21123,1197,3072,4095,10199,5292,13271
240320,202304,2269,5687,1580,4372,99,294,1065,2779,1164,3073
240325,202304,46880,105426,38751,92741,4407,11942,24282,54076,28689,66018
240330,202304,2147,5267,1673,4446,72,239,1148,2860,1220,3099
240340,202304,2493,4863,2011,4165,56,129,1670,3283,1726,3412
240350,202304,3005,6167,2661,5765,71,180,2426,5198,2497,5378
240360,202304,15816,37000,14120,34468,2180,5156,9085,22026,11265,27182
240370,202304,2656,5668,2047,4621,110,291,1519,3200,1629,3491
240375,202304,1150,2453,924,2086,32,91,684,1402,716,1493
240380,202304,2716,6817,2126,5645,234,603,1237,3164,1471,3767
240390,202304,1141,2572,779,1917,28,54,479,1082,507,1136
240400,202304,1686,3816,1247,3093,42,140,872,2014,914,2154
240410,202304,699,1891,568,1652,61,220,312,841,373,1061
240420,202304,6226,18144,5589,16934,435,1667,3947,11374,4382,13041
240430,202304,4184,9439,3525,8367,117,376,2764,6218,2881,6594
240440,202304,3372,6734,2891,6074,269,525,2208,4553,2477,5078
240450,202304,5318,12975,4199,11020,321,1020,2665,6381,2986,7401
240460,202304,4200,9656,3781,9027,293,645,3018,7210,3311,7855
240470,202304,4027,11213,2990,9042,706,1885,1274,4077,1980,5962
240480,202304,676,1690,412,1133,26,53,201,540,227,593
240485,202304,2488,6389,1990,5522,162,475,1247,3431,1409,3906
240490,202304,1951,4301,1469,3498,85,162,1063,2479,1148,2641
240500,202304,2585,6228,2247,5675,115,282,1805,4486,1920,4768
240510,202304,2025,4851,1740,4430,101,311,1378,3358,1479,3669
240520,202304,1919,3894,1473,3306,145,261,1111,2529,1256,2790
240530,202304,2858,6749,2523,6244,151,287,2029,4985,2180,5272
240540,202304,2748,5912,2499,5540,44,112,2257,4942,2301,5054
240550,202304,1068,2306,950,2120,14,44,847,1830,861,1874
240560,202304,4750,9856,4150,9097,145,255,3526,7682,3671,7937
240570,202304,3285,7998,2205,5754,309,837,865,1960,1174,2797
240580,202304,10625,26433,9418,24418,546,1508,7641,19455,8187,20963
240590,202304,1118,2152,975,1959,22,40,807,1557,829,1597
240600,202304,2104,5075,1534,4007,57,161,1063,2610,1120,2771
240610,202304,5438,12388,4665,11076,307,797,3290,7306,3597,8103
240615,202304,1527,3444,1238,2982,95,252,919,2086,1014,2338
240620,202304,2364,5630,2006,5050,67,219,1673,4077,1740,4296
240630,202304,2839,6198,2556,5773,220,341,1946,4490,2166,4831
240640,202304,1088,2570,856,2188,38,115,636,1561,674,1676
240650,202304,4789,12788,3945,11129,328,886,2583,7266,2911,8152
240660,202304,5389,9410,4866,8768,76,142,4577,8154,4653,8296
240670,202304,3081,7511,2432,6273,233,630,1555,3825,1788,4455
240680,202304,1907,4404,1531,3799,86,242,1143,2686,1229,2928
240690,202304,1471,3066,1140,2538,20,73,960,1998,980,2071
240700,202304,2792,7407,2251,6465,114,338,1644,4658,1758,4996
240710,202304,24761,51036,21272,45828,1749,3933,16073,33176,17822,37109
240720,202304,6222,14117,5221,12683,668,1660,3362,7970,4030,9630
240725,202304,1268,3328,972,2810,46,131,618,1715,664,1846
240730,202304,2678,6666,2085,5581,85,268,1566,4039,1651,4307
240740,202304,2236,5577,1793,4712,98,303,1261,3095,1359,3398
240750,202304,2617,7601,2259,6875,252,835,1377,4009,1629,4844
240760,202304,2049,4109,1513,3356,117,169,1113,2580,1230,2749
240770,202304,4038,9540,3394,8675,126,408,2816,6985,2942,7393
240780,202304,6490,15512,5436,13823,763,1934,3495,8688,4258,10622
240790,202304,1057,2634,867,2317,27,116,632,1584,659,1700
240800,202304,72901,146581,59031,126856,5985,13304,39000,78424,44985,91728
240810,202304,136332,289615,119976,265419,11306,25713,86956,185482,98262,211195
240820,202304,7886,20672,6878,18893,1085,3043,4085,11080,5170,14123
240830,202304,10401,25848,9016,23868,387,1208,7178,18626,7565,19834
240840,202304,1302,2938,1027,2505,48,97,720,1697,768,1794
240850,202304,1652,4118,1130,3060,78,207,677,1723,755,1930
240860,202304,1797,3862,1355,3134,39,126,1117,2458,1156,2584
240870,202304,1214,2810,950,2392,173,416,467,1195,640,1611
240880,202304,1528,4352,1300,3911,102,394,929,2683,1031,3077
240890,202304,6595,14565,5250,12333,489,1334,3522,7487,4011,8821
240895,202304,3558,9502,3213,8970,389,1062,2350,6609,2739,7671
240910,202304,4147,10052,3404,8793,63,212,2739,6819,2802,7031
240920,202304,1305,2825,1044,2471,121,217,673,1648,794,1865
240930,202304,4345,8873,3517,7857,268,400,2309,5653,2577,6053
240933,202304,1896,4286,1607,3879,42,176,1352,3114,1394,3290
240940,202304,8917,18515,7154,15793,718,1534,4835,10169,5553,11703
240950,202304,1310,3522,1118,3139,26,112,884,2360,910,2472
240960,202304,831,2080,746,1908,16,58,576,1400,592,1458
240970,202304,2404,5094,1962,4416,72,192,1628,3538,1700,3730
240980,202304,4802,10908,4317,10161,73,284,3828,8671,3901,8955
240990,202304,3558,8130,3131,7397,240,677,2309,5069,2549,5746
241000,202304,1267,2737,993,2277,13,46,814,1755,827,1801
241010,202304,3837,9874,3466,9185,133,431,2836,7226,2969,7657
241020,202304,2513,5999,1888,4822,103,321,1353,3223,1456,3544
241025,202304,1915,4999,1534,4349,37,150,1092,2962,1129,3112
241030,202304,2977,8300,2424,7235,248,756,1640,4753,1888,5509
241040,202304,2600,7191,2198,6529,134,449,1636,4820,1770,5269
241050,202304,1722,4279,1370,3653,42,132,1021,2651,1063,2783
241060,202304,986,2384,820,2052,37,93,587,1371,624,1464
241070,202304,853,2014,706,1790,20,59,545,1307,565,1366
241080,202304,1308,3320,1030,2788,40,133,718,1853,758,1986
241090,202304,2481,6192,1967,5362,69,259,1465,3822,1534,4081
241100,202304,1379,3455,1049,2821,88,181,659,1742,747,1923
241105,202304,1321,3455,1075,3019,205,614,531,1402,736,2016
241110,202304,1072,2764,797,2210,46,144,500,1307,546,1451
241120,202304,9057,23208,7734,21065,824,2295,5098,13731,5922,16026
241140,202304,3929,9420,2988,7632,171,434,2091,5191,2262,5625
241142,202304,892,2194,668,1792,62,162,359,868,421,1030
241150,202304,7016,16202,6137,14885,275,651,4817,11511,5092,12162
241160,202304,1307,3396,986,2797,157,478,478,1281,635,1759
241170,202304,1571,3566,1325,3154,37,102,1086,2475,1123,2577
241180,202304,1227,2800,910,2262,52,171,518,1210,570,1381
241190,202304,1419,3207,1165,2765,24,76,857,1920,881,1996
241200,202304,32179,67951,28507,62522,3120,7238,19966,41383,23086,48621
241210,202304,1987,4449,1435,3496,114,277,905,2140,1019,2417
241220,202304,12344,30498,10883,28169,2563,6665,5262,13658,7825,20323
241230,202304,3473,8133,3009,7475,115,270,2469,6058,2584,6328
241240,202304,1443,3720,881,2539,112,347,306,818,418,1165
241250,202304,7702,18027,6175,15455,141,555,4902,11584,5043,12139
241255,202304,3241,8538,2745,7641,182,594,1981,5301,2163,5895
241260,202304,5837,13546,4760,11820,179,527,3622,8577,3801,9104
241270,202304,1865,4964,1559,4395,108,340,1095,2988,1203,3328
241280,202304,3140,6209,2739,5548,89,170,2376,4680,2465,4850
241290,202304,3756,8311,2808,6850,101,309,2231,5217,2332,5526
241300,202304,1888,4406,1532,3857,44,147,1085,2575,1129,2722
241310,202304,2852,5744,2452,5217,65,130,2123,4448,2188,4578
241320,202304,1132,3364,964,3054,110,374,563,1722,673,2096
241330,202304,2081,4695,1661,4144,29,75,1477,3658,1506,3733
241335,202304,4482,11001,3934,10075,134,432,3193,7880,3327,8312
241340,202304,2079,4882,1645,4104,219,642,928,2106,1147,2748
241350,202304,2598,6208,2245,5614,100,244,1740,4259,1840,4503
241355,202304,1639,3888,1309,3279,52,111,983,2406,1035,2517
241360,202304,2473,5654,1786,4374,66,189,1319,3052,1385,3241
241370,202304,1590,3814,1240,3174,59,179,906,2144,965,2323
241380,202304,847,1997,680,1712,67,163,420,1046,487,1209
241390,202304,3286,8475,2878,7871,148,482,2232,6011,2380,6493
241400,202304,4343,10685,3814,9904,239,715,2950,7432,3189,8147
241410,202304,2978,7993,2390,6837,249,758,1526,4276,1775,5034
241415,202304,2269,5377,1913,4773,83,268,1484,3461,1567,3729
241420,202304,3809,9735,3419,9127,619,1732,2050,5458,2669,7190
241430,202304,855,1906,568,1385,19,51,392,874,411,925
241440,202304,10343,26963,9389,25413,243,803,7769,20542,8012,21345
241445,202304,1654,3371,1422,3065,27,54,1272,2712,1299,2766
241450,202304,3713,7529,2999,6466,207,409,2361,5014,2568,5423
241460,202304,4717,11381,3711,9438,314,872,2420,5759,2734,6631
241470,202304,1744,4070,1376,3553,36,133,1169,2955,1205,3088
241475,202304,1435,3471,1111,2892,22,74,836,2048,858,2122
241480,202304,3708,10222,3058,8917,873,2546,1079,3349,1952,5895
241490,202304,903,1823,644,1449,14,38,528,1146,542,1184
241500,202304,967,2338,856,2206,17,41,741,1902,758,1943
250010,202304,3229,8236,2613,7044,73,251,2001,5168,2074,5419
250020,202304,1918,4516,1420,3645,90,151,1050,2701,1140,2852
250030,202304,8521,20401,7429,18805,1053,2727,5000,12499,6053,15226
250040,202304,5732,14542,4981,13280,854,2173,2920,7729,3774,9902
250050,202304,4478,10362,3952,9709,178,439,3228,8035,3406,8474
250053,202304,1533,3872,1376,3640,142,302,922,2442,1064,2744
250057,202304,902,2435,820,2320,14,52,748,2106,762,2158
250060,202304,7511,16664,6599,15366,553,1295,4960,11427,5513,12722
250070,202304,4817,11746,3989,10376,45,192,3232,8054,3277,8246
250073,202304,957,2233,767,1931,9,31,624,1521,633,1552
250077,202304,3186,6710,2495,5671,36,107,2131,4668,2167,4775
250080,202304,7395,14193,6105,12663,68,187,5636,11501,5704,11688
250090,202304,4747,8887,4173,8183,63,129,3717,7090,3780,7219
250100,202304,4049,11012,3662,10351,270,699,2738,7603,3008,8302
250110,202304,6010,14703,5457,13946,371,1088,4172,10400,4543,11488
250115,202304,942,1923,709,1595,12,40,574,1232,586,1272
250120,202304,2149,5664,1909,5280,26,123,1558,4151,1584,4274
250130,202304,7495,15645,6439,14268,50,216,5764,12364,5814,12580
250135,202304,1650,3880,1413,3488,201,544,964,2283,1165,2827
250140,202304,2739,7068,2493,6776,192,574,1949,5388,2141,5962
250150,202304,5630,15688,5056,14777,199,709,4023,11423,4222,12132
250153,202304,1625,3904,1359,3518,75,154,1053,2702,1128,2856
250157,202304,2664,6092,2344,5604,59,177,1979,4584,2038,4761
250160,202304,4444,9783,3724,8803,85,219,3186,7426,3271,7645
250170,202304,2228,5214,1992,4886,39,126,1686,4015,1725,4141
250180,202304,31225,60465,27044,55312,1497,3659,21762,42364,23259,46023
250190,202304,5161,11841,4363,10726,450,1041,3031,7253,3481,8294
250200,202304,3192,5951,2726,5377,33,71,2470,4724,2503,4795
250205,202304,977,2765,807,2483,17,71,626,1901,643,1972
250210,202304,1713,4620,1503,4284,106,351,1121,3108,1227,3459
250215,202304,1893,4695,1616,4318,90,254,939,2523,1029,2777
250220,202304,802,1990,632,1725,21,89,457,1165,478,1254
250230,202304,1928,3936,1388,3174,21,50,1105,2440,1126,2490
250240,202304,3782,8177,3351,7516,35,139,2992,6505,3027,6644
250250,202304,5878,13694,5178,12757,414,667,4032,10472,4446,11139
250260,202304,1842,4771,1537,4222,78,206,1163,3193,1241,3399
250270,202304,1406,3801,1293,3667,95,273,901,2686,996,2959
250280,202304,4874,10341,4340,9663,296,498,3377,7695,3673,8193
250290,202304,2296,4688,1928,4169,33,74,1633,3396,1666,3470
250300,202304,7431,15763,6642,14815,242,726,5563,11978,5805,12704
250310,202304,1458,3738,1193,3278,61,150,863,2341,924,2491
250320,202304,18395,33718,16196,31269,185,504,14978,28208,15163,28712
250330,202304,3200,7221,2708,6552,69,245,2363,5482,2432,5727
250340,202304,1533,3186,1313,2899,20,48,1180,2576,1200,2624
250350,202304,4528,11772,3889,10657,334,742,2877,8139,3211,8881
250355,202304,2734,6392,2426,6027,17,68,2255,5567,2272,5635
250360,202304,2153,4964,1915,4656,117,343,1547,3588,1664,3931
250370,202304,20668,41162,17834,37133,259,782,15945,32000,16204,32782
250375,202304,1552,3288,1226,2911,17,32,1092,2652,1109,2684
250380,202304,2190,4555,2029,4370,48,148,1827,3801,1875,3949
250390,202304,2349,5141,2012,4636,133,304,1566,3572,1699,3876
250400,202304,90933,204641,70510,174523,21660,57232,20872,50061,42532,107293
250403,202304,2951,5971,2620,5613,53,241,2284,4578,2337,4819
250407,202304,1877,3703,1340,2946,144,253,874,2037,1018,2290
250410,202304,856,1991,743,1813,24,67,613,1436,637,1503
250415,202304,2432,5644,2131,5199,30,101,1882,4479,1912,4580
250420,202304,1729,3556,1557,3329,12,27,1448,3040,1460,3067
250430,202304,9415,18401,8143,16786,281,579,6993,13931,7274,14510
250435,202304,1950,4920,1481,4146,59,198,1087,2914,1146,3112
250440,202304,5232,12695,4564,11822,120,274,3954,10147,4074,10421
250450,202304,2192,4997,1809,4493,91,181,1425,3608,1516,3789
250460,202304,9718,23269,8461,21490,595,1636,6490,16170,7085,17806
250470,202304,2174,4551,1819,4019,64,138,1512,3218,1576,3356
250480,202304,4634,11244,3894,10320,126,291,3260,8671,3386,8962
250485,202304,848,1752,629,1448,72,118,418,951,490,1069
250490,202304,6945,13437,6199,12614,102,302,5595,11041,5697,11343
250500,202304,2439,5970,2131,5462,53,157,1745,4359,1798,4516
250510,202304,7092,14625,6154,13383,261,359,5105,11269,5366,11628
250520,202304,2209,5339,1890,4912,76,223,1499,3784,1575,4007
250523,202304,2718,5679,2409,5255,189,431,1867,3933,2056,4364
250527,202304,2096,4480,1902,4268,25,61,1723,3820,1748,3881
250530,202304,802,1846,690,1687,16,45,561,1326,577,1371
250535,202304,1631,4193,1462,3909,31,117,1199,3085,1230,3202
250540,202304,3995,7326,3458,6758,407,452,2789,5773,3196,6225
250550,202304,918,2687,797,2466,47,157,548,1660,595,1817
250560,202304,2046,5000,1745,4567,54,185,1449,3682,1503,3867
250570,202304,3292,8574,2816,7759,167,494,2118,5754,2285,6248
250580,202304,1252,2945,1105,2751,68,209,885,2135,953,2344
250590,202304,1266,2606,1156,2465,28,74,1038,2140,1066,2214
250600,202304,9126,22229,7534,20018,295,817,5807,15080,6102,15897
250610,202304,3396,8694,3022,8147,137,439,2413,6436,2550,6875
250620,202304,1124,2343,938,2066,42,111,753,1581,795,1692
250625,202304,2695,7114,2415,6668,48,223,2082,5615,2130,5838
250630,202304,15342,33701,13018,30138,1154,2940,9419,20687,10573,23627
250640,202304,4527,10400,4035,9773,88,311,3484,8228,3572,8539
250650,202304,1305,2741,1015,2358,12,45,860,1946,872,1991
250660,202304,1871,4138,1480,3586,38,91,1213,2810,1251,2901
250670,202304,2917,7656,2640,7188,44,185,2297,6063,2341,6248
250680,202304,7550,14442,6837,13648,39,156,6430,12509,6469,12665
250690,202304,8804,17127,7410,15486,151,303,6438,13213,6589,13516
250700,202304,5571,13984,4890,12905,745,2034,3202,8209,3947,10243
250710,202304,5135,13410,4435,12455,411,1173,3139,8814,3550,9987
250720,202304,3410,8169,3014,7612,68,257,2606,6423,2674,6680
250730,202304,5418,12234,4774,11393,246,641,4016,9312,4262,9953
250740,202304,2465,5388,2045,4844,129,275,1565,3715,1694,3990
250750,202304,163733,340475,142301,311598,8905,22117,111206,232536,120111,254653
250760,202304,3667,6854,3289,6332,80,158,3007,5659,3087,5817
250770,202304,4862,13129,4303,12363,632,1553,2822,8444,3454,9997
250780,202304,2259,5114,1929,4569,56,153,1603,3688,1659,3841
250790,202304,3151,7993,2752,7420,97,365,2235,5782,2332,6147
250800,202304,2932,6806,2549,6215,108,220,2083,5004,2191,5224
250810,202304,1753,3812,1468,3424,164,256,1081,2674,1245,2930
250820,202304,2558,5805,2345,5562,48,158,2116,4940,2164,5098
250830,202304,7387,19595,6074,17093,235,846,4357,11610,4592,12456
250840,202304,856,2520,761,2348,35,125,566,1755,601,1880
250850,202304,2161,5530,1896,5085,30,130,1545,4016,1575,4146
250855,202304,1403,3348,1249,3137,46,132,1040,2527,1086,2659
250860,202304,4256,11049,3524,9872,491,1440,1998,5395,2489,6835
250870,202304,1250,2948,1053,2649,64,146,791,1979,855,2125
250880,202304,1927,4377,1592,3885,139,326,1180,2839,1319,3165
250890,202304,14743,29952,12918,27664,267,1042,11327,22903,11594,23945
250900,202304,3962,9018,3472,8229,80,239,2988,6859,3068,7098
250905,202304,3056,7474,2815,7172,45,163,2549,6427,2594,6590
250910,202304,9149,17348,7877,15954,81,254,7198,14310,7279,14564
250915,202304,2628,5283,1938,4536,30,54,1709,4004,1739,4058
250920,202304,4749,10023,4274,9364,311,602,3490,7500,3801,8102
250930,202304,2783,6727,2455,6321,155,486,1918,4760,2073,5246
250933,202304,1484,3865,1300,3556,47,171,1009,2671,1056,2842
250937,202304,953,2230,806,2009,27,85,664,1636,691,1721
250939,202304,2485,5437,2169,5022,44,112,1824,4131,1868,4243
250940,202304,4730,10950,4093,10120,61,168,3598,8790,3659,8958
250950,202304,2006,4762,1619,4234,51,158,1269,3229,1320,3387
250960,202304,1344,3409,1183,3151,28,120,986,2514,1014,2634
250970,202304,11254,24576,9667,22062,405,848,7877,17604,8282,18452
250980,202304,2846,6637,2569,6265,21,89,2248,5312,2269,5401
250990,202304,2562,6778,2182,6137,124,400,1629,4445,1753,4845
251000,202304,2294,5895,1889,5211,47,158,1519,4144,1566,4302
251010,202304,2993,7353,2627,6818,37,162,2282,5777,2319,5939
251020,202304,1875,4612,1674,4303,30,133,1451,3621,1481,3754
251030,202304,1212,2913,1000,2558,50,140,678,1705,728,1845
251040,202304,2157,5302,1865,4847,25,102,1607,4098,1632,4200
251050,202304,1135,3014,956,2665,44,162,671,1753,715,1915
251060,202304,1365,2696,990,2207,34,77,724,1601,758,1678
251065,202304,557,1411,418,1148,11,36,293,765,304,801
251070,202304,897,1967,750,1765,13,46,624,1399,637,1445
251080,202304,26527,56881,22036,50452,3788,8696,12690,29123,16478,37819
251090,202304,3426,8735,2857,7800,65,185,2350,6270,2415,6455
251100,202304,924,2684,793,2421,28,88,587,1693,615,1781
251110,202304,2235,5132,1852,4447,161,360,1353,3170,1514,3530
251120,202304,9881,22523,8357,20645,484,1367,6398,15304,6882,16671
251130,202304,5982,10136,5350,9440,45,101,5072,8813,5117,8914
251140,202304,4785,12276,4206,11449,144,472,3307,8900,3451,9372
251150,202304,3386,8493,3078,8028,55,265,2625,6637,2680,6902
251160,202304,2931,6851,2572,6323,27,133,2322,5559,2349,5692
251170,202304,2280,4880,2014,4553,34,92,1829,4030,1863,4122
251180,202304,3364,7587,2796,6822,306,618,1873,4721,2179,5339
251190,202304,6944,13559,6297,12830,58,187,5796,11401,5854,11588
251200,202304,5575,13507,4928,12672,165,379,4145,10730,4310,11109
251203,202304,1228,3481,1069,3131,61,197,713,1985,774,2182
251207,202304,1319,3181,1001,2671,24,92,678,1742,702,1834
251210,202304,9781,21665,8025,19235,674,1297,5598,13835,6272,15132
251220,202304,1656,3390,1200,2786,88,202,912,2101,1000,2303
251230,202304,5579,14065,4793,12636,112,382,3833,9743,3945,10125
251240,202304,4401,11397,3717,10207,317,797,2441,6738,2758,7535
251250,202304,14960,33823,13065,30724,901,2312,9992,22393,10893,24705
251260,202304,650,1493,571,1367,14,57,462,1041,476,1098
251270,202304,5448,14203,4878,13425,270,690,3842,10780,4112,11470
251272,202304,1729,3857,1600,3702,41,152,1436,3198,1477,3350
251274,202304,994,2557,781,2181,62,209,448,1212,510,1421
251275,202304,1965,4059,1652,3597,85,203,1359,2839,1444,3042
251276,202304,1613,3919,1384,3603,37,140,1119,2798,1156,2938
251278,202304,803,1860,698,1695,38,96,550,1303,588,1399
251280,202304,3388,6941,3104,6569,54,167,2814,5761,2868,5928
251290,202304,10279,17932,9393,16936,300,626,8411,14779,8711,15405
251300,202304,1019,2592,892,2397,17,64,743,1966,760,2030
251310,202304,3416,8454,2923,7695,42,189,2440,6225,2482,6414
251315,202304,2222,6075,2003,5678,112,298,1559,4358,1671,4656
251320,202304,1917,4532,1506,3838,43,160,1158,2824,1201,2984
251330,202304,2567,5166,2070,4579,34,77,1800,3945,1834,4022
251335,202304,1334,3303,1195,3103,18,83,1074,2717,1092,2800
251340,202304,4583,9582,3689,8435,149,357,2938,6540,3087,6897
251350,202304,1306,3281,1177,3081,42,101,961,2499,1003,2600
251360,202304,2233,5374,1738,4646,26,74,1365,3563,1391,3637
251365,202304,941,2235,680,1747,27,59,516,1312,543,1371
251370,202304,35389,80129,30497,73579,5159,12214,17525,42783,22684,54997
251380,202304,1885,4009,1627,3627,54,122,1393,3037,1447,3159
251385,202304,928,2159,707,1776,28,79,502,1187,530,1266
251390,202304,9597,21919,8536,20376,748,1815,6285,14681,7033,16496
251392,202304,1240,2998,1031,2674,41,112,811,2087,852,2199
251394,202304,815,2076,669,1831,67,179,432,1130,499,1309
251396,202304,844,2085,708,1854,30,96,501,1242,531,1338
251398,202304,1197,2837,834,2194,23,79,592,1476,615,1555
251400,202304,1769,3414,1429,2967,74,124,1133,2290,1207,2414
251410,202304,1918,3866,1513,3276,14,54,1286,2630,1300,2684
251420,202304,2532,5623,2064,5076,53,167,1683,4007,1736,4174
251430,202304,1779,4749,1602,4453,59,196,1331,3634,1390,3830
251440,202304,1294,3142,1065,2756,77,155,771,2028,848,2183
251445,202304,2077,4845,1897,4609,33,111,1642,3860,1675,3971
251450,202304,5641,13992,5055,13118,53,189,4393,11164,4446,11353
251455,202304,1025,2720,920,2537,32,108,741,1979,773,2087
251460,202304,1175,2892,937,2505,90,239,655,1734,745,1973
251465,202304,611,1506,504,1325,10,41,389,966,399,1007
251470,202304,1348,3494,1021,2842,131,429,526,1304,657,1733
251480,202304,1258,2923,956,2422,15,53,723,1728,738,1781
251490,202304,2381,5414,1969,4866,136,240,1495,3693,1631,3933
251500,202304,2658,5966,2385,5601,97,237,1993,4523,2090,4760
251510,202304,3109,8544,2577,7533,130,410,1762,4969,1892,5379
251520,202304,1184,2807,901,2317,68,137,581,1441,649,1578
251530,202304,19123,38419,15848,34438,191,756,14161,29827,14352,30583
251540,202304,3602,9223,3189,8529,87,342,2611,6713,2698,7055
251550,202304,5347,10003,4436,8908,130,220,3802,7519,3932,7739
251560,202304,650,1801,577,1693,48,182,423,1161,471,1343
251570,202304,1096,2811,899,2421,21,101,703,1815,724,1916
251580,202304,2806,5406,2471,4932,29,106,2163,4072,2192,4178
251590,202304,1983,4184,1693,3841,63,147,1446,3185,1509,3332
251593,202304,1139,3053,1017,2856,91,296,690,1880,781,2176
251597,202304,2780,6291,2504,5942,12,60,2317,5389,2329,5449
251600,202304,7617,18693,6629,17215,277,805,5395,13741,5672,14546
251610,202304,4177,10077,3628,9087,361,837,2611,6429,2972,7266
251615,202304,1665,3512,1327,3027,21,52,1128,2479,1149,2531
251620,202304,24328,47520,19324,41487,229,456,16916,36154,17145,36610
251630,202304,6409,12582,5238,10977,299,671,4151,8250,4450,8921
251640,202304,2656,6307,2367,5892,24,97,2124,5178,2148,5275
251650,202304,5124,11389,4408,10471,125,310,3763,8753,3888,9063
251660,202304,4389,11154,3870,10285,61,259,3250,8323,3311,8582
251670,202304,5837,12513,5232,11730,55,218,4832,10548,4887,10766
251675,202304,1122,2338,1012,2197,39,107,894,1892,933,1999
251680,202304,3152,7165,2672,6544,111,197,2155,5312,2266,5509
251690,202304,3859,9721,3295,8797,137,386,2498,6585,2635,6971
251700,202304,2777,6704,2306,6067,45,182,1937,4885,1982,5067
251710,202304,947,2181,684,1688,45,133,441,979,486,1112
251720,202304,1526,3869,1229,3382,23,100,952,2500,975,2600
251740,202304,794,1932,646,1682,31,99,496,1244,527,1343
260005,202304,38713,72711,32684,65237,1866,3816,26367,50844,28233,54660
260010,202304,12563,29269,10411,25901,658,1786,6715,15945,7373,17731
260020,202304,8436,16744,6904,14654,74,270,5956,12229,6030,12499
260030,202304,10056,19624,8592,17624,74,271,7692,15214,7766,15485
260040,202304,8768,19814,7472,18091,419,1073,5612,13472,6031,14545
260050,202304,17923,37767,15503,35055,248,654,14495,32524,14743,33178
260060,202304,5181,10950,4452,9869,391,664,3298,7570,3689,8234
260070,202304,14644,29222,12705,26595,204,715,11057,22128,11261,22843
260080,202304,8497,16030,7467,14768,175,325,6461,12452,6636,12777
260090,202304,6749,14355,6000,13396,431,847,4759,10640,5190,11487
260100,202304,4028,8549,3475,7809,33,146,3111,6777,3144,6923
260105,202304,6257,14516,5593,13656,110,398,4770,11279,4880,11677
260110,202304,25981,65999,23060,61780,1150,3505,18510,48465,19660,51970
260120,202304,19767,43084,16976,39224,1906,4015,11912,27432,13818,31447
260130,202304,4035,8701,3452,7894,85,199,2861,6307,2946,6506
260140,202304,16915,31578,14877,29179,417,897,13001,24825,13418,25722
260150,202304,4604,8773,4113,8185,107,204,3707,7316,3814,7520
260160,202304,9185,17613,8084,16310,131,264,7450,14884,7581,15148
260170,202304,27575,55199,23722,50146,1202,2697,19279,39547,20481,42244
260180,202304,4366,9827,3694,8898,73,270,3160,7438,3233,7708
260190,202304,27075,44051,23283,39729,170,341,21549,35845,21719,36186
260200,202304,13464,28623,11754,26438,488,953,10298,23093,10786,24046
260210,202304,13386,33484,11418,30404,386,1167,9248,24295,9634,25462
260220,202304,15233,28479,14107,27092,338,573,12666,23911,13004,24484
260230,202304,16387,30469,14378,27999,317,607,12567,23923,12884,24530
260240,202304,3401,8756,2926,7908,63,253,2350,6142,2413,6395
260250,202304,2917,6346,2490,5714,105,255,1988,4401,2093,4656
260260,202304,17715,38900,15745,36214,1259,2585,11985,28002,13244,30587
260270,202304,6362,11722,5679,10976,75,205,5175,9766,5250,9971
260280,202304,16386,39044,14925,36981,321,1192,13374,32145,13695,33337
260290,202304,55189,121878,48041,112149,4251,10550,34897,78823,39148,89373
260300,202304,13327,28355,11544,25895,289,824,9960,21732,10249,22556
260310,202304,8207,16302,7381,15301,389,644,6252,13000,6641,13644
260320,202304,8858,23264,7374,20859,138,495,6128,17045,6266,17540
260330,202304,2945,8108,2468,7172,57,203,1965,5544,2022,5747
260340,202304,2688,6030,2357,5553,37,139,2079,4704,2116,4843
260345,202304,38164,81904,32700,74511,3026,7455,22648,48732,25674,56187
260350,202304,7912,14182,6923,13093,24,89,6472,11972,6496,12061
260360,202304,2916,6759,2534,6079,94,271,1824,4194,1918,4465
260370,202304,6878,16388,5851,14731,170,537,4728,11347,4898,11884
260380,202304,6060,15530,5172,14110,229,565,3983,10811,4212,11376
260390,202304,5636,15086,4496,12895,236,652,3006,8408,3242,9060
260392,202304,5001,12135,4520,11546,48,277,4009,10083,4057,10360
260400,202304,28071,52022,24634,47651,347,994,21320,38909,21667,39903
260410,202304,104824,221365,84664,194070,15446,37786,43323,97546,58769,135332
260415,202304,5991,12701,5096,11486,35,130,4537,9940,4572,10070
260420,202304,16843,28236,14585,25783,65,222,13992,24342,14057,24564
260430,202304,3180,9084,2683,8140,239,782,1711,5058,1950,5840
260440,202304,5294,10675,4727,9967,31,105,4371,9035,4402,9140
260450,202304,6920,15460,6191,14523,374,694,5150,12231,5524,12925
260460,202304,6958,16938,5977,15365,425,1277,4215,10233,4640,11510
260470,202304,6215,12908,5289,11868,134,276,4629,10665,4763,10941
260480,202304,4519,10432,3858,9502,333,891,2746,6644,3079,7535
260490,202304,7049,13225,6209,12138,39,127,5774,11035,5813,11162
260500,202304,7464,16335,6438,14940,572,1257,4528,10462,5100,11719
260510,202304,14101,27424,12266,24886,156,477,11089,21852,11245,22329
260515,202304,5606,12804,4441,10769,92,275,3358,7566,3450,7841
260520,202304,20212,40877,17820,37885,1049,2263,14674,30397,15723,32660
260530,202304,12665,29313,10905,26795,96,446,9833,23522,9929,23968
260540,202304,9823,17391,8846,16222,118,251,8264,14925,8382,15176
260545,202304,172,437,115,325,23,73,41,92,64,165
260550,202304,3808,9261,3044,7990,196,656,2040,4961,2236,5617
260560,202304,6851,15606,5680,13869,137,420,4809,11409,4946,11829
260570,202304,11529,23127,10178,21464,193,551,9121,18665,9314,19216
260580,202304,6445,11910,5919,11227,45,78,5540,10361,5585,10439
260590,202304,9764,16825,8531,15474,95,247,7847,13906,7942,14153
260600,202304,44033,94435,37281,84718,1267,3509,30352,65561,31619,69070
260610,202304,9634,22068,8410,20481,383,1037,6561,15677,6944,16714
260620,202304,28194,55590,25227,51769,1213,3308,20912,40498,22125,43806
260630,202304,2791,6697,2332,5964,57,156,1923,4791,1980,4947
260640,202304,33025,60056,28487,54950,1198,2208,24285,46105,25483,48313
260650,202304,7656,17008,6200,15229,464,839,5119,12639,5583,13478
260660,202304,9518,19797,8433,18479,275,724,7612,16364,7887,17088
260670,202304,2798,6313,2292,5500,82,240,1791,4082,1873,4322
260680,202304,39908,80990,34111,73308,2149,4848,26182,53783,28331,58631
260690,202304,4170,9490,3443,8403,81,285,2757,6500,2838,6785
260700,202304,9377,18840,8783,18204,69,202,8531,17619,8600,17821
260710,202304,1642,3819,1360,3396,54,179,1085,2632,1139,2811
260720,202304,39393,76436,34295,70417,1783,4078,28409,56652,30192,60730
260730,202304,10152,24822,8840,23032,201,711,7707,19595,7908,20306
260740,202304,1637,3926,1324,3418,23,95,1102,2790,1125,2885
260750,202304,9689,21045,7660,18606,215,384,6744,16765,6959,17149
260760,202304,8616,16412,7608,15252,126,353,6902,13501,7028,13854
260765,202304,10671,25815,9368,24056,698,1981,6762,16796,7460,18777
260770,202304,4775,10528,3912,9173,99,308,3188,7215,3287,7523
260775,202304,7585,16627,6687,15297,172,574,5545,11942,5717,12516
260780,202304,4666,11755,4108,10853,367,1161,2671,6488,3038,7649
260790,202304,194784,360472,166936,325762,20032,40622,119626,224174,139658,264796
260795,202304,4613,8721,3972,7934,161,368,3379,6579,3540,6947
260800,202304,7947,14251,7240,13332,307,468,6363,11508,6670,11976
260805,202304,4644,10731,4066,9819,142,444,3337,7710,3479,8154
260810,202304,8222,18890,7206,17112,283,766,5795,13118,6078,13884
260820,202304,6095,11354,5467,10663,78,207,4878,9399,4956,9606
260825,202304,3497,9204,3076,8522,125,396,2397,6498,2522,6894
260830,202304,5259,13328,4454,11999,531,1167,3017,8323,3548,9490
260840,202304,5778,11884,5178,11111,230,458,4543,9630,4773,10088
260845,202304,5641,12707,4991,11685,199,584,4010,8933,4209,9517
260850,202304,6053,14169,5064,12465,412,1073,3442,7962,3854,9035
260860,202304,4028,10316,3449,9298,165,495,2737,7170,2902,7665
260870,202304,5700,11082,4988,10229,133,246,4416,8980,4549,9226
260875,202304,10691,20905,8819,18369,694,1390,6417,13253,7111,14643
260880,202304,14198,31339,12570,28840,277,749,10917,24300,11194,25049
260890,202304,16742,36193,14475,32915,1349,3135,9741,21684,11090,24819
260900,202304,6908,17095,5732,15490,608,1674,3540,9432,4148,11106
260910,202304,4282,9509,3779,8802,157,364,3014,6900,3171,7264
260915,202304,7245,15051,6631,14337,28,106,6292,13432,6320,13538
260920,202304,4406,8317,3778,7659,113,192,3376,6789,3489,6981
260930,202304,5057,12827,4299,11589,176,614,3413,8857,3589,9471
260940,202304,19757,39347,17225,35947,1203,2642,13430,27038,14633,29680
260950,202304,9571,21175,7870,18509,371,1054,5628,12202,5999,13256
260960,202304,119176,213395,101866,192477,7332,14747,79121,142327,86453,157074
260970,202304,6912,15703,6005,14555,390,700,4532,11154,4922,11854
260980,202304,5916,14098,5177,13201,72,188,4718,12029,4790,12217
260990,202304,20603,50517,17419,46192,745,2296,13817,35758,14562,38054
261000,202304,21572,41615,18289,37582,603,1488,15425,30491,16028,31979
261010,202304,2690,5956,2318,5465,95,249,1994,4641,2089,4890
261020,202304,8541,18688,7571,17194,317,750,6242,13612,6559,14362
261030,202304,5042,12609,4417,11568,107,396,3605,9018,3712,9414
261040,202304,6674,16262,5498,14247,166,535,4362,10792,4528,11327
261050,202304,9874,21629,8965,20355,198,412,7640,17071,7838,17483
261060,202304,18838,39780,16459,36998,395,985,14007,30718,14402,31703
261070,202304,95352,181675,80833,163194,7724,15733,59371,115947,67095,131680
261080,202304,8990,17897,8137,16886,88,198,7694,15819,7782,16017
261090,202304,26186,49883,23419,46402,757,1412,20498,39956,21255,41368
261100,202304,11075,25486,9639,23473,586,1436,7446,17682,8032,19118
261110,202304,98042,229679,83490,204946,10067,27076,53119,124240,63186,151316
261120,202304,4938,9924,4354,9137,110,250,3796,7707,3906,7957
261130,202304,9750,19467,8650,18035,196,387,7565,15517,7761,15904
261140,202304,4947,9495,4354,8732,298,542,3388,6742,3686,7284
261150,202304,7071,14803,6278,13720,229,446,5361,11555,5590,12001
261153,202304,2318,6178,1890,5389,79,243,1335,3720,1414,3963
261160,202304,316295,629276,264506,562391,68218,147785,114186,245404,182404,393189
261170,202304,9875,18666,8596,17022,229,459,7570,14499,7799,14958
261180,202304,11683,25044,10296,23328,478,1034,8152,18184,8630,19218
261190,202304,6606,14780,5948,13814,139,556,5036,11128,5175,11684
261200,202304,4414,8492,3836,7748,146,303,3233,6360,3379,6663
261210,202304,2251,4866,1954,4466,141,225,1584,3635,1725,3860
261220,202304,18837,43342,16209,39158,1428,3639,11489,26222,12917,29861
261230,202304,4644,11494,3893,10501,38,146,3317,8881,3355,9027
261240,202304,7942,15195,7126,14076,202,410,6326,12189,6528,12599
261245,202304,4779,11195,3881,9738,70,302,3190,7576,3260,7878
261247,202304,3730,9766,3083,8648,324,867,2030,5710,2354,6577
261250,202304,38563,70761,34350,65989,3211,6335,27760,52732,30971,59067
261255,202304,4855,12604,3890,10826,164,557,2945,7940,3109,8497
261260,202304,20307,39621,18208,37049,291,815,17061,33926,17352,34741
261270,202304,6693,12345,5945,11479,209,384,5337,10110,5546,10494
261280,202304,3219,7641,2797,6978,113,371,2249,5340,2362,5711
261290,202304,3704,7903,3116,7265,99,264,2582,6022,2681,6286
261300,202304,17395,38642,14951,34979,398,1264,12233,27105,12631,28369
261310,202304,12737,26432,11014,24176,958,2122,8288,17640,9246,19762
261320,202304,7463,18003,6529,16557,114,321,5554,13753,5668,14074
261330,202304,8068,15682,7310,14741,177,434,6593,12992,6770,13426
261340,202304,7653,15137,6936,14298,108,317,6413,12893,6521,13210
261350,202304,10189,26911,8863,24708,340,925,6840,18845,7180,19770
261360,202304,11117,21722,9563,19597,409,869,7840,15496,8249,16365
261370,202304,32620,69394,27880,63304,2291,5462,20501,44975,22792,50437
261380,202304,5590,13294,4812,12068,488,1208,3380,8410,3868,9618
261390,202304,21290,52910,17834,47669,1367,4015,12319,31766,13686,35781
261400,202304,6278,15261,5458,13798,213,711,4375,10436,4588,11147
261410,202304,12524,26005,10423,22992,282,806,8877,18677,9159,19483
261420,202304,10793,25677,9777,24512,572,1746,7914,19427,8486,21173
261430,202304,5524,11122,4806,10106,31,111,4388,8911,4419,9022
261440,202304,1653,4453,1350,3903,49,219,976,2666,1025,2885
261450,202304,18957,42205,16723,39017,647,1492,13530,31212,14177,32704
261460,202304,9613,22370,8159,20199,276,697,6618,16198,6894,16895
261470,202304,4626,10289,4000,9411,53,193,3398,7762,3451,7955
261480,202304,6806,17399,5800,15786,238,865,4549,11868,4787,12733
261485,202304,7066,16807,6208,15563,428,1254,4748,11468,5176,12722
261500,202304,8706,18561,7552,17026,661,1221,5385,12516,6046,13737
261510,202304,2170,5786,1895,5344,72,250,1462,4073,1534,4323
261520,202304,2914,7485,2601,6916,145,415,1910,4883,2055,5298
261530,202304,15340,37942,12595,33534,735,2628,8078,19629,8813,22257
261540,202304,12194,29809,11168,28428,2943,6808,5502,15579,8445,22387
261550,202304,4651,10675,4066,9794,239,657,3053,6998,3292,7655
261560,202304,11944,26876,10586,25005,349,961,8965,20602,9314,21563
261570,202304,4456,10695,3459,9057,302,839,2347,5901,2649,6740
261580,202304,9135,19408,8075,18043,60,267,7553,16573,7613,16840
261590,202304,3388,7277,2808,6444,70,230,2325,5093,2395,5323
261600,202304,7657,14594,6644,13223,159,334,5720,10919,5879,11253
261610,202304,2669,6932,2167,6023,241,681,1273,3532,1514,4213
261618,202304,3606,6800,3197,6271,72,200,2824,5324,2896,5524
261620,202304,6043,14050,5559,13384,604,1313,4108,10241,4712,11554
261630,202304,7240,18327,6200,16390,492,1425,4030,10006,4522,11431
261640,202304,49300,93241,42465,85205,2212,3573,33787,68062,35999,71635
261650,202304,5478,10967,4653,9997,222,431,3872,8270,4094,8701
270010,202304,5056,15063,4336,13857,155,758,3400,10497,3555,11255
270020,202304,5111,10473,4488,9720,113,437,3977,8146,4090,8583
270030,202304,44578,106731,38185,97093,2495,6754,29728,73733,32223,80487
270040,202304,12189,28703,10371,26531,669,1848,8246,20911,8915,22759
270050,202304,6721,13659,5789,12622,138,331,5366,11605,5504,11936
270060,202304,2749,6330,2332,5821,159,411,1852,4548,2011,4959
270070,202304,6511,14310,5677,13207,90,347,5095,11422,5185,11769
270080,202304,1678,4052,1400,3629,97,244,1050,2663,1147,2907
270090,202304,2220,5696,2018,5358,32,132,1796,4667,1828,4799
270100,202304,8800,16291,7746,14938,155,355,6991,13116,7146,13471
270110,202304,3949,8402,3265,7602,217,351,2596,6304,2813,6655
270120,202304,2994,7446,2644,6977,85,257,2172,5660,2257,5917
270130,202304,6047,13748,5212,12758,147,463,4486,10781,4633,11244
270135,202304,2383,5005,2039,4631,27,122,1885,4207,1912,4329
270140,202304,10299,22876,8285,20169,363,1101,6458,14924,6821,16025
270150,202304,3914,8708,3624,8328,22,72,3481,7956,3503,8028
270160,202304,6123,15521,5325,14535,166,580,4791,12909,4957,13489
270170,202304,3758,10000,3144,9118,208,814,2219,6059,2427,6873
270180,202304,2845,7529,2547,7150,40,207,2264,6200,2304,6407
270190,202304,3063,6046,2812,5760,31,82,2661,5365,2692,5447
270200,202304,3084,8124,2676,7488,451,1127,1676,4834,2127,5961
270210,202304,7162,14366,6230,13306,92,267,5811,12214,5903,12481
270220,202304,2080,4492,1704,3993,118,320,1311,2909,1429,3229
270230,202304,12235,29274,10439,26638,1003,2760,7820,19424,8823,22184
270235,202304,7285,19828,6423,18507,265,781,5278,15028,5543,15809
270240,202304,13973,33278,11524,29863,1051,2976,8391,21116,9442,24092
270250,202304,4177,8231,3773,7704,154,299,3367,6778,3521,7077
270255,202304,5109,13177,4102,11471,150,488,3234,8783,3384,9271
270260,202304,6362,17582,5795,16665,89,403,5069,14314,5158,14717
270270,202304,1203,2853,1002,2617,120,294,734,1908,854,2202
270280,202304,4510,9621,3586,8509,294,578,2674,6564,2968,7142
270290,202304,9534,26537,8645,25184,170,726,7733,22241,7903,22967
270300,202304,4856,11438,3843,10321,218,510,3080,8400,3298,8910
270310,202304,7982,20143,6841,18481,162,542,5745,15306,5907,15848
270320,202304,6483,17259,5551,15572,245,830,4187,11161,4432,11991
270330,202304,5182,14189,4539,13289,177,760,3818,10954,3995,11714
270340,202304,1951,4588,1659,4178,84,168,1398,3532,1482,3700
270350,202304,2266,4578,1841,4092,150,286,1354,3086,1504,3372
270360,202304,4247,8044,3889,7648,43,109,3739,7286,3782,7395
270370,202304,1589,4450,1437,4176,33,154,1220,3487,1253,3641
270375,202304,4797,8597,4209,7974,19,58,4070,7648,4089,7706
270380,202304,6846,15767,5749,14462,622,1414,4289,11031,4911,12445
270390,202304,1486,3230,1186,2882,14,75,1012,2429,1026,2504
270400,202304,7715,18181,6386,16212,288,786,4917,12113,5205,12899
270410,202304,5973,14845,5216,13755,137,468,4515,11712,4652,12180
270420,202304,8243,19215,7544,18247,176,630,6801,15975,6977,16605
270430,202304,209770,425182,169614,375202,19922,46059,109828,233920,129750,279979
270440,202304,5563,13388,4852,12484,134,400,4272,10952,4406,11352
270450,202304,11126,23151,9965,21792,497,869,8412,18650,8909,19519
270460,202304,4683,9250,3982,8399,225,368,3503,7448,3728,7816
270470,202304,14519,34937,12669,32419,670,1978,10236,25589,10906,27567
270480,202304,3686,8368,3070,7529,181,515,2537,6031,2718,6546
270490,202304,1055,2646,925,2488,34,107,772,2032,806,2139
270500,202304,5797,15443,5244,14516,323,896,4205,11543,4528,12439
270510,202304,7771,16860,6546,15354,324,935,5296,11919,5620,12854
270520,202304,4883,12069,3902,10588,731,2091,1920,5185,2651,7276
270530,202304,1604,4166,1356,3781,93,241,938,2643,1031,2884
270540,202304,2720,6485,2287,5930,70,213,1992,5076,2062,5289
270550,202304,7769,17939,6140,16138,640,1548,4419,11880,5059,13428
270560,202304,3566,8020,3006,7296,159,495,2447,5755,2606,6250
270570,202304,6893,14384,6058,13259,596,1409,4913,10364,5509,11773
270580,202304,2897,6944,2625,6579,105,292,2300,5677,2405,5969
270590,202304,1703,4680,1581,4504,17,73,1473,4183,1490,4256
270600,202304,3320,8899,3033,8468,68,229,2681,7398,2749,7627
270610,202304,4289,10160,3815,9542,145,293,3358,8387,3503,8680
270620,202304,1408,3860,1281,3647,41,130,1079,2990,1120,3120
270630,202304,23842,48573,20895,44705,693,1898,18283,37805,18976,39703
270640,202304,6677,16606,5497,14759,139,535,4486,11774,4625,12309
270642,202304,3061,8618,2686,7999,203,652,1963,5670,2166,6322
270644,202304,4785,10504,4014,9531,288,688,3192,7481,3480,8169
270650,202304,4527,10471,4013,9828,266,804,3378,8077,3644,8881
270660,202304,2326,5159,2045,4788,87,205,1622,3717,1709,3922
270670,202304,23433,44969,20002,40819,717,1530,17397,34511,18114,36041
270680,202304,7855,14466,7181,13740,298,405,6608,12797,6906,13202
270690,202304,12587,26991,10406,24135,240,722,8775,19747,9015,20469
270700,202304,680,1793,598,1664,65,195,422,1130,487,1325
270710,202304,6914,18221,6071,16955,420,1224,4716,12991,5136,14215
270720,202304,4473,11058,3996,10297,92,296,3538,8902,3630,9198
270730,202304,9514,19002,8212,17637,988,1273,6169,14492,7157,15765
270740,202304,2727,6663,2403,6282,77,251,2020,5202,2097,5453
270750,202304,6758,15321,6004,14362,93,383,5458,12732,5551,13115
270760,202304,3998,9663,3325,8761,53,226,2840,7318,2893,7544
270770,202304,28962,63792,23899,57381,3297,8052,15698,36963,18995,45015
270780,202304,2497,5340,2305,5093,54,150,2120,4614,2174,4764
270790,202304,2146,4909,1834,4522,131,319,1481,3599,1612,3918
270800,202304,14584,32411,13157,30488,549,1345,11069,25230,11618,26575
270810,202304,4096,9802,3264,8600,200,620,2481,6354,2681,6974
270820,202304,1878,5071,1616,4678,52,215,1319,3735,1371,3950
270830,202304,6125,13314,5061,12032,212,572,4148,9665,4360,10237
270840,202304,9716,26202,8458,24291,372,1559,6828,18803,7200,20362
270850,202304,10895,21951,9561,20438,678,1599,8095,17115,8773,18714
270860,202304,17842,35410,14228,31367,563,1307,11894,25696,12457,27003
270870,202304,2737,7078,2195,6176,217,615,1426,3958,1643,4573
270880,202304,9248,25139,8254,23616,190,736,6793,18953,6983,19689
270890,202304,4220,10254,3580,9335,514,1322,2069,5312,2583,6634
270895,202304,4695,10972,4212,10375,137,384,3708,8979,3845,9363
270900,202304,1871,4379,1438,3724,21,72,1196,3014,1217,3086
270910,202304,5282,13123,4603,12176,283,614,3790,9986,4073,10600
270915,202304,11304,28291,9154,24948,865,2794,6211,15994,7076,18788
270920,202304,7229,18131,6260,16712,127,460,5396,14006,5523,14466
270930,202304,22016,44475,17534,39383,2131,4378,12648,29017,14779,33395
270940,202304,7262,17306,6023,15868,174,716,4957,12549,5131,13265
280010,202304,685,1812,536,1510,19,80,374,949,393,1029
280020,202304,6510,13748,5517,12283,425,971,4218,9017,4643,9988
280030,202304,125781,244105,105422,216796,16669,35122,64005,127310,80674,162432
280040,202304,3728,8522,3243,7839,158,467,2530,5852,2688,6319
280050,202304,5116,13047,4255,11653,955,2589,2109,5708,3064,8297
280060,202304,9632,20539,7854,17992,1042,2692,4992,10951,6034,13643
280067,202304,8896,18259,7627,16402,649,1053,5660,12117,6309,13170
280070,202304,2041,5622,1873,5368,118,398,1472,4085,1590,4483
280100,202304,5353,11942,4521,10712,591,1256,2862,6995,3453,8251
280110,202304,1980,4147,1700,3761,24,68,1556,3359,1580,3427
280120,202304,9729,23339,8606,21613,1191,2610,6022,15470,7213,18080
280130,202304,10492,21953,9171,20174,651,1467,7221,15588,7872,17055
280140,202304,7593,14641,6742,13480,686,1133,5099,10390,5785,11523
280150,202304,4843,11005,4160,10041,536,1137,2876,6869,3412,8006
280160,202304,1603,3840,1365,3477,132,373,949,2278,1081,2651
280170,202304,7281,15031,6530,14103,199,454,5650,11916,5849,12370
280190,202304,2091,3420,1907,3187,35,97,1792,2909,1827,3006
280200,202304,1498,3559,1239,3184,80,268,906,2186,986,2454
280210,202304,22278,46582,19338,42599,2280,5062,13044,27843,15324,32905
280220,202304,2055,4591,1770,4226,109,246,1410,3367,1519,3613
280230,202304,5002,11369,4037,9935,258,502,2796,6886,3054,7388
280240,202304,3862,9153,3411,8503,32,160,2981,7202,3013,7362
280250,202304,1255,2392,1051,2110,60,135,838,1599,898,1734
280260,202304,3088,5982,2733,5546,44,98,2538,5102,2582,5200
280270,202304,3006,7006,2646,6514,117,350,2277,5445,2394,5795
280280,202304,4691,12302,4156,11550,588,1399,2854,8174,3442,9573
280290,202304,27794,59081,23822,53639,2643,6285,14896,33640,17539,39925
280300,202304,16602,31646,14471,29351,1120,1554,11525,24434,12645,25988
280310,202304,1669,3790,1395,3367,48,126,1112,2580,1160,2706
280320,202304,11336,25663,9855,23533,1001,2417,7216,16472,8217,18889
280330,202304,5501,12223,4577,10930,358,821,3335,7772,3693,8593
280340,202304,6361,11834,5347,10720,191,300,4738,9495,4929,9795
280350,202304,40227,73511,35715,67731,1095,2483,30907,56335,32002,58818
280360,202304,6944,17176,5949,15624,647,1881,3814,9716,4461,11597
280370,202304,2884,5943,2340,5078,164,302,1730,3673,1894,3975
280380,202304,1285,2943,1086,2673,100,230,766,1877,866,2107
280390,202304,5152,10166,4347,8990,279,460,3544,7274,3823,7734
280400,202304,5141,10581,4463,9726,417,827,3402,7367,3819,8194
280410,202304,3477,8112,2916,7229,323,844,1851,4314,2174,5158
280420,202304,5484,12205,4925,11528,115,281,4451,10397,4566,10678
280430,202304,2923,5816,2610,5416,66,183,2309,4635,2375,4818
280440,202304,5513,12089,4881,11197,217,546,4151,9206,4368,9752
280445,202304,2661,6311,2374,5836,85,201,1880,4471,1965,4672
280450,202304,11981,26623,10352,24399,2314,5525,5295,12694,7609,18219
280460,202304,8729,17779,7903,16688,440,1074,6693,13681,7133,14755
280470,202304,1980,4940,1637,4316,143,418,1180,2967,1323,3385
280480,202304,64633,130184,56278,119016,5655,12883,40318,81857,45973,94740
280490,202304,4112,10833,3474,9723,135,535,2591,6857,2726,7392
280500,202304,1284,2599,1069,2341,27,78,897,1954,924,2032
280510,202304,4477,7526,3970,6901,54,140,3686,6187,3740,6327
280520,202304,2319,4755,2040,4382,165,287,1559,3341,1724,3628
280530,202304,2812,6368,2443,5873,121,288,1953,4603,2074,4891
280540,202304,10189,24432,9140,22962,402,976,7785,19402,8187,20378
280550,202304,8166,16415,6863,14650,138,499,5874,11917,6012,12416
280560,202304,9139,21331,8506,20446,126,392,7681,18136,7807,18528
280570,202304,8723,17635,7290,15908,309,724,5858,12377,6167,13101
280580,202304,7686,16083,6828,14919,490,915,5514,11900,6004,12815
280590,202304,3360,7051,2831,6412,162,433,2139,4607,2301,5040
280600,202304,5209,11094,4607,10229,279,603,3535,7666,3814,8269
280610,202304,3459,6824,3090,6365,135,315,2663,5289,2798,5604
280620,202304,7746,15712,6660,14370,548,823,4925,11003,5473,11826
280630,202304,5112,11367,4709,10868,440,861,3618,8531,4058,9392
280640,202304,3007,6562,2620,6136,85,190,2352,5494,2437,5684
280650,202304,1425,3356,1192,3015,122,301,824,2007,946,2308
280660,202304,4815,8921,4225,8243,228,417,3664,7037,3892,7454
280670,202304,25624,52478,22142,48020,3514,7537,14185,30416,17699,37953
280680,202304,3548,7454,3041,6757,302,549,2098,4807,2400,5356
280690,202304,1265,2532,1088,2317,42,107,909,1863,951,1970
280700,202304,1450,3010,1245,2726,28,68,1045,2220,1073,2288
280710,202304,18860,36215,16278,33328,1017,1556,13958,28789,14975,30345
280720,202304,3154,6209,2607,5563,39,88,2193,4640,2232,4728
280730,202304,1236,2845,1042,2557,108,266,713,1699,821,1965
280740,202304,21387,40079,18594,36288,980,2151,15253,28476,16233,30627
280750,202304,4065,10246,3481,9264,261,727,2478,6454,2739,7181
280760,202304,9138,19262,7783,17488,753,1528,5695,12739,6448,14267
290010,202304,3699,6744,2549,5066,26,53,2242,4274,2268,4327
290020,202304,7473,15104,6847,14373,505,768,5746,12272,6251,13040
290030,202304,5567,11095,4575,9953,359,678,3554,7875,3913,8553
290035,202304,6214,11727,5290,10544,246,420,4350,8567,4596,8987
290040,202304,7141,12137,6213,11061,265,367,5479,9722,5744,10089
290050,202304,2495,7143,2120,6402,151,485,1467,4301,1618,4786
290060,202304,1893,3601,1389,2927,168,382,1019,2059,1187,2441
290070,202304,53081,99610,45790,90487,2999,5747,35940,68999,38939,74746
290080,202304,8430,19216,7327,17678,809,2030,5262,12530,6071,14560
290090,202304,2761,4368,2056,3617,29,60,1916,3316,1945,3376
290100,202304,12050,27431,9742,24135,1749,4173,4971,12667,6720,16840
290110,202304,6836,15478,5854,13923,816,1842,3504,8230,4320,10072
290115,202304,4802,12789,4103,11583,381,1104,3155,8824,3536,9928
290120,202304,8218,17391,6947,15652,203,544,5958,13058,6161,13602
290130,202304,5602,11658,4321,10009,285,565,3065,7320,3350,7885
290135,202304,5677,11413,4648,9758,193,464,3774,7457,3967,7921
290140,202304,5345,12230,4170,10698,209,490,3395,8763,3604,9253
290150,202304,4199,7779,3663,7185,151,362,3136,5948,3287,6310
290160,202304,4426,8462,3936,7802,203,345,3335,6528,3538,6873
290170,202304,4644,9239,4122,8684,135,268,3660,7709,3795,7977
290180,202304,3610,8509,3069,7665,70,240,2616,6337,2686,6577
290190,202304,6212,13010,5572,12194,119,327,4920,10544,5039,10871
290195,202304,3344,6669,2663,5811,168,318,2193,4787,2361,5105
290200,202304,4950,12309,3863,10449,250,545,2717,7349,2967,7894
290205,202304,4553,9693,4023,8924,179,419,3308,7179,3487,7598
290210,202304,17882,39512,15792,36442,1573,3100,12054,28146,13627,31246
290220,202304,4173,7684,3715,7149,96,232,3312,6190,3408,6422
290225,202304,3801,6634,2989,5802,41,113,2771,5235,2812,5348
290230,202304,3869,7432,3548,7076,175,255,2940,6013,3115,6268
290240,202304,5169,10131,4268,9063,90,241,3767,7829,3857,8070
290250,202304,5017,12032,4119,10759,158,372,3421,9064,3579,9436
290260,202304,6537,13897,5590,12558,263,687,4709,10207,4972,10894
290265,202304,3805,10315,3114,9034,317,985,1983,5583,2300,6568
290270,202304,13024,39173,11872,37255,867,2768,9062,28475,9929,31243
290280,202304,7307,20123,6295,18150,593,1943,4237,11686,4830,13629
290290,202304,11710,30890,9351,26715,1129,3454,5739,15852,6868,19306
290300,202304,4922,12018,3675,9757,207,607,2625,6701,2832,7308
290310,202304,2844,4938,2358,4386,21,66,2213,4028,2234,4094
290320,202304,37413,82757,30521,72954,5289,13136,17870,41493,23159,54629
290323,202304,4623,11149,3878,9941,150,398,3021,7671,3171,8069
290327,202304,5074,12768,4262,11254,407,989,2844,7372,3251,8361
290330,202304,3086,4980,2523,4378,20,22,2363,4091,2383,4113
290340,202304,7857,16015,6241,14100,456,998,5042,11307,5498,12305
290350,202304,5679,14340,4737,12770,279,860,3444,9041,3723,9901
290360,202304,6640,13709,5810,12615,92,231,5168,11005,5260,11236
290370,202304,5743,12527,4142,10423,201,506,2907,7236,3108,7742
290380,202304,7243,15335,6048,13753,176,294,5148,11757,5324,12051
290390,202304,18807,46939,15580,41812,1467,3976,10825,28643,12292,32619
290395,202304,3532,8636,2815,7445,67,254,2226,5706,2293,5960
290400,202304,4502,11003,3630,9620,177,545,2726,6971,2903,7516
290405,202304,5423,13996,4566,12524,506,1330,2972,8316,3478,9646
290410,202304,6702,15867,5143,13496,188,697,3919,9876,4107,10573
290420,202304,3721,9022,3013,7951,122,318,2310,6053,2432,6371
290430,202304,4537,9641,3791,8590,157,437,3093,6664,3250,7101
290440,202304,3429,7606,2499,6166,175,385,1773,4392,1948,4777
290450,202304,5357,10018,4362,8661,85,212,3905,7440,3990,7652
290460,202304,15300,39242,12557,34287,2817,7950,4897,13045,7714,20995
290470,202304,6009,11839,4632,10037,404,910,3216,6725,3620,7635
290475,202304,8003,19823,6631,17584,89,407,5598,14468,5687,14875
290480,202304,2274,4831,1853,4231,73,229,1416,3007,1489,3236
290485,202304,5636,14169,4920,13169,229,683,3972,10573,4201,11256
290490,202304,11937,23339,10872,21972,472,952,9148,18208,9620,19160
290500,202304,5018,13519,3906,11321,762,2395,1519,4190,2281,6585
290510,202304,4451,9170,3758,8298,106,232,3293,7295,3399,7527
290515,202304,4169,10275,3626,9520,28,89,3290,8658,3318,8747
290520,202304,14987,37138,11564,30693,543,1758,7910,19377,8453,21135
290530,202304,5796,14913,4880,13468,94,377,4145,11280,4239,11657
290540,202304,4811,10751,4409,10314,174,464,3932,9157,4106,9621
290550,202304,5220,11497,4577,10741,53,113,4208,9950,4261,10063
290560,202304,7556,17401,5899,15017,587,1685,3739,8924,4326,10609
290570,202304,73972,154735,66499,145313,5130,12277,53171,112610,58301,124887
290580,202304,11294,25660,9895,23801,953,2064,7348,18027,8301,20091
290590,202304,8241,22976,6893,20691,165,567,5644,16950,5809,17517
290600,202304,23001,56951,19863,52059,1197,3336,15667,40227,16864,43563
290610,202304,2897,8159,2282,6985,103,342,1608,4827,1711,5169
290620,202304,7161,18776,6212,17266,441,1152,4941,13741,5382,14893
290630,202304,13144,24997,10970,22303,787,1605,8843,17803,9630,19408
290640,202304,3329,7214,2618,6248,270,527,1780,4428,2050,4955
290650,202304,23793,44772,21838,42580,851,1929,19819,37880,20670,39809
290660,202304,4511,10543,3562,8992,194,553,2523,6282,2717,6835
290670,202304,10729,21054,9440,19316,203,533,8373,16695,8576,17228
290680,202304,13578,31981,11247,28662,221,849,9455,23445,9676,24294
290682,202304,6738,13581,5856,12459,487,680,4357,10035,4844,10715
290685,202304,4235,8623,3125,7053,496,1005,1771,4153,2267,5158
290687,202304,10240,21553,8588,19105,1211,2527,5541,12442,6752,14969
290689,202304,3357,8216,2563,6877,361,940,1599,4297,1960,5237
290690,202304,6960,15866,5740,14149,391,980,4240,10201,4631,11181
290700,202304,3901,7787,3471,7276,77,196,3092,6345,3169,6541
290710,202304,11149,25072,9541,22918,195,604,8442,19910,8637,20514
290720,202304,25614,57662,22996,53796,1621,3326,18109,41702,19730,45028
290730,202304,8709,18257,7388,16713,564,1043,5276,12304,5840,13347
290740,202304,1331,3033,1011,2543,46,96,843,2099,889,2195
290750,202304,17636,34082,15112,30435,347,893,12735,24045,13082,24938
290755,202304,2328,6052,1872,5261,126,326,1299,3672,1425,3998
290760,202304,4423,11466,3708,10234,202,465,2655,7438,2857,7903
290770,202304,3824,8741,3557,8435,70,186,3208,7575,3278,7761
290780,202304,9305,20892,7860,18916,401,772,5931,14305,6332,15077
290790,202304,6278,14808,5398,13559,296,755,4431,11089,4727,11844
290800,202304,8339,14755,6087,12185,402,689,4513,9125,4915,9814
290810,202304,6860,14700,5590,12914,228,555,4376,9978,4604,10533
290820,202304,6587,14663,5665,13273,316,695,4048,9235,4364,9930
290830,202304,5127,11406,4510,10408,111,387,3626,7765,3737,8152
290840,202304,22439,52282,18969,47018,2102,4407,12310,32033,14412,36440
290850,202304,11383,20520,9871,18883,552,893,8233,15527,8785,16420
290860,202304,7961,18705,6956,17503,379,827,5910,15117,6289,15944
290870,202304,5790,14196,4440,11715,371,889,2925,7621,3296,8510
290880,202304,1685,3683,1331,3242,208,459,752,1970,960,2429
290890,202304,12214,21150,10736,19514,348,600,9679,17459,10027,18059
290900,202304,2727,6663,2108,5609,203,514,1266,3306,1469,3820
290910,202304,6183,12791,4727,10669,46,114,4118,9150,4164,9264
290920,202304,6379,13648,5489,12592,156,234,4667,11254,4823,11488
290930,202304,8539,21844,6817,18889,298,1009,5058,13576,5356,14585
290940,202304,4049,10389,3325,9260,186,598,2553,6947,2739,7545
290950,202304,1694,3788,1364,3308,119,277,884,2155,1003,2432
290960,202304,7458,15949,6616,14932,313,578,5540,12470,5853,13048
290970,202304,3609,10099,2960,8886,142,489,2238,6615,2380,7104
290980,202304,18206,36830,15872,33512,865,2013,11601,23105,12466,25118
290990,202304,11972,27654,10587,25586,334,1089,8884,20624,9218,21713
291000,202304,3947,8922,3079,7861,164,424,2466,6343,2630,6767
291005,202304,21732,45869,19237,42773,1087,2377,15840,34605,16927,36982
291010,202304,3489,9910,2763,8351,153,505,1779,5176,1932,5681
291020,202304,1514,3397,1235,2949,31,94,907,1999,938,2093
291030,202304,3080,6490,2279,5234,231,487,1416,3143,1647,3630
291040,202304,6357,15361,5152,13678,274,777,3968,10547,4242,11324
291050,202304,14561,28319,12901,26127,1525,2985,9522,18950,11047,21935
291060,202304,10993,23818,9671,22148,985,2095,7293,16626,8278,18721
291070,202304,22537,48189,19226,43252,341,1068,16800,36533,17141,37601
291072,202304,35939,76564,27754,64163,4086,9556,16049,35643,20135,45199
291075,202304,6389,14182,5747,13217,95,264,4803,10587,4898,10851
291077,202304,1988,4729,1540,3974,100,190,1065,2750,1165,2940
291080,202304,171641,356657,139827,314812,28500,65317,70099,153742,98599,219059
291085,202304,6713,15011,5467,13133,252,679,4457,10436,4709,11115
291090,202304,2595,4335,1920,3594,43,74,1650,3006,1693,3080
291100,202304,3932,7275,2845,5985,130,249,2255,4667,2385,4916
291110,202304,6959,19167,5826,17298,378,1334,4357,12532,4735,13866
291120,202304,10307,20489,8909,18788,565,1161,7069,14730,7634,15891
291125,202304,2850,4372,2166,3615,87,132,1888,3111,1975,3243
291130,202304,3823,9665,2825,7840,84,295,2179,5777,2263,6072
291140,202304,5760,13773,4119,10882,733,1765,2299,6053,3032,7818
291150,202304,3443,5866,2728,5088,71,110,2538,4717,2609,4827
291160,202304,6062,14905,4997,13393,636,1742,3076,7971,3712,9713
291165,202304,2405,6134,1740,4854,26,119,1188,3154,1214,3273
291170,202304,27245,61665,22731,54402,1770,4329,15036,34134,16806,38463
291180,202304,9759,16722,7720,14164,298,585,6791,12105,7089,12690
291185,202304,4285,9149,3810,8476,218,452,3063,6759,3281,7211
291190,202304,9316,19817,7782,17924,319,703,6069,14162,6388,14865
291200,202304,3216,8093,2385,6548,93,336,1605,4099,1698,4435
291210,202304,9567,17002,7167,14307,398,681,5624,11185,6022,11866
291220,202304,6176,14194,5515,13237,574,1317,3774,8925,4348,10242
291230,202304,6062,10241,4947,9041,72,118,4619,8373,4691,8491
291240,202304,4973,11542,4238,10349,82,226,3677,8819,3759,9045
291250,202304,3794,10289,2954,8784,200,566,1783,5394,1983,5960
291260,202304,1794,3616,1460,3190,38,71,1205,2653,1243,2724
291270,202304,6853,14896,5363,12904,649,1458,3718,9149,4367,10607
291280,202304,3399,7344,2540,6111,175,435,1775,4061,1950,4496
291290,202304,6596,15670,5080,13375,491,1353,3371,8628,3862,9981
291300,202304,4708,11079,3756,9544,223,539,2764,6903,2987,7442
291310,202304,6287,14542,5461,13188,144,395,4731,11164,4875,11559
291320,202304,7889,18908,6204,16181,1362,3409,3205,8534,4567,11943
291330,202304,2235,5157,1816,4478,67,188,1377,3288,1444,3476
291340,202304,5075,11699,4049,10060,219,450,2735,6718,2954,7168
291345,202304,3577,8803,3175,8221,197,569,2543,6521,2740,7090
291350,202304,8576,17831,6899,15763,216,544,5779,12924,5995,13468
291360,202304,55446,104814,44895,92729,5643,11470,29819,62019,35462,73489
291370,202304,10080,23792,8878,21979,793,2104,6549,15542,7342,17646
291380,202304,5904,11542,5287,10761,109,297,4774,9489,4883,9786
291390,202304,16874,30628,13241,26605,726,1249,11209,22286,11935,23535
291400,202304,20587,41350,17244,36551,1808,3629,11937,25250,13745,28879
291410,202304,3559,8348,2808,7099,60,197,2100,5106,2160,5303
291420,202304,2239,4840,1771,4275,19,58,1534,3649,1553,3707
291430,202304,3066,7615,2621,6887,118,387,2059,5207,2177,5594
291440,202304,8037,19822,6864,18040,538,1335,5007,13390,5545,14725
291450,202304,13917,25130,11516,22423,311,465,10295,20181,10606,20646
291460,202304,22717,48648,19887,44587,2023,4257,14381,31543,16404,35800
291465,202304,10567,22864,8477,20450,277,937,7229,16943,7506,17880
291470,202304,26026,47000,22351,42830,1200,2105,17964,34095,19164,36200
291480,202304,55544,108058,44559,93177,5158,10999,27448,54866,32606,65865
291490,202304,9226,17757,8264,16705,296,654,7450,14882,7746,15536
291500,202304,6784,12825,5784,11581,166,377,5321,10564,5487,10941
291510,202304,5884,11276,4547,9606,73,208,4022,8288,4095,8496
291520,202304,5519,11170,4276,9620,253,579,3456,7649,3709,8228
291530,202304,2829,5711,2075,4749,213,468,1419,3285,1632,3753
291535,202304,4666,11259,3903,9995,210,477,3120,8046,3330,8523
291540,202304,2652,5070,1914,4180,54,130,1634,3545,1688,3675
291550,202304,8217,14913,6574,12935,527,905,4912,9527,5439,10432
291560,202304,21660,46921,16453,40144,4034,9696,7392,18528,11426,28224
291570,202304,2910,5737,2258,4995,79,176,1981,4379,2060,4555
291580,202304,7776,17279,6139,15204,360,1013,4667,11152,5027,12165
291590,202304,3503,6334,3117,5898,69,187,2883,5294,2952,5481
291600,202304,6724,13593,5227,11434,512,1253,3512,7404,4024,8657
291610,202304,8694,16655,7761,15615,711,992,6159,12850,6870,13842
291620,202304,3593,7051,2772,6146,230,412,2046,4633,2276,5045
291630,202304,4324,7905,3351,6735,600,881,2352,5013,2952,5894
291640,202304,22780,45630,17805,38970,1455,3335,11672,24167,13127,27502
291650,202304,12737,25465,11366,23886,893,1251,9354,20322,10247,21573
291660,202304,2355,5168,1763,4290,126,376,1201,2686,1327,3062
291670,202304,2390,5715,1956,5079,225,515,1282,3443,1507,3958
291680,202304,4968,10712,4058,9517,658,1561,2412,5699,3070,7260
291685,202304,5654,12696,4531,11128,258,584,3405,8274,3663,8858
291690,202304,5532,9784,4059,7861,157,328,3532,6626,3689,6954
291700,202304,11762,27367,10413,25270,312,979,9015,21213,9327,22192
291710,202304,6776,13236,5267,11260,353,758,4020,8245,4373,9003
291720,202304,5276,14280,4359,12568,969,2897,2253,6344,3222,9241
291730,202304,9915,18288,8590,16631,411,843,7357,14041,7768,14884
291733,202304,3535,7918,2919,7096,122,228,2170,5475,2292,5703
291735,202304,3114,7854,2348,6499,60,166,1632,4502,1692,4668
291740,202304,4868,11357,3230,8382,108,233,2264,5754,2372,5987
291750,202304,27303,55709,23000,49567,3121,5986,15286,33047,18407,39033
291760,202304,13552,33999,10691,29690,3458,11235,2500,6172,5958,17407
291770,202304,9392,21965,7740,19156,405,1237,5933,13824,6338,15061
291780,202304,6430,14442,5830,13641,172,429,5044,11560,5216,11989
291790,202304,3760,8105,3452,7735,408,623,2543,5989,2951,6612
291800,202304,44986,93134,36354,81383,4420,10579,23105,48795,27525,59374
291810,202304,13339,27479,11543,25375,494,894,9659,21405,10153,22299
291820,202304,4817,10946,4190,10144,130,320,3432,8204,3562,8524
291830,202304,6051,11409,4946,10012,367,509,3858,7899,4225,8408
291835,202304,7748,21013,6194,18233,763,2279,3961,11682,4724,13961
291840,202304,66067,152747,57930,140682,6491,16830,41113,97390,47604,114220
291845,202304,4236,8128,3530,7305,277,443,2830,6031,3107,6474
291850,202304,5506,12888,4686,11664,124,316,4014,9960,4138,10276
291855,202304,2905,4687,2392,4141,35,57,2256,3875,2291,3932
291860,202304,2549,6259,1741,4740,48,131,1162,3053,1210,3184
291870,202304,1487,3452,984,2587,55,158,659,1675,714,1833
291875,202304,3448,9547,2940,8500,69,284,2170,6002,2239,6286
291880,202304,6768,16440,5659,14705,346,820,4269,11229,4615,12049
291890,202304,2109,3779,1396,2952,224,463,867,1786,1091,2249
291900,202304,1640,3409,1255,2836,38,88,1008,2177,1046,2265
291905,202304,2547,6187,2086,5474,98,321,1559,3926,1657,4247
291910,202304,4533,8416,3926,7714,84,179,3514,6834,3598,7013
291915,202304,8699,21980,7090,19332,258,659,5252,14647,5510,15306
291920,202304,45998,97519,40734,90770,1944,5378,33249,70873,35193,76251
291930,202304,3396,7396,2879,6706,322,690,2062,4864,2384,5554
291940,202304,4465,10303,3031,8007,283,715,1826,4722,2109,5437
291950,202304,10859,30345,9104,27200,535,1608,6065,18017,6600,19625
291955,202304,25985,55027,23289,51632,1571,3684,18596,40496,20167,44180
291960,202304,4715,9365,3985,8466,307,474,3157,6919,3464,7393
291970,202304,6155,12477,5237,11397,205,484,4237,9052,4442,9536
291980,202304,12184,30616,9948,27024,976,2499,6654,18220,7630,20719
291990,202304,2757,6212,2286,5639,36,128,2095,5085,2131,5213
291992,202304,5747,11429,5073,10562,194,443,4301,8612,4495,9055
291995,202304,2833,6246,2351,5546,82,249,1955,4462,2037,4711
292000,202304,3383,6624,2839,6008,97,231,2435,5077,2532,5308
292010,202304,7143,14151,5881,12341,104,342,5113,10354,5217,10696
292020,202304,5724,13712,4935,12457,137,498,4113,9932,4250,10430
292030,202304,2566,6531,2206,5918,193,554,1449,3753,1642,4307
292040,202304,5706,12057,4573,10494,160,391,3814,8612,3974,9003
292045,202304,5585,10923,4510,9417,21,55,4243,8810,4264,8865
292050,202304,7717,19061,6250,16610,282,867,4311,11032,4593,11899
292060,202304,16331,30742,15138,29333,513,907,13513,25655,14026,26562
292070,202304,8733,17317,7761,16193,559,1110,6576,13653,7135,14763
292080,202304,4741,8790,3966,7839,48,152,3698,7181,3746,7333
292090,202304,5162,9988,3679,8178,205,505,2928,6445,3133,6950
292100,202304,16336,34346,13961,31351,2178,4947,8553,19121,10731,24068
292105,202304,3973,9131,3435,8388,48,158,2893,6979,2941,7137
292110,202304,8323,16327,6116,13414,822,1921,4025,8582,4847,10503
292120,202304,8703,19379,7230,17006,821,1677,4934,11556,5755,13233
292130,202304,4073,8629,3332,7712,245,594,2445,5520,2690,6114
292140,202304,7135,13738,6065,12268,183,388,5393,10717,5576,11105
292145,202304,3210,7612,2695,6812,159,297,2028,5243,2187,5540
292150,202304,19865,43010,17185,38851,377,966,14831,32472,15208,33438
292160,202304,3504,7384,2662,6346,22,75,2110,5270,2132,5345
292170,202304,10615,25113,8831,22335,568,1661,6583,16070,7151,17731
292180,202304,3373,8530,2583,7084,208,588,1621,4270,1829,4858
292190,202304,3746,8416,3156,7574,291,733,2206,5237,2497,5970
292200,202304,11715,25541,8872,21620,2016,5098,4080,9975,6096,15073
292205,202304,4630,11119,4049,10290,109,295,3478,8823,3587,9118
292210,202304,8281,15694,6940,14065,95,285,6474,12872,6569,13157
292220,202304,2774,5560,2374,4990,206,411,1714,3449,1920,3860
292225,202304,3763,9764,3271,9059,69,270,2815,7648,2884,7918
292230,202304,10806,22383,9440,20590,326,846,7918,16804,8244,17650
292240,202304,6139,15485,5215,13848,336,840,3697,9757,4033,10597
292250,202304,7671,16709,6836,15565,342,838,5501,12157,5843,12995
292260,202304,4143,9608,3626,8975,61,174,3217,7906,3278,8080
292265,202304,4530,10361,3763,9190,70,267,3206,7572,3276,7839
292270,202304,6133,11174,5088,9952,196,318,4304,8297,4500,8615
292273,202304,3418,6565,2741,5746,158,272,1986,4368,2144,4640
292275,202304,2240,4869,1871,4392,50,164,1585,3620,1635,3784
292280,202304,3364,6823,2701,6062,112,200,2290,5211,2402,5411
292285,202304,3112,6393,2490,5572,124,222,2022,4580,2146,4802
292290,202304,9151,20231,7375,17760,212,527,6206,14703,6418,15230
292300,202304,12926,28793,10245,25121,1626,4049,6078,14907,7704,18956
292303,202304,4207,9273,3647,8447,58,131,3250,7393,3308,7524
292305,202304,2763,6561,2514,6220,62,186,2239,5463,2301,5649
292310,202304,8475,17984,7417,16710,157,463,6519,14330,6676,14793
292320,202304,6902,16498,5569,14288,168,510,4420,11019,4588,11529
292330,202304,3997,6671,3368,5989,159,235,2841,5108,3000,5343
292335,202304,6158,14143,5426,13069,307,722,4450,10718,4757,11440
292340,202304,6222,16054,5071,13858,395,977,3502,9512,3897,10489
292350,202304,3400,7751,2885,7077,151,406,2384,5766,2535,6172
292360,202304,5989,14106,4991,12533,277,733,3680,9029,3957,9762
292370,202304,13537,26999,11710,24645,83,322,11111,22984,11194,23306
292380,202304,8207,20175,7308,18645,445,1199,5706,14190,6151,15389
292390,202304,5938,9396,4721,8025,116,200,4309,7262,4425,7462
292400,202304,29359,70003,25304,63990,2593,6422,17698,44222,20291,50644
292405,202304,5524,11766,4602,10365,158,346,3612,8241,3770,8587
292410,202304,3084,5667,2684,5207,94,165,2383,4604,2477,4769
292420,202304,6243,11964,5585,11092,142,252,5065,9871,5207,10123
292430,202304,5925,15860,4457,13206,334,1074,3008,8699,3342,9773
292440,202304,11470,29202,10522,27858,126,583,9545,24880,9671,25463
292450,202304,4942,12443,3746,10225,104,297,2906,7778,3010,8075
292460,202304,7923,16122,6763,14442,153,429,5967,12354,6120,12783
292465,202304,3076,6918,2605,6319,112,233,1775,4553,1887,4786
292467,202304,2650,6098,2346,5702,310,626,1660,4261,1970,4887
292470,202304,3331,7911,2533,6677,170,412,1764,4672,1934,5084
292480,202304,8217,15068,6925,13545,180,343,6295,12208,6475,12551
292490,202304,3438,6543,2842,5793,73,159,2331,4734,2404,4893
292500,202304,9015,19821,7206,17077,400,877,5410,12507,5810,13384
292510,202304,17428,39141,13828,33733,1185,2703,9688,23464,10873,26167
292520,202304,9250,20352,8184,18830,412,1105,6609,14722,7021,15827
292525,202304,8132,16214,6818,14714,146,341,6130,13159,6276,13500
292530,202304,46161,103111,37264,89722,7370,19035,19472,44985,26842,64020
292540,202304,5260,8613,4276,7575,148,226,3853,6844,4001,7070
292550,202304,10414,24898,8164,22184,709,1793,5566,15914,6275,17707
292560,202304,5584,12316,4616,10981,179,533,3558,8092,3737,8625
292570,202304,4516,10295,3777,9048,59,224,3209,7358,3268,7582
292575,202304,8108,20939,7375,19926,1199,3248,4983,13592,6182,16840
292580,202304,9735,19944,8158,17755,482,705,6788,14817,7270,15522
292590,202304,8842,20978,7462,18558,320,1028,6160,14780,6480,15808
292593,202304,3521,7751,2763,6496,84,208,2257,5185,2341,5393
292595,202304,6866,15520,6028,14494,315,633,4967,12149,5282,12782
292600,202304,13773,32285,11889,29565,689,1575,9375,23313,10064,24888
292610,202304,5595,12089,4737,10743,150,334,3887,8588,4037,8922
292620,202304,8362,18586,6988,16923,118,287,6402,15474,6520,15761
292630,202304,11540,23864,9308,20455,1148,2855,6285,13000,7433,15855
292640,202304,9661,24795,8027,22064,487,1358,5485,15062,5972,16420
292650,202304,5028,11324,4468,10579,65,214,4094,9544,4159,9758
292660,202304,12906,32178,11096,29556,615,1493,8409,22589,9024,24082
292665,202304,2420,6301,2036,5792,124,297,1575,4612,1699,4909
292670,202304,3987,10212,3131,8655,274,872,2033,5346,2307,6218
292680,202304,4613,10910,3745,9462,97,238,2920,7143,3017,7381
292690,202304,2839,6890,1994,5532,228,599,1219,3453,1447,4052
292700,202304,12918,29451,11086,26772,649,1376,8390,20017,9039,21393
292710,202304,4309,9035,4039,8716,141,214,3782,8215,3923,8429
292720,202304,10584,21715,8978,19861,478,932,6873,15653,7351,16585
292730,202304,6931,13098,6239,12161,326,540,5303,10195,5629,10735
292740,202304,526188,1029050,471131,956202,50079,105135,342138,669647,392217,774782
292750,202304,9002,18636,7794,17111,302,624,6615,14398,6917,15022
292760,202304,4732,11849,4071,10732,185,546,3120,8022,3305,8568
292770,202304,9657,20703,7998,18486,1041,2448,5535,12799,6576,15247
292780,202304,2571,4383,1920,3627,51,119,1640,2923,1691,3042
292790,202304,4661,8586,3542,7382,297,546,2781,5861,3078,6407
292800,202304,14730,31184,12773,28339,1042,2060,9792,21816,10834,23876
292805,202304,4626,9173,3755,8119,143,333,3173,6699,3316,7032
292810,202304,16926,32579,14022,28450,439,1168,11971,22979,12410,24147
292820,202304,7949,20649,5934,17231,529,1713,4027,11351,4556,13064
292830,202304,3579,7353,3125,6823,160,329,2560,5691,2720,6020
292840,202304,12655,25354,10958,23176,155,459,10028,20668,10183,21127
292850,202304,3164,7210,2702,6581,235,537,1898,4529,2133,5066
292860,202304,22796,42355,20446,39507,412,1034,18114,33900,18526,34934
292870,202304,29206,59532,25277,54197,1867,4003,18040,36983,19907,40986
292880,202304,13570,33910,11328,30396,456,1571,8127,20637,8583,22208
292890,202304,10933,23410,9746,21814,243,737,8511,18417,8754,19154
292895,202304,4140,7456,3283,6240,246,396,2646,5015,2892,5411
292900,202304,3721,8034,3345,7535,54,191,2830,6086,2884,6277
292905,202304,5405,12192,4345,10617,197,548,3341,7819,3538,8367
292910,202304,7002,15256,6187,14207,176,371,5090,11419,5266,11790
292920,202304,12391,28604,11355,27192,365,1080,9717,22653,10082,23733
292925,202304,6193,16126,5068,14032,460,1053,3423,9500,3883,10553
292930,202304,8684,22164,7444,19876,1042,2820,4172,10769,5214,13589
292935,202304,3379,6088,2756,5397,25,81,2531,4882,2556,4963
292937,202304,3293,7645,2730,6884,232,639,1420,4057,1652,4696
292940,202304,3617,8008,2931,6999,502,1099,1783,4360,2285,5459
292950,202304,11074,25804,9672,23784,591,1388,7249,17409,7840,18797
292960,202304,6793,14075,5718,12626,216,409,4631,10059,4847,10468
292970,202304,4912,11973,4343,11193,118,314,3624,9402,3742,9716
292975,202304,5248,10255,4738,9676,102,233,4355,8793,4457,9026
292980,202304,4804,9040,4067,8037,56,160,3667,7047,3723,7207
292990,202304,13829,34205,11497,30307,413,1300,9020,22899,9433,24199
293000,202304,3247,7019,2713,6199,167,339,2041,4682,2208,5021
293010,202304,23571,51419,19167,45040,2597,6436,12134,27828,14731,34264
293015,202304,10359,27942,8238,24053,735,2175,5539,16134,6274,18309
293020,202304,12665,29878,11583,28370,168,558,10568,25609,10736,26167
293030,202304,6255,14789,4798,12578,402,737,3149,8646,3551,9383
293040,202304,5290,11948,4220,10479,135,361,3520,8634,3655,8995
293050,202304,32152,62432,28352,57125,1992,3967,22058,43055,24050,47022
293060,202304,4624,10844,3721,9230,244,641,2696,6404,2940,7045
293070,202304,42797,80856,38373,75450,2338,4854,31112,59102,33450,63956
293075,202304,4388,11770,3799,10854,66,325,3270,9276,3336,9601
293076,202304,4149,8824,3774,8393,104,187,3361,7546,3465,7733
293077,202304,8112,19055,6605,16802,1008,2255,3774,10214,4782,12469
293080,202304,5272,13917,4450,12479,85,343,3675,10045,3760,10388
293090,202304,3700,9974,2859,8530,217,673,1951,5711,2168,6384
293100,202304,7126,16725,5747,14410,359,759,4377,10956,4736,11715
293105,202304,4605,13046,3912,11699,272,820,2698,8025,2970,8845
293110,202304,3141,6385,2673,5739,135,275,2142,4515,2277,4790
293120,202304,6501,13356,5968,12643,538,762,4798,10546,5336,11308
293130,202304,4410,10432,3835,9700,127,405,3346,8297,3473,8702
293135,202304,39551,84930,29421,71185,5806,15545,11656,26959,17462,42504
293140,202304,3628,6034,3202,5551,105,144,2854,4878,2959,5022
293150,202304,6177,16355,5105,14416,447,1329,3439,9396,3886,10725
293160,202304,5116,10337,4562,9717,561,747,3530,8186,4091,8933
293170,202304,6832,10959,5819,9809,104,227,5164,8453,5268,8680
293180,202304,5594,13356,4636,11708,108,333,3803,9297,3911,9630
293190,202304,21035,42020,18712,38887,123,482,17293,34966,17416,35448
293200,202304,11720,22998,9687,19995,627,973,7917,16330,8544,17303
293210,202304,6734,14710,5719,13260,612,1259,4104,9626,4716,10885
293220,202304,7520,15097,5707,12327,768,1623,3819,7905,4587,9528
293230,202304,5964,11566,4567,9865,407,752,3402,7432,3809,8184
293240,202304,5426,12199,4439,10683,205,367,3323,8323,3528,8690
293245,202304,4850,11288,4395,10653,299,698,3531,8387,3830,9085
293250,202304,7005,14870,5670,13043,464,1130,4217,9464,4681,10594
293260,202304,5969,13194,4883,11587,169,313,3598,8602,3767,8915
293270,202304,9365,17557,7577,15647,589,704,6154,13472,6743,14176
293280,202304,5612,12366,4914,11427,313,673,3953,9141,4266,9814
293290,202304,21877,52139,19328,48329,1815,4710,13898,34037,15713,38747
293300,202304,8429,16810,7252,15140,638,1285,5439,10994,6077,12279
293305,202304,5514,11015,4611,9909,55,146,4190,8925,4245,9071
293310,202304,2709,5982,2295,5362,31,118,1924,4348,1955,4466
293315,202304,5744,10933,4820,9683,485,699,3817,7809,4302,8508
293317,202304,3452,7067,3076,6536,312,484,2235,4842,2547,5326
293320,202304,17976,33984,16057,31901,197,486,14801,28797,14998,29283
293325,202304,2304,4895,1784,4253,194,461,1193,2809,1387,3270
293330,202304,99595,226275,82312,198820,10165,27453,49837,111460,60002,138913
293340,202304,2616,6503,2133,5685,187,488,1447,3816,1634,4304
293345,202304,4739,10826,3799,9458,777,1734,2077,5760,2854,7494
293350,202304,7118,17387,6156,16172,265,637,5218,13837,5483,14474
293360,202304,19504,40550,16735,36999,565,1171,14582,32394,15147,33565
310010,202304,1207,2494,856,2045,120,320,372,765,492,1085
310020,202304,4017,9454,3030,7750,527,1453,1294,3002,1821,4455
310030,202304,2387,6003,1921,5216,257,750,1270,3306,1527,4056
310040,202304,1013,2378,792,2006,79,257,463,1025,542,1282
310050,202304,2064,5072,1726,4562,149,479,1150,2898,1299,3377
310060,202304,3798,9129,3116,8172,196,584,2160,5654,2356,6238
310070,202304,430,938,333,808,10,29,246,580,256,609
310080,202304,883,2251,673,1889,96,311,331,870,427,1181
310090,202304,6675,13994,5551,12332,208,592,4517,9581,4725,10173
310100,202304,4693,10500,3896,9323,105,373,3335,7702,3440,8075
310110,202304,5900,13850,4651,11783,608,1796,2872,6793,3480,8589
310120,202304,826,1832,551,1432,89,300,280,606,369,906
310130,202304,538,1220,462,1105,30,97,352,787,382,884
310140,202304,455,1155,353,1011,79,256,168,417,247,673
310150,202304,8064,17728,6147,14536,510,1517,3750,7899,4260,9416
310160,202304,13378,29223,10379,24645,1859,4958,5112,11030,6971,15988
310163,202304,1482,4026,1139,3363,267,881,320,771,587,1652
310170,202304,12346,26599,10141,23385,963,2280,7251,16251,8214,18531
310180,202304,2519,5393,1842,4349,215,562,1187,2666,1402,3228
310190,202304,3363,8772,2672,7595,613,1913,549,1389,1162,3302
310200,202304,2452,6284,1857,5277,502,1524,706,1820,1208,3344
310205,202304,1438,3552,1162,3155,149,422,748,2036,897,2458
310210,202304,2889,7068,2335,6067,134,343,1658,4159,1792,4502
310220,202304,1424,3547,1043,2853,91,291,640,1633,731,1924
310230,202304,2939,6838,2448,5995,321,911,1509,3418,1830,4329
310240,202304,1291,3283,1084,2958,72,243,723,1874,795,2117
310250,202304,1522,3207,1282,2863,39,105,1045,2246,1084,2351
310260,202304,4798,11418,3255,8608,772,2399,1085,2252,1857,4651
310270,202304,3591,6853,2934,6028,113,258,2437,4944,2550,5202
310280,202304,3638,7015,2838,5962,162,418,2124,4093,2286,4511
310285,202304,2225,6234,1835,5532,214,693,1086,3242,1300,3935
310290,202304,2034,4831,1725,4290,207,608,1077,2392,1284,3000
310300,202304,2104,5232,1582,4332,175,575,825,1963,1000,2538
310310,202304,406,859,284,668,54,133,146,311,200,444
310320,202304,586,1358,398,1046,27,78,218,544,245,622
310330,202304,618,1361,359,902,62,157,140,319,202,476
310340,202304,10258,23313,8006,19585,1019,2520,4216,10000,5235,12520
310350,202304,17463,38912,12661,31358,1859,5211,6733,15238,8592,20449
310360,202304,791,1524,657,1362,32,82,467,906,499,988
310370,202304,1447,4163,1243,3821,269,913,421,1333,690,2246
310375,202304,1064,2414,754,1974,250,645,239,615,489,1260
310380,202304,434,956,257,700,20,59,136,343,156,402
310390,202304,713,1946,575,1680,103,331,238,626,341,957
310400,202304,16177,36183,12259,30281,1079,3104,7992,18425,9071,21529
310410,202304,1286,3413,816,2423,94,325,336,843,430,1168
310420,202304,6160,14849,4678,12253,600,1733,2435,5759,3035,7492
310430,202304,2144,5352,1537,4279,273,812,674,1582,947,2394
310440,202304,808,1879,544,1422,88,215,247,596,335,811
310445,202304,1617,4117,1262,3431,92,237,897,2358,989,2595
310450,202304,5989,12531,4602,10436,280,821,3542,7513,3822,8334
310460,202304,2132,5248,1590,4290,251,707,437,984,688,1691
310470,202304,4029,8470,3150,7308,492,1035,1946,4629,2438,5664
310480,202304,1238,2880,935,2391,104,339,553,1260,657,1599
310490,202304,3713,8904,2905,7605,404,1231,1562,3676,1966,4907
310500,202304,1873,4384,1525,3847,225,587,949,2283,1174,2870
310510,202304,3025,6975,2257,5630,404,1095,1010,2342,1414,3437
310520,202304,1409,3316,964,2485,152,440,432,1055,584,1495
310530,202304,1056,2522,769,2044,105,332,306,661,411,993
310540,202304,3441,9128,2820,7941,535,1672,1233,3131,1768,4803
310550,202304,1541,3369,1126,2700,92,259,710,1536,802,1795
310560,202304,21746,51230,16161,41404,1787,5420,8524,18659,10311,24079
310570,202304,1552,3246,1221,2828,54,162,1032,2305,1086,2467
310590,202304,5376,12469,4300,10538,282,815,2635,5796,2917,6611
310600,202304,1768,4513,1439,3880,163,466,795,1969,958,2435
310610,202304,587,1513,370,1133,92,304,75,200,167,504
310620,202304,300092,667842,233169,551937,23496,66927,141237,295576,164733,362503
310630,202304,5802,14323,4383,11599,549,1504,2549,6354,3098,7858
310640,202304,1984,4432,1606,3828,119,396,1175,2530,1294,2926
310650,202304,2880,7004,2125,5640,143,441,1263,3153,1406,3594
310660,202304,1777,4067,1445,3612,24,65,1249,3087,1273,3152
310665,202304,1740,3739,1475,3399,48,149,1188,2688,1236,2837
310670,202304,86376,191879,72707,169974,7116,18830,49856,108546,56972,127376
310680,202304,981,2037,818,1810,19,72,676,1418,695,1490
310690,202304,3233,6698,2413,5544,257,616,1652,3559,1909,4175
310700,202304,659,1226,515,1045,9,21,438,863,447,884
310710,202304,7938,20216,5706,16765,1354,4443,903,2321,2257,6764
310720,202304,1475,2973,1190,2611,46,139,906,1896,952,2035
310730,202304,12927,29521,10997,26630,582,1699,8216,18784,8798,20483
310740,202304,8878,21502,6881,17877,827,2550,3618,8272,4445,10822
310750,202304,1725,3637,1319,3059,157,427,766,1553,923,1980
310760,202304,885,1980,628,1587,72,148,397,1014,469,1162
310770,202304,1340,3320,944,2684,130,433,458,1123,588,1556
310780,202304,5035,10512,4051,9134,328,772,2866,6332,3194,7104
310790,202304,2296,6592,1970,5925,424,1459,477,1146,901,2605
310800,202304,2806,7851,2021,6230,461,1595,112,265,573,1860
310810,202304,1896,3988,1566,3492,112,268,1141,2425,1253,2693
310820,202304,1489,3424,899,2452,167,452,271,695,438,1147
310825,202304,3240,7956,2582,6962,45,224,2155,5535,2200,5759
310830,202304,2744,6634,2110,5570,395,1163,1034,2412,1429,3575
310840,202304,2778,6838,2126,5774,453,1370,698,1603,1151,2973
310850,202304,1604,3943,1313,3519,56,201,939,2361,995,2562
310855,202304,4121,9548,3279,8251,262,668,2355,5738,2617,6406
310860,202304,8311,21359,6797,18690,880,2228,3957,11023,4837,13251
310870,202304,1142,2524,914,2212,49,124,665,1529,714,1653
310880,202304,1068,2910,792,2335,98,298,421,1194,519,1492
310890,202304,2686,7186,1796,5438,345,1109,252,642,597,1751
310900,202304,5350,13745,4072,11197,762,2347,1752,4195,2514,6542
310910,202304,2740,6140,1856,4750,283,808,496,1085,779,1893
310920,202304,2290,5356,1741,4561,231,694,1094,2706,1325,3400
310925,202304,1354,3047,1066,2617,55,155,780,1801,835,1956
310930,202304,6850,15889,4658,12517,886,2491,2151,5916,3037,8407
310940,202304,8554,17750,6943,15492,283,753,5429,11552,5712,12305
310945,202304,1700,3847,1304,3211,160,438,754,1699,914,2137
310950,202304,2264,6229,1454,4470,258,912,377,876,635,1788
310960,202304,797,2098,489,1432,84,265,138,371,222,636
310970,202304,1406,3942,1019,3160,250,799,189,548,439,1347
310980,202304,404,892,243,614,26,78,119,271,145,349
310990,202304,1855,4322,1517,3795,178,528,916,2060,1094,2588
311000,202304,5233,12881,4104,11005,734,2172,2238,5501,2972,7673
311010,202304,1195,2855,981,2517,234,630,489,1218,723,1848
311020,202304,1448,3321,947,2473,68,200,545,1329,613,1529
311030,202304,2327,5265,1711,4296,447,1291,688,1531,1135,2822
311040,202304,356,1023,272,845,75,267,64,166,139,433
311050,202304,3946,8818,3026,7478,458,1341,1585,3536,2043,4877
311060,202304,4600,10533,3451,8586,438,1261,1653,3618,2091,4879
311070,202304,3152,6892,2275,5586,322,976,1225,2686,1547,3662
311080,202304,1436,2810,1131,2382,36,106,894,1751,930,1857
311090,202304,2852,7981,2346,7098,578,1828,687,2017,1265,3845
311100,202304,3109,7975,2063,6033,395,1304,584,1409,979,2713
311110,202304,4553,9087,2404,5898,577,1429,404,934,981,2363
311115,202304,1796,3353,1504,2987,43,101,1296,2506,1339,2607
311120,202304,9107,21495,7018,17905,1031,2982,3191,6911,4222,9893
311130,202304,2296,5585,1771,4840,193,649,1024,2588,1217,3237
311140,202304,1990,4519,1510,3855,227,612,883,2182,1110,2794
311150,202304,1726,5009,1393,4379,209,722,725,2119,934,2841
311160,202304,5138,13129,3797,10759,651,2130,1611,4129,2262,6259
311170,202304,1166,2724,969,2478,76,210,593,1589,669,1799
311180,202304,1820,3784,1258,2989,195,458,665,1489,860,1947
311190,202304,1033,2699,767,2170,112,355,338,807,450,1162
311200,202304,2894,6927,2168,5644,409,1157,912,1975,1321,3132
311205,202304,1116,2941,887,2521,50,155,557,1483,607,1638
311210,202304,1251,3309,1113,3118,129,319,776,2264,905,2583
311220,202304,1086,2396,965,2193,28,89,771,1612,799,1701
311230,202304,9628,26391,7161,21418,1522,4752,2413,7097,3935,11849
311240,202304,1474,3273,1178,2871,159,468,709,1556,868,2024
311250,202304,1699,4232,1329,3623,249,733,561,1349,810,2082
311260,202304,3242,7327,2108,5442,285,836,1022,2269,1307,3105
311265,202304,1718,3642,1251,2933,53,159,954,2111,1007,2270
311270,202304,3689,9650,3148,8807,203,777,2178,5707,2381,6484
311280,202304,1516,3669,948,2617,220,673,258,585,478,1258
311290,202304,2178,6088,1957,5673,128,397,1275,3603,1403,4000
311300,202304,5356,13068,4455,11607,199,637,3608,9110,3807,9747
311310,202304,651,1643,547,1461,42,114,341,867,383,981
311320,202304,3913,10616,3201,9047,369,1165,1612,3975,1981,5140
311330,202304,7895,17007,6060,14273,809,2094,2908,6775,3717,8869
311340,202304,13601,34011,10843,29355,2365,6871,3583,8931,5948,15802
311350,202304,2821,6359,2008,4944,279,769,930,1941,1209,2710
311360,202304,1412,3132,1021,2604,272,738,449,1123,721,1861
311370,202304,5623,12534,4128,10195,556,1595,2216,4958,2772,6553
311380,202304,474,1366,368,1150,53,180,191,572,244,752
311390,202304,2095,5778,1700,5239,627,2058,403,1050,1030,3108
311400,202304,2056,5015,1496,4016,258,762,508,1069,766,1831
311410,202304,2364,6383,1909,5628,279,930,876,2368,1155,3298
311420,202304,2020,5242,1531,4376,333,1021,491,1146,824,2167
311430,202304,5668,13628,3841,10196,576,1619,1587,3889,2163,5508
311440,202304,3846,9697,2827,7919,855,2731,507,1048,1362,3779
311450,202304,3113,8284,1973,5887,496,1686,448,1020,944,2706
311455,202304,1320,2774,954,2256,99,247,587,1318,686,1565
311460,202304,747,2045,483,1491,91,326,110,261,201,587
311470,202304,595,1675,401,1276,93,352,63,160,156,512
311480,202304,1464,2944,1214,2590,80,179,984,2041,1064,2220
311490,202304,346,942,262,769,49,182,120,294,169,476
311500,202304,634,1432,500,1236,60,177,296,684,356,861
311510,202304,4472,9769,3258,7877,332,945,1886,4048,2218,4993
311520,202304,828,2013,716,1818,58,173,454,1120,512,1293
311530,202304,11491,24292,8133,19274,1971,5454,2729,5591,4700,11045
311535,202304,1166,2805,846,2212,124,371,420,990,544,1361
311540,202304,662,1740,578,1602,80,244,398,1076,478,1320
311545,202304,2410,6188,2073,5660,105,323,1608,4294,1713,4617
311547,202304,2206,4290,1911,3897,62,135,1633,3235,1695,3370
311550,202304,3615,8801,2934,7666,459,1375,1347,3071,1806,4446
311560,202304,368,736,228,519,35,89,75,144,110,233
311570,202304,1575,3370,1081,2694,77,207,730,1853,807,2060
311580,202304,2739,4824,1948,3892,187,373,1356,2593,1543,2966
311590,202304,774,1788,646,1613,64,199,417,974,481,1173
311600,202304,1775,4044,1454,3609,182,539,1001,2373,1183,2912
311610,202304,2762,7341,2189,6315,144,482,1427,3885,1571,4367
311615,202304,4530,10249,3700,8968,135,436,3021,6997,3156,7433
311620,202304,716,1757,534,1458,64,198,295,745,359,943
311630,202304,1586,4035,1230,3299,112,329,724,1861,836,2190
311640,202304,967,2326,768,2020,113,325,432,1055,545,1380
311650,202304,2287,5092,1821,4410,246,631,1054,2398,1300,3029
311660,202304,3973,10305,2965,8413,395,1297,922,2009,1317,3306
311670,202304,2032,4515,1520,3666,177,479,811,1827,988,2306
311680,202304,2844,6634,2176,5563,143,364,1551,3938,1694,4302
311690,202304,765,1463,560,1200,50,121,368,778,418,899
311700,202304,2476,5328,1887,4496,30,112,1572,3576,1602,3688
311710,202304,1924,5131,1426,4243,389,1296,410,1103,799,2399
311720,202304,518,1414,422,1240,51,171,246,700,297,871
311730,202304,5733,12842,4135,10071,827,2290,2069,4480,2896,6770
311740,202304,1186,2884,964,2568,75,199,714,1940,789,2139
311750,202304,4890,12913,3922,11192,362,1210,2500,6550,2862,7760
311760,202304,914,2311,703,1914,105,355,290,595,395,950
311770,202304,2717,6945,2137,5974,476,1422,738,1838,1214,3260
311780,202304,1878,4786,1433,4002,294,880,519,1257,813,2137
311783,202304,2863,6523,2333,5699,46,174,1923,4471,1969,4645
311787,202304,987,2619,750,2125,117,374,282,654,399,1028
311790,202304,1868,4836,1292,3739,251,812,298,712,549,1524
311800,202304,6536,17638,5131,14827,1164,3477,1002,2260,2166,5737
311810,202304,1237,3007,1041,2702,55,170,810,1982,865,2152
311820,202304,1255,2637,966,2217,74,186,681,1473,755,1659
311830,202304,11452,29352,8534,23492,2425,7041,1675,4224,4100,11265
311840,202304,4893,10723,3898,9371,307,783,2797,6683,3104,7466
311850,202304,428,982,339,838,12,48,241,547,253,595
311860,202304,98897,216122,79153,183784,8235,22108,51258,109016,59493,131124
311870,202304,2231,5468,1596,4425,255,838,687,1646,942,2484
311880,202304,7541,17619,6318,15936,480,1152,4585,11661,5065,12813
311890,202304,2357,4717,1885,4089,62,198,1491,3001,1553,3199
311900,202304,789,1875,589,1604,108,279,300,833,408,1112
311910,202304,5314,12037,4264,10642,733,2013,2385,5595,3118,7608
311920,202304,2670,5890,2184,5215,142,332,1550,3634,1692,3966
311930,202304,6148,12290,4725,10413,782,2031,2767,5455,3549,7486
311940,202304,19434,46039,14218,36733,2111,5888,6230,14544,8341,20432
311950,202304,2922,6769,2187,5538,192,531,1329,3313,1521,3844
311960,202304,575,1341,437,1125,57,169,197,438,254,607
311970,202304,481,1464,360,1172,68,257,84,215,152,472
311980,202304,562,1370,303,887,38,125,114,285,152,410
311990,202304,630,1435,421,1112,71,229,176,386,247,615
311995,202304,1167,3112,578,1781,47,166,90,174,137,340
312000,202304,971,2027,746,1714,40,97,558,1239,598,1336
312010,202304,1412,3150,1141,2769,62,166,767,1773,829,1939
312015,202304,1611,3988,1391,3646,66,239,1111,2806,1177,3045
312020,202304,2319,6378,1587,4724,271,858,388,980,659,1838
312030,202304,2680,5256,2262,4769,77,213,2020,4167,2097,4380
312040,202304,1038,2812,749,2250,115,349,324,895,439,1244
312050,202304,1484,4147,1224,3684,231,855,435,1129,666,1984
312060,202304,1195,2704,785,2120,199,572,271,687,470,1259
312070,202304,1116,2897,749,2124,36,123,480,1255,516,1378
312080,202304,3664,8007,2925,6941,155,433,2057,4433,2212,4866
312083,202304,1351,2764,1078,2380,48,140,883,1851,931,1991
312087,202304,3059,6737,2487,5896,101,266,2011,4673,2112,4939
312090,202304,14910,34216,11850,29496,1207,3635,7205,16256,8412,19891
312100,202304,2061,5015,1589,4233,106,356,995,2388,1101,2744
312110,202304,1221,3449,1002,2997,164,613,496,1301,660,1914
312120,202304,1320,3321,910,2612,233,785,280,639,513,1424
312125,202304,2527,5511,2133,4974,111,288,1730,3900,1841,4188
312130,202304,1481,3135,1104,2542,76,224,657,1297,733,1521
312140,202304,940,2478,762,2132,200,596,309,760,509,1356
312150,202304,687,1653,559,1399,43,119,378,866,421,985
312160,202304,12145,28293,9472,23789,1090,3250,5117,11398,6207,14648
312170,202304,1061,2468,820,2051,58,163,528,1251,586,1414
312180,202304,1727,4053,1412,3536,162,450,831,1930,993,2380
312190,202304,1023,2439,791,2054,86,256,414,962,500,1218
312200,202304,5706,13881,4439,11912,868,2530,2345,5831,3213,8361
312210,202304,1781,3276,1370,2735,82,176,1109,2111,1191,2287
312220,202304,1978,5421,1685,4914,174,539,1101,3179,1275,3718
312230,202304,26425,59996,19475,48187,3723,10491,7259,14708,10982,25199
312235,202304,2745,5630,2251,4977,193,407,1710,3637,1903,4044
312240,202304,972,2804,750,2376,156,512,228,666,384,1178
312245,202304,4030,7475,3504,6766,47,119,3249,6139,3296,6258
312247,202304,1241,2610,863,2059,107,267,519,1166,626,1433
312250,202304,1092,2698,701,1957,91,280,247,631,338,911
312260,202304,1246,2907,1016,2505,66,174,795,1866,861,2040
312270,202304,923,2275,697,1829,29,105,441,1017,470,1122
312280,202304,526,1455,442,1314,104,354,171,442,275,796
312290,202304,1210,3125,1018,2825,193,631,391,957,584,1588
312300,202304,1475,3963,1085,3089,248,761,270,605,518,1366
312310,202304,1272,3425,990,2857,124,433,523,1376,647,1809
312320,202304,2631,6025,1871,4721,330,852,612,1356,942,2208
312330,202304,1161,2920,948,2545,152,471,546,1342,698,1813
312340,202304,288,687,210,563,30,105,117,268,147,373
312350,202304,290,568,214,482,14,42,144,281,158,323
312352,202304,1775,5165,1573,4801,300,982,719,2347,1019,3329
312360,202304,4474,11317,3355,9274,682,2067,1414,3445,2096,5512
312370,202304,2589,5751,2061,4966,248,698,1280,2858,1528,3556
312380,202304,2613,5244,2138,4611,24,67,1841,3822,1865,3889
312385,202304,1477,3628,1166,3082,418,1138,275,742,693,1880
312390,202304,2389,6126,1786,5005,276,878,511,1174,787,2052
312400,202304,3789,9820,3247,8984,1149,3522,598,1561,1747,5083
312410,202304,19729,45023,16315,39754,1924,5084,10631,24484,12555,29568
312420,202304,5000,11987,4014,10439,856,2565,1842,4395,2698,6960
312430,202304,11173,24141,9213,20949,321,956,7218,15425,7539,16381
312440,202304,1319,3730,1113,3349,559,1794,205,553,764,2347
312450,202304,1696,4484,1294,3782,352,1107,465,1331,817,2438
312460,202304,609,1322,446,1096,23,64,301,708,324,772
312470,202304,555,1279,355,942,54,157,119,254,173,411
312480,202304,1257,2954,957,2510,91,277,529,1297,620,1574
312490,202304,3327,6559,2599,5554,223,527,1602,3204,1825,3731
312500,202304,1348,2823,1153,2569,54,155,914,1966,968,2121
312510,202304,6599,16031,4431,11906,806,2162,1307,3126,2113,5288
312520,202304,460,1042,360,890,60,179,227,522,287,701
312530,202304,916,1853,763,1673,56,123,579,1255,635,1378
312540,202304,1823,4503,1279,3489,158,429,704,1810,862,2239
312550,202304,980,2254,706,1762,43,117,444,1002,487,1119
312560,202304,2196,5174,1660,4341,100,272,1169,2994,1269,3266
312570,202304,3402,7134,2563,6076,434,1053,1319,3052,1753,4105
312580,202304,799,1974,526,1417,50,153,271,641,321,794
312590,202304,1815,4750,1424,3975,183,585,758,1903,941,2488
312595,202304,2639,6627,2160,5907,348,904,1144,3349,1492,4253
312600,202304,1596,3700,1085,2635,180,525,376,842,556,1367
312610,202304,8800,20768,5983,15689,1088,3168,1892,4126,2980,7294
312620,202304,3052,6770,2328,5780,62,257,1924,4632,1986,4889
312630,202304,403,1034,298,854,59,207,120,297,179,504
312640,202304,598,1552,485,1373,72,231,253,651,325,882
312650,202304,2495,5540,1751,4228,56,184,1312,2910,1368,3094
312660,202304,1615,3466,1272,2925,110,274,905,1950,1015,2224
312670,202304,7514,15681,6310,13875,125,519,5242,10729,5367,11248
312675,202304,1409,3262,1189,2956,79,221,913,2184,992,2405
312680,202304,1964,4219,1778,3973,32,122,1616,3478,1648,3600
312690,202304,3699,6876,2786,5736,158,315,2224,4463,2382,4778
312695,202304,1254,2861,1062,2578,51,93,892,2147,943,2240
312700,202304,2536,6258,1808,4972,204,656,974,2449,1178,3105
312705,202304,2089,3798,1831,3470,15,45,1738,3252,1753,3297
312707,202304,1640,4177,1161,3361,50,218,762,2005,812,2223
312710,202304,9220,19995,6172,15354,1674,4238,1796,4506,3470,8744
312720,202304,1262,3058,1027,2685,102,291,680,1664,782,1955
312730,202304,1902,4140,1375,3433,121,314,894,2169,1015,2483
312733,202304,1540,3777,1166,3102,48,161,775,1878,823,2039
312735,202304,984,2274,750,1853,58,174,484,1075,542,1249
312737,202304,1003,2025,731,1648,64,163,517,1115,581,1278
312738,202304,1016,2268,713,1762,72,210,462,1019,534,1229
312740,202304,494,1250,329,951,78,240,84,182,162,422
312750,202304,1739,4485,1264,3625,164,532,558,1457,722,1989
312760,202304,2204,5907,1616,4762,264,815,593,1587,857,2402
312770,202304,56502,125235,37414,93357,6223,17565,15591,34939,21814,52504
312780,202304,3253,8143,2708,7239,422,1133,1534,3986,1956,5119
312790,202304,284,646,141,406,6,17,31,56,37,73
312800,202304,7323,17312,5897,14818,484,1537,3849,8840,4333,10377
312810,202304,1892,4794,1278,3760,386,1257,394,999,780,2256
312820,202304,2090,4966,1697,4329,120,304,1202,3011,1322,3315
312825,202304,1919,3645,1605,3244,39,87,1376,2716,1415,2803
312830,202304,3357,8560,2282,6540,569,1731,722,1767,1291,3498
312840,202304,1810,4182,1412,3564,165,471,739,1681,904,2152
312850,202304,1431,2704,1081,2240,21,69,825,1521,846,1590
312860,202304,1204,2957,859,2401,237,681,266,646,503,1327
312870,202304,7367,18226,4803,13488,828,2532,1455,3571,2283,6103
312880,202304,1892,4170,1485,3525,271,596,739,1761,1010,2357
312890,202304,2871,6235,2137,5105,153,356,1301,2918,1454,3274
312900,202304,1626,3723,1288,3242,402,1055,521,1277,923,2332
312910,202304,1767,3116,1086,2246,162,309,598,1223,760,1532
312920,202304,1149,2855,817,2317,131,448,261,579,392,1027
312930,202304,3022,6588,2201,5366,345,895,1157,2784,1502,3679
312940,202304,1219,2975,952,2605,90,294,502,1253,592,1547
312950,202304,4217,9137,3103,7491,442,1239,1816,3995,2258,5234
312960,202304,2122,5000,1743,4435,127,297,1244,3239,1371,3536
312965,202304,1977,4770,1595,4169,169,422,1009,2637,1178,3059
312970,202304,2043,5048,1644,4447,187,654,957,2340,1144,2994
312980,202304,32591,80760,26520,70048,5200,14515,11555,28320,16755,42835
312990,202304,636,1444,423,1099,75,227,181,424,256,651
313000,202304,606,1537,457,1286,29,121,288,714,317,835
313005,202304,2931,7607,2392,6720,126,367,1723,4706,1849,5073
313010,202304,7547,18182,6150,15992,964,2865,3603,8804,4567,11669
313020,202304,1258,3482,985,2968,202,664,191,462,393,1126
313030,202304,1470,3029,1050,2447,88,229,751,1645,839,1874
313040,202304,1095,2986,927,2675,50,201,577,1551,627,1752
313050,202304,2234,5684,1592,4704,262,878,391,993,653,1871
313055,202304,2228,5479,1897,4965,700,2071,834,1971,1534,4042
313060,202304,1289,2957,941,2368,187,569,246,505,433,1074
313065,202304,2101,5079,1868,4714,26,112,1611,3904,1637,4016
313070,202304,1064,2618,829,2240,103,301,411,1035,514,1336
313080,202304,478,1205,360,1000,67,224,140,315,207,539
313090,202304,6848,15479,5622,13619,257,674,4045,9477,4302,10151
313100,202304,1565,3722,1302,3340,63,220,950,2304,1013,2524
313110,202304,1856,4480,1304,3496,148,454,660,1582,808,2036
313115,202304,3494,8608,2808,7377,269,847,1662,3866,1931,4713
313120,202304,4428,9827,3241,8242,327,895,2084,5233,2411,6128
313130,202304,40924,94242,31204,77536,3341,9458,18298,41439,21639,50897
313140,202304,990,1905,676,1508,53,130,506,1099,559,1229
313150,202304,1728,4520,1240,3621,352,1176,180,399,532,1575
313160,202304,1797,3970,1346,3309,40,105,1029,2411,1069,2516
313170,202304,14308,37016,10816,30243,1790,5458,4262,10402,6052,15860
313180,202304,3100,7142,2383,5752,170,438,1664,3817,1834,4255
313190,202304,5731,14650,4340,12027,788,2421,1796,4342,2584,6763
313200,202304,1376,3128,1175,2793,30,84,965,2210,995,2294
313210,202304,5317,12169,4385,10787,401,1115,3025,7010,3426,8125
313220,202304,2425,5832,1652,4346,241,708,770,1698,1011,2406
313230,202304,3401,8407,2754,7560,52,184,2246,6151,2298,6335
313240,202304,14284,31682,10467,25783,1124,3392,5999,13289,7123,16681
313250,202304,7737,20369,5925,16664,1154,3478,2689,6940,3843,10418
313260,202304,997,2233,695,1775,70,254,381,817,451,1071
313270,202304,8382,16286,7074,14617,587,1236,5694,11575,6281,12811
313280,202304,568,1382,391,1062,48,151,183,455,231,606
313290,202304,1282,3826,1016,3331,254,941,356,1080,610,2021
313300,202304,2297,5703,1769,4795,362,1065,621,1488,983,2553
313310,202304,1860,4968,1509,4239,273,848,477,1057,750,1905
313320,202304,2405,5812,1767,4814,392,1160,562,1509,954,2669
313330,202304,5209,11848,3811,9782,286,825,2485,6172,2771,6997
313340,202304,2130,4309,1659,3679,121,311,1232,2578,1353,2889
313350,202304,3734,9326,2548,6865,332,1028,1165,2620,1497,3648
313360,202304,2145,4783,1507,3771,267,792,794,1762,1061,2554
313370,202304,2038,4972,1536,4048,337,967,561,1248,898,2215
313375,202304,2293,5570,1486,4122,276,860,413,944,689,1804
313380,202304,8421,19366,6396,15746,998,2896,3159,6686,4157,9582
313390,202304,962,2684,826,2443,46,194,576,1620,622,1814
313400,202304,4653,10139,3464,8391,160,442,2572,5994,2732,6436
313410,202304,1773,4053,1326,3336,334,852,716,1710,1050,2562
313420,202304,19805,41345,11481,28099,2669,7325,3186,6808,5855,14133
313430,202304,1570,3515,1322,3080,62,237,1034,2195,1096,2432
313440,202304,9217,16940,6939,14215,176,453,5668,11143,5844,11596
313450,202304,885,2212,634,1740,110,347,226,481,336,828
313460,202304,2955,7513,2407,6654,427,1321,1126,2953,1553,4274
313470,202304,3364,7572,2740,6677,153,411,2131,5077,2284,5488
313480,202304,1417,3686,882,2586,95,300,393,1025,488,1325
313490,202304,3814,9259,2147,6121,396,1212,535,1307,931,2519
313500,202304,703,1652,478,1240,69,173,215,501,284,674
313505,202304,13185,29726,11243,27096,539,1300,8994,21306,9533,22606
313507,202304,1626,3712,1287,3200,52,182,986,2330,1038,2512
313510,202304,19500,46148,15229,38255,1457,4023,8890,20279,10347,24302
313520,202304,19782,45100,16202,39467,692,2075,12763,29614,13455,31689
313530,202304,715,1974,526,1579,78,286,215,539,293,825
313535,202304,2735,6990,2167,5918,257,681,1288,3406,1545,4087
313540,202304,1090,2786,845,2263,109,346,412,949,521,1295
313545,202304,1367,4049,1145,3629,172,573,541,1632,713,2205
313550,202304,2626,6731,2177,5788,234,670,1468,3792,1702,4462
313560,202304,3716,5937,2902,4989,38,60,2597,4394,2635,4454
313570,202304,1186,3056,942,2647,209,622,415,1050,624,1672
313580,202304,7742,16069,6209,13682,335,912,4623,9499,4958,10411
313590,202304,1445,3410,1150,2996,243,669,597,1573,840,2242
313600,202304,5541,11514,4757,10391,103,315,4272,9030,4375,9345
313610,202304,1206,2744,992,2381,77,219,651,1421,728,1640
313620,202304,7067,16991,5823,14835,569,1743,3832,9124,4401,10867
313630,202304,10902,24275,8151,20248,829,2478,5035,11696,5864,14174
313640,202304,1655,3061,1178,2464,95,237,878,1787,973,2024
313650,202304,1945,5403,1523,4670,157,520,907,2790,1064,3310
313652,202304,1103,2780,958,2520,74,237,689,1692,763,1929
313655,202304,1461,3081,1151,2703,65,162,882,2020,947,2182
313657,202304,1296,3092,1026,2652,40,169,744,1748,784,1917
313660,202304,1528,3471,1245,3023,81,284,916,2046,997,2330
313665,202304,7287,16723,5866,14309,561,1640,3820,8472,4381,10112
313670,202304,71835,160004,50983,126393,6730,18380,26262,59683,32992,78063
313680,202304,1356,3102,1078,2665,52,145,716,1652,768,1797
313690,202304,1213,3314,896,2711,180,618,189,488,369,1106
313695,202304,2106,5086,1586,4237,136,351,1025,2768,1161,3119
313700,202304,3448,9573,2986,8965,243,789,2363,7102,2606,7891
313710,202304,1743,3641,1260,3002,144,436,783,1745,927,2181
313720,202304,8137,20255,6085,16142,835,2450,2962,6934,3797,9384
313730,202304,1682,3269,1264,2731,77,147,846,1796,923,1943
313740,202304,2010,6632,1703,5900,366,1427,453,1348,819,2775
313750,202304,2937,6786,2385,5935,336,997,1472,3329,1808,4326
313753,202304,2506,5788,1670,4421,426,1249,472,1136,898,2385
313760,202304,7777,19472,6256,16694,989,3047,3094,7325,4083,10372
313770,202304,5032,12886,3983,11202,772,2135,2409,6875,3181,9010
313780,202304,5060,11904,3730,9914,749,1974,1177,3034,1926,5008
313790,202304,761,1943,628,1682,73,222,392,987,465,1209
313800,202304,1664,3441,1201,2801,115,306,687,1459,802,1765
313810,202304,2298,4764,1837,4104,83,235,1491,3169,1574,3404
313820,202304,21245,50621,14365,36625,2363,6317,4560,10251,6923,16568
313830,202304,493,1325,366,1065,72,240,138,356,210,596
313835,202304,1144,2814,839,2320,73,241,449,1124,522,1365
313840,202304,10435,24432,8206,21039,1885,5115,2382,5750,4267,10865
313850,202304,1232,2631,979,2285,165,416,522,1092,687,1508
313860,202304,3624,8435,2764,7011,395,1089,1389,3170,1784,4259
313862,202304,1383,2915,750,1973,57,168,376,941,433,1109
313865,202304,3252,7405,2688,6559,76,236,2091,4839,2167,5075
313867,202304,1690,4837,1355,4190,323,1032,573,1794,896,2826
313868,202304,2040,5532,1617,4774,68,254,1214,3406,1282,3660
313870,202304,1323,3115,892,2352,133,370,374,865,507,1235
313880,202304,2828,6550,2176,5493,342,1041,1087,2296,1429,3337
313890,202304,2914,5168,2231,4302,60,133,1816,3354,1876,3487
313900,202304,6893,17471,4867,13516,1275,3749,1407,3283,2682,7032
313910,202304,951,2532,717,2088,145,449,189,500,334,949
313920,202304,3462,9137,2851,7986,541,1562,1408,3890,1949,5452
313925,202304,1942,4372,1555,3727,210,443,953,2217,1163,2660
313930,202304,6402,15348,5054,13226,439,1090,3308,8580,3747,9670
313940,202304,12515,33408,9793,28973,2268,7377,2171,6737,4439,14114
313950,202304,7001,13550,5477,11654,286,706,4041,8258,4327,8964
313960,202304,7126,15517,4866,11889,686,1978,2233,4729,2919,6707
313970,202304,2014,4627,1695,4114,53,138,1194,2722,1247,2860
313980,202304,1790,4269,1316,3572,256,766,540,1349,796,2115
313990,202304,2788,7196,2177,6056,360,1229,1234,2978,1594,4207
314000,202304,13340,29867,10587,25257,717,2113,6919,15649,7636,17762
314010,202304,1636,3558,1283,3074,86,247,922,2084,1008,2331
314015,202304,3008,7295,2441,6315,272,863,1460,3370,1732,4233
314020,202304,651,1589,417,1212,150,523,24,64,174,587
314030,202304,1041,2655,762,2126,113,337,311,806,424,1143
314040,202304,760,1940,648,1740,79,265,385,980,464,1245
314050,202304,2616,6018,1978,4946,120,354,1302,2950,1422,3304
314053,202304,2587,6583,2056,5604,336,873,1188,3316,1524,4189
314055,202304,2912,6353,2443,5718,74,210,2026,4731,2100,4941
314060,202304,1599,3748,1148,3011,42,128,825,2087,867,2215
314070,202304,6229,14760,5142,12934,751,2019,2918,6856,3669,8875
314080,202304,2424,5841,1809,4791,175,525,882,2068,1057,2593
314085,202304,2878,6926,2289,6071,250,725,1465,3829,1715,4554
314090,202304,6238,14545,5316,13253,579,1566,3337,8378,3916,9944
314100,202304,3517,7879,2709,6762,75,204,2015,4993,2090,5197
314110,202304,6241,15732,5080,13616,725,2124,2599,6248,3324,8372
314120,202304,825,1801,403,1064,75,225,160,369,235,594
314130,202304,848,2007,635,1619,21,76,457,1088,478,1164
314140,202304,5672,13648,4502,11624,518,1460,2535,6152,3053,7612
314150,202304,1731,3971,1235,3153,143,422,738,1793,881,2215
314160,202304,2906,6586,1992,5053,217,553,811,1939,1028,2492
314170,202304,1164,2851,912,2367,64,207,611,1410,675,1617
314180,202304,6687,16442,5173,14010,702,1951,2539,6715,3241,8666
314190,202304,758,1726,594,1487,64,216,353,782,417,998
314200,202304,3649,9142,3015,8131,298,796,1903,5029,2201,5825
314210,202304,2372,5626,1834,4694,315,860,626,1436,941,2296
314220,202304,2178,5307,1694,4567,274,875,758,1814,1032,2689
314225,202304,1231,3241,969,2761,132,422,556,1474,688,1896
314230,202304,1079,2603,843,2250,139,401,430,1069,569,1470
314240,202304,1348,3395,1056,2949,230,666,440,1226,670,1892
314250,202304,512,1380,333,1008,47,157,127,338,174,495
314260,202304,1354,3204,1070,2835,388,1092,298,688,686,1780
314270,202304,4013,9858,3263,8663,86,243,2474,6407,2560,6650
314280,202304,4412,9461,3115,7597,348,980,1859,4180,2207,5160
314290,202304,5561,12527,4754,11191,245,647,3576,8023,3821,8670
314300,202304,2423,6327,1568,4546,367,1165,416,976,783,2141
314310,202304,4444,10966,3123,8742,877,2842,388,837,1265,3679
314315,202304,1213,3319,957,2795,68,242,663,1824,731,2066
314320,202304,4188,10052,2942,7805,460,1451,1285,2976,1745,4427
314330,202304,70339,181452,54258,153805,13139,38208,15028,40762,28167,78970
314340,202304,3356,7774,2381,6117,435,1371,1035,2169,1470,3540
314345,202304,2005,4811,1639,4200,130,324,1167,2880,1297,3204
314350,202304,1186,3063,743,2189,120,368,159,323,279,691
314360,202304,687,1805,436,1292,67,196,130,339,197,535
314370,202304,914,2067,733,1818,77,206,500,1177,577,1383
314380,202304,1498,3773,1081,3063,259,816,344,904,603,1720
314390,202304,19814,44248,14080,34816,2044,5815,6409,13496,8453,19311
314400,202304,4755,13107,3657,11012,1278,4111,939,2831,2217,6942
314410,202304,3677,9682,2545,7417,626,2163,469,1092,1095,3255
314420,202304,947,2127,669,1698,25,86,438,1039,463,1125
314430,202304,9859,21072,7066,16764,1060,2687,3416,7599,4476,10286
314435,202304,2277,5534,1765,4744,338,944,852,2169,1190,3113
314437,202304,1092,2466,818,2042,65,183,555,1311,620,1494
314440,202304,746,1982,546,1600,124,432,166,377,290,809
314450,202304,1794,4219,1448,3646,192,541,798,1798,990,2339
314460,202304,4271,11487,3314,9601,748,2439,1343,3340,2091,5779
314465,202304,2812,6977,2275,6013,71,217,1744,4383,1815,4600
314467,202304,1184,2769,952,2395,139,402,593,1411,732,1813
314470,202304,2904,7337,2406,6452,481,1400,1129,2701,1610,4101
314480,202304,11257,27819,8654,22717,1276,3743,4050,9299,5326,13042
314490,202304,1296,3037,935,2398,90,259,585,1401,675,1660
314500,202304,2378,5279,1644,4234,481,1207,366,925,847,2132
314505,202304,2867,5632,2373,4980,150,251,1840,3792,1990,4043
314510,202304,2660,6549,1997,5611,649,2143,589,1464,1238,3607
314520,202304,9842,26528,7937,22948,1749,5417,1884,4886,3633,10303
314530,202304,6669,17901,5890,16526,389,1296,4332,11600,4721,12896
314535,202304,3554,7448,2893,6536,161,399,2331,5160,2492,5559
314537,202304,1464,3691,1133,3143,84,220,735,1958,819,2178
314540,202304,523,1180,377,964,18,52,217,507,235,559
314545,202304,2310,4822,2046,4516,70,195,1624,3569,1694,3764
314550,202304,915,2024,591,1475,55,175,299,645,354,820
314560,202304,6140,15869,4704,13009,598,1949,2259,5302,2857,7251
314570,202304,411,1066,308,896,49,161,140,386,189,547
314580,202304,605,1603,467,1338,110,328,152,423,262,751
314585,202304,917,2494,689,2033,61,220,334,894,395,1114
314587,202304,2761,6607,2162,5684,701,1899,993,2463,1694,4362
314590,202304,5388,12953,4178,10851,539,1571,2105,4944,2644,6515
314600,202304,2261,5778,1469,4309,321,1066,182,462,503,1528
314610,202304,11915,27384,9432,23485,1120,3352,4824,11665,5944,15017
314620,202304,3087,6076,2500,5365,170,293,1959,4265,2129,4558
314625,202304,1985,4368,1684,3964,44,183,1455,3286,1499,3469
314630,202304,6052,13674,4849,12033,193,556,3816,9271,4009,9827
314640,202304,1053,2034,819,1691,28,83,649,1236,677,1319
314650,202304,1009,2234,705,1753,79,231,399,874,478,1105
314655,202304,1807,4487,1279,3594,180,470,657,1832,837,2302
314660,202304,445,858,346,706,12,32,271,508,283,540
314670,202304,1917,3938,1320,3106,37,114,928,2064,965,2178
314675,202304,2026,4656,1721,4183,112,265,1323,3154,1435,3419
314690,202304,2540,6381,1948,5490,527,1530,682,1856,1209,3386
314700,202304,14829,36375,10403,28592,1615,4879,4744,12002,6359,16881
314710,202304,10047,25700,7627,20722,1188,3554,3009,7017,4197,10571
314720,202304,2930,7975,2095,6302,446,1500,398,958,844,2458
314730,202304,3127,7512,2182,5782,381,1131,804,1794,1185,2925
314740,202304,4060,10189,3206,8757,605,1830,1573,3895,2178,5725
314750,202304,370,882,291,727,30,98,181,392,211,490
314760,202304,2324,6213,1491,4437,246,839,408,863,654,1702
314770,202304,1282,3493,719,2166,110,334,148,395,258,729
314780,202304,445,1032,319,827,28,80,196,476,224,556
314790,202304,15283,37034,11245,30031,2034,6089,4721,11503,6755,17592
314795,202304,1835,4176,1548,3723,73,204,1197,2745,1270,2949
314800,202304,14623,34544,10187,26841,1724,5039,4087,9286,5811,14325
314810,202304,13417,32006,10286,26885,2507,6961,4071,9829,6578,16790
314820,202304,1553,3391,1205,2896,75,226,781,1761,856,1987
314830,202304,2208,5451,1810,4799,155,419,1146,2853,1301,3272
314840,202304,1096,2973,873,2578,80,311,599,1645,679,1956
314850,202304,3436,5720,2873,5055,40,81,2656,4622,2696,4703
314860,202304,4147,10129,3446,8978,135,490,2588,6424,2723,6914
314870,202304,8654,16818,6701,14515,290,623,5103,11164,5393,11787
314875,202304,2208,5991,1936,5600,249,681,1310,3813,1559,4494
314880,202304,937,2128,710,1766,50,145,437,1025,487,1170
314890,202304,639,1784,463,1385,62,211,226,591,288,802
314900,202304,1134,2444,866,2033,110,300,505,1081,615,1381
314910,202304,1992,5261,1504,4469,291,1059,662,1744,953,2803
314915,202304,2540,6689,2043,5847,204,585,1240,3508,1444,4093
314920,202304,703,1558,515,1300,29,88,372,927,401,1015
314930,202304,8086,20288,6417,17232,1075,3315,2969,6953,4044,10268
314940,202304,521,1114,417,961,42,114,261,563,303,677
314950,202304,846,1904,576,1485,63,223,314,719,377,942
314960,202304,1186,2549,928,2139,81,183,625,1400,706,1583
314970,202304,1461,3924,1128,3297,203,658,452,1140,655,1798
314980,202304,2760,6302,2277,5619,224,579,1637,3946,1861,4525
314990,202304,3410,9053,2398,6847,412,1223,658,1593,1070,2816
314995,202304,2099,5138,1606,4275,76,266,1032,2502,1108,2768
315000,202304,1289,2957,912,2378,91,268,594,1476,685,1744
315010,202304,505,1236,401,1080,36,118,252,639,288,757
315015,202304,3097,7464,2706,6856,266,837,1906,4566,2172,5403
315020,202304,945,2521,686,2020,61,199,323,830,384,1029
315030,202304,841,1975,581,1530,190,485,135,313,325,798
315040,202304,1226,2835,1026,2530,150,425,667,1532,817,1957
315050,202304,1411,3304,1030,2732,93,291,493,1199,586,1490
315053,202304,1512,3418,1118,2771,143,338,624,1480,767,1818
315057,202304,2248,5624,1758,4831,166,402,1114,3246,1280,3648
315060,202304,889,2388,646,1896,118,377,191,514,309,891
315070,202304,1121,2155,850,1783,81,212,634,1205,715,1417
315080,202304,4138,9699,3099,7843,151,423,2240,5357,2391,5780
315090,202304,1011,2702,765,2269,113,363,362,950,475,1313
315100,202304,1773,4737,1204,3522,172,577,511,1269,683,1846
315110,202304,2836,6005,2077,4920,174,407,1189,2740,1363,3147
315120,202304,15912,33578,11710,27416,1315,3079,6860,15609,8175,18688
315130,202304,2265,5488,1933,4951,200,600,1065,2411,1265,3011
315140,202304,4141,10240,3369,8952,581,1691,1868,4594,2449,6285
315150,202304,5646,13395,4026,10728,725,2137,1773,4384,2498,6521
315160,202304,2504,5439,1787,4353,262,700,1036,2388,1298,3088
315170,202304,1734,5068,1229,3911,236,812,353,1035,589,1847
315180,202304,22311,51136,13434,35295,1947,5810,4881,10761,6828,16571
315190,202304,2701,5484,2069,4654,251,551,1490,3355,1741,3906
315200,202304,5892,14422,4486,12142,1348,3956,1543,3705,2891,7661
315210,202304,10579,25509,7586,19700,848,2465,3648,8138,4496,10603
315213,202304,1243,3035,1081,2803,22,82,904,2262,926,2344
315217,202304,3267,8323,2416,6892,141,547,1621,4376,1762,4923
315220,202304,10610,26175,8186,22154,752,1730,4399,12036,5151,13766
315230,202304,3638,7089,2982,6242,154,253,2193,4531,2347,4784
315240,202304,3089,7852,2502,6876,629,1838,1093,2863,1722,4701
315250,202304,19392,47060,14775,38801,2283,6706,6840,15884,9123,22590
315260,202304,1165,2888,719,2045,135,394,155,353,290,747
315270,202304,1226,3158,977,2717,125,424,479,1109,604,1533
315280,202304,4011,9256,2722,7037,730,1999,809,1905,1539,3904
315290,202304,1502,3375,985,2581,187,556,421,976,608,1532
315300,202304,799,1796,589,1497,36,104,406,983,442,1087
315310,202304,1595,3588,1201,2931,80,253,836,1819,916,2072
315320,202304,744,2016,540,1613,78,237,205,553,283,790
315330,202304,874,2584,541,1762,68,248,220,610,288,858
315340,202304,3387,7779,2339,6168,603,1647,815,2029,1418,3676
315350,202304,2391,5245,2015,4702,142,388,1581,3526,1723,3914
315360,202304,2115,5542,1667,4709,219,654,778,2001,997,2655
315370,202304,768,1872,604,1600,91,265,277,655,368,920
315380,202304,292,762,201,580,38,111,27,52,65,163
315390,202304,1566,3961,1289,3501,134,460,762,1828,896,2288
315400,202304,5034,12055,4025,10376,508,1454,2346,5645,2854,7099
315410,202304,2882,5981,2041,4751,414,1157,561,1133,975,2290
315415,202304,1838,4674,1486,4095,443,1444,271,615,714,2059
315420,202304,1870,4832,1365,3952,343,1069,344,823,687,1892
315430,202304,4347,9897,3025,7954,526,1546,1373,3388,1899,4934
315440,202304,1261,2926,993,2521,104,297,615,1428,719,1725
315445,202304,2816,5441,2097,4486,119,243,1655,3495,1774,3738
315450,202304,2665,6546,2165,5745,208,595,1433,3601,1641,4196
315460,202304,60340,142071,51272,127155,4917,14839,34209,77610,39126,92449
315470,202304,823,2094,589,1573,53,156,287,672,340,828
315480,202304,1925,4759,1388,3674,193,545,677,1602,870,2147
315490,202304,3505,8100,2454,6453,408,1164,911,2171,1319,3335
315500,202304,644,1574,412,1105,22,56,246,592,268,648
315510,202304,1699,3689,1386,3242,18,84,1175,2566,1193,2650
315520,202304,1352,3017,1147,2720,44,106,955,2190,999,2296
315530,202304,1012,2223,862,1985,60,179,671,1415,731,1594
315540,202304,2072,4935,1356,3639,132,439,599,1424,731,1863
315550,202304,2214,5584,1564,4423,273,912,517,1397,790,2309
315560,202304,8105,21053,7011,19191,521,1338,5063,13701,5584,15039
315570,202304,3113,7125,2203,5545,339,1043,1154,2437,1493,3480
315580,202304,4115,8536,3214,7211,400,1030,1521,3038,1921,4068
315590,202304,1607,2970,1351,2605,40,148,1129,1961,1169,2109
315600,202304,3020,8227,2115,6523,546,1646,804,2604,1350,4250
315610,202304,1218,2777,901,2241,114,368,477,993,591,1361
315620,202304,647,1565,480,1310,33,104,258,692,291,796
315630,202304,1515,3658,1164,3002,174,482,562,1310,736,1792
315640,202304,501,1108,395,977,31,83,261,610,292,693
315645,202304,1154,2782,837,2300,160,473,274,680,434,1153
315650,202304,2247,4473,1819,3888,89,192,1459,3035,1548,3227
315660,202304,2493,5946,1865,4847,243,645,1008,2514,1251,3159
315670,202304,20935,49780,16522,42068,2941,7988,8274,19472,11215,27460
315680,202304,3844,9617,2882,7952,416,1277,1479,3831,1895,5108
315690,202304,4829,11080,3007,8036,629,1640,842,2356,1471,3996
315700,202304,10781,25938,8280,21228,770,2250,4836,11268,5606,13518
315710,202304,2124,4643,1529,3788,86,232,1012,2345,1098,2577
315720,202304,5529,13312,4549,11680,211,742,3275,7828,3486,8570
315725,202304,2861,6503,2268,5633,242,579,1487,3820,1729,4399
315727,202304,770,1785,568,1466,69,209,294,692,363,901
315730,202304,730,1991,611,1765,134,401,228,582,362,983
315733,202304,1846,4229,1468,3650,239,635,695,1579,934,2214
315737,202304,1424,3472,1037,2750,33,109,732,1831,765,1940
315740,202304,1047,2648,860,2283,78,248,581,1409,659,1657
315750,202304,1583,3594,1201,3059,95,234,762,1963,857,2197
315760,202304,1481,3016,1207,2663,29,89,1006,2130,1035,2219
315765,202304,2505,5243,2074,4711,27,97,1882,4241,1909,4338
315770,202304,1496,3821,1223,3449,408,1242,320,903,728,2145
315780,202304,39862,96809,33632,85891,2345,7208,22370,52961,24715,60169
315790,202304,4230,11914,3592,10749,324,958,2110,6616,2434,7574
315800,202304,1634,4713,1260,3888,160,609,576,1501,736,2110
315810,202304,1735,3651,1424,3176,57,164,1149,2441,1206,2605
315820,202304,3653,7858,2972,6970,298,656,2088,4854,2386,5510
315830,202304,1523,4148,1038,3073,118,391,290,671,408,1062
315840,202304,1069,2358,768,1874,64,170,409,877,473,1047
315850,202304,1434,3702,1134,3210,173,532,593,1590,766,2122
315860,202304,683,1728,519,1462,101,316,174,407,275,723
315870,202304,550,1388,444,1224,28,88,314,818,342,906
315880,202304,1402,3124,1021,2504,118,345,526,1082,644,1427
315890,202304,2205,5551,1812,5035,596,1856,630,1673,1226,3529
315895,202304,7928,19678,5935,16002,710,2186,2766,6666,3476,8852
315900,202304,1070,2596,899,2362,147,416,496,1218,643,1634
315910,202304,777,1743,679,1608,47,138,554,1280,601,1418
315920,202304,1602,3776,969,2614,153,538,382,842,535,1380
315930,202304,1412,2835,997,2280,69,169,601,1293,670,1462
315935,202304,1420,3742,1134,3222,204,612,525,1443,729,2055
315940,202304,724,1751,577,1543,81,240,309,765,390,1005
315950,202304,1560,3749,1344,3416,147,403,989,2503,1136,2906
315960,202304,6618,17217,4546,13132,996,3176,891,1831,1887,5007
315970,202304,684,1709,561,1546,77,229,361,983,438,1212
315980,202304,5247,10687,3164,7355,548,1381,1601,3303,2149,4684
315990,202304,4254,10008,3335,8454,500,1337,1717,4014,2217,5351
316000,202304,979,2064,776,1782,68,197,500,1042,568,1239
316010,202304,826,2194,641,1842,99,295,267,626,366,921
316020,202304,1129,2806,923,2448,87,283,595,1472,682,1755
316030,202304,3312,8089,2532,6765,376,1041,1457,3934,1833,4975
316040,202304,3204,8579,2226,6737,378,1301,596,1465,974,2766
316045,202304,2777,5668,2558,5397,172,258,2222,4792,2394,5050
316050,202304,521,1235,388,1016,34,93,240,560,274,653
316060,202304,879,1846,644,1539,29,90,472,1059,501,1149
316070,202304,7459,18022,6093,15523,1008,2587,3020,7217,4028,9804
316080,202304,1021,2764,808,2351,163,511,333,865,496,1376
316090,202304,641,1550,539,1360,44,137,338,756,382,893
316095,202304,1512,4282,1118,3357,262,850,371,993,633,1843
316100,202304,3017,7726,2187,6054,352,1138,948,2304,1300,3442
316105,202304,874,2070,678,1759,52,134,426,1119,478,1253
316110,202304,18453,42774,15352,37862,910,2824,11526,26746,12436,29570
316120,202304,1515,3774,988,2717,159,492,335,728,494,1220
316130,202304,1543,3173,1033,2371,96,264,623,1279,719,1543
316140,202304,1283,3191,792,2265,143,418,276,729,419,1147
316150,202304,2707,5655,2120,4775,165,461,1245,2557,1410,3018
316160,202304,1190,2821,959,2437,39,145,694,1683,733,1828
316165,202304,1073,2308,860,2019,87,222,571,1266,658,1488
316170,202304,1796,3616,1422,3100,67,198,1082,2179,1149,2377
316180,202304,1993,5114,1371,3912,270,826,450,1102,720,1928
316190,202304,3306,8673,1919,5510,228,714,846,2028,1074,2742
316200,202304,4713,11504,3811,10057,566,1737,1999,4777,2565,6514
316210,202304,7085,18844,5151,14619,1635,4986,536,1307,2171,6293
316220,202304,890,2490,625,1997,127,431,121,360,248,791
316225,202304,2003,4077,1516,3340,58,207,1177,2352,1235,2559
316230,202304,616,1447,482,1235,112,313,241,578,353,891
316240,202304,6838,17370,5952,15785,434,1268,4410,11272,4844,12540
316245,202304,3865,10723,3429,10021,203,873,2531,6900,2734,7773
316250,202304,14421,31510,11060,26106,1962,5023,4828,10690,6790,15713
316255,202304,3538,9265,3036,8424,199,568,2180,6044,2379,6612
316257,202304,1942,3973,1471,3274,148,309,1043,2253,1191,2562
316260,202304,3339,6598,2635,5571,273,529,1725,3579,1998,4108
316265,202304,1315,3202,1032,2734,27,72,738,1873,765,1945
316270,202304,4684,12648,3964,11191,528,1635,2223,5760,2751,7395
316280,202304,3737,8913,3094,7797,372,996,1761,4218,2133,5214
316290,202304,5050,12139,3900,10048,494,1342,1655,3835,2149,5177
316292,202304,7761,18573,6324,16348,728,2136,4146,10085,4874,12221
316294,202304,1168,3206,890,2726,186,658,275,724,461,1382
316295,202304,4590,11429,3788,10108,304,992,2480,6106,2784,7098
316300,202304,1365,3182,1098,2816,58,177,820,1999,878,2176
316310,202304,888,2344,675,1931,147,484,209,528,356,1012
316320,202304,825,2130,635,1844,114,368,133,338,247,706
316330,202304,1289,2965,1004,2519,55,159,766,1859,821,2018
316340,202304,1246,2998,995,2557,94,307,631,1459,725,1766
316350,202304,1776,4110,1525,3702,163,417,1095,2544,1258,2961
316360,202304,793,1894,656,1687,74,191,485,1273,559,1464
316370,202304,7601,17400,5804,14409,664,2055,3179,6701,3843,8756
316380,202304,2154,4474,1764,3941,97,201,1323,2892,1420,3093
316390,202304,910,2268,675,1880,248,785,146,330,394,1115
316400,202304,1523,3966,975,2910,120,392,331,841,451,1233
316410,202304,1535,3444,1292,3070,35,109,1084,2475,1119,2584
316420,202304,2302,5582,1922,5042,40,148,1544,3886,1584,4034
316430,202304,1124,2684,781,2112,133,414,326,780,459,1194
316440,202304,1037,2978,828,2632,161,571,218,637,379,1208
316443,202304,695,1773,487,1382,105,355,166,417,271,772
316447,202304,2728,5888,2316,5290,32,94,2064,4592,2096,4686
316450,202304,2517,6636,1883,5402,241,745,1080,2963,1321,3708
316460,202304,1712,4067,1419,3616,119,345,920,2172,1039,2517
316470,202304,9328,23973,7099,19736,1036,3249,3172,7653,4208,10902
316480,202304,279,639,234,584,32,93,134,300,166,393
316490,202304,413,1071,293,854,51,175,96,228,147,403
316500,202304,1685,4651,1176,3526,219,711,351,901,570,1612
316510,202304,975,2836,798,2507,131,419,379,1173,510,1592
316520,202304,1672,3707,1236,2952,202,527,492,1001,694,1528
316530,202304,1468,3299,1113,2700,94,331,695,1461,789,1792
316540,202304,1351,3035,1077,2665,188,546,472,1030,660,1576
316550,202304,1828,4389,1547,3926,57,182,1287,3174,1344,3356
316553,202304,6187,16125,4587,12675,621,1954,2172,5103,2793,7057
316555,202304,3292,8477,2843,7905,95,357,2397,6543,2492,6900
316556,202304,664,1429,506,1160,34,78,298,581,332,659
316557,202304,1502,4074,1288,3735,437,1382,500,1345,937,2727
316560,202304,501,1404,348,1109,59,215,88,234,147,449
316570,202304,1791,4521,1467,3977,369,907,458,1360,827,2267
316580,202304,457,962,300,701,38,99,127,259,165,358
316590,202304,1582,3589,1094,2705,122,271,661,1520,783,1791
316600,202304,1238,3156,1084,2874,167,508,675,1632,842,2140
316610,202304,762,1987,610,1739,60,185,376,1015,436,1200
316620,202304,2864,6325,2465,5748,179,391,1936,4446,2115,4837
316630,202304,1823,5018,1580,4570,462,1310,604,1966,1066,3276
316640,202304,219,539,171,453,36,108,68,155,104,263
316650,202304,1412,3491,1147,3090,87,240,776,2007,863,2247
316660,202304,199,472,107,279,11,31,41,89,52,120
316670,202304,1993,4587,1490,3841,405,1103,471,1078,876,2181
316680,202304,2890,6834,2186,5538,196,545,1446,3519,1642,4064
316690,202304,1639,4390,1180,3501,214,687,204,435,418,1122
316695,202304,1164,3091,934,2704,22,76,638,1770,660,1846
316700,202304,651,1110,562,1013,16,37,504,880,520,917
316710,202304,4400,11875,3571,10289,427,1461,2073,5395,2500,6856
316720,202304,29012,70440,23032,59765,3408,9853,12117,28570,15525,38423
316730,202304,683,1473,547,1271,59,150,318,656,377,806
316740,202304,1075,2624,948,2449,155,442,633,1597,788,2039
316750,202304,505,1275,380,1069,75,226,168,433,243,659
316760,202304,4914,13519,4159,12189,1387,4629,1585,4433,2972,9062
316770,202304,1899,3822,1420,3191,47,125,1118,2501,1165,2626
316780,202304,744,1993,602,1746,207,680,112,225,319,905
316790,202304,894,2208,665,1786,115,336,187,469,302,805
316800,202304,8319,20709,6641,17927,931,2717,3302,8380,4233,11097
316805,202304,1516,2748,1246,2436,30,83,1074,2031,1104,2114
316810,202304,937,2292,743,1963,83,238,532,1373,615,1611
316820,202304,481,942,297,654,16,53,201,390,217,443
316830,202304,1129,2564,865,2146,96,255,530,1252,626,1507
316840,202304,3707,8137,3021,7110,136,415,2407,5365,2543,5780
316850,202304,2886,6282,2195,5178,193,551,1438,3084,1631,3635
316860,202304,29724,65486,23068,55746,3059,8795,12565,28039,15624,36834
316870,202304,11241,26738,8596,22029,984,2976,4758,10743,5742,13719
316880,202304,1466,3393,1248,3098,161,459,768,1748,929,2207
316890,202304,1393,2975,907,2363,119,392,561,1338,680,1730
316900,202304,3360,7894,2702,6752,433,1199,1306,2878,1739,4077
316905,202304,594,1616,482,1413,230,684,108,336,338,1020
316910,202304,1273,3031,879,2381,218,640,212,512,430,1152
316920,202304,2500,5081,1930,4278,193,557,1373,2722,1566,3279
316930,202304,12053,30237,9615,26206,2019,6077,3940,9601,5959,15678
316935,202304,5571,13229,4186,10809,715,2065,1968,4537,2683,6602
316940,202304,7650,20218,6143,17419,1106,3422,2734,6818,3840,10240
316950,202304,2498,4953,1966,4259,90,196,1660,3497,1750,3693
316960,202304,6799,13275,4986,10984,391,958,3623,7724,4014,8682
316970,202304,5338,12812,4443,11339,645,1816,2238,5116,2883,6932
316980,202304,1129,2862,854,2421,239,751,346,887,585,1638
316990,202304,16602,40042,12577,32426,3017,8313,3081,6686,6098,14999
317000,202304,3319,7960,2924,7465,156,361,2409,6131,2565,6492
317005,202304,3181,8075,2497,6759,424,1272,1258,3129,1682,4401
317010,202304,37531,81794,27232,66348,4101,11229,15293,34859,19394,46088
317020,202304,95930,212445,63052,157383,12299,33575,23346,51436,35645,85011
317030,202304,813,1974,654,1747,15,53,483,1246,498,1299
317040,202304,14312,33290,9839,25961,2543,7256,2474,6483,5017,13739
317043,202304,1189,2264,890,1884,36,75,720,1507,756,1582
317047,202304,1363,2913,969,2298,50,138,691,1547,741,1685
317050,202304,1447,4225,1046,3290,176,601,367,915,543,1516
317052,202304,3004,7045,2391,6128,234,687,1601,3849,1835,4536
317057,202304,2832,5232,2199,4349,36,115,1845,3421,1881,3536
317060,202304,595,1492,355,1022,71,218,115,297,186,515
317065,202304,1327,3487,1117,3075,76,263,728,1799,804,2062
317070,202304,10677,27336,8658,23672,1331,4293,4289,10433,5620,14726
317075,202304,1377,3098,1099,2683,177,447,642,1453,819,1900
317080,202304,8379,17792,6418,14708,1235,3044,3132,6825,4367,9869
317090,202304,5827,14668,5078,13527,406,1000,3694,9799,4100,10799
317100,202304,3207,7084,2200,5517,467,1253,936,2144,1403,3397
317103,202304,3096,6465,2632,5843,155,422,2146,4550,2301,4972
317107,202304,1816,4190,1364,3384,53,168,920,1954,973,2122
317110,202304,829,1791,488,1264,89,261,203,478,292,739
317115,202304,1379,3520,1134,3107,154,461,658,1758,812,2219
317120,202304,24984,57975,20734,51299,1555,4724,13869,31575,15424,36299
317130,202304,14107,30611,10151,24148,1442,3787,4255,9554,5697,13341
317140,202304,1180,2561,893,2116,89,218,600,1380,689,1598
317150,202304,1309,2630,1007,2234,24,82,876,1856,900,1938
317160,202304,4083,9224,2659,6900,281,697,1295,3551,1576,4248
317170,202304,2534,5712,2005,4796,88,270,1405,2981,1493,3251
317180,202304,2227,6328,1634,5012,311,1002,322,896,633,1898
317190,202304,1308,3282,978,2739,186,572,462,1189,648,1761
317200,202304,8108,19802,6081,15964,1320,3628,1507,3457,2827,7085
317210,202304,1530,3220,1190,2779,44,144,856,1946,900,2090
317220,202304,416,1031,363,954,64,201,215,499,279,700
320010,202304,5919,16083,4480,13184,788,2598,1961,5506,2749,8104
320013,202304,2570,6364,1807,4950,327,975,813,2205,1140,3180
320016,202304,3516,8357,2718,7108,245,669,1772,4509,2017,5178
320020,202304,6240,14162,4830,11797,670,1943,2698,6061,3368,8004
320030,202304,2265,5645,1496,4126,222,692,680,1642,902,2334
320035,202304,2441,5852,2030,5193,343,1027,1186,2878,1529,3905
320040,202304,5718,14456,4778,12871,678,1959,2602,6517,3280,8476
320050,202304,2321,4743,2005,4304,196,567,1379,2661,1575,3228
320060,202304,19009,47007,14136,37808,2633,7561,6248,15139,8881,22700
320070,202304,2444,5814,1874,4788,206,668,1025,2264,1231,2932
320080,202304,7055,16467,5026,12679,859,2327,2239,5054,3098,7381
320090,202304,10373,25679,7071,19321,1469,4423,2513,5988,3982,10411
320100,202304,4415,10073,3657,8849,466,1348,2331,5293,2797,6641
320110,202304,3091,6241,2242,5008,284,737,1407,2786,1691,3523
320115,202304,2739,7874,2348,7218,824,2643,786,2484,1610,5127
320120,202304,34304,78156,25223,62875,3367,9328,12976,29193,16343,38521
320130,202304,77183,180624,63609,158084,8001,22042,38972,90586,46973,112628
320140,202304,5265,12819,3903,10247,619,1905,1888,4408,2507,6313
320150,202304,18555,43736,13296,34631,3191,9439,2198,4333,5389,13772
320160,202304,8346,20559,6215,16823,863,2640,3192,8079,4055,10719
320170,202304,2283,5881,1642,4688,446,1309,513,1552,959,2861
320180,202304,912,2648,707,2239,227,808,145,395,372,1203
320190,202304,4002,11401,2945,9197,625,2189,581,1529,1206,3718
320200,202304,1671,4248,1144,3289,244,765,308,852,552,1617
320210,202304,5774,13275,4504,11201,728,1962,2395,5478,3123,7440
320220,202304,4715,10731,3533,8829,724,1889,1554,3580,2278,5469
320225,202304,1935,5426,1311,4075,366,1274,295,852,661,2126
320230,202304,7236,17251,5503,14469,1378,3819,1458,3921,2836,7740
320240,202304,22536,52251,17155,44046,4498,12854,4951,11653,9449,24507
320245,202304,4092,11125,2956,8709,779,2462,335,863,1114,3325
320250,202304,3776,8888,2577,6411,390,1072,1289,2749,1679,3821
320255,202304,2763,7361,2371,6692,362,1116,1574,4386,1936,5502
320260,202304,1789,4671,1167,3433,298,893,291,735,589,1628
320265,202304,2891,8231,2098,6575,730,2511,221,593,951,3104
320270,202304,2839,7202,2138,5926,576,1799,638,1648,1214,3447
320280,202304,11387,25640,9443,22614,1016,2867,6517,14553,7533,17420
320290,202304,1625,4509,1085,3293,270,909,286,796,556,1705
320300,202304,5659,14937,4533,12875,1287,4112,1439,3799,2726,7911
320305,202304,6949,17404,5304,14417,936,2866,2580,6474,3516,9340
320310,202304,2675,6593,1941,5126,350,1039,851,1954,1201,2993
320313,202304,3195,7180,2187,5392,423,1175,817,1649,1240,2824
320316,202304,1958,5096,1473,4287,233,681,777,2265,1010,2946
320320,202304,27663,67535,20550,55833,5173,15050,6538,16991,11711,32041
320330,202304,3573,8605,2817,7378,423,1130,1613,4181,2036,5311
320332,202304,11060,25995,8967,22566,1701,4724,4836,11360,6537,16084
320334,202304,2506,6406,1690,4862,296,1022,399,862,695,1884
320335,202304,2358,6186,1567,4505,317,1075,470,1166,787,2241
320340,202304,7321,15160,6107,13465,437,1096,4339,9246,4776,10342
320350,202304,6742,14672,4791,11380,530,1418,2694,5772,3224,7190
320360,202304,1718,4069,1221,3155,155,435,588,1390,743,1825
320370,202304,3656,9896,2859,8273,779,2585,1018,2635,1797,5220
320380,202304,4008,8692,3400,7726,241,734,2535,5280,2776,6014
320390,202304,10271,24413,7661,19529,1554,4231,3122,7224,4676,11455
320400,202304,4005,10478,2957,8343,835,2594,1043,2705,1878,5299
320405,202304,6791,15732,5167,13034,753,2050,2788,6629,3541,8679
320410,202304,5884,14189,4476,11989,826,2237,2109,5610,2935,7847
320420,202304,5546,12305,4293,10433,981,2599,1730,3953,2711,6552
320425,202304,2720,5773,2098,4798,150,378,1459,3090,1609,3468
320430,202304,3953,9154,3144,7828,429,1141,1928,4543,2357,5684
320435,202304,3030,8508,2468,7390,860,2831,763,2275,1623,5106
320440,202304,1906,4787,1433,3901,258,788,631,1484,889,2272
320450,202304,2764,6622,2237,5728,309,998,1330,2999,1639,3997
320455,202304,5735,16130,4002,12294,935,3252,993,2533,1928,5785
320460,202304,2630,7184,1944,5822,571,1932,536,1387,1107,3319
320465,202304,2031,5224,1458,4142,386,1190,557,1548,943,2738
320470,202304,5533,13378,4117,10743,767,2240,1425,3221,2192,5461
320480,202304,3253,6922,2622,5931,302,738,1803,3853,2105,4591
320490,202304,34341,77691,25702,63553,4855,12128,11419,27616,16274,39744
320495,202304,1771,4419,1287,3503,306,977,201,359,507,1336
320500,202304,90761,210430,73733,182497,8778,24769,46080,105287,54858,130056
320501,202304,6215,16195,4514,13101,1232,3893,1076,2902,2308,6795
320503,202304,3305,8668,2258,6611,628,2030,603,1546,1231,3576
320506,202304,3592,9711,2704,7839,749,2407,644,1546,1393,3953
320510,202304,16031,38021,12628,32397,2040,5353,6516,16068,8556,21421
320515,202304,2307,5821,1700,4612,496,1441,503,1248,999,2689
320517,202304,2876,7678,2341,6648,665,2071,913,2474,1578,4545
320520,202304,63348,143664,50295,122812,7407,20190,25740,58029,33147,78219
320530,202304,47361,107221,38391,92744,2798,8535,26116,57240,28914,65775
330010,202304,37566,81994,31792,73131,2431,6546,23780,51803,26211,58349
330015,202304,2350,4874,1838,4094,241,668,1159,2340,1400,3008
330020,202304,31322,66707,26782,60262,2669,6896,19902,42924,22571,49820
330022,202304,2537,6298,1944,5317,402,1164,755,1971,1157,3135
330023,202304,9710,20356,7878,17659,1080,2715,5091,10640,6171,13355
330025,202304,10273,20837,7233,16147,1131,2807,3583,7230,4714,10037
330030,202304,15732,34916,12596,30151,942,2826,8864,19463,9806,22289
330040,202304,25437,56380,21460,50144,909,2793,16676,36310,17585,39103
330045,202304,146437,275297,126513,251107,5254,11839,108989,210062,114243,221901
330050,202304,4821,10615,3928,9258,602,1767,2496,5179,3098,6946
330060,202304,8369,18521,6219,15052,1140,3202,2539,5444,3679,8646
330070,202304,44846,93250,37969,83945,4464,10692,26216,56276,30680,66968
330080,202304,14847,30224,12728,27378,1601,3505,8983,18935,10584,22440
330090,202304,4556,8455,3392,6935,315,540,2311,4798,2626,5338
330093,202304,4112,8455,3180,7215,212,559,2555,5574,2767,6133
330095,202304,1979,4800,1559,4073,172,518,930,2197,1102,2715
330100,202304,107019,232701,95358,216650,4615,12739,77512,169564,82127,182303
330110,202304,3302,7631,2735,6734,268,798,1916,4368,2184,5166
330115,202304,3879,8210,2754,6484,440,1184,1570,3302,2010,4486
330120,202304,4844,9182,3832,7960,167,439,3082,6036,3249,6475
330130,202304,7858,18061,6588,16227,873,2295,4284,10120,5157,12415
330140,202304,6155,12094,5197,10861,187,557,4456,8858,4643,9415
330150,202304,3621,8180,2891,7067,497,1313,1587,3659,2084,4972
330160,202304,2249,5170,1788,4415,292,874,1054,2284,1346,3158
330170,202304,232140,444526,200713,404287,21524,46644,151916,296898,173440,343542
330180,202304,3159,6115,2624,5397,94,271,2156,4181,2250,4452
330185,202304,17440,33865,15043,30828,491,1386,13143,25855,13634,27241
330187,202304,8425,17431,6681,14799,848,2133,4427,9050,5275,11183
330190,202304,67915,130991,59646,120074,2480,6162,50273,97300,52753,103462
330200,202304,28324,58670,23871,53134,2894,6789,17355,37757,20249,44546
330205,202304,2989,6617,2283,5505,168,484,1554,3442,1722,3926
330210,202304,4555,9804,3373,7953,426,1138,1996,4243,2422,5381
330220,202304,20660,43871,15723,36162,2401,6359,8232,16754,10633,23113
330225,202304,6273,13698,4962,11800,363,1005,3470,7790,3833,8795
330227,202304,29268,57656,25862,53559,523,1499,23443,47089,23966,48588
330230,202304,2500,5282,1688,4176,164,434,794,1919,958,2353
330240,202304,41399,89163,35531,80452,3135,8212,26157,56146,29292,64358
330245,202304,2238,5091,1393,3646,276,805,595,1343,871,2148
330250,202304,69960,140900,60599,128091,6103,14102,45592,93064,51695,107166
330260,202304,9685,19130,7925,16848,422,1074,6431,13149,6853,14223
330270,202304,48003,101611,31779,75849,3942,10609,17121,37398,21063,48007
330280,202304,4040,8467,3224,7230,198,558,2307,4733,2505,5291
330285,202304,45702,86883,38663,77345,1476,3914,32781,62191,34257,66105
330290,202304,6871,13039,5699,11563,301,875,4717,8938,5018,9813
330300,202304,8401,16703,6312,13893,455,1130,4704,9875,5159,11005
330310,202304,3822,7844,2950,6537,133,356,2252,4711,2385,5067
330320,202304,27414,53723,22250,47354,2628,5420,16458,34245,19086,39665
330330,202304,77124,145471,64325,129043,4544,10116,50968,98113,55512,108229
330340,202304,28609,59283,22295,50101,2888,7864,13474,27137,16362,35001
330350,202304,253977,469935,219715,429558,8526,18635,193964,370005,202490,388640
330360,202304,11179,22036,9891,20491,385,760,8747,17838,9132,18598
330370,202304,8187,19191,6556,16633,1167,3323,3356,7890,4523,11213
330380,202304,10555,22514,8672,19466,573,1669,6522,13596,7095,15265
330385,202304,6268,14607,5164,13022,869,2528,2752,6470,3621,8998
330390,202304,53117,114516,42357,97363,3763,10826,29589,61883,33352,72709
330395,202304,5076,10425,4254,9418,145,448,3462,7268,3607,7716
330400,202304,5085,11423,4284,10188,216,714,3298,7221,3514,7935
330410,202304,4813,10314,3701,8584,404,1186,2611,5514,3015,6700
330411,202304,3946,9455,3214,8253,188,615,2248,5331,2436,5946
330412,202304,2464,5681,2063,5091,161,486,1468,3344,1629,3830
330414,202304,35534,76329,29980,68857,2029,5327,23359,51662,25388,56989
330415,202304,6374,15130,4776,12477,474,1375,2825,6906,3299,8281
330420,202304,18441,40596,14115,33926,1487,4178,8600,18765,10087,22943
330430,202304,16114,30245,13941,27447,485,1171,11891,22420,12376,23591
330440,202304,4248,9518,3255,7840,325,936,2245,4951,2570,5887
330450,202304,2070,4910,1648,4239,128,369,1041,2487,1169,2856
330452,202304,30498,64968,25468,57734,2019,5727,19206,40786,21225,46513
330455,202304,1081135,2069530,924086,1859334,88373,194142,695214,1346441,783587,1540583
330460,202304,1731,4037,1363,3508,214,606,743,1847,957,2453
330470,202304,8735,18401,6402,15002,1428,3796,2630,5622,4058,9418
330475,202304,13532,29390,11157,26347,1457,3967,7509,16958,8966,20925
330480,202304,7969,17826,6829,16196,597,1561,4765,10651,5362,12212
330490,202304,174238,341993,147769,307566,12022,26784,113489,228556,125511,255340
330500,202304,12042,25141,10188,22725,614,1552,7973,17165,8587,18717
330510,202304,73127,150690,60067,133301,5127,12892,45952,97513,51079,110405
330513,202304,1829,4022,1481,3566,227,601,835,1934,1062,2535
330515,202304,3963,9132,3220,8084,489,1438,1656,3744,2145,5182
330520,202304,21371,45931,18222,41440,1563,4262,13173,28298,14736,32560
330530,202304,2224,4834,1604,3897,311,828,762,1797,1073,2625
330540,202304,4364,9960,3440,8482,702,1847,1716,3970,2418,5817
330550,202304,28624,55623,20983,44722,2641,6356,13385,26621,16026,32977
330555,202304,31804,54648,27249,49344,983,2069,23560,41850,24543,43919
330560,202304,5619,12384,4620,10863,651,1602,3003,6731,3654,8333
330570,202304,4434,9850,3909,9154,538,1493,2745,6186,3283,7679
330575,202304,9218,19143,8152,17402,309,880,6936,13940,7245,14820
330580,202304,34453,74692,29133,66163,3922,9578,18514,38886,22436,48464
330590,202304,2181,4776,1846,4362,240,551,1203,2859,1443,3410
330600,202304,19221,41876,16077,37105,934,2727,11824,25407,12758,28134
330610,202304,14470,31269,12027,27556,1092,2908,8523,18255,9615,21163
330615,202304,3021,6888,2515,6234,453,998,1602,4118,2055,5116
330620,202304,6420,15085,5259,13254,767,2245,3148,7319,3915,9564
330630,202304,45430,94955,35736,80150,1467,4466,27639,57697,29106,62163
350010,202304,3040,7263,1941,5134,349,1006,510,1071,859,2077
350020,202304,827,2033,522,1457,80,228,183,441,263,669
350030,202304,4977,12226,4009,10649,833,2521,2036,4902,2869,7423
350040,202304,976,2591,617,1844,85,309,200,442,285,751
350050,202304,1987,4461,1370,3470,222,669,466,887,688,1556
350055,202304,1249,2762,1013,2418,146,405,604,1285,750,1690
350060,202304,419,912,223,530,45,117,93,201,138,318
350070,202304,4449,10637,3176,8402,481,1422,1420,3249,1901,4671
350075,202304,865,2257,657,1884,195,579,124,360,319,939
350080,202304,860,2098,576,1564,47,155,303,709,350,864
350090,202304,807,1595,539,1212,70,186,334,672,404,858
350100,202304,3445,7909,2550,6468,152,524,1722,3929,1874,4453
350110,202304,654,1413,492,1148,14,38,361,792,375,830
350115,202304,1416,3875,1183,3431,193,639,569,1447,762,2086
350120,202304,705,1543,396,1036,42,123,192,462,234,585
350130,202304,4467,10660,3578,9116,447,1277,2054,4618,2501,5895
350140,202304,893,2234,643,1795,46,173,378,943,424,1116
350150,202304,587,1647,469,1428,100,340,145,368,245,708
350160,202304,16161,37868,12084,30390,1640,4635,7252,16750,8892,21385
350170,202304,3878,9479,3304,8303,549,1472,1864,4204,2413,5676
350180,202304,1252,2776,804,2021,86,236,449,1024,535,1260
350190,202304,5045,12858,3854,10205,461,1527,2310,5190,2771,6717
350200,202304,721,1687,557,1405,42,117,355,817,397,934
350210,202304,8741,18276,6388,14621,427,1259,4608,9649,5035,10908
350220,202304,4164,10355,3007,8219,548,1648,1330,3158,1878,4806
350230,202304,1492,3339,1177,2918,150,470,710,1634,860,2104
350240,202304,760,2013,462,1339,79,229,122,295,201,524
350250,202304,4750,11701,3660,9997,964,2714,1084,2867,2048,5581
350260,202304,1090,2331,690,1691,88,243,403,883,491,1126
350270,202304,5739,13580,4612,11581,587,1652,2704,6182,3291,7834
350275,202304,4008,9250,3339,8313,221,735,2545,5932,2766,6667
350280,202304,25030,53297,17127,40874,2401,6319,9042,19564,11443,25883
350290,202304,4637,11631,3369,9171,613,1859,1437,3383,2050,5242
350300,202304,903,2044,726,1746,96,267,479,1041,575,1308
350310,202304,1265,3209,987,2706,136,426,477,1164,613,1590
350315,202304,781,1737,553,1401,28,107,337,732,365,839
350320,202304,23026,54181,18018,45601,3014,8615,9212,20759,12226,29374
350330,202304,18211,40847,13954,33284,1201,3369,9691,21263,10892,24632
350335,202304,464,1210,335,967,39,122,142,395,181,517
350340,202304,1738,4215,1120,3020,155,494,539,1259,694,1753
350350,202304,915,2084,735,1889,123,307,432,1114,555,1421
350360,202304,1550,3986,1285,3484,217,660,599,1503,816,2163
350370,202304,933,2083,679,1638,188,443,262,569,450,1012
350380,202304,6294,16119,4698,12880,1067,3074,1674,4139,2741,7213
350390,202304,15531,35973,12179,30510,1572,4431,7497,17189,9069,21620
350395,202304,498,1186,265,752,28,83,92,223,120,306
350400,202304,11428,26191,8308,20997,2089,5774,2669,6133,4758,11907
350410,202304,14443,36657,11088,30601,2161,6585,4524,11409,6685,17994
350420,202304,1551,3690,1108,2897,204,544,373,808,577,1352
350430,202304,852,2053,673,1784,110,352,361,839,471,1191
350440,202304,2783,6187,2216,5312,163,478,1502,3270,1665,3748
350450,202304,9758,24338,7816,21069,1586,4930,3761,8999,5347,13929
350460,202304,3126,7381,2067,5449,312,920,977,2257,1289,3177
350470,202304,337,756,263,646,9,24,196,456,205,480
350480,202304,1188,2801,781,2105,191,575,151,328,342,903
350490,202304,2636,5988,1955,4968,288,856,993,2152,1281,3008
350500,202304,794,1990,569,1599,91,289,225,571,316,860
350510,202304,1595,3617,1235,3020,118,316,778,1753,896,2069
350520,202304,3200,8500,2536,7328,356,1139,1203,3139,1559,4278
350530,202304,4156,9527,3211,7799,243,733,2054,4465,2297,5198
350535,202304,1941,4632,1626,4198,240,685,1030,2531,1270,3216
350540,202304,2658,5288,2045,4440,240,666,1466,2834,1706,3500
350550,202304,13161,29484,9593,23608,986,2890,5789,12732,6775,15622
350560,202304,6207,13891,5275,12502,237,750,4155,9252,4392,10002
350570,202304,42570,104039,35070,91066,5655,16199,19010,45579,24665,61778
350580,202304,2827,6834,1856,5044,543,1598,468,966,1011,2564
350590,202304,6918,16767,5354,13530,680,2011,3349,7591,4029,9602
350600,202304,44152,96934,29099,71644,4570,12952,13861,29946,18431,42898
350610,202304,9676,23760,7345,19343,829,2528,4320,10252,5149,12780
350620,202304,521,1257,347,984,42,131,190,497,232,628
350630,202304,2349,4961,1711,3931,104,295,1232,2571,1336,2866
350635,202304,15514,32812,12213,27925,1249,3182,8679,18689,9928,21871
350640,202304,1145,2885,639,1832,109,328,178,429,287,757
350650,202304,11445,28105,8556,22750,1548,4558,3760,8852,5308,13410
350660,202304,6528,14862,5154,12750,653,1592,3242,7820,3895,9412
350670,202304,2425,5965,1824,4933,314,903,940,2429,1254,3332
350680,202304,1502,3666,1033,2826,144,420,491,1191,635,1611
350690,202304,1909,4530,1425,3697,255,732,728,1755,983,2487
350700,202304,7030,15907,5561,13704,1124,3254,3032,6710,4156,9964
350710,202304,4130,9618,3476,8585,589,1738,1919,4238,2508,5976
350715,202304,895,2398,756,2158,169,559,359,866,528,1425
350720,202304,215,494,153,401,24,69,48,101,72,170
350730,202304,820,2206,636,1856,44,149,356,932,400,1081
350740,202304,2087,5080,1452,3825,236,673,498,1152,734,1825
350745,202304,787,1909,495,1365,41,145,256,631,297,776
350750,202304,15708,37102,12782,32334,2184,6366,6381,14443,8565,20809
350760,202304,24764,53720,19036,44335,2496,7070,11474,23624,13970,30694
350770,202304,1360,3023,913,2281,95,269,572,1305,667,1574
350775,202304,921,1943,624,1503,82,209,338,756,420,965
350780,202304,3022,6752,2237,5697,567,1359,836,2315,1403,3674
350790,202304,2658,6575,1734,4928,400,1168,415,924,815,2092
350800,202304,4592,11560,3918,10469,461,1388,2510,6241,2971,7629
350810,202304,3795,8252,2830,6844,641,1643,1277,2847,1918,4490
350820,202304,1207,2598,766,1808,56,155,485,1034,541,1189
350830,202304,1084,2647,644,1763,112,339,221,467,333,806
350840,202304,4517,12200,3502,10386,682,2247,1496,3938,2178,6185
350850,202304,11290,27615,8990,23621,1454,4200,4978,12085,6432,16285
350860,202304,5291,11999,4580,11033,483,1298,3157,7346,3640,8644
350870,202304,3505,8677,2580,7235,478,1376,1222,3257,1700,4633
350880,202304,2123,5221,1766,4575,454,1265,755,1695,1209,2960
350890,202304,645,1572,428,1147,75,198,142,333,217,531
350900,202304,13066,31041,9674,24472,1445,4088,5439,12279,6884,16367
350910,202304,1239,2603,1037,2320,96,224,776,1691,872,1915
350920,202304,17189,38866,14483,34539,784,2216,11281,25464,12065,27680
350925,202304,5745,13656,4326,11331,696,2129,2380,5416,3076,7545
350930,202304,1849,4468,1283,3411,93,262,700,1754,793,2016
350940,202304,3653,8176,2972,7138,249,714,2176,4849,2425,5563
350945,202304,1235,3102,914,2497,177,503,380,926,557,1429
350950,202304,134633,308407,106468,258407,13328,36166,66019,148109,79347,184275
350960,202304,9822,23378,7739,19597,1172,3393,4099,9272,5271,12665
350970,202304,5210,13162,3903,10832,1012,3237,1284,2742,2296,5979
350980,202304,1024,2321,855,2050,121,342,549,1192,670,1534
350990,202304,2867,6699,2283,5807,512,1538,1136,2576,1648,4114
350995,202304,1116,3008,1019,2830,67,246,704,1815,771,2061
351000,202304,3912,9933,2470,7021,527,1616,682,1780,1209,3396
351010,202304,512,1192,317,834,53,163,153,371,206,534
351015,202304,1304,3498,1079,3057,204,654,459,1095,663,1749
351020,202304,10931,26261,8412,21966,1584,4530,4272,10020,5856,14550
351030,202304,4107,10875,3274,9269,616,2003,1557,3991,2173,5994
351040,202304,7766,16363,6502,14473,298,841,5301,11182,5599,12023
351050,202304,23640,53312,18517,45711,3100,8389,10297,23721,13397,32110
351060,202304,67615,152226,53010,128397,4617,13002,37112,84567,41729,97569
351070,202304,1923,4424,1152,3133,303,893,232,531,535,1424
351080,202304,3732,8071,2818,6982,355,1031,1776,4102,2131,5133
351090,202304,434,1082,335,914,63,172,134,348,197,520
351100,202304,3685,9005,2435,6544,459,1374,869,2144,1328,3518
351110,202304,7650,18324,5630,14753,935,2795,2882,6817,3817,9612
351120,202304,1005,2356,665,1727,124,354,232,500,356,854
351130,202304,1494,3928,687,2053,130,428,147,354,277,782
351140,202304,2958,7396,2278,6210,503,1537,939,2208,1442,3745
351150,202304,3836,9872,2734,7716,457,1472,992,2437,1449,3909
351160,202304,1858,5191,1316,3991,250,825,248,609,498,1434
351170,202304,2156,5059,1868,4583,140,438,1351,3035,1491,3473
351190,202304,1272,3280,896,2572,204,615,244,630,448,1245
351200,202304,1976,4554,1479,3820,168,491,875,2053,1043,2544
351210,202304,1922,4293,1316,3284,89,274,840,1885,929,2159
351220,202304,5059,11797,4372,10745,506,1211,2885,6867,3391,8078
351230,202304,2947,6832,2299,5780,427,1202,1082,2347,1509,3549
351240,202304,2991,7414,1660,4672,345,981,293,668,638,1649
351250,202304,1292,3287,765,2200,108,315,253,671,361,986
351260,202304,1027,2357,718,1825,147,370,274,656,421,1026
351270,202304,680,1685,485,1316,57,169,244,543,301,712
351280,202304,5020,12216,3763,9890,874,2417,1388,3317,2262,5734
351290,202304,1977,4289,1371,3294,120,345,996,2243,1116,2588
351300,202304,30463,73736,23035,60482,4174,12013,11438,27511,15612,39524
351310,202304,5152,11276,4037,9486,218,648,2995,6548,3213,7196
351320,202304,1025,2780,722,2200,133,424,186,486,319,910
351330,202304,375,929,240,675,24,81,102,240,126,321
351340,202304,10988,24528,9357,21763,1612,4490,5961,12205,7573,16695
351350,202304,17864,39849,14933,35039,1076,3093,11517,25219,12593,28312
351360,202304,5202,11975,4309,10702,771,2278,2298,5074,3069,7352
351370,202304,2590,6671,1717,4919,401,1248,377,845,778,2093
351380,202304,62539,136072,46072,109388,4733,12657,30124,66769,34857,79426
351385,202304,479,1197,201,589,28,79,86,240,114,319
351390,202304,1865,4163,1328,3441,79,239,1079,2712,1158,2951
351400,202304,1545,3833,1261,3305,245,623,630,1571,875,2194
351410,202304,3440,8556,2623,7056,493,1433,1153,2831,1646,4264
351420,202304,618,1386,388,1008,61,165,221,525,282,690
351430,202304,1334,3034,1110,2694,93,246,808,1845,901,2091
351440,202304,4755,11411,3343,8700,587,1630,1131,2444,1718,4074
351450,202304,2210,5363,1522,4133,298,977,481,1029,779,2006
351460,202304,1345,3147,1113,2799,174,461,679,1616,853,2077
351470,202304,1584,3681,1251,3142,89,256,808,1888,897,2144
351480,202304,3129,8047,2505,7066,449,1437,1215,3120,1664,4557
351490,202304,2973,7340,2578,6665,97,352,2056,5089,2153,5441
351492,202304,477,1109,408,981,8,24,327,742,335,766
351495,202304,288,709,230,605,24,54,136,342,160,396
351500,202304,60062,128067,47588,108797,5975,15246,32111,68325,38086,83571
351510,202304,18529,39980,14017,32633,1514,4013,9238,20174,10752,24187
351512,202304,591,1478,410,1100,77,215,128,304,205,519
351515,202304,4091,9105,2629,6558,534,1415,649,1614,1183,3029
351518,202304,2525,6183,1751,4808,309,955,688,1593,997,2548
351519,202304,768,1969,469,1393,113,371,98,233,211,604
351520,202304,1370,3179,701,1945,70,234,338,825,408,1059
351530,202304,426,1029,273,731,45,121,125,275,170,396
351535,202304,2061,4773,1476,3775,235,650,648,1528,883,2178
351540,202304,3472,7718,2407,5933,255,751,1269,2731,1524,3482
351550,202304,9845,22320,6967,17402,910,2480,3823,8593,4733,11073
351560,202304,692,1851,549,1574,100,313,217,578,317,891
351565,202304,349,860,265,723,40,134,109,248,149,382
351570,202304,31449,73597,25222,62323,2034,5876,17393,40037,19427,45913
351580,202304,277,686,165,489,22,62,59,185,81,247
351590,202304,542,1187,290,756,23,66,152,352,175,418
351600,202304,1655,4114,1287,3417,206,580,591,1399,797,1979
351610,202304,857,1876,554,1368,54,140,306,692,360,832
351620,202304,32060,77997,24298,65547,3686,11561,11597,28093,15283,39654
351630,202304,38815,88747,32007,78095,2646,7655,23069,52664,25715,60319
351640,202304,27471,61696,22388,53501,1520,4431,16460,36709,17980,41140
351650,202304,464,1213,221,672,41,136,45,111,86,247
351660,202304,766,2017,532,1534,93,295,137,336,230,631
351670,202304,8064,20130,5380,14413,1129,2994,2273,5435,3402,8429
351680,202304,526,1362,352,1022,61,164,112,296,173,460
351685,202304,609,1549,483,1356,90,246,196,473,286,719
351690,202304,1502,3553,885,2401,111,365,363,853,474,1218
351700,202304,1758,3941,1308,3209,219,606,728,1599,947,2205
351710,202304,1001,2373,752,1941,63,202,433,962,496,1164
351720,202304,1993,4776,1441,3823,253,689,661,1619,914,2308
351730,202304,1312,2979,1080,2639,83,226,684,1536,767,1762
351740,202304,4223,9678,3459,8416,466,1286,2110,4674,2576,5960
351750,202304,2459,5990,1561,4286,209,612,787,1974,996,2586
351760,202304,4236,10528,3271,8770,593,1876,1514,3561,2107,5437
351770,202304,2691,6455,2189,5586,582,1472,1113,2656,1695,4128
351780,202304,1391,3250,825,2177,106,312,353,850,459,1162
351790,202304,2010,4328,1530,3650,274,621,888,2085,1162,2706
351800,202304,555,1222,290,752,34,93,109,229,143,322
351810,202304,1460,3464,1201,3094,320,940,533,1229,853,2169
351820,202304,4087,9906,3120,8170,640,1873,1242,2793,1882,4666
351830,202304,6734,15232,5185,12761,414,1240,3527,7925,3941,9165
351840,202304,12697,31098,10107,26585,974,2948,6568,15804,7542,18752
351850,202304,1843,4853,1212,3626,208,715,358,836,566,1551
351860,202304,3528,9132,2768,7844,727,2311,1253,3191,1980,5502
351870,202304,37972,86919,30149,74446,5994,15616,14899,35393,20893,51009
351880,202304,232583,507237,186227,433433,25803,72182,120707,255197,146510,327379
351885,202304,1372,3054,1134,2715,47,149,858,1926,905,2075
351890,202304,1031,2489,650,1865,120,390,159,382,279,772
351900,202304,1631,3958,1240,3377,120,330,797,2110,917,2440
351905,202304,805,2109,621,1736,82,248,282,680,364,928
351907,202304,30828,73144,24431,62221,2762,8131,15556,36588,18318,44719
351910,202304,2283,5205,1678,4092,158,469,1015,2125,1173,2594
351920,202304,1142,2716,885,2263,153,432,364,820,517,1252
351925,202304,1283,3106,1017,2652,96,307,600,1418,696,1725
351930,202304,5906,12970,5391,12149,618,1577,4179,8999,4797,10576
351940,202304,1411,3375,1053,2760,198,555,408,1035,606,1590
351950,202304,2119,4131,1629,3474,86,228,1201,2385,1287,2613
351960,202304,7319,16787,5627,14009,1345,3602,2358,5222,3703,8824
351970,202304,14618,34050,12319,30462,1391,4359,8572,19445,9963,23804
351980,202304,1397,3125,911,2321,135,391,411,930,546,1321
351990,202304,1829,3999,1366,3349,64,226,765,1639,829,1865
352000,202304,3631,8851,3114,7866,272,832,2153,5008,2425,5840
352010,202304,3078,7331,2414,6298,702,1887,646,1656,1348,3543
352020,202304,2230,5228,1750,4414,257,759,994,2250,1251,3009
352030,202304,8264,18526,6733,16117,820,2400,4446,9802,5266,12202
352040,202304,5907,13692,4346,10943,751,2118,1777,3891,2528,6009
352042,202304,5003,10635,3574,8508,386,1047,2363,5370,2749,6417
352044,202304,2629,6496,1581,4545,261,854,349,765,610,1619
352050,202304,17746,43601,12463,33613,3582,10419,2785,5957,6367,16376
352060,202304,1002,2390,763,1986,156,429,357,837,513,1266
352070,202304,1189,2343,812,1844,66,179,472,963,538,1142
352080,202304,553,1314,346,933,43,121,123,274,166,395
352090,202304,2022,5269,1681,4662,206,669,888,2162,1094,2831
352100,202304,5026,12804,3916,10790,740,2348,1708,4260,2448,6608
352110,202304,981,2459,735,1986,160,446,320,755,480,1201
352115,202304,618,1578,508,1427,150,486,224,546,374,1032
352120,202304,1083,2800,857,2370,80,231,544,1378,624,1609
352130,202304,2490,6594,1584,4386,214,608,722,1784,936,2392
352140,202304,1773,4361,1331,3494,262,675,559,1399,821,2074
352150,202304,1112,2669,825,2192,113,337,498,1237,611,1574
352160,202304,1223,2781,876,2223,91,265,438,1040,529,1305
352170,202304,3772,9409,2903,7661,496,1524,1347,3059,1843,4583
352180,202304,3566,8909,2790,7590,584,1721,1129,2780,1713,4501
352190,202304,2170,4939,1753,4306,335,874,931,2218,1266,3092
352200,202304,427,1251,311,1008,48,170,115,333,163,503
352210,202304,31985,63720,26039,55844,1399,3533,21181,43520,22580,47053
352215,202304,796,1953,598,1602,107,310,302,767,409,1077
352220,202304,38366,81447,29865,67889,3785,10036,19424,39759,23209,49795
352230,202304,20743,53283,16430,45666,4273,13118,6227,14977,10500,28095
352240,202304,13962,32646,11006,27971,2183,6221,5870,13404,8053,19625
352250,202304,34135,86828,28176,77193,3825,11509,18176,47508,22001,59017
352260,202304,6589,15247,4707,11622,810,2279,2412,5085,3222,7364
352265,202304,1125,2975,991,2786,184,569,526,1382,710,1951
352270,202304,2721,6994,2175,5944,406,1204,948,2328,1354,3532
352280,202304,3113,6845,2382,5776,370,1017,1322,2866,1692,3883
352290,202304,2037,5074,1658,4384,209,625,956,2253,1165,2878
352300,202304,1212,2869,780,2009,84,235,416,961,500,1196
352310,202304,55476,132603,44043,114547,6831,18831,27250,68227,34081,87058
352320,202304,9030,20496,7238,17431,908,2586,4502,9514,5410,12100
352330,202304,3503,7715,2808,6762,264,841,1913,4176,2177,5017
352340,202304,10531,25216,8106,20850,1284,3788,4320,9844,5604,13632
352350,202304,3350,8051,2751,6893,139,407,2024,4812,2163,5219
352360,202304,2011,4682,1627,4030,157,424,1096,2510,1253,2934
352370,202304,1329,3342,1122,2994,54,166,839,2148,893,2314
352380,202304,1256,2939,954,2452,204,555,340,793,544,1348
352390,202304,19114,43828,14020,34889,2113,6071,8274,18606,10387,24677
352400,202304,4911,12759,3829,10725,938,2876,1293,3159,2231,6035
352410,202304,5042,11244,3984,9568,476,1241,2455,5513,2931,6754
352420,202304,1059,2503,759,2005,132,359,314,740,446,1099
352430,202304,11869,25303,9134,20906,1176,3158,5405,11318,6581,14476
352440,202304,25789,63755,20041,53289,4694,13146,7152,17886,11846,31032
352450,202304,1006,2369,580,1654,91,301,243,595,334,896
352460,202304,3513,8764,2610,7214,475,1472,1191,2977,1666,4449
352470,202304,3884,9495,3110,8276,278,890,2000,4854,2278,5744
352480,202304,5971,12995,4111,9839,576,1639,2127,4390,2703,6029
352490,202304,1087,2725,862,2360,173,517,350,894,523,1411
352500,202304,14963,35440,10454,27558,3679,11239,2110,3462,5789,14701
352510,202304,6132,14524,4960,12527,548,1539,3381,8027,3929,9566
352520,202304,3802,9313,2964,7929,538,1643,1595,3782,2133,5425
352530,202304,15709,36460,11339,28692,2406,6949,4200,8621,6606,15570
352540,202304,732,1864,541,1488,73,203,283,707,356,910
352550,202304,1375,3401,929,2626,192,648,339,774,531,1422
352560,202304,849,2018,720,1798,45,150,522,1199,567,1349
352570,202304,2769,7159,1856,5446,456,1559,287,489,743,2048
352580,202304,970,2182,830,1961,108,305,554,1187,662,1492
352585,202304,486,1259,359,1028,37,138,175,416,212,554
352590,202304,16222,39840,12236,32881,2243,6882,6651,16095,8894,22977
352600,202304,2541,6039,2077,5263,266,758,1322,3022,1588,3780
352610,202304,3848,9156,2964,7751,461,1419,1475,3487,1936,4906
352620,202304,7905,17388,6019,14743,1364,3523,2850,6704,4214,10227
352630,202304,1056,2369,799,2024,132,378,386,905,518,1283
352640,202304,4424,10156,3327,8222,301,859,2127,4736,2428,5595
352650,202304,705,1849,461,1346,78,237,170,443,248,680
352660,202304,1446,3707,1190,3243,97,343,797,1973,894,2316
352670,202304,13912,33049,10471,26533,1950,5449,5048,11335,6998,16784
352680,202304,4396,11681,3267,9267,689,2330,1539,3502,2228,5832
352690,202304,34469,79868,27870,69252,1276,3991,20811,48709,22087,52700
352700,202304,1043,2466,794,2065,103,284,406,974,509,1258
352710,202304,7197,17033,5365,13889,1447,4281,2199,4926,3646,9207
352720,202304,13414,30342,11100,26396,1550,4208,6624,14395,8174,18603
352725,202304,655,1434,382,986,17,48,230,532,247,580
352730,202304,5532,15486,4989,14335,683,2224,2421,5803,3104,8027
352740,202304,3048,6836,2315,5778,319,916,1167,2653,1486,3569
352750,202304,523,1220,337,920,37,123,150,353,187,476
352760,202304,1995,4973,1577,4245,214,596,857,2173,1071,2769
352770,202304,1204,2882,850,2258,114,327,455,1119,569,1446
352780,202304,815,2161,561,1634,139,384,155,435,294,819
352790,202304,511,1245,380,994,58,151,157,349,215,500
352800,202304,1700,4648,1203,3592,232,744,241,511,473,1255
352810,202304,1611,3536,1122,2692,189,474,622,1380,811,1854
352820,202304,537,1431,404,1199,85,262,98,245,183,507
352830,202304,677,1619,342,964,38,107,107,262,145,369
352840,202304,4981,12832,4058,11239,939,2848,1774,4591,2713,7439
352850,202304,17697,37594,13337,31023,2336,6246,7611,15839,9947,22085
352860,202304,1501,3792,1135,3140,219,640,419,1071,638,1711
352870,202304,1033,2507,726,1880,84,241,430,1033,514,1274
352880,202304,2090,4666,1514,3677,252,644,634,1342,886,1986
352885,202304,461,1138,363,967,45,151,234,575,279,726
352890,202304,880,1896,610,1386,62,158,404,804,466,962
352900,202304,25547,60728,17847,46471,2982,8113,7216,17267,10198,25380
352910,202304,454,1130,257,747,21,68,105,265,126,333
352920,202304,3558,8271,2796,6989,152,487,2071,4836,2223,5323
352930,202304,7615,18145,5982,14995,943,2794,3053,6559,3996,9353
352940,202304,36217,86924,29558,74166,4323,12066,18043,41930,22366,53996
352950,202304,682,1728,440,1291,88,291,139,335,227,626
352960,202304,913,2264,545,1511,78,235,179,386,257,621
352965,202304,275,724,191,565,42,119,56,154,98,273
352970,202304,5115,9478,4276,8284,123,299,3731,6891,3854,7190
352980,202304,1928,4291,1518,3723,383,1003,795,1841,1178,2844
352990,202304,5790,13450,4434,11304,788,2185,2396,5788,3184,7973
353000,202304,548,1383,304,866,42,132,107,263,149,395
353010,202304,3440,7787,2458,6061,422,1194,1198,2629,1620,3823
353020,202304,4002,9620,2566,6842,392,1210,1045,2487,1437,3697
353030,202304,6147,14565,4326,11521,1045,3004,1260,3063,2305,6067
353040,202304,962,2046,724,1681,78,203,487,1034,565,1237
353050,202304,6710,17246,4909,13690,870,2700,2510,6466,3380,9166
353060,202304,67404,151906,56316,135079,3450,10346,43077,97096,46527,107442
353070,202304,14838,37328,11274,30119,1925,5719,5409,12744,7334,18463
353080,202304,6608,15889,4752,12465,987,2919,1972,4342,2959,7261
353090,202304,740,2019,598,1761,60,199,334,928,394,1127
353100,202304,382,922,163,474,29,95,49,103,78,198
353110,202304,10813,24725,8753,21936,2022,5144,4328,11151,6350,16295
353120,202304,643,1505,496,1278,70,229,254,556,324,785
353130,202304,3965,8655,2758,6582,618,1660,1277,2604,1895,4264
353140,202304,4132,8940,3165,7442,430,1234,1963,4187,2393,5421
353150,202304,2202,5046,1650,4159,333,886,735,1712,1068,2598
353160,202304,799,1919,545,1483,67,204,248,573,315,777
353170,202304,866,2010,679,1746,79,237,392,945,471,1182
353180,202304,12724,29587,10010,24943,2399,6576,4408,9918,6807,16494
353190,202304,4573,11024,3555,9101,444,1287,2046,4725,2490,6012
353200,202304,2218,5531,1464,4103,202,656,597,1460,799,2116
353205,202304,616,1601,520,1397,44,147,306,715,350,862
353210,202304,1169,2294,787,1700,28,72,609,1213,637,1285
353215,202304,482,1195,385,1028,52,160,173,409,225,569
353220,202304,969,2489,676,1916,116,330,215,537,331,867
353230,202304,1069,2734,835,2361,206,661,200,504,406,1165
353240,202304,3273,7709,2741,6925,383,1097,1669,3952,2052,5049
353250,202304,1748,3554,1242,2785,155,370,772,1647,927,2017
353260,202304,1431,3090,820,2127,169,488,333,765,502,1253
353270,202304,1090,2478,883,2130,101,295,551,1185,652,1480
353280,202304,947,2313,709,1938,143,409,260,682,403,1091
353282,202304,2167,5539,1763,4807,167,526,1048,2613,1215,3139
353284,202304,446,1023,253,671,20,62,104,224,124,286
353286,202304,203,499,118,351,25,69,24,57,49,126
353290,202304,1610,3961,931,2593,178,475,239,605,417,1080
353300,202304,2778,6798,2072,5501,372,1107,933,2097,1305,3204
353310,202304,503,1131,393,954,26,81,268,581,294,662
353320,202304,821,2033,668,1775,61,184,392,952,453,1136
353325,202304,1016,2602,749,2079,124,355,346,865,470,1220
353330,202304,805,1845,525,1361,70,194,259,586,329,780
353340,202304,4475,11105,3566,9422,591,1842,1917,4461,2508,6303
353350,202304,5695,12770,4267,10342,1063,2795,1292,2675,2355,5470
353360,202304,908,2296,757,2028,73,247,486,1194,559,1441
353370,202304,773,2029,647,1836,66,210,402,1102,468,1312
353380,202304,390,973,308,828,41,140,178,416,219,556
353390,202304,8436,19413,6362,16098,580,1748,3904,9043,4484,10791
353400,202304,743,1807,585,1538,109,338,261,520,370,858
353410,202304,682,1640,506,1308,152,431,207,444,359,875
353420,202304,622,1475,440,1138,75,207,116,242,191,449
353430,202304,2964,7482,2366,6440,488,1425,1076,2707,1564,4132
353440,202304,104988,250849,80817,204578,10557,30547,49834,114277,60391,144824
353450,202304,488,1142,350,918,44,122,171,411,215,533
353460,202304,4220,10531,3008,8249,619,1943,703,1524,1322,3467
353470,202304,12167,28862,9077,23420,1573,4570,4162,9412,5735,13982
353475,202304,2050,4743,1400,3584,165,494,703,1535,868,2029
353480,202304,2061,4713,1730,4237,108,328,1248,2846,1356,3174
353490,202304,1372,3265,1030,2687,128,357,556,1313,684,1670
353500,202304,1589,3543,1169,2877,254,694,587,1308,841,2002
353510,202304,1311,3392,968,2660,172,501,388,899,560,1400
353520,202304,1340,3219,877,2422,143,433,351,801,494,1234
353530,202304,3288,7563,2710,6593,309,877,1717,3787,2026,4664
353540,202304,2864,6848,2356,6098,407,1147,1363,3301,1770,4448
353550,202304,8145,18138,6558,15608,983,2513,3979,8735,4962,11248
353560,202304,3004,7326,2393,6440,699,2069,827,1846,1526,3915
353570,202304,807,2026,526,1504,93,297,194,478,287,775
353580,202304,3159,7529,2525,6412,468,1173,1385,3366,1853,4539
353590,202304,923,2158,700,1818,113,297,372,905,485,1202
353600,202304,1961,4668,1441,3778,197,569,704,1726,901,2295
353610,202304,1029,2735,783,2239,125,401,351,895,476,1296
353620,202304,3853,9072,2793,7417,662,1862,870,1996,1532,3858
353625,202304,786,1803,453,1210,52,175,245,586,297,761
353630,202304,2055,5412,1757,4856,247,759,1010,2515,1257,3274
353640,202304,1824,4287,1410,3582,189,487,899,2158,1088,2645
353650,202304,9027,22615,7209,19488,1031,3093,4063,10099,5094,13192
353657,202304,466,1164,357,993,36,120,159,402,195,522
353660,202304,1760,3365,1251,2711,168,410,859,1758,1027,2168
353670,202304,5741,14255,4497,11934,855,2660,2112,4872,2967,7532
353680,202304,909,2109,680,1790,106,313,393,958,499,1271
353690,202304,527,1368,255,752,29,85,67,161,96,246
353700,202304,2871,6560,2358,5783,215,573,1591,3705,1806,4278
353710,202304,5386,11612,4140,9623,686,1624,2290,4628,2976,6252
353715,202304,524,1325,316,902,25,87,135,333,160,420
353720,202304,2500,5952,1950,5108,404,1158,868,2145,1272,3303
353730,202304,6697,15607,5320,13282,718,2143,3270,7414,3988,9557
353740,202304,2799,6677,2106,5482,393,1120,980,2263,1373,3383
353750,202304,1154,3189,871,2680,227,736,197,561,424,1297
353760,202304,19700,39200,15510,33852,2874,6958,8823,18360,11697,25318
353770,202304,812,2167,449,1386,62,237,62,150,124,387
353780,202304,9106,21245,7514,18488,1269,3527,4305,9758,5574,13285
353790,202304,3715,10108,2809,8336,646,2121,612,1448,1258,3569
353800,202304,24710,58094,20442,51637,2900,7834,12501,29924,15401,37758
353810,202304,1594,3848,1141,2949,193,507,469,1137,662,1644
353820,202304,2335,5672,1650,4438,475,1298,443,1023,918,2321
353830,202304,765,1782,582,1511,82,244,306,714,388,958
353850,202304,2019,4939,1575,4171,283,777,724,1752,1007,2529
353860,202304,3685,8897,2843,7529,668,2103,1331,2952,1999,5055
353870,202304,39682,95269,29493,76672,4440,12640,14313,33068,18753,45708
353880,202304,3951,9666,3221,8347,229,739,2141,5067,2370,5806
353890,202304,4265,8088,2970,6210,214,545,2112,3932,2326,4477
353900,202304,936,2414,713,1993,95,301,299,734,394,1035
353910,202304,4160,9630,3570,8758,277,791,2638,6234,2915,7025
353920,202304,2601,6463,1902,5214,559,1701,437,893,996,2594
353930,202304,7253,17145,5284,13508,999,2846,2335,5176,3334,8022
353940,202304,1700,4461,1228,3537,212,669,480,1197,692,1866
353950,202304,4529,10940,3487,9098,966,2756,1083,2465,2049,5221
353960,202304,948,2317,656,1798,168,456,118,293,286,749
353970,202304,888,1831,705,1572,63,174,529,1104,592,1278
353980,202304,23298,51418,18323,43467,797,2502,14233,31498,15030,34000
353990,202304,1257,2750,922,2210,165,439,527,1157,692,1596
354000,202304,3227,7356,1938,4968,330,909,763,1687,1093,2596
354010,202304,417,1006,319,852,56,185,185,457,241,642
354020,202304,5265,12381,4184,10420,829,2264,1921,4193,2750,6457
354025,202304,887,2275,600,1719,104,341,155,370,259,711
354030,202304,651,1384,359,901,57,150,169,378,226,528
354040,202304,980,2043,672,1597,46,136,468,1018,514,1154
354050,202304,1356,3529,961,2864,191,634,370,1032,561,1666
354060,202304,5465,13517,4095,10732,629,1891,2135,4850,2764,6741
354070,202304,5383,12445,3805,9514,638,1767,1775,3834,2413,5601
354075,202304,3733,9283,3067,8186,544,1648,1771,4268,2315,5916
354080,202304,1913,4868,1347,3811,192,577,631,1586,823,2163
354085,202304,523,977,412,839,2,7,309,577,311,584
354090,202304,2236,5521,1933,4916,108,320,1493,3586,1601,3906
354100,202304,32411,79411,24196,65899,4709,14183,11710,29433,16419,43616
354105,202304,1469,3487,1068,2797,155,485,546,1255,701,1740
354110,202304,591,1508,464,1292,83,264,206,529,289,793
354120,202304,1799,4468,1220,3271,241,704,453,1020,694,1724
354130,202304,7699,18300,5365,13963,1494,4053,1263,2715,2757,6768
354140,202304,24915,57849,18746,46732,2713,7653,9976,21962,12689,29615
354150,202304,3550,7793,2814,6713,737,1795,870,2029,1607,3824
354160,202304,3562,9206,2966,8151,697,2063,1305,3286,2002,5349
354165,202304,947,2456,760,2104,83,308,484,1184,567,1492
354170,202304,2587,6457,2085,5580,328,1007,997,2299,1325,3306
354180,202304,558,1432,438,1190,41,124,247,608,288,732
354190,202304,1961,5068,1428,4028,89,315,797,2055,886,2370
354200,202304,1163,2622,879,2173,103,301,541,1205,644,1506
354210,202304,1391,3287,1100,2810,105,312,693,1593,798,1905
354220,202304,4034,9671,3055,7872,592,1650,1371,3205,1963,4855
354230,202304,1016,2281,826,2045,43,131,616,1465,659,1596
354240,202304,2372,6066,1666,4641,314,927,636,1506,950,2433
354250,202304,816,1934,562,1513,139,362,199,496,338,858
354260,202304,11872,26973,9397,23011,1446,3865,4770,10882,6216,14747
354270,202304,1265,3349,1051,2962,167,501,521,1295,688,1796
354280,202304,1038,2299,858,2027,46,141,633,1342,679,1483
354290,202304,1243,3498,1028,3073,146,471,578,1645,724,2116
354300,202304,4332,11451,3626,10219,954,2732,1660,4472,2614,7204
354310,202304,1045,2651,902,2421,140,429,542,1349,682,1778
354320,202304,1172,2601,793,2004,132,355,382,809,514,1164
354323,202304,563,1252,368,913,50,134,186,414,236,548
354325,202304,1691,4776,1050,3269,193,609,170,446,363,1055
354330,202304,13123,29826,9602,23280,1149,3145,5827,12815,6976,15960
354340,202304,54895,125741,41526,103624,6262,17184,23504,54994,29766,72178
354350,202304,1484,3366,1211,2927,140,448,780,1653,920,2101
354360,202304,820,1788,527,1352,125,336,182,422,307,758
354370,202304,1266,3193,1044,2859,162,478,624,1607,786,2085
354380,202304,673,1666,497,1386,73,259,191,450,264,709
354390,202304,20151,44448,14464,34877,2096,5654,8114,17685,10210,23339
354400,202304,2056,5982,1605,5001,289,964,515,1493,804,2457
354410,202304,9417,21218,7417,17819,1111,3048,4335,9432,5446,12480
354420,202304,1826,4402,1309,3438,183,536,667,1544,850,2080
354425,202304,3718,8159,2748,6558,481,1212,1512,3404,1993,4616
354430,202304,2270,5267,1777,4507,157,471,1157,2702,1314,3173
354440,202304,756,1813,515,1348,62,181,268,619,330,800
354450,202304,633,1581,360,1060,49,153,123,282,172,435
354460,202304,1002,2392,669,1829,180,563,185,412,365,975
354470,202304,497,1255,308,877,27,95,109,243,136,338
354480,202304,1762,3693,1217,2825,91,259,810,1712,901,1971
354490,202304,1020,2757,783,2261,164,472,348,920,512,1392
354500,202304,3007,7440,2381,6418,628,1822,831,2008,1459,3830
354510,202304,940,2406,753,2073,85,272,410,981,495,1253
354515,202304,566,1501,384,1124,74,220,122,319,196,539
354520,202304,10800,26443,8136,21174,1055,3168,4702,10929,5757,14097
354530,202304,6800,16696,5524,14419,1427,3760,2165,5301,3592,9061
354540,202304,1589,3830,1174,3124,204,595,531,1301,735,1896
354550,202304,714,1802,579,1559,77,233,296,708,373,941
354560,202304,2760,6175,1549,4014,171,457,888,2084,1059,2541
354570,202304,1141,2704,516,1452,99,288,74,185,173,473
354580,202304,11011,27508,7833,21567,1178,3662,4210,10594,5388,14256
354600,202304,2634,6495,2043,5410,337,911,1106,2766,1443,3677
354610,202304,575,1445,314,909,33,101,143,374,176,475
354620,202304,622,1644,389,1187,39,140,182,505,221,645
354625,202304,380,998,226,701,30,101,69,188,99,289
354630,202304,3260,8341,2749,7444,823,2297,820,1994,1643,4291
354640,202304,5129,12677,4031,10619,496,1568,2235,5242,2731,6810
354650,202304,1114,2635,905,2299,217,507,429,1049,646,1556
354660,202304,4509,9920,2719,7103,360,1110,1176,2695,1536,3805
354670,202304,1518,3824,1095,2992,234,709,373,855,607,1564
354680,202304,8467,18977,6816,16435,1090,2871,4083,9299,5173,12170
354690,202304,672,1883,488,1498,77,244,193,527,270,771
354700,202304,1177,2813,855,2205,110,318,481,1128,591,1446
354710,202304,604,1481,403,1101,46,132,186,442,232,574
354720,202304,386,857,199,519,67,161,57,138,124,299
354730,202304,14925,38820,11937,33343,1742,5348,7029,18420,8771,23768
354740,202304,381,984,175,520,40,121,27,60,67,181
354750,202304,3139,7534,2179,5726,341,1021,958,2158,1299,3179
354760,202304,2910,6966,2149,5660,449,1303,821,1875,1270,3178
354765,202304,432,1094,203,603,19,69,68,155,87,224
354770,202304,3169,7243,2391,5857,495,1324,1105,2413,1600,3737
354780,202304,85448,187811,67702,155471,4471,12754,49426,103439,53897,116193
354790,202304,1173,2961,903,2535,80,252,548,1458,628,1710
354800,202304,3561,8412,2630,6850,598,1687,1022,2339,1620,4026
354805,202304,1843,3947,1392,3316,107,287,964,2076,1071,2363
354810,202304,670,1879,413,1349,82,310,114,322,196,632
354820,202304,1211,3236,864,2583,180,564,249,612,429,1176
354830,202304,681,1543,398,1032,89,265,144,297,233,562
354840,202304,1067,2597,649,1721,49,154,364,850,413,1004
354850,202304,30521,68537,22800,55889,1984,5981,15658,35077,17642,41058
354860,202304,1950,4864,1339,3716,194,611,571,1400,765,2011
354870,202304,93126,208305,74144,175294,5805,16343,51484,111413,57289,127756
354880,202304,8267,19185,4823,12210,625,1827,2278,4561,2903,6388
354890,202304,24867,55661,20120,47674,2502,6998,12106,26500,14608,33498
354900,202304,470,1117,313,861,79,233,105,247,184,480
354910,202304,7898,19214,5104,14309,1111,3350,1537,3675,2648,7025
354920,202304,603,1536,322,973,48,162,74,171,122,333
354925,202304,338,906,193,609,22,65,39,108,61,173
354930,202304,442,1026,307,786,35,96,163,366,198,462
354940,202304,3499,9306,2726,7684,770,2319,1040,2495,1810,4814
354950,202304,2023,4515,1692,4096,117,370,1225,2746,1342,3116
354960,202304,1057,2585,763,2110,87,302,361,876,448,1178
354970,202304,5731,14099,4591,12272,359,1231,3226,8059,3585,9290
354980,202304,47903,104683,34564,82673,3879,11091,22594,48928,26473,60019
354990,202304,106134,235918,78628,188593,5289,15784,54673,119415,59962,135199
354995,202304,4500,8425,3546,7207,165,403,2891,5633,3056,6036
355000,202304,1924,4395,1469,3709,236,707,746,1660,982,2367
355010,202304,5307,13111,3642,9731,1203,3141,856,2150,2059,5291
355020,202304,4086,10943,3255,9556,800,2647,1232,3159,2032,5806
355030,202304,1780003,4023000,1361946,3262895,187609,503522,771880,1670649,959489,2174171
355040,202304,4710,10061,3715,8758,393,1037,2745,6202,3138,7239
355050,202304,1412,2967,1035,2451,267,653,369,796,636,1449
355060,202304,9105,22180,6999,18506,1107,3381,3848,9200,4955,12581
355070,202304,14648,32925,12277,29276,1402,3947,8187,17928,9589,21875
355080,202304,1251,3260,809,2470,196,632,136,339,332,971
355090,202304,1783,4399,1454,3855,255,745,783,1871,1038,2616
355100,202304,42734,96266,36161,86655,3748,10306,26024,59036,29772,69342
355110,202304,1234,3116,890,2622,169,521,60,141,229,662
355120,202304,916,2217,649,1824,83,267,315,809,398,1076
355130,202304,1085,2178,637,1404,26,69,459,901,485,970
355140,202304,3019,5525,2609,4980,82,206,2299,4225,2381,4431
355150,202304,6549,15102,5419,13246,614,1707,3564,8167,4178,9874
355160,202304,3116,7689,2240,6222,502,1489,684,1694,1186,3183
355170,202304,16189,36720,12968,31517,2042,5600,7528,16992,9570,22592
355180,202304,3704,8473,2802,7159,563,1692,1415,3239,1978,4931
355190,202304,2409,5879,1922,5128,788,2210,487,1367,1275,3577
355200,202304,1133,3112,967,2856,273,934,344,913,617,1847
355210,202304,4184,10289,3253,8433,838,2224,1266,3025,2104,5249
355220,202304,72235,168765,59741,146315,7728,21993,36262,80052,43990,102045
355230,202304,1562,3704,858,2321,153,442,337,758,490,1200
355240,202304,32799,79377,24324,63811,2660,7902,15022,36318,17682,44220
355250,202304,54894,130914,43108,109073,9155,24872,21617,49930,30772,74802
355255,202304,791,1872,439,1241,46,133,169,425,215,558
355260,202304,2024,4299,1527,3551,122,368,1066,2262,1188,2630
355270,202304,1599,4237,1303,3697,341,973,515,1360,856,2333
355280,202304,43906,99868,33108,81215,4063,11121,19472,43901,23535,55022
355290,202304,1211,2948,965,2560,204,529,465,1142,669,1671
355300,202304,1837,4795,1532,4243,270,818,695,1691,965,2509
355310,202304,1151,2845,868,2365,117,344,486,1241,603,1585
355320,202304,696,1724,533,1419,112,346,218,469,330,815
355330,202304,4003,9157,3199,7811,163,491,2432,5547,2595,6038
355340,202304,5324,11047,4086,9460,825,2007,1836,4348,2661,6355
355350,202304,1781,4536,1399,3841,269,852,634,1547,903,2399
355360,202304,1651,3818,1288,3272,168,477,737,1661,905,2138
355365,202304,435,994,229,653,38,107,76,185,114,292
355370,202304,7453,17163,5930,14838,1320,2997,2838,7306,4158,10303
355380,202304,3890,9403,2980,7805,576,1669,1130,2508,1706,4177
355385,202304,1787,4211,1457,3718,125,379,924,2133,1049,2512
355390,202304,1011,2568,749,2054,116,344,359,847,475,1191
355395,202304,2267,6047,1633,4799,276,917,649,1627,925,2544
355400,202304,12746,32698,10463,28460,2233,6893,4592,10977,6825,17870
355410,202304,32214,81053,22575,61910,4364,13302,9091,22450,13455,35752
355420,202304,754,2206,627,1974,135,481,199,577,334,1058
355430,202304,4755,11000,3780,9340,630,1741,2101,4875,2731,6616
355440,202304,886,2215,567,1599,92,269,139,332,231,601
355450,202304,4755,11180,3371,8635,462,1312,1716,3820,2178,5132
355460,202304,592,1378,413,1088,43,131,188,455,231,586
355465,202304,557,1302,448,1137,66,165,277,687,343,852
355470,202304,1403,3329,858,2296,236,702,305,716,541,1418
355475,202304,428,934,351,833,22,62,257,572,279,634
355480,202304,5528,13948,4409,12246,654,2085,2701,7131,3355,9216
355490,202304,1111,2815,656,1917,74,245,297,768,371,1013
355495,202304,1197,2912,887,2424,118,407,423,1001,541,1408
355500,202304,9208,21404,6343,16210,845,2532,3051,6747,3896,9279
355510,202304,1765,4096,1202,3138,206,565,540,1247,746,1812
355520,202304,378,863,188,535,35,109,34,89,69,198
355530,202304,378,813,168,426,11,35,94,210,105,245
355535,202304,683,1709,548,1493,115,366,264,602,379,968
355540,202304,17880,38717,15247,35176,1520,3912,11196,24722,12716,28634
355550,202304,838,2245,728,2053,88,288,427,1082,515,1370
355560,202304,1410,3450,810,2311,176,566,33,99,209,665
355570,202304,374,914,209,570,50,149,73,176,123,325
355580,202304,1475,3393,876,2313,165,459,178,423,343,882
355590,202304,207,508,156,428,13,40,88,223,101,263
355600,202304,1690,4020,1113,3000,171,498,314,727,485,1225
355610,202304,2589,5902,1781,4527,295,806,962,2197,1257,3003
355620,202304,6563,15831,5146,13269,560,1800,3120,7151,3680,8951
355630,202304,3407,8267,2482,6575,294,842,1495,3593,1789,4435
355635,202304,1251,3314,914,2660,135,417,332,851,467,1268
355640,202304,4480,11469,3030,8753,807,2358,476,1367,1283,3725
355645,202304,4733,12187,3490,9991,526,1701,1855,4918,2381,6619
355650,202304,10566,25314,8682,22144,1686,4557,4437,10357,6123,14914
355660,202304,1676,4170,1090,3154,165,487,181,452,346,939
355670,202304,5857,14152,4328,11034,567,1748,2232,4797,2799,6545
355680,202304,3183,8385,1718,5153,453,1490,132,339,585,1829
355690,202304,898,2437,623,1930,196,625,14,25,210,650
355695,202304,321,818,201,581,20,65,39,77,59,142
355700,202304,11581,28786,9885,25482,1219,3618,6171,14563,7390,18181
355710,202304,13380,29379,9495,22409,1331,3668,5073,10188,6404,13856
355715,202304,589,1513,345,981,91,262,82,210,173,472
355720,202304,1862,4579,1473,3941,254,752,792,1925,1046,2677
355730,202304,1381,3374,1118,2958,99,306,664,1607,763,1913
410010,202304,1492,3894,1141,3178,248,723,252,600,500,1323
410020,202304,1396,3645,1031,2910,292,808,253,650,545,1458
410030,202304,2165,5183,1807,4658,272,735,944,2366,1216,3101
410040,202304,19117,47869,14296,39247,3077,9105,4623,11377,7700,20482
410045,202304,884,2259,656,1796,139,387,174,413,313,800
410050,202304,2609,6436,1932,5306,343,1056,626,1523,969,2579
410060,202304,2509,6537,2038,5711,542,1696,584,1434,1126,3130
410070,202304,2442,5753,1782,4607,333,945,687,1534,1020,2479
410080,202304,1684,4209,1218,3430,268,775,263,658,531,1433
410090,202304,1415,3111,1137,2725,207,469,461,1206,668,1675
410100,202304,2589,6816,1757,5032,287,909,114,286,401,1195
410105,202304,709,1589,480,1182,26,81,289,604,315,685
410110,202304,3938,8912,2922,7213,376,1053,1616,3585,1992,4638
410115,202304,657,1618,482,1306,64,201,180,401,244,602
410120,202304,4154,9638,3626,8845,631,1450,2299,5540,2930,6990
410130,202304,1647,3909,1465,3607,186,490,915,2163,1101,2653
410140,202304,21998,50048,14975,38055,2846,7892,4986,11206,7832,19098
410150,202304,19605,44035,11331,28792,1918,5435,3936,8357,5854,13792
410160,202304,3656,9580,2982,8407,688,2196,1050,2693,1738,4889
410165,202304,757,1927,587,1575,89,268,286,697,375,965
410170,202304,3657,8818,2236,5906,397,1119,428,929,825,2048
410180,202304,22336,56680,17609,47631,3071,9200,8542,20406,11613,29606
410185,202304,571,1522,424,1192,79,244,162,386,241,630
410190,202304,2738,6433,1941,5058,395,1066,453,991,848,2057
410200,202304,7139,15220,4047,10173,859,2299,771,1658,1630,3957
410210,202304,3831,9121,2424,6686,369,1162,798,1804,1167,2966
410220,202304,741,1824,472,1262,101,286,171,392,272,678
410230,202304,2547,6293,1910,5077,306,913,787,1752,1093,2665
410240,202304,6252,15529,4407,12189,885,2880,708,1615,1593,4495
410250,202304,2825,6403,2073,5242,264,678,924,2225,1188,2903
410260,202304,2438,5563,1587,4047,330,895,785,1784,1115,2679
410270,202304,613,1513,444,1214,58,189,189,431,247,620
410275,202304,716,1852,493,1403,87,288,192,478,279,766
410280,202304,2856,7005,1964,5350,276,857,863,2031,1139,2888
410290,202304,4020,10320,2806,7942,999,2791,642,1760,1641,4551
410300,202304,819,1909,662,1659,75,235,348,744,423,979
410302,202304,399,946,251,693,30,93,111,279,141,372
410304,202304,1841,3985,1566,3573,181,439,943,2129,1124,2568
410305,202304,2113,4663,1509,3799,174,487,981,2317,1155,2804
410310,202304,3993,9154,3306,8021,253,813,2271,5046,2524,5859
410315,202304,861,1858,590,1450,157,404,189,434,346,838
410320,202304,1132,3025,744,2268,90,304,106,277,196,581
410322,202304,751,1927,383,1083,48,145,124,272,172,417
410330,202304,1762,4041,1254,3159,214,545,414,924,628,1469
410335,202304,1013,2544,763,2102,141,404,250,613,391,1017
410337,202304,960,2294,672,1745,84,237,238,521,322,758
410340,202304,544,1424,372,1026,25,84,155,319,180,403
410345,202304,3396,8331,2192,5923,530,1471,813,1934,1343,3405
410347,202304,951,2306,714,1906,109,294,189,483,298,777
410350,202304,2042,4636,1449,3717,142,424,822,1843,964,2267
410360,202304,4834,11585,3583,9431,686,1914,1042,2532,1728,4446
410370,202304,18195,45601,12101,31897,1436,4371,5299,11475,6735,15846
410380,202304,2203,5000,1484,3757,194,545,522,1149,716,1694
410390,202304,3472,7660,2408,5995,499,1518,1003,2059,1502,3577
410395,202304,1078,2860,845,2423,188,537,299,870,487,1407
410400,202304,10167,23014,7887,19105,831,2369,5069,11041,5900,13410
410405,202304,1126,2454,774,1955,106,307,389,892,495,1199
410410,202304,1997,4718,1743,4317,133,384,1162,2824,1295,3208
410420,202304,15884,38792,12158,31939,2023,5893,5604,12900,7627,18793
410425,202304,4787,12038,3347,9244,606,1765,1205,2939,1811,4704
410430,202304,16752,38772,11975,30559,1864,5302,4802,10853,6666,16155
410440,202304,3000,7688,2599,6982,408,1244,1435,3570,1843,4814
410442,202304,3071,8273,2427,6997,670,2005,560,1515,1230,3520
410445,202304,2736,7209,1874,5562,409,1352,223,691,632,2043
410450,202304,1942,4486,1444,3762,271,738,463,1100,734,1838
410460,202304,3177,7182,2267,5662,329,921,1098,2375,1427,3296
410465,202304,3748,9869,2841,8215,631,1878,780,1902,1411,3780
410470,202304,3005,7626,2151,6211,707,2318,154,402,861,2720
410480,202304,51440,116156,30394,81043,4528,13657,9396,20919,13924,34576
410490,202304,14793,37113,10906,29501,1814,5390,5069,12091,6883,17481
410500,202304,2217,5323,1459,3927,277,756,288,575,565,1331
410510,202304,2177,5072,1568,4040,338,864,495,1214,833,2078
410520,202304,3786,10621,3376,9892,1093,3437,1265,3542,2358,6979
410530,202304,1825,4273,900,2429,124,377,251,518,375,895
410540,202304,3487,8623,2479,6737,430,1318,1086,2609,1516,3927
410550,202304,9563,23890,6710,18122,1136,3479,2084,4552,3220,8031
410560,202304,1857,4489,1373,3566,293,858,377,788,670,1646
410570,202304,3364,8247,2362,6557,855,2731,219,531,1074,3262
410580,202304,38232,89444,29082,73736,4525,12871,15128,34673,19653,47544
410590,202304,2118,5466,1433,3962,201,592,391,851,592,1443
410600,202304,2264,5424,1783,4559,367,958,697,1675,1064,2633
410610,202304,846,1997,639,1636,61,177,333,749,394,926
410620,202304,3616,8889,2607,6855,650,1842,724,1631,1374,3473
410630,202304,3068,7354,2067,5504,422,1340,453,885,875,2225
410640,202304,6365,13968,4434,10722,1009,2649,731,1704,1740,4353
410645,202304,1764,3996,1476,3653,133,370,1150,2821,1283,3191
410650,202304,3246,8119,2238,6150,463,1357,893,2167,1356,3524
410655,202304,1046,2379,701,1790,95,287,276,593,371,880
410657,202304,696,1777,459,1292,59,182,189,424,248,606
410660,202304,4626,10728,2874,7259,454,1252,1070,2306,1524,3558
410670,202304,1218,2885,746,2003,126,351,262,588,388,939
410680,202304,2925,8141,2000,5968,531,1589,443,1293,974,2882
410685,202304,642,1556,459,1235,117,345,186,443,303,788
410690,202304,180693,410251,129406,319422,20407,57646,57308,121367,77715,179013
410700,202304,2998,7159,2467,6360,594,1626,899,2105,1493,3731
410710,202304,1105,2639,713,1917,188,558,264,589,452,1147
410712,202304,798,2034,663,1798,105,299,354,919,459,1218
410715,202304,1052,2806,673,2004,80,275,288,767,368,1042
410720,202304,4860,11141,3990,9749,564,1722,1492,3324,2056,5046
410725,202304,1432,3294,895,2360,198,571,196,402,394,973
410730,202304,1086,2572,721,1893,101,327,159,391,260,718
410740,202304,1029,2734,790,2297,60,210,422,1203,482,1413
410750,202304,2451,5469,1917,4579,307,752,877,1931,1184,2683
410752,202304,488,1127,257,699,97,250,49,117,146,367
410753,202304,422,1124,300,888,47,153,86,211,133,364
410754,202304,1400,3203,1147,2845,88,224,839,2075,927,2299
410755,202304,652,1566,483,1276,58,172,232,530,290,702
410760,202304,4451,10834,3120,8499,838,2740,758,1832,1596,4572
410765,202304,23699,58643,18940,50225,3922,11627,6470,14450,10392,26077
410770,202304,1234,2773,850,2152,90,206,411,1012,501,1218
410773,202304,1621,3875,1372,3475,281,776,727,1668,1008,2444
410775,202304,2070,4228,1826,3914,44,110,1442,2911,1486,3021
410780,202304,726,1724,511,1337,91,255,159,377,250,632
410785,202304,984,2198,708,1768,109,320,317,729,426,1049
410790,202304,1361,3676,1114,3234,226,729,168,391,394,1120
410800,202304,4272,8458,3447,7323,64,189,2404,4795,2468,4984
410810,202304,550,1368,405,1108,43,141,200,477,243,618
410820,202304,1219,3163,694,1905,154,442,138,288,292,730
410830,202304,58556,126852,42516,101044,6614,18147,21699,45995,28313,64142
410832,202304,1361,3324,1105,2897,105,322,680,1617,785,1939
410840,202304,11368,26671,6684,17949,1391,4153,1724,3448,3115,7601
410845,202304,1479,3154,1182,2749,130,354,750,1602,880,1956
410850,202304,2646,6751,2271,6119,450,1370,1050,2570,1500,3940
410855,202304,853,2014,537,1416,62,196,254,547,316,743
410860,202304,6106,13119,4873,11172,202,652,3525,7349,3727,8001
410865,202304,1757,4536,1490,4079,211,618,826,2308,1037,2926
410870,202304,1441,3553,1134,3021,149,430,618,1557,767,1987
410880,202304,5906,14577,4010,11257,712,1982,620,1812,1332,3794
410890,202304,1461,3643,1181,3139,231,597,555,1381,786,1978
410895,202304,1201,3485,993,3042,336,1160,239,607,575,1767
410900,202304,1033,2616,687,2003,104,323,137,282,241,605
410910,202304,535,1163,339,822,16,46,193,409,209,455
410920,202304,1146,2520,869,2102,92,264,490,1101,582,1365
410930,202304,2157,5113,1467,3991,361,1106,238,533,599,1639
410940,202304,31675,78329,23482,64217,4739,14663,9534,23363,14273,38026
410950,202304,2440,6149,2179,5741,221,546,1617,4179,1838,4725
410960,202304,10962,24302,7833,19432,2243,6422,2860,6216,5103,12638
410965,202304,1364,3281,849,2325,120,376,352,849,472,1225
410970,202304,5292,13298,3777,10370,933,3051,682,1392,1615,4443
410975,202304,1841,4077,1319,3247,215,574,554,1253,769,1827
410980,202304,9649,22111,6337,16412,675,2024,3186,7235,3861,9259
410990,202304,1862,4022,1292,3199,231,648,621,1444,852,2092
411000,202304,845,2183,593,1728,105,334,185,475,290,809
411005,202304,564,1325,355,930,43,110,140,315,183,425
411007,202304,3131,7620,2300,6221,472,1426,797,1868,1269,3294
411010,202304,5822,15339,4366,12512,1219,3653,830,1953,2049,5606
411020,202304,2867,7371,2371,6574,630,1874,713,1851,1343,3725
411030,202304,843,2001,601,1545,78,215,251,563,329,778
411040,202304,1256,2985,668,1780,130,352,182,400,312,752
411050,202304,2421,7004,1920,6025,403,1405,318,784,721,2189
411060,202304,2850,6979,1882,5093,323,954,651,1419,974,2373
411065,202304,475,1138,289,775,39,118,106,249,145,367
411070,202304,9896,22489,7830,19208,1167,3331,4197,9250,5364,12581
411080,202304,2520,6085,2003,5220,483,1442,622,1428,1105,2870
411090,202304,952,2463,584,1724,85,295,140,326,225,621
411095,202304,2965,6671,1731,4574,253,674,279,592,532,1266
411100,202304,1482,3565,992,2690,139,471,358,867,497,1338
411110,202304,758,1905,358,1064,33,96,29,46,62,142
411120,202304,2099,5025,1671,4331,274,865,824,1870,1098,2735
411125,202304,6792,17842,5949,16412,1743,5050,2111,5707,3854,10757
411130,202304,910,2242,627,1707,173,460,175,483,348,943
411140,202304,2618,7470,2120,6435,537,1716,559,1690,1096,3406
411150,202304,4950,11684,3301,8504,713,1963,318,625,1031,2588
411155,202304,1341,3047,933,2335,127,382,483,976,610,1358
411160,202304,471,1013,303,757,41,112,85,213,126,325
411170,202304,999,2630,734,2107,144,449,312,838,456,1287
411180,202304,6853,15966,5560,13777,794,2289,3136,6929,3930,9218
411190,202304,2726,6508,2095,5429,284,835,976,2197,1260,3032
411200,202304,6261,15416,4855,12980,968,3060,1669,3563,2637,6623
411210,202304,4497,9502,3209,7384,390,1082,1526,3070,1916,4152
411220,202304,1212,2813,840,2173,153,421,313,714,466,1135
411230,202304,1004,2515,751,2040,156,443,227,544,383,987
411240,202304,1888,4190,1364,3363,271,726,471,1041,742,1767
411250,202304,2795,6790,2016,5465,456,1368,546,1271,1002,2639
411260,202304,392,946,252,676,42,141,110,251,152,392
411270,202304,2436,6025,1807,4866,269,807,852,2000,1121,2807
411275,202304,2016,4112,1461,3270,153,436,914,1797,1067,2233
411280,202304,1852,4605,1352,3685,306,901,443,1040,749,1941
411290,202304,1020,2461,684,1819,75,250,355,853,430,1103
411295,202304,1579,3772,1166,3037,217,572,494,1158,711,1730
411300,202304,1201,2899,748,2046,87,258,257,543,344,801
411310,202304,1188,2439,930,2095,166,419,498,1014,664,1433
411320,202304,7296,16679,5563,13747,799,2251,2834,6011,3633,8262
411325,202304,1853,4618,1509,4016,268,740,841,2257,1109,2997
411330,202304,3886,9657,2920,8047,735,2277,850,2123,1585,4400
411340,202304,986,2520,587,1694,85,261,178,444,263,705
411342,202304,1269,2923,682,1777,132,402,258,533,390,935
411345,202304,1474,3412,1083,2743,66,184,731,1771,797,1955
411350,202304,3721,9318,2445,6839,626,1898,316,735,942,2633
411360,202304,945,2124,670,1672,99,297,302,636,401,933
411370,202304,74098,170963,54869,139481,4531,13777,32335,73945,36866,87722
411373,202304,1735,4011,1370,3466,208,585,560,1371,768,1956
411375,202304,1344,3158,906,2366,121,326,330,756,451,1082
411380,202304,1405,3021,954,2198,42,115,633,1313,675,1428
411390,202304,1893,4661,1466,3802,239,712,615,1298,854,2010
411400,202304,2921,6552,2207,5356,247,697,1209,2623,1456,3320
411410,202304,3706,9701,2758,7748,676,2095,681,1609,1357,3704
411420,202304,5155,11931,2782,7649,406,1254,515,963,921,2217
411430,202304,5122,12176,3887,9997,753,2177,1405,3032,2158,5209
411435,202304,533,1334,299,856,48,144,54,116,102,260
411440,202304,3277,8157,2487,6730,590,1695,705,1653,1295,3348
411450,202304,3068,7545,2404,6456,376,1000,1303,3485,1679,4485
411460,202304,5567,13560,3641,10049,533,1726,963,2119,1496,3845
411470,202304,1094,2483,853,2088,82,276,515,1115,597,1391
411480,202304,6893,16752,4953,13235,981,3057,1514,3390,2495,6447
411490,202304,2071,4802,1601,4112,196,589,790,1816,986,2405
411500,202304,1661,4133,1194,3192,220,664,281,557,501,1221
411510,202304,2817,6344,2164,5314,359,1041,612,1412,971,2453
411520,202304,45966,105661,27752,71072,3340,10147,12498,27202,15838,37349
411530,202304,1124,2698,620,1763,90,290,124,307,214,597
411535,202304,628,1752,420,1299,44,145,120,328,164,473
411540,202304,3274,7324,2256,5515,160,426,1430,3278,1590,3704
411545,202304,1049,2805,893,2517,78,243,570,1568,648,1811
411550,202304,853,1978,644,1610,105,277,231,502,336,779
411560,202304,2356,6217,1297,3920,193,599,94,198,287,797
411570,202304,9565,20655,6829,16614,1575,4182,2321,5106,3896,9288
411573,202304,932,2322,762,2033,108,363,427,1003,535,1366
411575,202304,2512,6142,1843,4931,346,994,607,1468,953,2462
411580,202304,5357,12359,3227,8843,452,1381,539,1079,991,2460
411585,202304,711,2005,367,1171,55,166,45,121,100,287
411590,202304,590,1452,435,1153,43,135,241,565,284,700
411600,202304,427,992,282,763,44,115,113,259,157,374
411605,202304,1959,4192,1277,3175,158,455,594,1478,752,1933
411610,202304,3599,7264,2622,5650,67,213,2010,3936,2077,4149
411620,202304,3750,8725,3068,7692,623,1610,1376,3411,1999,5021
411630,202304,1080,2547,707,1876,109,365,311,688,420,1053
411640,202304,551,1383,373,1011,43,122,133,293,176,415
411650,202304,242,655,158,485,27,87,45,113,72,200
411660,202304,1044,2501,730,1916,114,309,252,552,366,861
411670,202304,1892,4147,1281,3109,134,343,734,1612,868,1955
411680,202304,1688,4175,1248,3348,238,694,433,1008,671,1702
411690,202304,4993,11680,3696,9521,800,2086,1179,2976,1979,5062
411695,202304,780,2154,543,1577,41,128,248,656,289,784
411700,202304,1981,4812,1373,3683,316,899,336,794,652,1693
411705,202304,3072,7577,2569,6750,415,1175,1593,4112,2008,5287
411710,202304,2592,6134,1826,4760,379,1055,573,1253,952,2308
411720,202304,1266,2947,884,2264,127,320,299,689,426,1009
411721,202304,1198,2824,870,2246,166,438,256,600,422,1038
411722,202304,1198,3161,718,2078,125,384,257,608,382,992
411725,202304,1560,4155,1015,3095,250,868,225,590,475,1458
411727,202304,1749,4532,1149,3319,229,700,139,252,368,952
411729,202304,714,1734,420,1186,88,292,91,174,179,466
411730,202304,6823,16358,5231,13437,1172,3411,2065,4847,3237,8258
411740,202304,575,1423,327,931,86,222,66,155,152,377
411745,202304,960,2569,670,1965,104,335,134,305,238,640
411750,202304,8242,19766,6133,15918,849,2417,3024,7284,3873,9701
411760,202304,9312,22078,7005,18499,2196,6110,1437,3789,3633,9899
411770,202304,3872,10376,2916,8412,662,2044,646,1603,1308,3647
411780,202304,3162,8151,2635,7272,717,2040,762,2174,1479,4214
411790,202304,3915,8727,2495,6311,332,993,1042,2185,1374,3178
411800,202304,1413,3810,1049,2976,203,631,270,604,473,1235
411810,202304,1874,4531,1375,3599,234,631,498,1148,732,1779
411820,202304,21851,51538,18600,46374,4318,11048,9820,23563,14138,34611
411830,202304,594,1451,401,1073,71,185,61,145,132,330
411840,202304,15896,38627,11188,29580,1709,5033,4328,9698,6037,14731
411845,202304,780,2073,488,1452,84,275,116,287,200,562
411850,202304,10051,23894,7080,18898,1957,5672,1222,2567,3179,8239
411860,202304,918,2393,685,1935,138,391,132,336,270,727
411870,202304,720,1905,525,1510,133,444,109,224,242,668
411880,202304,2971,6507,2130,5191,358,943,948,2069,1306,3012
411885,202304,1275,3194,920,2560,134,416,230,522,364,938
411890,202304,1827,4558,1356,3769,236,722,163,415,399,1137
411900,202304,1041,2646,646,1854,177,535,75,189,252,724
411910,202304,1397,3815,996,3010,193,681,331,855,524,1536
411915,202304,20512,46929,14591,36347,2196,6134,6494,14058,8690,20192
411920,202304,1457,3815,1203,3382,300,944,446,1111,746,2055
411925,202304,596,1450,402,1088,87,241,186,454,273,695
411930,202304,6346,17114,5385,15488,2702,8125,570,1797,3272,9922
411940,202304,4086,10764,3237,9123,789,2305,1150,2864,1939,5169
411950,202304,19998,48413,16856,43466,2023,6141,10657,25490,12680,31631
411960,202304,7346,17870,5821,15129,1143,3289,2291,5213,3434,8502
411965,202304,632,1609,445,1227,73,205,194,474,267,679
411970,202304,1444,2949,1116,2520,225,427,516,1347,741,1774
411980,202304,2081,4468,1548,3674,346,822,699,1561,1045,2383
411990,202304,50110,120495,34394,93284,6255,18809,14409,35252,20664,54061
411995,202304,6362,14149,4876,11941,1404,3871,1484,3295,2888,7166
412000,202304,2431,5028,1786,3986,41,123,1379,2822,1420,2945
412010,202304,751,2072,487,1507,58,207,122,274,180,481
412015,202304,609,1598,495,1387,91,278,242,658,333,936
412020,202304,559,1500,352,1080,52,183,107,285,159,468
412030,202304,764,1987,589,1674,86,245,279,724,365,969
412033,202304,1132,2783,802,2192,94,271,331,787,425,1058
412035,202304,841,2138,531,1574,110,328,219,612,329,940
412040,202304,867,2144,566,1564,90,258,174,377,264,635
412050,202304,1742,4126,1212,3219,326,986,215,514,541,1500
412060,202304,8913,23175,7199,19937,1938,6140,1980,4849,3918,10989
412065,202304,745,1874,530,1465,96,292,143,344,239,636
412070,202304,1651,3857,1263,3169,137,410,621,1303,758,1713
412080,202304,3419,8086,2561,6514,315,904,1389,3002,1704,3906
412085,202304,400,972,168,512,19,71,44,108,63,179
412090,202304,8010,18452,5923,15035,1286,3658,2556,6153,3842,9811
412100,202304,2310,5664,1667,4587,517,1571,358,987,875,2558
412110,202304,1143,2841,700,1971,83,238,210,486,293,724
412120,202304,2888,7318,2242,6221,486,1502,674,1592,1160,3094
412125,202304,963,2530,586,1740,90,250,133,372,223,622
412130,202304,944,2228,630,1660,138,377,133,318,271,695
412135,202304,647,1650,335,986,42,145,136,336,178,481
412140,202304,2430,5568,1735,4386,307,825,421,1009,728,1834
412150,202304,3349,7896,2808,6969,595,1613,1370,2985,1965,4598
412160,202304,1130,3327,548,1771,43,149,35,68,78,217
412170,202304,5752,13940,4801,12510,939,2660,2307,5356,3246,8016
412175,202304,1600,4255,1319,3746,312,927,442,1198,754,2125
412180,202304,2079,5341,1541,4375,236,762,570,1449,806,2211
412190,202304,3886,9215,2764,7247,338,1021,1179,2769,1517,3790
412200,202304,2388,6301,1585,4533,427,1340,315,777,742,2117
412210,202304,792,1801,502,1335,67,208,235,563,302,771
412215,202304,4035,10009,2860,7771,599,1736,1253,3351,1852,5087
412217,202304,1240,2850,1015,2466,12,44,786,1757,798,1801
412220,202304,7577,20306,6049,17529,1404,4113,1474,4073,2878,8186
412230,202304,3438,9110,2639,7671,402,1380,521,1223,923,2603
412240,202304,10118,24736,6755,18485,1262,3799,2151,4923,3413,8722
412250,202304,2356,5689,1700,4504,427,1213,313,650,740,1863
412260,202304,1654,3962,1263,3227,225,593,428,960,653,1553
412265,202304,1294,3033,1021,2611,137,389,632,1494,769,1883
412270,202304,1338,3453,911,2573,122,396,380,906,502,1302
412280,202304,522,1351,395,1127,90,251,85,215,175,466
412290,202304,1282,2972,963,2438,173,468,377,874,550,1342
412300,202304,2249,5298,1666,4357,325,910,531,1195,856,2105
412310,202304,777,2138,561,1701,102,364,154,387,256,751
412320,202304,874,2121,539,1465,52,184,181,447,233,631
412330,202304,1961,4794,1294,3598,248,751,335,848,583,1599
412340,202304,1496,3770,1041,2902,158,484,137,344,295,828
412350,202304,3785,9493,2537,7068,439,1373,706,1628,1145,3001
412360,202304,349,828,265,678,6,21,194,468,200,489
412370,202304,1437,3567,974,2705,195,573,220,562,415,1135
412380,202304,1789,4678,1307,3756,325,1022,71,216,396,1238
412382,202304,614,1430,417,1119,48,165,214,460,262,625
412385,202304,2865,6829,2289,5802,684,1720,784,2039,1468,3759
412390,202304,3026,6929,2350,5822,445,1173,709,1644,1154,2817
412395,202304,920,2308,666,1786,92,246,333,828,425,1074
412400,202304,1145,2745,809,2134,146,412,260,582,406,994
412402,202304,2983,6816,2070,5373,458,1168,618,1563,1076,2731
412405,202304,3706,9385,2480,7180,716,2029,393,1065,1109,3094
412410,202304,8131,19709,6007,16371,1126,3559,2005,4907,3131,8466
412420,202304,636,1502,406,1059,45,125,160,371,205,496
412430,202304,639,1562,357,991,56,149,128,335,184,484
412440,202304,3633,8758,2602,7027,590,1635,772,1996,1362,3631
412450,202304,645,1760,423,1257,53,161,47,90,100,251
412460,202304,1453,3299,1103,2735,210,579,473,1094,683,1673
412470,202304,1922,5462,1599,4809,398,1346,437,1153,835,2499
412480,202304,1732,3959,1182,2915,205,559,474,995,679,1554
412490,202304,1641,3695,1254,3057,80,232,756,1643,836,1875
412500,202304,2521,5855,1865,4715,317,876,616,1330,933,2206
412510,202304,2281,6352,1638,4878,428,1376,255,563,683,1939
412520,202304,1701,4072,1074,2885,205,552,144,333,349,885
412530,202304,862,2171,627,1738,116,320,148,363,264,683
412535,202304,964,2449,577,1674,87,267,67,137,154,404
412540,202304,1233,3062,844,2375,163,573,159,372,322,945
412545,202304,870,2106,584,1568,105,300,198,487,303,787
412550,202304,47390,114896,35340,92561,5135,14992,17119,39493,22254,54485
412555,202304,354,849,237,621,27,95,74,135,101,230
412560,202304,6687,17203,5016,13724,1276,3888,979,2196,2255,6084
412570,202304,5409,12514,3336,8800,601,1816,706,1443,1307,3259
412575,202304,1413,3194,1124,2733,325,770,476,1067,801,1837
412580,202304,1932,4485,1384,3549,133,377,762,1723,895,2100
412590,202304,552,1370,302,851,61,192,44,88,105,280
412600,202304,2116,4933,1692,4174,103,330,1122,2503,1225,2833
412610,202304,1008,2543,735,1989,106,288,310,721,416,1009
412620,202304,1602,3778,1259,3273,249,696,541,1281,790,1977
412625,202304,11800,29343,8064,22345,1622,4868,1354,3039,2976,7907
412627,202304,1337,3540,974,2830,250,818,200,521,450,1339
412630,202304,3289,9069,2320,7065,395,1316,522,1359,917,2675
412635,202304,584,1439,359,1030,56,166,105,245,161,411
412640,202304,1186,3000,702,1991,103,297,127,269,230,566
412650,202304,2043,5214,1621,4388,267,814,635,1495,902,2309
412660,202304,3481,8146,2485,6333,308,883,991,2192,1299,3075
412665,202304,516,1208,384,985,73,198,151,355,224,553
412667,202304,2049,5141,1495,4090,238,751,588,1484,826,2235
412670,202304,1156,2475,805,1935,135,394,348,692,483,1086
412680,202304,2606,6484,1779,5004,220,726,503,1130,723,1856
412690,202304,1413,3357,988,2575,186,543,354,768,540,1311
412700,202304,2160,5305,1828,4755,404,1139,836,1986,1240,3125
412710,202304,6651,17711,4966,14387,858,2732,1334,3015,2192,5747
412720,202304,1625,4328,1320,3732,210,637,395,861,605,1498
412730,202304,3383,8109,2572,6622,412,1247,1178,2635,1590,3882
412740,202304,2467,6397,1712,5000,326,1050,296,782,622,1832
412750,202304,4844,11885,3870,10369,542,1627,2112,5195,2654,6822
412760,202304,3932,9478,3266,8397,646,1897,1752,4133,2398,6030
412770,202304,14979,36859,8716,25118,1125,3538,2147,5044,3272,8582
412780,202304,1575,3763,1134,3000,286,846,347,776,633,1622
412785,202304,2722,5840,1914,4558,272,695,1232,2747,1504,3442
412788,202304,1710,4469,1372,3900,367,1064,490,1285,857,2349
412790,202304,1689,4115,1107,3050,189,609,444,993,633,1602
412795,202304,1464,3527,860,2411,151,431,209,531,360,962
412796,202304,2669,7131,2265,6473,539,1633,661,1696,1200,3329
412800,202304,5249,11360,3879,9036,387,1156,2214,4374,2601,5530
412810,202304,16821,39665,11551,29758,1331,3928,5128,11359,6459,15287
412820,202304,7737,19841,5530,15573,1464,4406,1413,3695,2877,8101
412830,202304,415,1098,321,918,41,114,92,237,133,351
412840,202304,2432,5174,1782,4024,150,432,1153,2277,1303,2709
412850,202304,3364,8121,2548,6852,300,969,1321,3149,1621,4118
412853,202304,1972,4373,1664,3906,221,612,964,1956,1185,2568
412855,202304,1669,4021,884,2433,122,365,194,406,316,771
412860,202304,934,2210,608,1680,111,335,249,596,360,931
412862,202304,785,1886,527,1456,104,289,219,543,323,832
412863,202304,1584,4244,1382,3873,282,911,684,1697,966,2608
412865,202304,784,2035,593,1655,147,429,132,336,279,765
412870,202304,1200,2863,878,2363,265,804,224,563,489,1367
412880,202304,1171,2981,828,2394,179,545,283,737,462,1282
420005,202304,561,1552,331,997,42,128,153,437,195,565
420010,202304,3681,8448,2573,6602,172,484,1880,4749,2052,5233
420020,202304,509,1504,386,1203,76,263,120,289,196,552
420030,202304,161,538,118,426,35,136,26,86,61,222
420040,202304,724,2116,450,1497,77,290,34,85,111,375
420050,202304,961,2265,663,1649,122,340,376,811,498,1151
420055,202304,217,600,133,406,22,76,56,147,78,223
420060,202304,266,699,203,558,30,87,102,258,132,345
420070,202304,1074,2950,851,2505,169,559,455,1246,624,1805
420075,202304,95,257,53,157,8,23,21,47,29,70
420080,202304,513,1420,359,1050,74,225,77,184,151,409
420090,202304,557,1605,365,1166,78,276,92,222,170,498
420100,202304,1846,4134,1506,3593,109,255,1106,2611,1215,2866
420110,202304,374,1107,309,958,51,174,159,466,210,640
420120,202304,836,2189,591,1685,83,260,273,685,356,945
420125,202304,465,1349,310,977,59,195,90,231,149,426
420127,202304,399,1046,188,572,24,84,73,208,97,292
420130,202304,6419,16644,4896,13982,1010,3338,1958,4659,2968,7997
420140,202304,6044,15066,4726,12806,1307,3977,1243,2902,2550,6879
420150,202304,856,2140,673,1842,61,199,370,950,431,1149
420160,202304,257,623,122,346,19,61,44,112,63,173
420165,202304,218,627,144,448,23,86,43,102,66,188
420170,202304,443,1242,362,1057,38,129,198,512,236,641
420180,202304,178,555,103,369,18,84,28,87,46,171
420190,202304,254,711,159,484,31,92,41,114,72,206
420195,202304,2591,6270,2037,5364,441,1351,1034,2451,1475,3802
420200,202304,10421,23197,6983,17035,901,2524,3379,6799,4280,9323
420205,202304,2798,6859,1945,5206,269,809,1014,2498,1283,3307
420207,202304,2875,6896,1933,5163,371,1122,801,1854,1172,2976
420208,202304,448,1220,284,891,99,332,62,142,161,474
420209,202304,220,660,133,419,20,76,65,172,85,248
420210,202304,5869,14116,4318,11408,712,2121,2229,5374,2941,7495
420213,202304,992,2739,801,2325,159,502,306,836,465,1338
420215,202304,302,832,220,652,53,165,65,177,118,342
420220,202304,446,1264,308,969,53,198,123,319,176,517
420230,202304,8048,19715,6366,16635,831,2473,3608,8550,4439,11023
420240,202304,20564,53706,14054,39088,1836,5917,6449,14833,8285,20750
420243,202304,621,1441,504,1231,80,218,322,750,402,968
420245,202304,2669,6250,2078,5244,205,619,1286,2958,1491,3577
420250,202304,869,1893,763,1753,48,154,614,1329,662,1483
420253,202304,561,1311,413,1087,49,138,248,625,297,763
420257,202304,210,516,147,406,30,104,71,188,101,292
420260,202304,1598,3709,1214,3189,95,305,903,2293,998,2598
420270,202304,753,1880,379,995,41,111,176,410,217,521
420280,202304,1989,5291,1579,4434,217,727,763,1926,980,2653
420285,202304,193,536,108,330,19,66,27,62,46,128
420287,202304,569,1235,403,1005,69,189,186,432,255,621
420290,202304,7371,19220,5944,16279,880,2831,3454,8438,4334,11269
420300,202304,10228,27144,6063,17646,1168,3599,1874,4649,3042,8248
420310,202304,1006,2172,606,1514,64,185,286,633,350,818
420315,202304,1127,2918,737,2146,92,303,374,997,466,1300
420320,202304,8654,21774,6643,18589,1918,5744,1974,5098,3892,10842
420325,202304,410,1120,302,899,42,144,112,276,154,420
420330,202304,1378,3814,885,2721,165,534,264,726,429,1260
420340,202304,1620,3823,1262,3191,288,790,543,1185,831,1975
420350,202304,1758,3887,1387,3263,139,358,977,2202,1116,2560
420360,202304,3751,9858,2116,6406,365,1183,188,509,553,1692
420370,202304,1803,4305,1496,3785,115,374,1099,2588,1214,2962
420380,202304,5781,14256,4118,11138,759,2352,1881,4542,2640,6894
420390,202304,1435,3488,1041,2713,184,519,358,649,542,1168
420395,202304,1650,4302,1195,3468,178,566,239,510,417,1076
420400,202304,1521,3770,1106,2988,141,430,617,1538,758,1968
420410,202304,753,1849,547,1439,75,213,303,759,378,972
420415,202304,446,1192,322,909,63,202,145,381,208,583
420417,202304,782,2188,595,1772,139,392,262,821,401,1213
420419,202304,185,603,135,466,47,177,13,47,60,224
420420,202304,20016,49036,14019,37825,3682,11267,4595,10578,8277,21845
420425,202304,793,2100,565,1622,55,174,282,762,337,936
420430,202304,4371,11048,2888,7979,475,1501,1226,2876,1701,4377
420435,202304,445,1121,270,799,62,185,133,381,195,566
420440,202304,1044,2559,716,1872,254,627,207,509,461,1136
420445,202304,287,679,185,495,32,95,59,116,91,211
420450,202304,1123,3069,853,2496,160,550,340,828,500,1378
420455,202304,2708,6100,2027,5069,553,1376,752,1913,1305,3289
420460,202304,13032,31933,10298,27053,1440,4415,5793,13775,7233,18190
420470,202304,856,2196,483,1327,83,265,153,323,236,588
420475,202304,89,233,40,127,7,27,13,38,20,65
420480,202304,7271,17155,4909,13121,919,2611,2062,5207,2981,7818
420490,202304,505,1345,356,997,55,175,159,399,214,574
420500,202304,1694,4370,1151,3379,213,754,531,1393,744,2147
420510,202304,158,451,111,342,19,71,32,66,51,137
420515,202304,169,473,127,375,18,65,41,92,59,157
420517,202304,914,2186,772,1930,97,257,461,1107,558,1364
420519,202304,370,948,272,789,38,117,125,354,163,471
420520,202304,345,907,189,611,26,94,6,13,32,107
420530,202304,943,2791,667,2153,121,450,209,560,330,1010
420535,202304,273,757,107,340,13,44,30,77,43,121
420540,202304,53940,122149,39078,97294,5325,15605,17216,35894,22541,51499
420543,202304,312,854,230,672,37,128,89,221,126,349
420545,202304,2020,5777,1533,4675,304,1032,594,1585,898,2617
420550,202304,5603,13593,3657,10051,627,1874,1491,3754,2118,5628
420555,202304,427,1156,295,885,40,148,151,394,191,542
420560,202304,545,1194,394,987,60,160,215,532,275,692
420570,202304,4100,9696,3120,7973,518,1515,1701,3963,2219,5478
420580,202304,2281,6102,1613,4902,392,1301,463,1295,855,2596
420590,202304,4081,10508,2721,7623,459,1457,835,1871,1294,3328
420600,202304,1781,4473,1474,3917,128,460,981,2381,1109,2841
420610,202304,766,1976,520,1481,114,313,237,639,351,952
420620,202304,1101,2707,787,2173,135,406,304,782,439,1188
420630,202304,1430,4052,1027,3097,167,560,453,1215,620,1775
420640,202304,590,1585,308,972,65,207,16,33,81,240
420650,202304,4737,11610,3280,8727,488,1471,1462,3206,1950,4677
420660,202304,576,1419,355,960,62,176,65,143,127,319
420665,202304,911,2208,621,1692,123,386,260,571,383,957
420670,202304,1525,4191,896,2785,98,359,172,393,270,752
420675,202304,272,677,178,520,14,55,109,289,123,344
420680,202304,327,715,189,522,18,75,111,265,129,340
420690,202304,1223,3332,820,2403,132,403,275,666,407,1069
420700,202304,4223,10400,3328,8835,274,852,2276,5685,2550,6537
420710,202304,1430,3869,1188,3358,163,550,669,1630,832,2180
420720,202304,1712,4342,1318,3624,207,647,786,1974,993,2621
420730,202304,4799,11645,3777,9929,687,2065,1852,4355,2539,6420
420740,202304,513,1439,310,969,77,271,72,191,149,462
420750,202304,2873,7930,2014,5967,343,1207,769,1969,1112,3176
420757,202304,141,361,72,225,10,32,34,101,44,133
420760,202304,463,1268,252,723,45,131,78,177,123,308
420765,202304,741,2023,386,1167,64,219,185,525,249,744
420768,202304,1794,4535,1490,3981,197,517,1034,2734,1231,3251
420770,202304,288,833,129,457,13,59,18,33,31,92
420775,202304,369,951,231,692,45,147,84,219,129,366
420780,202304,1251,3351,787,2298,156,445,133,348,289,793
420785,202304,286,704,207,542,12,35,100,200,112,235
420790,202304,1426,3795,1124,3166,214,760,642,1555,856,2315
420800,202304,974,2240,644,1641,172,455,322,766,494,1221
420810,202304,1869,5155,1551,4538,369,1274,724,1812,1093,3086
420820,202304,18636,44420,14229,37316,2065,6029,7479,17948,9544,23977
420830,202304,6690,16326,5064,13493,945,2842,2153,5251,3098,8093
420840,202304,759,2282,421,1431,75,286,41,114,116,400
420845,202304,3871,9344,2751,7432,536,1744,1211,2960,1747,4704
420850,202304,1329,3845,967,2957,183,641,328,787,511,1428
420860,202304,468,1205,299,892,91,284,79,200,170,484
420870,202304,1013,2699,703,2065,146,463,235,620,381,1083
420880,202304,1551,4332,1259,3773,286,974,504,1326,790,2300
420890,202304,10081,26126,6498,18751,978,3158,2206,5312,3184,8470
420895,202304,246,685,159,470,24,73,73,194,97,267
420900,202304,2139,5070,1314,3609,177,599,574,1288,751,1887
420910,202304,46877,116385,33601,92309,5303,16793,15247,35798,20550,52591
420915,202304,580,1952,470,1684,86,338,220,774,306,1112
420917,202304,601,1463,294,749,48,101,156,389,204,490
420920,202304,112,291,48,147,7,30,7,12,14,42
420930,202304,23926,55980,18097,45975,2508,7435,10140,23095,12648,30530
420940,202304,4780,11085,3210,8458,668,2029,970,1935,1638,3964
420945,202304,257,776,144,447,21,80,61,160,82,240
420950,202304,516,1370,348,1005,60,202,109,261,169,463
420960,202304,1402,3302,1022,2677,169,507,442,999,611,1506
420970,202304,2843,7237,1971,5628,407,1197,596,1727,1003,2924
420980,202304,309,1007,249,860,77,282,42,121,119,403
420985,202304,474,1251,275,843,55,179,67,169,122,348
420990,202304,463,1321,297,931,54,179,62,150,116,329
421000,202304,736,2126,502,1593,111,375,97,241,208,616
421003,202304,517,1265,184,542,15,38,15,38,30,76
421005,202304,137,388,97,296,14,44,38,118,52,162
421010,202304,4918,12167,3621,9840,621,2027,1481,3226,2102,5253
421020,202304,499,1495,404,1293,61,233,210,612,271,845
421030,202304,1345,3522,1040,2915,216,670,399,997,615,1667
421040,202304,844,1985,522,1441,59,183,317,809,376,992
421050,202304,1575,4100,1056,2901,181,562,381,809,562,1371
421055,202304,180,508,122,373,19,68,56,147,75,215
421060,202304,932,2517,679,1965,129,421,303,748,432,1169
421070,202304,859,2358,537,1579,104,328,241,622,345,950
421080,202304,647,1775,509,1507,84,299,212,552,296,851
421085,202304,397,1099,184,601,18,55,28,73,46,128
421090,202304,386,963,229,620,16,59,104,227,120,286
421100,202304,1088,2334,518,1416,79,228,117,269,196,497
421105,202304,1999,5040,1455,4019,298,880,546,1396,844,2276
421110,202304,1665,3922,1407,3556,134,420,922,2229,1056,2649
421120,202304,1417,4018,1029,3189,138,483,354,916,492,1399
421125,202304,506,1215,367,920,86,231,149,329,235,560
421130,202304,8690,22711,7343,20121,1397,4245,3871,9768,5268,14013
421140,202304,454,1189,311,905,78,227,113,295,191,522
421145,202304,478,1262,349,996,97,305,98,223,195,528
421150,202304,980,2618,691,1991,124,401,290,689,414,1090
421160,202304,847,2197,675,1854,90,292,414,1022,504,1314
421165,202304,294,828,183,536,30,93,58,135,88,228
421170,202304,1573,3870,1366,3554,119,329,1014,2587,1133,2916
421175,202304,1370,3454,842,2501,172,570,332,913,504,1483
421180,202304,501,1238,298,832,38,130,154,352,192,482
421185,202304,400,973,289,758,50,140,137,301,187,441
421187,202304,303,918,189,631,36,111,66,224,102,335
421189,202304,508,1366,388,1134,70,241,149,367,219,608
421190,202304,19041,47777,14620,39229,2503,7739,6934,16225,9437,23964
421200,202304,1026,2596,792,2140,103,335,448,1132,551,1467
421205,202304,313,793,248,683,56,153,96,259,152,412
421210,202304,1390,3373,787,2295,186,526,234,636,420,1162
421220,202304,1779,4833,1405,4085,362,1144,456,1184,818,2328
421223,202304,536,1308,371,1014,68,216,203,509,271,725
421225,202304,1396,3637,1225,3367,131,446,842,2229,973,2675
421227,202304,888,2370,593,1763,130,413,229,660,359,1073
421230,202304,801,2018,577,1606,112,357,235,601,347,958
421240,202304,344,978,168,566,25,116,46,111,71,227
421250,202304,3460,8239,2624,6863,418,1108,1567,3887,1985,4995
421260,202304,334,1028,99,314,18,59,11,25,29,84
421265,202304,1267,2806,1078,2550,95,211,864,2023,959,2234
421270,202304,467,1216,246,776,61,211,85,253,146,464
421280,202304,3555,8674,2757,7350,450,1391,1433,3485,1883,4876
421290,202304,1416,3672,717,2012,120,353,119,268,239,621
421300,202304,418,1095,214,665,33,110,34,92,67,202
421310,202304,307,814,209,606,75,227,70,178,145,405
421315,202304,418,1084,253,727,55,163,79,198,134,361
421320,202304,781,2372,434,1387,44,142,56,87,100,229
421330,202304,782,2167,518,1580,111,350,146,390,257,740
421335,202304,518,1480,419,1292,63,219,205,600,268,819
421340,202304,1806,4819,1281,3882,222,739,527,1479,749,2218
421350,202304,2215,5269,1513,4112,310,878,543,1406,853,2284
421360,202304,2684,6826,1668,4799,444,1511,510,1044,954,2555
421370,202304,959,2923,619,2038,114,427,183,480,297,907
421380,202304,1099,2560,964,2353,85,271,680,1558,765,1829
421390,202304,199,523,88,282,27,93,22,60,49,153
421400,202304,831,2119,575,1624,107,334,260,659,367,993
421410,202304,243,632,137,417,39,111,28,89,67,200
421415,202304,243,639,179,491,23,67,63,153,86,220
421420,202304,764,2019,559,1564,80,248,274,683,354,931
421430,202304,125,367,85,265,14,46,16,35,30,81
421440,202304,870,2262,554,1637,113,338,228,629,341,967
421450,202304,521,1536,358,1159,44,148,30,106,74,254
421460,202304,414,1242,229,814,13,41,17,37,30,78
421470,202304,483,1305,346,1051,48,141,98,292,146,433
421480,202304,4130,10532,3014,8240,422,1375,1376,3308,1798,4683
421490,202304,147,444,94,310,12,54,25,67,37,121
421500,202304,3135,8474,2289,6717,462,1570,756,1796,1218,3366
421505,202304,412,1034,341,927,36,116,208,546,244,662
421507,202304,538,1355,328,915,55,166,133,317,188,483
421510,202304,563,1480,386,1082,58,195,163,358,221,553
421520,202304,570,1488,332,922,55,151,100,229,155,380
421530,202304,410,1200,250,831,35,151,49,111,84,262
421535,202304,560,1409,362,991,52,155,196,486,248,641
421540,202304,469,1065,283,765,32,104,104,254,136,358
421545,202304,868,2432,669,2057,132,459,298,817,430,1276
421550,202304,2880,7216,2219,6044,384,1154,1105,2790,1489,3944
421555,202304,282,777,86,273,14,46,17,35,31,81
421560,202304,129,404,81,271,13,49,24,67,37,116
421565,202304,1310,3215,972,2652,222,685,422,1027,644,1712
421567,202304,566,1648,437,1298,126,402,122,349,248,751
421568,202304,390,1103,212,662,46,167,60,157,106,324
421569,202304,175,485,90,267,14,47,44,106,58,153
421570,202304,2078,5505,1498,4242,286,914,612,1461,898,2375
421575,202304,390,1085,286,815,37,132,139,339,176,471
421580,202304,6593,16845,4330,12057,631,2010,1832,4281,2463,6291
421590,202304,244,651,187,537,43,138,80,213,123,351
421600,202304,781,1920,525,1391,72,215,229,501,301,716
421605,202304,860,2187,640,1832,119,345,256,708,375,1053
421610,202304,1283,3213,910,2527,188,596,379,961,567,1557
421620,202304,5135,12668,3617,9964,732,2317,1480,3525,2212,5842
421625,202304,164,449,89,262,12,35,28,64,40,99
421630,202304,3680,9185,2456,6874,414,1298,778,1807,1192,3105
421635,202304,578,1473,407,1127,34,123,247,586,281,709
421640,202304,928,2288,691,1926,178,518,333,867,511,1385
421650,202304,3566,8878,2482,6992,500,1588,851,2095,1351,3683
421660,202304,16741,42670,12706,34976,1811,5793,6636,16120,8447,21913
421670,202304,1166,3097,814,2237,147,460,346,821,493,1281
421680,202304,2333,4718,1914,4070,133,365,1499,2934,1632,3299
421690,202304,1932,5319,1370,4170,282,910,346,951,628,1861
421700,202304,770,2198,492,1522,78,270,117,283,195,553
421710,202304,266,808,159,500,19,65,65,186,84,251
421715,202304,215,527,161,395,29,91,97,208,126,299
421720,202304,2651,6924,1620,4681,368,1171,450,1049,818,2220
421725,202304,367,872,211,577,28,81,100,228,128,309
421730,202304,692,1951,467,1339,77,218,202,527,279,745
421740,202304,1096,2912,761,2222,147,450,293,715,440,1165
421750,202304,1211,2835,683,1867,164,493,223,541,387,1034
421755,202304,202,544,110,330,19,61,34,78,53,139
421760,202304,1381,3379,895,2496,170,547,341,812,511,1359
421770,202304,3236,7909,2350,6381,430,1224,893,2208,1323,3432
421775,202304,257,675,157,457,17,50,48,107,65,157
421780,202304,1232,3224,853,2462,143,444,379,964,522,1408
421790,202304,1166,3000,635,1931,141,439,186,491,327,930
421795,202304,302,883,185,561,30,97,52,139,82,236
421800,202304,4030,10381,3069,8569,522,1606,1409,3548,1931,5154
421810,202304,732,1929,517,1511,63,207,251,698,314,905
421820,202304,1459,3993,1018,2960,191,637,327,774,518,1411
421825,202304,2074,4627,1749,4136,118,314,1292,2965,1410,3279
421830,202304,2500,6856,1846,5494,403,1290,422,1194,825,2484
421835,202304,321,741,243,611,31,90,148,355,179,445
421840,202304,481,1446,383,1218,76,279,116,319,192,598
421850,202304,498,1416,285,967,60,205,45,124,105,329
421860,202304,303,779,173,522,22,74,55,124,77,198
421870,202304,7181,16830,5408,13429,662,2045,3249,6982,3911,9027
421875,202304,393,1150,177,548,26,86,35,89,61,175
421880,202304,883,2385,585,1719,113,299,141,394,254,693
421885,202304,374,1010,204,610,33,97,57,152,90,249
421890,202304,1332,3420,998,2800,153,540,601,1524,754,2064
421895,202304,542,1317,463,1189,48,104,298,795,346,899
421900,202304,1426,3559,1043,2715,140,440,493,1053,633,1493
421910,202304,428,1245,226,750,32,125,51,137,83,262
421915,202304,489,1317,301,867,77,238,57,125,134,363
421917,202304,800,1770,463,1280,129,376,90,246,219,622
421920,202304,517,1490,356,1122,100,330,100,290,200,620
421930,202304,4219,10111,2583,7068,483,1441,863,2012,1346,3453
421935,202304,524,1485,424,1282,101,309,198,581,299,890
421940,202304,429,1194,214,633,36,121,68,158,104,279
421950,202304,4116,10136,2550,7099,469,1456,741,1658,1210,3114
421960,202304,184,447,105,311,15,39,36,94,51,133
421970,202304,2644,6601,1686,4565,323,998,691,1575,1014,2573
421985,202304,391,1035,276,788,30,89,141,380,171,469
422000,202304,2600,6107,2053,5305,164,507,1419,3572,1583,4079
430003,202304,774,1905,554,1525,85,256,299,789,384,1045
430005,202304,459,1055,357,894,18,58,266,606,284,664
430010,202304,2291,4856,1734,4019,359,814,868,2007,1227,2821
430020,202304,686,1471,518,1235,65,175,320,705,385,880
430030,202304,1219,2672,770,1843,112,287,450,953,562,1240
430040,202304,12214,26679,7963,19825,2131,5731,2249,4973,4380,10704
430045,202304,661,1433,502,1182,28,81,378,846,406,927
430047,202304,284,620,118,308,21,53,39,99,60,152
430050,202304,1029,2416,611,1618,107,285,228,537,335,822
430055,202304,314,712,160,412,16,38,80,184,96,222
430057,202304,112,255,60,161,18,50,13,32,31,82
430060,202304,28313,66682,23017,58674,3951,10985,12616,30587,16567,41572
430063,202304,830,2133,706,1904,146,395,403,1065,549,1460
430064,202304,1409,3503,1052,2867,218,634,527,1358,745,1992
430066,202304,127,269,99,226,7,22,81,178,88,200
430070,202304,720,1806,166,509,26,87,19,38,45,125
430080,202304,1180,2823,666,1782,110,348,322,707,432,1055
430085,202304,1138,2278,700,1622,117,305,310,686,427,991
430087,202304,1150,2615,934,2309,81,240,595,1405,676,1645
430090,202304,545,1368,231,725,52,171,47,121,99,292
430100,202304,1364,3070,823,2084,129,362,331,701,460,1063
430105,202304,1866,4321,1353,3479,180,556,752,1800,932,2356
430107,202304,206,556,107,313,16,45,30,73,46,118
430110,202304,2681,6155,2076,5243,344,974,1024,2406,1368,3380
430120,202304,1472,3814,1090,2929,186,491,504,1248,690,1739
430130,202304,4310,8883,3220,7429,1149,2661,599,1623,1748,4284
430140,202304,1269,3048,919,2448,157,454,442,1090,599,1544
430150,202304,692,1714,392,1123,86,271,107,271,193,542
430155,202304,264,626,118,335,17,47,23,49,40,96
430160,202304,27992,56741,22775,49779,1734,4465,16446,33971,18180,38436
430163,202304,4415,8761,3192,7038,61,201,2622,5517,2683,5718
430165,202304,393,986,157,474,20,59,21,51,41,110
430170,202304,1132,2788,410,1311,88,318,57,119,145,437
430175,202304,1035,2356,895,2102,152,356,545,1235,697,1591
430180,202304,807,1898,593,1523,147,373,239,601,386,974
430185,202304,770,1895,408,1141,99,300,76,171,175,471
430187,202304,1065,2060,796,1745,96,209,549,1187,645,1396
430190,202304,1832,4190,1424,3565,283,716,658,1546,941,2262
430192,202304,131,330,63,179,12,35,18,40,30,75
430195,202304,511,1397,90,278,8,24,16,33,24,57
430200,202304,1383,3565,1105,3088,303,880,248,710,551,1590
430205,202304,679,1312,639,1240,13,30,604,1151,617,1181
430210,202304,9154,22245,5564,14710,788,2257,1607,3312,2395,5569
430215,202304,436,976,270,675,36,103,127,287,163,390
430220,202304,686,1639,249,741,36,112,79,189,115,301
430222,202304,302,756,207,576,38,108,77,199,115,307
430223,202304,345,827,263,691,30,83,151,373,181,456
430225,202304,41,90,32,75,2,3,21,44,23,47
430230,202304,2645,6240,2220,5645,133,361,1772,4426,1905,4787
430235,202304,572,1449,385,1080,58,188,99,211,157,399
430237,202304,646,1313,501,1094,23,70,408,844,431,914
430240,202304,1651,3697,971,2500,138,403,447,994,585,1397
430245,202304,902,2172,743,1893,148,358,422,1113,570,1471
430250,202304,1315,2947,947,2360,295,789,246,544,541,1333
430258,202304,159,394,121,328,12,34,53,140,65,174
430260,202304,882,2028,584,1510,68,197,335,822,403,1019
430265,202304,296,810,204,643,36,116,75,237,111,353
430270,202304,4220,8694,3401,7498,468,1156,2261,4651,2729,5807
430280,202304,6385,13309,4697,10637,721,1755,2482,5245,3203,7000
430290,202304,2722,5587,2223,4983,208,504,1647,3540,1855,4044
430300,202304,13667,29826,10682,25024,1411,3819,6511,14031,7922,17850
430310,202304,17982,40789,13378,32746,1715,4673,7768,17430,9483,22103
430320,202304,1094,2607,644,1759,59,165,349,896,408,1061
430330,202304,748,1744,478,1228,91,243,163,358,254,601
430340,202304,810,1681,562,1309,80,192,373,828,453,1020
430350,202304,11046,24524,8580,20553,1116,2946,5172,11578,6288,14524
430355,202304,426,1133,163,505,32,87,17,41,49,128
430360,202304,1108,2522,680,1810,162,473,193,451,355,924
430367,202304,419,856,278,643,36,115,179,359,215,474
430370,202304,554,1484,226,674,47,145,56,124,103,269
430380,202304,754,1771,404,1152,87,258,105,272,192,530
430390,202304,4363,10012,2966,7589,602,1643,357,671,959,2314
430400,202304,1296,2498,980,2086,132,349,602,1154,734,1503
430410,202304,675,1436,513,1199,48,125,383,858,431,983
430420,202304,3733,8486,2923,6973,387,1115,1813,3811,2200,4926
430430,202304,573,1387,265,769,48,146,45,116,93,262
430435,202304,2320,5223,1669,4096,292,759,827,1938,1119,2697
430440,202304,6466,14614,5432,12991,559,1585,3658,8139,4217,9724
430450,202304,9859,20808,8076,17937,1229,3209,4834,9842,6063,13051
430460,202304,52313,116853,38513,94925,5384,14805,21402,49271,26786,64076
430461,202304,230,587,95,276,19,64,39,95,58,159
430462,202304,374,910,194,559,34,109,60,148,94,257
430463,202304,9532,22691,7135,18430,1378,4084,3440,8189,4818,12273
430465,202304,701,1569,480,1177,71,198,271,631,342,829
430466,202304,6195,13801,5007,12071,811,2173,2954,6510,3765,8683
430467,202304,634,1431,471,1183,48,146,282,651,330,797
430468,202304,1835,4018,1522,3573,86,275,1189,2647,1275,2922
430469,202304,726,1945,152,462,15,46,49,105,64,151
430470,202304,7254,17244,4878,13146,1268,3947,1202,2713,2470,6660
430471,202304,974,2265,835,2043,101,297,591,1336,692,1633
430480,202304,793,2057,520,1501,82,269,172,385,254,654
430485,202304,207,509,106,285,22,51,24,61,46,112
430490,202304,567,1358,328,898,38,116,158,354,196,470
430495,202304,479,1236,329,963,55,174,159,443,214,617
430500,202304,1140,2744,826,2239,278,837,219,505,497,1342
430510,202304,35036,84593,26360,68722,5003,14613,11615,26595,16618,41208
430511,202304,395,1052,147,453,26,83,25,54,51,137
430512,202304,1270,2598,1033,2268,223,537,440,912,663,1449
430513,202304,947,2117,485,1204,67,185,274,594,341,779
430515,202304,472,1173,339,928,46,136,156,393,202,529
430517,202304,1752,4362,1343,3531,239,614,736,1892,975,2506
430520,202304,1586,3790,928,2447,156,429,219,513,375,942
430530,202304,1074,2557,478,1337,86,252,133,337,219,589
430535,202304,4522,10486,3337,8481,481,1302,1702,4061,2183,5363
430537,202304,678,1478,604,1353,77,160,441,960,518,1120
430540,202304,687,1582,418,1136,80,209,198,525,278,734
430543,202304,1313,2222,837,1670,220,425,207,456,427,881
430544,202304,838,2196,559,1599,139,434,174,472,313,906
430545,202304,3040,7057,2378,6081,395,1060,1334,3275,1729,4335
430550,202304,473,1211,327,918,100,263,86,237,186,500
430558,202304,186,409,82,207,3,7,44,103,47,110
430560,202304,351,789,185,527,22,70,59,145,81,215
430570,202304,1001,2275,721,1780,164,504,316,594,480,1098
430580,202304,908,2194,707,1890,179,476,261,741,440,1217
430583,202304,212,510,47,130,6,25,12,16,18,41
430585,202304,244,566,140,357,29,80,45,98,74,178
430587,202304,243,613,182,518,24,76,78,213,102,289
430590,202304,1613,3634,1282,3108,141,360,833,1963,974,2323
430593,202304,37,99,32,84,5,17,14,27,19,44
430595,202304,498,1222,144,437,18,47,19,34,37,81
430597,202304,548,1279,292,782,24,61,97,189,121,250
430600,202304,2367,5877,1053,2886,162,472,212,511,374,983
430605,202304,1648,3887,1206,3141,177,477,547,1337,724,1814
430607,202304,828,1740,562,1287,58,137,340,737,398,874
430610,202304,7639,16157,5611,13259,1369,3868,2376,4822,3745,8690
430613,202304,307,681,95,262,11,32,27,57,38,89
430620,202304,1015,2221,768,1802,149,419,405,795,554,1214
430630,202304,472,1244,170,480,30,88,51,121,81,209
430632,202304,510,1275,221,611,37,108,83,202,120,310
430635,202304,686,1402,510,1102,57,107,362,775,419,882
430637,202304,629,1392,468,1146,44,134,307,680,351,814
430640,202304,1339,3493,940,2688,136,415,349,856,485,1271
430642,202304,430,1131,268,754,43,130,105,266,148,396
430645,202304,194,443,101,258,19,58,33,59,52,117
430650,202304,2232,5458,1689,4613,523,1381,626,1878,1149,3259
430655,202304,391,896,232,577,29,88,137,290,166,378
430660,202304,6647,15075,5119,12696,873,2423,2678,6129,3551,8552
430670,202304,714,1601,508,1248,98,240,227,527,325,767
430673,202304,587,1265,288,751,64,162,108,254,172,416
430675,202304,287,807,66,222,10,36,7,23,17,59
430676,202304,7520,16926,6037,14625,974,2511,3640,8410,4614,10921
430680,202304,1528,3640,1023,2695,325,928,331,653,656,1581
430690,202304,4148,9515,3275,8054,1061,2751,1233,2878,2294,5629
430692,202304,241,669,189,583,14,53,149,448,163,501
430693,202304,1104,2763,700,2001,154,467,171,450,325,917
430695,202304,460,1073,295,734,44,129,157,348,201,477
430697,202304,633,1435,498,1245,71,191,330,807,401,998
430700,202304,10108,23215,6622,17065,1458,4112,1582,3286,3040,7398
430705,202304,430,960,212,573,29,82,83,197,112,279
430710,202304,2489,4318,1684,3294,61,178,1387,2546,1448,2724
430720,202304,936,2144,504,1381,61,186,260,647,321,833
430730,202304,1122,2859,777,2192,126,376,315,806,441,1182
430740,202304,840,2117,457,1304,75,243,151,388,226,631
430745,202304,599,1300,447,1026,55,186,286,535,341,721
430750,202304,2104,4748,1457,3622,346,895,688,1595,1034,2490
430755,202304,562,1294,417,1025,37,110,257,566,294,676
430760,202304,3219,7304,2555,6313,540,1429,1239,2841,1779,4270
430770,202304,9670,21353,7805,18626,898,2434,5078,11457,5976,13891
430780,202304,2692,6256,1902,4948,279,809,1024,2472,1303,3281
430781,202304,771,1813,525,1306,165,440,202,415,367,855
430783,202304,417,909,277,691,65,175,137,318,202,493
430786,202304,42,127,28,97,4,12,7,18,11,30
430790,202304,6060,13655,4626,11263,474,1447,2894,6292,3368,7739
430800,202304,1076,2091,818,1743,50,116,638,1297,688,1413
430805,202304,485,1059,347,796,8,30,283,606,291,636
430807,202304,728,1683,438,1154,65,194,173,376,238,570
430810,202304,888,2029,502,1305,73,213,193,415,266,628
430820,202304,1670,4369,991,2919,178,531,294,744,472,1275
430825,202304,318,724,137,323,22,54,55,113,77,167
430830,202304,2531,5646,2122,4942,125,295,1646,3639,1771,3934
430840,202304,1483,3189,1008,2448,154,385,620,1437,774,1822
430843,202304,224,533,106,292,9,22,35,84,44,106
430845,202304,640,1339,428,994,58,157,250,501,308,658
430850,202304,2934,7149,2038,5542,588,1733,494,1231,1082,2964
430860,202304,1465,3414,801,2147,124,401,331,736,455,1137
430865,202304,715,1644,435,1153,109,328,155,324,264,652
430870,202304,619,1602,281,843,51,154,50,125,101,279
430880,202304,1846,3780,1354,2996,155,413,916,1872,1071,2285
430885,202304,207,519,134,371,16,38,84,230,100,268
430890,202304,1360,3175,872,2366,181,584,91,175,272,759
430900,202304,4141,7808,2927,6140,142,418,2183,4203,2325,4621
430905,202304,1134,2665,790,2050,144,387,314,734,458,1121
430910,202304,2861,7143,2190,5780,344,1087,1024,2269,1368,3356
430912,202304,615,1633,403,1178,71,196,212,629,283,825
430915,202304,616,1643,400,1191,109,347,95,284,204,631
430920,202304,35264,79489,28604,68991,3425,9215,18589,42366,22014,51581
430925,202304,105,219,54,134,7,19,25,60,32,79
430930,202304,15883,33238,11981,27658,1350,3492,7664,16446,9014,19938
430940,202304,1563,3660,1107,2853,233,643,452,1022,685,1665
430950,202304,1049,2067,709,1537,58,183,517,997,575,1180
430955,202304,527,1305,158,433,23,64,48,105,71,169
430957,202304,249,700,218,635,40,116,116,342,156,458
430960,202304,1687,3772,1016,2606,272,731,324,741,596,1472
430965,202304,1962,4071,1567,3492,62,147,1239,2749,1301,2896
430970,202304,418,968,252,669,38,103,118,297,156,400
430975,202304,587,1528,458,1260,85,275,167,397,252,672
430980,202304,529,1156,311,790,43,122,141,309,184,431
430990,202304,702,1764,514,1398,74,221,242,616,316,837
430995,202304,650,1463,481,1203,84,222,261,598,345,820
431000,202304,1691,3834,783,2147,125,347,82,177,207,524
431010,202304,3405,8176,2448,6549,465,1437,943,2115,1408,3552
431020,202304,11028,22727,6763,16139,1087,3053,3246,6623,4333,9676
431030,202304,399,1051,205,645,39,144,27,78,66,222
431033,202304,5243,11501,3681,9049,843,2102,1422,3378,2265,5480
431036,202304,353,774,91,274,7,17,28,72,35,89
431040,202304,1056,2444,728,1904,78,270,443,1040,521,1310
431041,202304,503,1124,350,880,58,147,139,291,197,438
431043,202304,468,1120,325,831,26,91,209,475,235,566
431046,202304,113,285,53,147,7,18,12,29,19,47
431050,202304,1492,3265,1121,2696,191,462,633,1502,824,1964
431053,202304,877,2074,486,1350,104,307,160,347,264,654
431055,202304,742,1668,565,1373,56,142,380,930,436,1072
431057,202304,206,604,146,458,35,122,55,157,90,279
431060,202304,7057,15764,5003,12542,1188,3265,2018,4485,3206,7750
431065,202304,565,1299,374,986,54,159,197,488,251,647
431070,202304,502,1234,305,828,64,180,82,221,146,401
431075,202304,335,804,189,494,34,117,95,192,129,309
431080,202304,794,2057,563,1589,84,255,178,424,262,679
431085,202304,940,2282,508,1344,67,193,218,557,285,750
431087,202304,477,1207,396,1049,51,146,237,597,288,743
431090,202304,469,1058,191,556,33,102,39,109,72,211
431100,202304,5511,10520,4090,8750,401,995,2850,5694,3251,6689
431110,202304,1774,3778,1294,2952,186,472,705,1426,891,1898
431112,202304,772,1804,638,1569,85,245,412,945,497,1190
431113,202304,656,1524,508,1260,115,296,284,654,399,950
431115,202304,1303,3186,1012,2683,114,399,701,1692,815,2091
431120,202304,3351,7731,2314,5861,531,1544,915,1970,1446,3514
431123,202304,434,1050,272,721,45,116,126,315,171,431
431125,202304,1471,3421,1060,2695,263,691,566,1405,829,2096
431127,202304,277,695,81,243,12,42,17,37,29,79
431130,202304,4159,9342,3301,8047,559,1476,1727,3910,2286,5386
431140,202304,7340,16585,4778,11897,649,1768,2211,4609,2860,6377
431142,202304,807,1763,605,1435,85,219,393,901,478,1120
431150,202304,1257,3052,936,2503,123,368,518,1309,641,1677
431160,202304,831,2040,558,1514,155,449,170,411,325,860
431162,202304,706,1658,504,1291,51,171,302,705,353,876
431164,202304,197,455,58,181,9,26,9,25,18,51
431170,202304,559,1375,416,1101,128,331,90,217,218,548
431171,202304,1168,2295,989,2082,151,316,753,1563,904,1879
431173,202304,570,1358,407,1127,124,394,115,269,239,663
431175,202304,1608,3485,1003,2458,153,367,476,1095,629,1462
431177,202304,1178,2734,883,2286,171,498,482,1168,653,1666
431179,202304,363,795,132,373,27,79,40,107,67,186
431180,202304,2936,7177,1889,5143,455,1249,435,990,890,2239
431190,202304,707,1692,307,853,27,80,70,126,97,206
431198,202304,500,1343,409,1168,91,262,171,491,262,753
431200,202304,343,838,113,303,24,57,17,44,41,101
431205,202304,284,714,169,471,47,131,57,150,104,281
431210,202304,800,1717,640,1474,129,313,325,740,454,1053
431213,202304,345,840,250,657,22,67,130,305,152,372
431215,202304,746,1698,386,1050,51,155,179,440,230,595
431217,202304,203,486,143,370,29,80,57,133,86,213
431220,202304,732,1691,481,1239,111,291,235,541,346,832
431225,202304,1985,4077,1534,3386,168,409,1037,2205,1205,2614
431230,202304,905,2245,669,1739,131,400,334,726,465,1126
431235,202304,203,546,34,109,1,2,9,25,10,27
431237,202304,452,1259,338,1026,51,170,173,501,224,671
431238,202304,44,140,37,124,8,34,18,49,26,83
431240,202304,6764,14891,5595,13052,567,1648,3743,8026,4310,9674
431242,202304,388,880,317,746,43,113,182,397,225,510
431244,202304,476,1118,223,572,49,117,77,168,126,285
431245,202304,1544,3378,1020,2508,104,269,500,1119,604,1388
431247,202304,341,788,230,590,37,114,104,224,141,338
431250,202304,2429,5311,1905,4595,407,1006,999,2375,1406,3381
431260,202304,380,948,231,647,24,91,98,237,122,328
431261,202304,340,914,278,812,24,86,169,451,193,537
431262,202304,332,901,179,561,28,103,87,256,115,359
431265,202304,1884,4244,765,2079,150,452,202,421,352,873
431267,202304,281,667,194,509,28,91,116,273,144,364
431270,202304,3549,7267,1947,4665,498,1258,677,1494,1175,2752
431275,202304,193,495,133,360,21,68,79,186,100,254
431280,202304,317,848,153,470,27,79,40,113,67,192
431290,202304,442,1257,295,920,48,167,48,122,96,289
431295,202304,85,218,37,112,11,34,10,31,21,65
431300,202304,363,943,103,298,14,50,30,65,44,115
431301,202304,314,863,92,294,14,44,10,26,24,70
431303,202304,818,1893,507,1306,35,113,233,493,268,606
431306,202304,2855,6386,1800,4630,253,717,745,1641,998,2358
431308,202304,48,134,41,116,15,43,13,37,28,80
431310,202304,662,1570,427,1098,79,183,197,476,276,659
431320,202304,816,2113,526,1525,86,274,172,420,258,694
431330,202304,2436,5421,1393,3616,196,564,697,1599,893,2163
431333,202304,242,613,142,407,29,84,36,95,65,179
431335,202304,40,108,26,84,8,23,1,4,9,27
431337,202304,5261,10944,4535,9924,207,657,3827,7919,4034,8576
431339,202304,547,1296,379,1010,90,238,146,378,236,616
431340,202304,24268,54873,18005,44563,2534,7168,9657,21728,12191,28896
431342,202304,479,1048,359,859,52,135,238,555,290,690
431344,202304,433,1047,241,678,41,106,128,347,169,453
431346,202304,257,617,93,279,18,57,26,62,44,119
431349,202304,1240,2604,833,1847,142,355,483,980,625,1335
431350,202304,6186,14047,4913,12074,686,1883,3011,6893,3697,8776
431360,202304,675,1541,357,945,105,302,99,212,204,514
431365,202304,3039,5972,2423,5173,132,360,2007,4088,2139,4448
431370,202304,6431,13724,4794,11227,814,2156,2706,5912,3520,8068
431380,202304,1141,2796,908,2410,204,541,482,1280,686,1821
431390,202304,3365,7693,2245,5833,251,796,1227,2749,1478,3545
431395,202304,2262,4592,1794,3942,179,421,1269,2650,1448,3071
431400,202304,363,968,212,626,41,130,44,111,85,241
431402,202304,1086,2231,817,1836,89,217,553,1182,642,1399
431403,202304,230,616,180,518,45,146,61,151,106,297
431405,202304,7299,17165,5789,14713,1030,2972,2864,6568,3894,9540
431406,202304,702,1769,465,1275,124,319,136,402,260,721
431407,202304,650,1624,418,1143,83,218,171,438,254,656
431410,202304,24819,55670,18221,44994,2360,6909,10962,24253,13322,31162
431413,202304,298,823,75,229,5,13,23,56,28,69
431415,202304,903,2081,615,1598,121,361,250,542,371,903
431417,202304,667,1354,421,965,68,191,220,477,288,668
431420,202304,2139,4284,1619,3610,122,317,1128,2355,1250,2672
431430,202304,670,1613,337,964,57,168,106,268,163,436
431440,202304,49462,101749,38783,86491,5736,14993,22580,44517,28316,59510
431442,202304,196,525,98,305,12,41,12,35,24,76
431445,202304,898,2049,614,1343,16,52,505,979,521,1031
431446,202304,327,871,273,771,31,97,152,412,183,509
431447,202304,907,2180,501,1377,86,242,172,460,258,702
431449,202304,963,2228,651,1668,100,259,347,808,447,1067
431450,202304,3140,5506,2512,4679,199,310,1978,3561,2177,3871
431454,202304,52,162,43,140,9,33,22,68,31,101
431455,202304,641,1437,339,858,40,94,157,371,197,465
431460,202304,3974,8287,2642,6057,533,1326,1176,2494,1709,3820
431470,202304,1710,4274,1226,3334,263,790,429,1071,692,1861
431475,202304,301,797,57,189,4,15,6,11,10,26
431477,202304,575,1352,330,884,87,211,110,279,197,490
431478,202304,281,770,59,187,10,30,9,22,19,52
431480,202304,4101,9826,3326,8619,788,2109,1310,3258,2098,5367
431490,202304,176204,362795,139126,307601,7737,21894,107045,221277,114782,243171
431500,202304,561,1299,423,1054,64,159,221,523,285,682
431505,202304,286,633,203,512,23,53,141,356,164,409
431507,202304,337,783,140,403,39,122,23,52,62,174
431510,202304,2079,4935,1416,3661,501,1353,342,850,843,2203
431513,202304,258,543,138,343,29,95,44,71,73,166
431514,202304,154,363,126,319,7,19,81,182,88,201
431515,202304,668,1427,517,1169,114,278,281,604,395,882
431517,202304,85,232,67,195,9,35,28,75,37,110
431520,202304,421,987,178,480,26,85,74,156,100,241
431530,202304,6587,13613,4053,9780,945,2399,1709,3847,2654,6246
431531,202304,264,600,156,407,31,79,53,136,84,215
431532,202304,740,1545,432,1017,75,188,207,468,282,656
431535,202304,351,874,171,479,23,62,37,86,60,148
431540,202304,2217,5996,1987,5673,111,336,1535,4414,1646,4750
431545,202304,428,998,108,262,14,29,51,114,65,143
431550,202304,2824,6448,2003,4965,256,720,1083,2466,1339,3186
431555,202304,843,1761,492,1186,49,130,274,645,323,775
431560,202304,33072,73614,23152,58430,4375,10948,9661,24066,14036,35014
431570,202304,6935,13469,6026,12209,360,919,5030,9610,5390,10529
431575,202304,479,1047,412,942,77,172,252,540,329,712
431580,202304,811,1938,573,1495,64,208,327,758,391,966
431590,202304,1041,2632,666,1825,169,500,237,558,406,1058
431595,202304,431,1073,280,762,58,174,98,227,156,401
431600,202304,2288,5235,1660,4246,303,889,700,1586,1003,2475
431610,202304,1820,3972,1171,2867,210,513,445,1148,655,1661
431620,202304,571,1345,311,794,56,181,174,358,230,539
431630,202304,1563,3637,744,2041,181,541,213,508,394,1049
431640,202304,8912,17908,7403,15930,955,2310,4945,10176,5900,12486
431642,202304,787,1651,496,1143,101,232,236,492,337,724
431643,202304,460,1088,218,588,22,53,80,193,102,246
431645,202304,3125,5401,2494,4623,32,76,2206,3947,2238,4023
431647,202304,366,849,125,358,16,43,18,40,34,83
431650,202304,171,455,127,379,18,59,61,156,79,215
431660,202304,1023,2549,536,1579,96,318,126,313,222,631
431670,202304,1538,3411,927,2330,144,384,459,1025,603,1409
431673,202304,252,636,105,338,14,53,32,88,46,141
431675,202304,432,1058,112,364,13,46,15,30,28,76
431680,202304,12794,28017,9733,22826,1937,5228,4942,10315,6879,15543
431690,202304,35646,78229,26247,62326,4362,11943,14565,31392,18927,43335
431695,202304,275,631,175,450,25,96,99,203,124,299
431697,202304,556,1197,417,983,75,181,238,548,313,729
431700,202304,1851,4030,1436,3346,240,512,742,1735,982,2247
431710,202304,19384,39304,14678,33022,1689,4357,9631,20471,11320,24828
431720,202304,8784,19565,5420,13804,1418,3863,1105,2269,2523,6132
431725,202304,43,110,30,86,7,25,13,33,20,58
431730,202304,5790,12374,3957,9687,747,2027,1984,4397,2731,6424
431740,202304,6434,14374,4396,11094,976,2747,1371,2999,2347,5746
431750,202304,10874,25209,7875,20405,2027,5605,2669,6513,4696,12118
431755,202304,364,944,91,284,15,49,14,34,29,83
431760,202304,6684,14109,4843,11141,547,1557,2993,6113,3540,7670
431770,202304,2610,5299,1990,4467,386,799,1214,2741,1600,3540
431775,202304,256,612,142,388,30,96,42,91,72,187
431780,202304,2652,5920,1745,4341,334,901,557,1263,891,2164
431790,202304,912,2295,634,1755,146,441,260,685,406,1126
431795,202304,307,743,151,439,20,57,37,96,57,153
431800,202304,10379,22797,6830,17418,1953,5889,811,1661,2764,7550
431805,202304,327,817,68,237,3,5,3,5,6,10
431810,202304,3928,8232,2642,6028,407,1059,1502,3083,1909,4142
431820,202304,2742,6463,2119,5539,502,1466,942,2293,1444,3759
431830,202304,10670,22294,7834,18450,2420,6467,1235,2881,3655,9348
431840,202304,3608,7992,2933,7002,475,1244,1785,4109,2260,5353
431842,202304,598,1409,212,596,38,110,34,80,72,190
431843,202304,369,939,247,677,61,187,100,239,161,426
431844,202304,211,569,79,260,18,59,17,56,35,115
431845,202304,584,1386,380,992,31,92,226,565,257,657
431846,202304,372,807,327,744,16,43,290,643,306,686
431848,202304,178,447,102,291,11,35,30,66,41,101
431849,202304,417,1014,74,210,12,34,8,12,20,46
431850,202304,5346,13078,4067,10733,1044,2979,1187,2891,2231,5870
431860,202304,841,1862,459,1132,68,189,285,646,353,835
431861,202304,121,312,75,214,15,50,27,61,42,111
431862,202304,615,1815,499,1609,96,364,237,710,333,1074
431870,202304,31043,69059,25120,60303,2548,7006,16649,37424,19197,44430
431880,202304,5093,11874,3783,9659,530,1622,2043,4756,2573,6378
431890,202304,6168,14200,3995,10211,1147,3044,1008,2398,2155,5442
431900,202304,1305,3033,882,2300,165,503,419,924,584,1427
431910,202304,896,2023,361,957,60,174,102,202,162,376
431912,202304,706,1562,572,1343,86,206,364,831,450,1037
431915,202304,1451,3000,1178,2591,70,168,944,2002,1014,2170
431920,202304,1684,3215,1387,2853,35,85,1223,2454,1258,2539
431930,202304,898,2127,612,1627,202,562,206,524,408,1086
431935,202304,97,234,71,191,11,31,13,26,24,57
431936,202304,360,923,206,561,38,110,113,291,151,401
431937,202304,181,438,117,320,28,66,34,86,62,152
431940,202304,3811,8081,2528,5934,192,512,1621,3529,1813,4041
431950,202304,2833,6466,2192,5464,531,1410,887,2058,1418,3468
431960,202304,3737,8343,2817,6776,844,2140,675,1546,1519,3686
431970,202304,523,1271,249,654,46,143,78,157,124,300
431971,202304,96,233,53,151,13,40,16,42,29,82
431973,202304,711,1954,494,1515,47,147,346,1063,393,1210
431975,202304,130,268,48,122,11,32,13,23,24,55
431980,202304,1560,3304,1236,2827,131,388,857,1748,988,2136
431990,202304,8753,18841,6436,15646,434,1292,4360,10055,4794,11347
432000,202304,20232,41983,15572,35160,1806,4794,10473,21873,12279,26667
432010,202304,3565,7673,2419,5917,574,1438,857,1930,1431,3368
432020,202304,1889,4757,1207,3354,390,1140,206,544,596,1684
432023,202304,660,1462,317,825,37,96,142,320,179,416
432026,202304,1251,3052,976,2547,289,763,350,951,639,1714
432030,202304,560,1247,313,824,28,85,178,422,206,507
432032,202304,373,898,255,673,23,70,135,300,158,370
432035,202304,857,2160,708,1909,189,501,313,849,502,1350
432040,202304,1136,2676,539,1507,64,201,234,557,298,758
432045,202304,228,559,133,376,16,54,64,165,80,219
432050,202304,694,1585,512,1288,64,198,269,644,333,842
432055,202304,851,1972,577,1492,182,455,151,407,333,862
432057,202304,184,451,157,392,13,35,106,237,119,272
432060,202304,527,1215,153,466,20,67,29,76,49,143
432065,202304,275,681,216,566,48,147,112,267,160,414
432067,202304,993,2471,833,2147,115,297,515,1297,630,1594
432070,202304,1990,4580,1525,3765,229,649,778,1716,1007,2365
432080,202304,6519,13516,4869,11114,913,2517,2316,4656,3229,7173
432085,202304,482,1225,414,1128,84,249,207,517,291,766
432090,202304,3493,8088,2146,5625,435,1103,921,2197,1356,3300
432100,202304,1132,2670,540,1572,95,277,64,149,159,426
432110,202304,2637,6157,1988,5070,451,1290,610,1300,1061,2590
432120,202304,4683,11322,3827,9969,624,1875,2002,4734,2626,6609
432130,202304,3507,7767,2909,6952,533,1299,1444,3466,1977,4765
432132,202304,328,835,181,511,27,94,94,227,121,321
432135,202304,1226,2533,830,1890,98,223,507,1172,605,1395
432140,202304,2392,5837,1994,5139,245,713,1342,3285,1587,3998
432143,202304,1965,4666,1500,3933,144,419,933,2360,1077,2779
432145,202304,2223,5477,1477,4033,254,797,488,1030,742,1827
432146,202304,155,397,127,361,43,135,33,87,76,222
432147,202304,689,1742,373,1067,121,358,58,163,179,521
432149,202304,610,1353,282,711,33,79,119,263,152,342
432150,202304,5299,11846,4077,9947,852,2423,2067,4372,2919,6795
432160,202304,8477,19172,6527,16294,1624,4353,2571,6064,4195,10417
432162,202304,236,512,42,116,8,24,7,9,15,33
432163,202304,192,450,38,108,1,3,7,14,8,17
432166,202304,807,2025,650,1743,126,366,240,555,366,921
432170,202304,1903,4785,1337,3753,253,767,517,1282,770,2049
432180,202304,3660,8066,1939,4962,272,795,905,1976,1177,2771
432183,202304,502,1300,391,1079,74,247,207,518,281,765
432185,202304,1068,2482,659,1725,134,405,316,737,450,1142
432190,202304,2840,6161,2093,5041,163,500,1448,3169,1611,3669
432195,202304,1236,2967,759,2073,145,413,230,608,375,1021
432200,202304,4697,10419,3661,8858,294,783,2609,5992,2903,6775
432210,202304,505,1175,343,895,44,113,171,394,215,507
432215,202304,783,1959,622,1671,96,244,302,844,398,1088
432218,202304,250,574,123,326,16,49,47,94,63,143
432220,202304,4567,9688,3315,7691,562,1373,1852,4003,2414,5376
432225,202304,201,502,140,385,28,71,53,145,81,216
432230,202304,950,2158,454,1234,71,220,149,325,220,545
432232,202304,580,1348,385,1006,71,203,183,425,254,628
432234,202304,311,759,182,498,38,99,48,115,86,214
432235,202304,60,139,36,89,6,18,20,42,26,60
432237,202304,357,846,314,773,15,34,266,645,281,679
432240,202304,22068,47134,16685,40186,1681,4046,11333,26836,13014,30882
432250,202304,9130,22193,6934,18027,1199,3547,3839,9198,5038,12745
432252,202304,564,1299,381,945,47,135,195,429,242,564
432253,202304,1153,2994,806,2181,240,696,194,446,434,1142
432254,202304,690,1598,224,632,32,100,45,94,77,194
432255,202304,121,299,79,217,8,26,37,85,45,111
432260,202304,7492,16885,5665,13699,1061,2893,2976,6389,4037,9282
432270,202304,2906,6889,2369,5976,741,1918,820,2014,1561,3932
432280,202304,1490,3606,811,2307,133,425,237,534,370,959
432285,202304,159,469,33,95,3,6,9,25,12,31
432290,202304,424,1029,281,737,64,203,103,211,167,414
432300,202304,40626,88426,32124,75561,2676,7775,22883,50096,25559,57871
432310,202304,1338,2857,1037,2377,129,268,780,1805,909,2073
432320,202304,184,422,111,294,20,58,41,87,61,145
432330,202304,225,509,94,279,21,58,15,44,36,102
432335,202304,193,553,75,262,6,16,9,23,15,39
432340,202304,397,955,206,597,31,96,80,222,111,318
432345,202304,1087,1980,933,1802,20,50,820,1533,840,1583
432350,202304,369,874,192,555,39,131,62,144,101,275
432360,202304,257,742,53,171,6,21,14,41,20,62
432370,202304,450,1016,241,652,24,69,127,329,151,398
432375,202304,603,1370,417,1015,148,384,112,271,260,655
432377,202304,202,594,48,169,5,17,13,36,18,53
432380,202304,2409,6206,1691,4868,287,915,792,2161,1079,3076
500020,202304,4322,9604,3040,7674,347,1046,1976,4741,2323,5787
500025,202304,1390,3195,910,2329,120,317,500,1216,620,1533
500060,202304,10482,26185,7597,20448,957,2802,4347,11293,5304,14095
500070,202304,6506,14681,4732,11825,882,2421,2249,5371,3131,7792
500080,202304,1898,4348,1205,3164,201,577,482,1116,683,1693
500085,202304,2553,5886,1795,4585,435,1211,705,1622,1140,2833
500090,202304,2455,5928,1713,4735,303,907,468,1364,771,2271
500100,202304,4915,11396,3643,9405,604,1701,1493,3555,2097,5256
500110,202304,13656,30462,9444,23890,1979,5428,4409,10636,6388,16064
500124,202304,2776,6953,2244,6161,343,917,1374,3776,1717,4693
500150,202304,1970,4108,1415,3375,236,628,763,1656,999,2284
500190,202304,6361,15197,4236,11269,962,2680,1342,3175,2304,5855
500200,202304,3379,7188,2227,5332,263,682,1285,2828,1548,3510
500210,202304,6448,13529,4666,11290,1290,3333,2312,5332,3602,8665
500215,202304,1774,4454,1309,3683,148,436,700,1924,848,2360
500220,202304,4318,10528,3224,8736,457,1318,1731,4320,2188,5638
500230,202304,2682,5805,2079,4979,309,777,1275,2920,1584,3697
500240,202304,5246,13963,3838,11189,556,1765,1561,4468,2117,6233
500260,202304,3954,7956,2619,6123,260,715,1632,3526,1892,4241
500270,202304,191988,418240,128567,318856,17427,49899,61535,135017,78962,184916
500280,202304,1719,3936,1123,3046,188,494,625,1689,813,2183
500290,202304,4655,10552,2866,7595,467,1465,1063,2441,1530,3906
500295,202304,5331,11797,3647,8991,576,1626,1638,3476,2214,5102
500310,202304,1302,2420,851,1868,135,226,456,996,591,1222
500315,202304,6168,13164,5132,11813,302,783,4298,9614,4600,10397
500320,202304,25937,63085,18189,50581,4489,12153,7536,21922,12025,34075
500325,202304,7810,15819,5618,12872,689,1756,3539,7639,4228,9395
500330,202304,8562,18069,5739,14017,604,1583,3228,7744,3832,9327
500345,202304,2740,6318,1883,4949,358,995,640,1518,998,2513
500348,202304,2858,6632,2233,5614,187,546,1588,3832,1775,4378
500350,202304,1478,3797,863,2539,110,356,277,717,387,1073
500370,202304,35385,85232,26551,71238,3693,11301,13037,32946,16730,44247
500375,202304,3179,7914,2001,5578,268,809,707,1685,975,2494
500380,202304,4462,10409,3117,8181,884,2321,480,1276,1364,3597
500390,202304,909,1743,556,1327,89,238,356,843,445,1081
500400,202304,2030,4881,1387,3691,233,715,518,1188,751,1903
500410,202304,2973,6427,2068,5155,233,561,1124,2910,1357,3471
500430,202304,3549,8153,2435,6481,406,1082,911,2642,1317,3724
500440,202304,2015,4541,1135,3028,198,544,428,1138,626,1682
500450,202304,2463,5734,1574,4292,311,897,398,987,709,1884
500460,202304,4798,11740,2990,8340,551,1688,591,1482,1142,3170
500470,202304,3570,8920,2395,6657,562,1737,680,1538,1242,3275
500480,202304,2346,6784,1905,6094,214,722,1325,4280,1539,5002
500490,202304,1440,3232,870,2361,176,551,213,555,389,1106
500500,202304,5105,12594,3425,10024,1126,3848,321,944,1447,4792
500510,202304,876,2086,589,1569,63,206,357,832,420,1038
500515,202304,2017,4841,1555,4136,234,649,789,2081,1023,2730
500520,202304,4281,11162,3287,9515,742,2144,1580,4661,2322,6805
500525,202304,1255,3344,1000,2958,141,446,559,1587,700,2033
500540,202304,6454,15888,3962,11544,1093,3577,629,1488,1722,5065
500560,202304,7214,17038,5909,15394,297,889,4834,12478,5131,13367
500568,202304,5818,11856,3725,8761,852,2040,1527,3195,2379,5235
500570,202304,11328,24216,8058,19076,1046,2918,4753,10136,5799,13054
500580,202304,3895,9259,2816,7417,732,1992,1102,2842,1834,4834
500600,202304,4617,10794,3358,8811,811,2257,918,2297,1729,4554
500620,202304,10487,24987,7348,19296,1098,3059,3734,9035,4832,12094
500625,202304,703,1758,495,1371,75,249,218,543,293,792
500627,202304,976,2512,609,1849,112,374,167,456,279,830
500630,202304,9973,20925,5974,14687,1319,3571,1907,4192,3226,7763
500635,202304,3267,9747,2391,8488,343,1105,1471,5772,1814,6877
500640,202304,2163,4351,1490,3489,81,196,1039,2308,1120,2504
500660,202304,27491,62171,18808,49614,5360,14905,6486,16831,11846,31736
500690,202304,3454,8183,2335,6403,836,2516,742,1915,1578,4431
500710,202304,4220,10334,3002,8249,710,2142,809,2064,1519,4206
500720,202304,6290,15163,4264,11839,887,2641,1278,3272,2165,5913
500730,202304,1311,2948,750,1981,155,387,247,636,402,1023
500740,202304,5729,12800,3673,9687,940,2514,1250,3217,2190,5731
500750,202304,1411,3241,1009,2578,137,401,468,1047,605,1448
500755,202304,1397,3384,899,2470,162,502,258,587,420,1089
500769,202304,6509,15212,3609,9941,887,2484,435,1027,1322,3511
500770,202304,1705,4329,1230,3573,239,735,406,1151,645,1886
500780,202304,1593,3768,1039,2803,171,521,246,519,417,1040
500790,202304,9771,24234,7043,19359,1360,4098,2621,6830,3981,10928
500793,202304,2653,6242,1902,4957,377,1061,748,1700,1125,2761
500795,202304,3825,7966,3119,7054,272,707,2498,5569,2770,6276
500797,202304,1031,2374,717,1820,243,679,207,477,450,1156
500800,202304,4443,9529,2838,7157,682,1945,749,1828,1431,3773
500830,202304,26925,61692,18145,46236,3998,10840,6388,14752,10386,25592
500840,202304,1794,4046,1146,2854,127,332,565,1244,692,1576
510010,202304,2181,4429,1601,3711,204,447,1077,2496,1281,2943
510020,202304,5071,12219,2823,7949,490,1392,724,1823,1214,3215
510025,202304,9513,21411,6237,16330,719,2042,3495,8552,4214,10594
510030,202304,3908,8105,2511,5956,212,524,1284,2971,1496,3495
510035,202304,1332,3419,857,2641,222,691,307,1012,529,1703
510040,202304,3022,6187,2263,5231,318,726,1367,3232,1685,3958
510050,202304,2827,5334,2033,4350,220,574,1484,3020,1704,3594
510060,202304,1941,4663,1336,3588,345,999,271,571,616,1570
510080,202304,1937,4615,1260,3517,203,618,466,1088,669,1706
510100,202304,856,1776,624,1444,69,179,387,813,456,992
510120,202304,321,550,195,405,10,24,152,296,162,320
510125,202304,2636,6277,1986,5258,259,805,883,2058,1142,2863
510130,202304,2062,4723,1480,3836,296,872,734,1744,1030,2616
510140,202304,3715,9231,2539,7632,1044,3424,683,2086,1727,5510
510160,202304,2552,5440,1969,4691,71,189,1750,4136,1821,4325
510170,202304,6290,14839,4820,12551,843,2472,2465,6011,3308,8483
510180,202304,18905,38511,13066,30615,1884,4759,7020,16348,8904,21107
510185,202304,2077,5135,1407,4165,502,1568,427,1416,929,2984
510190,202304,3113,8039,1982,6201,467,1585,507,1557,974,3142
510250,202304,22592,51469,16801,42971,2519,7095,9533,23938,12052,31033
510260,202304,2222,9006,1871,8422,262,1135,1168,5879,1430,7014
510263,202304,4936,12819,3339,9713,603,1902,802,1875,1405,3777
510267,202304,7094,19188,4224,12832,743,2407,812,2071,1555,4478
510268,202304,1524,3805,1047,2994,265,783,205,518,470,1301
510269,202304,1174,2984,774,2259,147,468,317,849,464,1317
510270,202304,3640,9763,2557,7923,413,1419,1033,3076,1446,4495
510279,202304,2233,5401,1285,3709,195,602,391,1000,586,1602
510285,202304,1300,3201,827,2377,210,667,259,661,469,1328
510300,202304,5197,11385,3956,9776,291,762,2930,7140,3221,7902
510305,202304,1854,4771,1273,3756,284,859,426,1236,710,2095
510310,202304,1346,3080,971,2488,258,626,367,960,625,1586
510320,202304,5181,11755,3514,9088,788,2288,1054,2371,1842,4659
510325,202304,5345,14549,3642,11288,874,2930,696,2050,1570,4980
510330,202304,3291,8547,2260,6866,565,1867,946,2808,1511,4675
510335,202304,6156,15989,4697,13688,972,3041,2384,6815,3356,9856
510336,202304,653,1718,478,1454,67,191,269,876,336,1067
510337,202304,1779,4725,1162,3642,406,1394,282,799,688,2193
510340,202304,127438,266429,88919,212785,17182,47755,40963,87771,58145,135526
510343,202304,1550,3429,1060,2673,129,359,592,1394,721,1753
510345,202304,1698,4141,1290,3429,241,700,685,1630,926,2330
510350,202304,4015,9569,2705,7445,791,2256,647,1706,1438,3962
510360,202304,2307,4315,1417,3282,55,108,1052,2520,1107,2628
510370,202304,2246,5850,1737,5093,322,916,1003,3055,1325,3971
510380,202304,666,1512,397,1072,50,160,162,414,212,574
510385,202304,1532,4709,1179,4096,106,416,804,2864,910,3280
510390,202304,1826,3986,1263,3330,232,661,796,2051,1028,2712
510395,202304,843,1696,562,1307,43,83,376,885,419,968
510410,202304,6757,16336,5102,13699,701,1958,3276,8722,3977,10680
510420,202304,3307,6024,2318,4734,59,131,1875,3725,1934,3856
510450,202304,626,1416,376,1019,81,223,141,343,222,566
510452,202304,1184,3044,918,2547,140,394,530,1466,670,1860
510454,202304,1472,3564,1025,2822,187,495,559,1642,746,2137
510455,202304,1157,2916,757,2171,147,461,276,718,423,1179
510460,202304,2440,5714,1724,4649,635,1984,473,869,1108,2853
510480,202304,6135,13917,4032,10168,723,2010,1761,3922,2484,5932
510490,202304,2194,4998,1636,4294,230,594,1060,2846,1290,3440
510500,202304,1774,4047,1072,2977,266,786,263,705,529,1491
510510,202304,5021,12908,3467,10318,1047,3434,988,2830,2035,6264
510515,202304,6815,16514,4771,13051,918,2685,1861,4676,2779,7361
510517,202304,2039,4828,1425,3947,493,1540,446,1095,939,2635
510520,202304,2805,5473,1506,3768,206,543,624,1621,830,2164
510523,202304,1421,3149,1032,2566,172,474,591,1366,763,1840
510525,202304,10571,27294,7770,21906,1572,4798,2751,6973,4323,11771
510530,202304,698,1651,533,1425,40,124,382,997,422,1121
510550,202304,3181,8388,2425,7118,493,1520,1249,3539,1742,5059
510558,202304,2833,7157,2059,5980,312,841,1002,3089,1314,3930
510560,202304,2404,6416,1534,4726,387,1277,268,815,655,2092
510562,202304,7699,16617,5764,13510,937,2388,3029,6459,3966,8847
510590,202304,4091,9194,2984,7765,316,869,2098,5392,2414,6261
510600,202304,1585,3155,1094,2474,242,692,533,987,775,1679
510610,202304,3481,7661,2454,6300,328,998,1487,3647,1815,4645
510615,202304,3564,8334,2499,6697,457,1314,1316,3432,1773,4746
510617,202304,1319,3623,1067,3250,138,444,760,2385,898,2829
510618,202304,1606,3842,1155,3144,218,692,600,1520,818,2212
510619,202304,904,2199,505,1470,112,334,101,218,213,552
510620,202304,1726,3653,834,2259,297,902,71,146,368,1048
510621,202304,1956,4938,1175,3527,284,898,308,807,592,1705
510622,202304,7066,18230,4494,12983,1263,3879,612,1480,1875,5359
510623,202304,3412,7765,2474,6360,525,1438,965,2359,1490,3797
510624,202304,1856,4652,1049,3173,126,434,203,530,329,964
510625,202304,4505,10183,2785,7289,559,1609,936,2357,1495,3966
510626,202304,1625,3865,1114,3074,304,953,263,683,567,1636
510627,202304,804,1935,460,1303,120,362,125,377,245,739
510628,202304,1739,3657,1113,2862,384,1124,373,843,757,1967
510629,202304,2219,5728,1405,4203,326,1089,315,874,641,1963
510630,202304,4203,10740,2712,8160,650,2030,632,2062,1282,4092
510631,202304,729,1581,561,1348,24,50,446,1079,470,1129
510637,202304,4502,9874,3221,8108,901,2556,1105,2554,2006,5110
510642,202304,7250,18214,5629,15920,1032,3332,3230,8758,4262,12090
510645,202304,1252,2360,753,1712,209,480,305,684,514,1164
510650,202304,9653,20860,7526,18544,975,1513,5424,14795,6399,16308
510665,202304,2107,4324,1342,3164,298,669,536,1332,834,2001
510670,202304,501,1049,320,807,41,101,176,443,217,544
510675,202304,8335,21343,5686,16487,1424,4621,1131,2829,2555,7450
510677,202304,2736,6594,1973,5464,347,1033,1120,3028,1467,4061
510680,202304,872,2121,489,1451,88,286,126,310,214,596
510682,202304,2124,5529,1598,4693,490,1602,589,1627,1079,3229
510685,202304,629,1619,469,1327,48,130,276,772,324,902
510700,202304,5404,11736,3745,9416,391,1159,2526,6065,2917,7224
510704,202304,14351,31752,9771,24388,2301,6241,3209,7083,5510,13324
510706,202304,3075,8421,2188,6905,437,1406,897,3005,1334,4411
510710,202304,3704,8507,2327,6039,655,1688,542,1262,1197,2950
510715,202304,799,1598,498,1172,48,131,313,703,361,834
510718,202304,2697,6037,1677,4658,329,928,788,2425,1117,3353
510719,202304,585,1172,342,832,51,144,161,323,212,467
510720,202304,1110,2382,751,1893,157,454,327,739,484,1193
510724,202304,1085,2901,732,2212,101,352,314,844,415,1196
510726,202304,1065,1958,637,1439,66,143,367,813,433,956
510729,202304,731,1615,341,910,34,103,112,284,146,387
510730,202304,3619,8163,2506,6505,444,1354,1276,2931,1720,4285
510735,202304,1660,4245,1352,3799,132,354,1060,3002,1192,3356
510740,202304,1176,2640,807,2017,69,199,509,1134,578,1333
510757,202304,646,1938,504,1700,130,499,212,659,342,1158
510760,202304,56793,118289,35506,87022,7599,21113,12435,26260,20034,47373
510770,202304,5290,10585,3832,8766,215,478,2842,6536,3057,7014
510774,202304,523,1254,364,1019,61,179,202,570,263,749
510775,202304,823,1971,513,1486,115,354,125,336,240,690
510776,202304,967,2340,656,1750,123,353,305,785,428,1138
510777,202304,1725,4337,1228,3692,236,805,710,2004,946,2809
510779,202304,1019,2565,750,2130,99,265,454,1348,553,1613
510780,202304,5423,12225,3900,10040,719,1816,2000,5430,2719,7246
510785,202304,2490,6096,1463,4265,334,1025,445,1241,779,2266
510787,202304,4419,11616,3036,8970,1084,3338,301,802,1385,4140
510788,202304,601,1355,397,1035,67,160,187,537,254,697
510790,202304,24904,61159,15860,45406,3376,10664,1558,3847,4934,14511
510792,202304,13816,36141,9073,27098,2163,7088,1993,5101,4156,12189
510794,202304,1517,3939,1100,3263,326,1093,187,425,513,1518
510795,202304,14089,33161,10021,26365,2228,6528,3627,8473,5855,15001
510800,202304,1836,4656,1280,3735,371,1178,165,351,536,1529
510805,202304,1833,4753,1162,3542,247,805,403,1125,650,1930
510810,202304,830,1596,544,1226,171,344,260,625,431,969
510820,202304,927,1699,549,1230,23,57,376,798,399,855
510830,202304,1074,2415,830,2101,103,290,544,1402,647,1692
510835,202304,737,1582,476,1216,58,168,292,702,350,870
510840,202304,81881,158653,59697,131900,9569,20777,36468,80804,46037,101581
510850,202304,2201,5371,1382,4042,333,1079,100,197,433,1276
510860,202304,3352,8173,2253,6480,808,2527,428,1182,1236,3709
510880,202304,875,2341,628,1907,211,667,117,334,328,1001
510885,202304,770,1788,502,1370,105,267,124,332,229,599
510890,202304,1045,2711,740,2174,223,721,166,444,389,1165
510895,202304,1837,4366,1229,3328,231,740,585,1388,816,2128
520005,202304,4854,11673,3880,10372,1281,3193,1388,4396,2669,7589
520010,202304,3676,9012,2744,7239,599,1773,1118,2517,1717,4290
520013,202304,4512,10554,2924,7716,774,2050,759,2092,1533,4142
520015,202304,617,1465,455,1224,105,275,158,457,263,732
520017,202304,1522,3535,1051,2787,187,570,445,1040,632,1610
520020,202304,702,1242,541,1059,51,96,417,794,468,890
520025,202304,50308,121466,43087,111306,6673,18175,27023,68246,33696,86421
520030,202304,9072,18999,7595,17047,612,1345,5828,12860,6440,14205
520050,202304,520,1181,284,747,57,142,114,296,171,438
520055,202304,2092,4891,1264,3201,216,523,504,1171,720,1694
520060,202304,2423,5736,1652,4436,319,961,428,1094,747,2055
520080,202304,2312,5359,1771,4647,382,966,837,2269,1219,3235
520082,202304,1015,2421,698,1872,154,442,241,665,395,1107
520085,202304,1266,2899,1023,2578,237,594,480,1176,717,1770
520090,202304,1102,1985,819,1685,110,151,630,1362,740,1513
520110,202304,55898,137592,38548,108650,10528,32028,2733,6574,13261,38602
520120,202304,317,704,175,458,25,78,68,157,93,235
520130,202304,4906,10815,3757,9022,767,1931,1518,3469,2285,5400
520140,202304,65193,158798,45683,126491,15162,45143,5391,14693,20553,59836
520145,202304,719,1561,459,1179,106,294,156,352,262,646
520150,202304,871,1969,663,1700,86,215,370,912,456,1127
520160,202304,1083,2477,723,1833,128,306,311,794,439,1100
520170,202304,5849,11690,3878,9240,506,1323,2474,5624,2980,6947
520180,202304,3539,8049,2880,7152,384,1098,1900,4511,2284,5609
520215,202304,2228,4900,1675,4109,188,537,1058,2445,1246,2982
520235,202304,944,1838,627,1415,100,253,400,849,500,1102
520250,202304,2238,5180,1605,4235,643,1884,166,504,809,2388
520260,202304,908,2036,552,1452,112,292,180,460,292,752
520280,202304,1040,2151,818,1837,216,487,373,820,589,1307
520310,202304,1129,2315,767,1793,178,489,355,803,533,1292
520320,202304,2612,6196,1930,5130,290,779,967,2599,1257,3378
520330,202304,6412,14970,5022,12726,756,2232,2958,6901,3714,9133
520340,202304,2825,5737,1667,4101,192,436,802,2081,994,2517
520350,202304,4433,9972,2996,7759,989,2642,817,2125,1806,4767
520355,202304,2267,5814,1687,4734,531,1589,250,625,781,2214
520357,202304,1097,2353,797,1935,55,138,611,1458,666,1596
520360,202304,998,2298,789,1972,124,365,391,888,515,1253
520380,202304,1669,3979,994,2743,165,469,277,657,442,1126
520390,202304,1440,3190,927,2466,245,752,179,488,424,1240
520393,202304,870,1857,605,1473,86,226,285,636,371,862
520396,202304,1093,2477,920,2213,64,147,633,1459,697,1606
520400,202304,1977,4308,1534,3732,102,258,1117,2720,1219,2978
520410,202304,2754,5620,1937,4443,284,749,1112,2347,1396,3096
520420,202304,460,960,368,822,19,54,276,590,295,644
520425,202304,1889,4388,1054,2812,300,867,186,396,486,1263
520430,202304,3083,6786,1851,4737,377,973,307,676,684,1649
520440,202304,3699,8504,2163,5763,437,1313,457,1110,894,2423
520450,202304,18230,40820,12618,32028,3283,8676,3422,8392,6705,17068
520455,202304,1006,2394,706,1958,201,573,201,576,402,1149
520460,202304,1310,2844,991,2412,238,536,518,1324,756,1860
520465,202304,1089,2349,908,2116,52,149,704,1603,756,1752
520470,202304,3034,6753,2367,5923,776,2115,922,2258,1698,4373
520480,202304,1247,3104,929,2585,216,605,388,1040,604,1645
520485,202304,1894,5216,1530,4645,266,867,826,2436,1092,3303
520490,202304,5478,12867,4205,10971,694,1935,2430,6126,3124,8061
520495,202304,2020,3871,1533,3230,128,280,1115,2306,1243,2586
520500,202304,2206,4946,1670,4054,298,815,863,1882,1161,2697
520505,202304,1192,2227,937,1918,106,172,712,1466,818,1638
520510,202304,12740,28739,9755,24265,1657,4819,4993,11340,6650,16159
520520,202304,1419,3337,1123,2897,305,845,457,1131,762,1976
520530,202304,3183,7712,2307,6223,449,1198,1062,3034,1511,4232
520540,202304,3779,9146,2598,6971,459,1332,874,2059,1333,3391
520545,202304,1841,4098,1419,3474,348,855,615,1455,963,2310
520547,202304,1795,4248,1395,3575,289,735,697,1759,986,2494
520549,202304,21922,50363,18204,45087,2286,6299,12145,28659,14431,34958
520551,202304,6556,14687,5436,13113,466,1372,4091,9357,4557,10729
520552,202304,1206,2856,950,2488,241,653,435,1161,676,1814
520570,202304,685,1442,432,1057,74,164,193,461,267,625
520580,202304,2820,5683,2067,4822,450,1031,1093,2572,1543,3603
520590,202304,1706,3958,1182,3116,260,704,464,1176,724,1880
520620,202304,12398,28980,10122,25791,1818,5035,5765,14222,7583,19257
520630,202304,1065,2461,763,1995,107,281,325,828,432,1109
520640,202304,2812,6410,2058,5086,531,1345,576,1475,1107,2820
520650,202304,1324,2610,980,2156,216,443,508,1163,724,1606
520660,202304,597,1467,368,1054,82,252,95,275,177,527
520670,202304,1220,2836,991,2498,97,215,675,1659,772,1874
520680,202304,1053,2237,837,1946,134,261,519,1230,653,1491
520690,202304,418,1025,293,796,84,228,84,202,168,430
520710,202304,555,1243,374,945,21,54,232,543,253,597
520725,202304,1646,3723,1106,2831,213,576,465,1150,678,1726
520735,202304,1146,2477,775,1898,237,554,232,567,469,1121
520740,202304,3266,6941,2310,5622,492,1220,1011,2416,1503,3636
520750,202304,915,1908,669,1561,113,256,368,817,481,1073
520753,202304,1602,3829,1220,3184,226,668,592,1397,818,2065
520760,202304,1834,3495,1542,3152,28,61,1423,2902,1451,2963
520780,202304,1955,4325,1441,3607,226,572,720,1747,946,2319
520790,202304,3929,8730,2683,6740,426,983,1408,3686,1834,4669
520800,202304,23995,54640,18823,47049,3467,8894,10407,25903,13874,34797
520810,202304,1427,2893,1070,2477,281,653,504,1251,785,1904
520815,202304,697,1998,513,1607,92,294,152,467,244,761
520830,202304,2192,4377,1582,3654,96,224,1205,2726,1301,2950
520840,202304,3658,8958,2918,7975,814,2443,989,2632,1803,5075
520850,202304,1154,2335,864,1929,161,419,431,899,592,1318
520860,202304,12070,29446,8900,24005,2286,6542,2999,7586,5285,14128
520870,202304,196212,418080,143829,339993,27214,68813,67440,147783,94654,216596
520880,202304,12338,32055,9901,27748,2107,6036,4135,11163,6242,17199
520890,202304,6130,12506,4326,9840,695,1892,2338,4824,3033,6716
520910,202304,5746,13456,3877,10240,864,2438,1025,2404,1889,4842
520915,202304,1027,2461,696,1831,132,383,303,728,435,1111
520920,202304,5532,11362,4201,9745,871,1853,2290,5513,3161,7366
520929,202304,776,1723,589,1448,102,199,257,675,359,874
520940,202304,1180,2872,928,2493,90,273,669,1725,759,1998
520945,202304,581,1202,423,990,43,90,248,572,291,662
520960,202304,1415,2914,1088,2463,396,853,379,939,775,1792
520970,202304,4690,11077,3501,9249,1213,3302,725,1995,1938,5297
520980,202304,947,2009,698,1691,103,257,346,793,449,1050
520990,202304,3914,8487,3193,7612,518,1102,2172,5306,2690,6408
520993,202304,1491,3408,996,2502,272,711,320,733,592,1444
520995,202304,3211,7427,2293,6019,566,1652,491,1371,1057,3023
521000,202304,12133,28764,8176,21602,1330,3644,2690,6486,4020,10130
521010,202304,4961,11588,3674,9375,571,1639,1907,4481,2478,6120
521015,202304,969,2218,680,1718,40,108,445,1054,485,1162
521020,202304,5871,13374,3620,9409,815,2228,945,2292,1760,4520
521030,202304,1018,1706,795,1417,22,43,692,1192,714,1235
521040,202304,10702,24501,7895,20161,2040,5290,2321,6119,4361,11409
521056,202304,1303,3175,884,2463,262,720,160,473,422,1193
521060,202304,1228,2971,848,2276,193,577,282,712,475,1289
521080,202304,1271,2596,701,1743,130,329,248,576,378,905
521090,202304,3789,9601,2539,7078,611,1884,258,635,869,2519
521100,202304,2433,4940,1805,4112,243,585,1157,2613,1400,3198
521120,202304,6181,13825,4724,11941,1363,3429,1171,3412,2534,6841
521130,202304,1283,2864,613,1633,71,206,313,817,384,1023
521140,202304,2062,4699,1515,3774,196,495,911,2136,1107,2631
521150,202304,18028,37850,11858,28889,3052,8211,4635,10611,7687,18822
521160,202304,1040,1989,666,1413,68,126,431,871,499,997
521170,202304,1328,2897,966,2333,167,455,425,931,592,1386
521180,202304,10917,25789,8479,21843,1806,5059,3796,9388,5602,14447
521190,202304,14576,34055,9591,25963,2305,6818,2871,7096,5176,13914
521200,202304,878,2004,601,1572,93,267,259,601,352,868
521205,202304,770,1671,593,1403,27,66,469,1061,496,1127
521210,202304,1056,2619,621,1743,163,500,144,302,307,802
521220,202304,4766,10438,3237,8042,827,2355,1283,2767,2110,5122
521225,202304,535,1016,404,874,37,76,306,664,343,740
521230,202304,1828,4189,1507,3767,640,1688,445,1072,1085,2760
521250,202304,47384,107810,38763,96114,8852,23824,21088,49798,29940,73622
521260,202304,655,1369,484,1126,69,186,270,578,339,764
521270,202304,2694,5859,2217,5253,245,529,1570,3800,1815,4329
521280,202304,2226,5537,1667,4642,335,991,609,1641,944,2632
521290,202304,712,1495,483,1195,49,132,283,647,332,779
521295,202304,1464,2972,1095,2493,182,401,609,1303,791,1704
521300,202304,2278,5139,1733,4328,362,893,877,2191,1239,3084
521305,202304,809,1725,551,1378,53,146,349,837,402,983
521308,202304,5942,14365,4156,11175,385,1145,2566,6506,2951,7651
521310,202304,13913,32425,9650,24906,2007,5716,3700,8592,5707,14308
521340,202304,519,1097,340,847,28,65,184,430,212,495
521350,202304,2344,5577,1799,4758,130,374,1284,3303,1414,3677
521370,202304,1591,3885,1047,2994,340,1051,152,452,492,1503
521375,202304,2034,4988,1371,3809,280,773,332,961,612,1734
521377,202304,1608,3222,1185,2695,157,302,827,2005,984,2307
521380,202304,8179,20294,5261,15065,907,2813,923,2653,1830,5466
521385,202304,866,1910,646,1626,99,230,341,914,440,1144
521390,202304,877,2118,590,1661,144,474,114,277,258,751
521400,202304,3762,8118,2988,7080,444,1087,1809,4163,2253,5250
521405,202304,1663,4112,1108,3072,129,389,526,1377,655,1766
521410,202304,1135,2477,903,2140,216,453,469,1169,685,1622
521440,202304,1742,3940,1342,3347,405,956,579,1501,984,2457
521450,202304,5254,14211,3944,11724,1027,3109,886,2623,1913,5732
521460,202304,7919,18537,5532,14345,1446,3930,1771,4380,3217,8310
521470,202304,1056,2424,735,1854,139,318,337,811,476,1129
521480,202304,644,1309,443,992,65,159,240,459,305,618
521483,202304,2854,6375,2059,5195,656,1650,694,1771,1350,3421
521486,202304,2135,4753,1646,4043,148,279,1050,2560,1198,2839
521487,202304,598,1290,444,1090,95,231,259,631,354,862
521490,202304,1036,2494,778,2094,40,141,554,1389,594,1530
521500,202304,2437,5912,1926,5190,191,701,1129,2793,1320,3494
521520,202304,1055,2236,819,1910,112,232,496,1150,608,1382
521523,202304,18922,49855,14616,41885,4513,13355,5507,15070,10020,28425
521525,202304,1307,2882,990,2426,98,298,630,1448,728,1746
521530,202304,2739,6742,1780,4872,351,983,516,1291,867,2274
521540,202304,904,2186,681,1821,174,520,274,672,448,1192
521550,202304,2159,5101,1135,3070,210,599,248,709,458,1308
521560,202304,7315,16899,5320,14187,1553,4299,2070,5659,3623,9958
521565,202304,841,1941,573,1498,106,286,249,630,355,916
521570,202304,5450,13526,3791,10533,835,2519,536,1484,1371,4003
521580,202304,690,1494,451,1104,80,209,181,395,261,604
521590,202304,1109,2217,798,1799,108,254,479,1019,587,1273
521600,202304,540,1308,319,899,58,192,139,336,197,528
521630,202304,2133,4299,1317,3134,423,1050,328,693,751,1743
521640,202304,2425,5395,1548,4054,362,1082,422,988,784,2070
521645,202304,637,1550,351,1022,160,448,20,47,180,495
521680,202304,1757,4342,1378,3744,355,995,563,1486,918,2481
521690,202304,651,1518,536,1367,83,227,297,732,380,959
521710,202304,4346,9773,2889,7358,521,1467,820,1782,1341,3249
521720,202304,3112,6485,1965,4762,256,679,1062,2478,1318,3157
521730,202304,5157,12779,3751,10436,1009,3155,825,1850,1834,5005
521740,202304,5966,13755,4750,12010,1660,4538,1422,3156,3082,7694
521760,202304,24590,55815,20205,49815,4190,11617,11433,26531,15623,38148
521770,202304,4043,8805,2622,6647,516,1343,570,1411,1086,2754
521800,202304,8971,21249,6325,17002,2018,5542,1638,4823,3656,10365
521805,202304,1427,2776,933,2122,197,408,440,1069,637,1477
521810,202304,932,1968,684,1633,125,303,398,950,523,1253
521830,202304,7611,18452,6214,16291,554,1696,4397,11041,4951,12737
521839,202304,1096,2316,844,1927,82,223,599,1258,681,1481
521850,202304,8863,19200,5669,14339,1827,4670,670,1555,2497,6225
521860,202304,2012,5166,1401,4034,259,812,410,1055,669,1867
521870,202304,897,2253,655,1817,124,385,247,577,371,962
521878,202304,1056,2554,688,1830,68,197,359,873,427,1070
521880,202304,31927,72268,23211,58843,4944,13505,10213,24110,15157,37615
521890,202304,4191,9884,2863,7641,774,2097,750,1840,1524,3937
521900,202304,1736,3844,949,2530,266,599,41,113,307,712
521910,202304,1698,3539,1242,2960,313,721,468,1073,781,1794
521920,202304,688,1614,540,1377,67,207,338,795,405,1002
521925,202304,1040,2410,758,1998,152,435,338,844,490,1279
521930,202304,6906,15586,4636,12248,1420,3233,1725,5026,3145,8259
521935,202304,1254,2814,864,2169,93,247,510,1206,603,1453
521940,202304,1615,3325,1093,2598,195,503,580,1321,775,1824
521945,202304,826,1909,562,1452,96,249,285,723,381,972
521950,202304,926,2011,641,1573,111,279,296,707,407,986
521960,202304,804,1952,550,1470,61,197,325,786,386,983
521970,202304,3485,7239,2656,6213,273,572,1904,4549,2177,5121
521971,202304,948,2191,642,1678,154,388,163,403,317,791
521973,202304,2092,4999,1526,4027,202,541,869,2204,1071,2745
521975,202304,17857,41012,14598,36441,2524,6902,8680,20757,11204,27659
521980,202304,2771,6043,2079,5116,145,392,1558,3769,1703,4161
521990,202304,1733,3910,1449,3525,281,739,861,2120,1142,2859
522000,202304,3239,7716,2481,6745,967,2818,737,2059,1704,4877
522005,202304,529,1084,323,796,58,157,110,250,168,407
522010,202304,6010,13870,4248,10965,991,2705,1423,3426,2414,6131
522015,202304,1328,3173,1001,2683,283,784,387,991,670,1775
522020,202304,6850,14827,4617,11475,990,2574,2022,4947,3012,7521
522026,202304,948,2297,621,1720,114,371,190,435,304,806
522028,202304,645,1434,446,1106,70,209,225,488,295,697
522040,202304,4758,9526,3315,7570,480,1225,1935,3990,2415,5215
522045,202304,26758,67222,20225,56485,4681,13940,5265,13903,9946,27843
522050,202304,1499,3546,1072,2833,201,600,465,1050,666,1650
522060,202304,3928,9550,2845,7832,584,1556,1169,3217,1753,4773
522068,202304,2292,4936,1860,4430,133,274,1483,3569,1616,3843
522070,202304,1066,2068,867,1787,28,53,745,1502,773,1555
522100,202304,1125,2600,730,1932,117,329,321,787,438,1116
522108,202304,1470,2977,1152,2551,60,153,903,1911,963,2064
522119,202304,2490,5259,2013,4684,325,667,1236,2920,1561,3587
522130,202304,672,1483,526,1289,40,86,399,994,439,1080
522140,202304,31886,75232,22540,58917,4996,13945,6733,15867,11729,29812
522145,202304,935,2090,670,1704,145,411,340,824,485,1235
522150,202304,1366,2984,920,2295,219,545,275,668,494,1213
522155,202304,1225,2934,927,2461,150,367,490,1288,640,1655
522157,202304,926,1828,753,1624,45,93,576,1244,621,1337
522160,202304,7885,18672,5239,14121,1378,4035,527,1489,1905,5524
522170,202304,3409,8064,2641,6913,406,1052,1574,4095,1980,5147
522180,202304,925,1943,613,1398,124,289,188,433,312,722
522185,202304,32027,72008,23587,60894,9811,27760,3843,10321,13654,38081
522190,202304,1009,2121,674,1617,124,324,321,681,445,1005
522200,202304,2644,6591,1967,5436,524,1464,720,1952,1244,3416
522205,202304,1983,4528,1451,3733,521,1441,336,769,857,2210
522220,202304,1480,3211,1089,2699,151,366,641,1633,792,1999
522230,202304,1660,3640,1290,3110,182,487,776,1796,958,2283
530010,202304,351930,821476,296627,738509,43476,118031,177430,418449,220906,536480
110001,202303,4952,12785,3319,9767,784,2579,1030,2864,1814,5443
110002,202303,17490,41170,12786,33563,3261,9245,3623,9008,6884,18253
110003,202303,918,2515,665,2021,162,519,141,372,303,891
110004,202303,17783,41612,12280,32483,2677,7546,4286,10719,6963,18265
110005,202303,3193,7758,2273,6322,538,1519,695,1971,1233,3490
110006,202303,1786,4735,1124,3415,191,646,220,600,411,1246
110007,202303,1508,3600,955,2668,266,763,196,602,462,1365
110008,202303,4311,10028,3224,8550,631,1464,1801,5342,2432,6806
110009,202303,5600,14472,3616,10937,794,2627,1275,3623,2069,6250
110010,202303,10251,28080,7878,24026,1937,5366,3537,12381,5474,17747
110011,202303,9624,23381,6708,18390,1848,5294,1459,3774,3307,9068
110012,202303,22270,51502,14921,39562,3755,10131,3667,9058,7422,19189
110013,202303,7197,18826,4990,14645,1810,5717,821,2358,2631,8075
110014,202303,4823,11587,3203,8655,518,1527,1490,3839,2008,5366
110015,202303,7668,18020,4993,13314,1071,3250,1501,3262,2572,6512
110018,202303,5728,13380,3667,9925,765,2202,880,2098,1645,4300
110020,202303,118929,248025,91027,211314,18937,45509,47595,109988,66532,155497
110025,202303,5953,13424,4259,10666,656,1863,2242,5244,2898,7107
110026,202303,712,1785,504,1433,119,365,144,418,263,783
110028,202303,9368,22184,6009,16500,1477,4566,650,1693,2127,6259
110029,202303,1940,4490,1204,3273,220,584,479,1289,699,1873
110030,202303,17865,39250,11337,29620,3227,9126,1580,4132,4807,13258
110032,202303,4646,11883,2830,8329,903,2689,482,1462,1385,4151
110033,202303,5952,16117,4483,13476,1383,4281,1471,4612,2854,8893
110034,202303,3956,8848,2662,7027,936,2745,632,1766,1568,4511
110037,202303,1928,5341,1333,4236,363,1198,382,1191,745,2389
110040,202303,3615,9305,2591,7522,674,2128,637,1665,1311,3793
110045,202303,5633,14908,4143,12301,1185,3815,1348,3902,2533,7717
110050,202303,2126,5364,1397,4118,467,1559,165,377,632,1936
110060,202303,1153,3171,758,2278,198,614,163,473,361,1087
110070,202303,1897,5424,1343,4239,355,1220,311,826,666,2046
110080,202303,8133,18092,6067,15365,1349,3538,2903,7527,4252,11065
110090,202303,746,1887,517,1476,122,413,152,401,274,814
110092,202303,1705,4533,1226,3673,283,890,584,1739,867,2629
110094,202303,3467,9358,2569,7709,910,2888,379,1190,1289,4078
110100,202303,2213,5833,1737,5003,637,1927,515,1473,1152,3400
110110,202303,2212,5532,1573,4537,467,1476,288,872,755,2348
110120,202303,1652,4322,1160,3399,281,860,305,860,586,1720
110130,202303,3372,7785,2072,5552,423,1164,263,676,686,1840
110140,202303,3078,8021,2305,6594,478,1510,1039,2805,1517,4315
110143,202303,1750,4415,1272,3596,357,1127,397,1034,754,2161
110145,202303,1173,2851,722,2017,186,506,271,786,457,1292
110146,202303,638,1574,430,1235,136,378,137,428,273,806
110147,202303,983,2321,661,1753,91,275,329,757,420,1032
110148,202303,1182,3034,617,1837,139,464,68,143,207,607
110149,202303,4266,10098,2931,8065,984,2817,673,1927,1657,4744
110150,202303,3054,7404,1966,5680,609,1933,289,873,898,2806
110155,202303,1038,2783,715,2032,141,459,292,730,433,1189
110160,202303,1790,4919,1287,3890,457,1431,206,603,663,2034
110170,202303,2589,6113,1688,4517,274,825,946,2319,1220,3144
110175,202303,2655,6918,1820,5215,335,1052,780,2103,1115,3155
110180,202303,1630,4048,1139,3148,166,478,513,1379,679,1857
120001,202303,4377,10981,3528,9746,514,1651,2268,6062,2782,7713
120005,202303,2457,8271,2189,7845,261,955,1614,5914,1875,6869
120010,202303,7840,18546,6804,17152,621,1440,5241,13298,5862,14738
120013,202303,3146,8906,2694,8285,862,2570,1127,3911,1989,6481
120017,202303,3814,9126,3207,8301,435,1090,2102,5707,2537,6797
120020,202303,19787,60635,18274,58051,1286,4449,14391,45519,15677,49968
120025,202303,4707,10567,3877,9635,574,1419,2543,6607,3117,8026
120030,202303,7727,27441,7154,26509,536,2233,5342,20351,5878,22584
120032,202303,2124,8345,1996,8099,102,637,1677,6665,1779,7302
120033,202303,5443,16140,5093,15568,127,548,4477,13468,4604,14016
120034,202303,3614,10714,3126,9940,155,635,2599,8108,2754,8743
120035,202303,5197,15986,4820,15363,252,920,4141,13097,4393,14017
120038,202303,4072,10416,3492,9555,545,1586,2108,5872,2653,7458
120039,202303,2509,9419,2337,9099,139,718,1889,7289,2028,8007
120040,202303,77842,187344,67361,172394,8577,23313,44591,112292,53168,135605
120042,202303,4383,13181,4032,12581,194,744,3338,10263,3532,11007
120043,202303,1831,6459,1549,6048,56,352,1286,4932,1342,5284
120045,202303,7516,16999,6296,15533,575,1540,4759,11707,5334,13247
120050,202303,12413,36555,11436,35224,528,1948,9662,29711,10190,31659
120060,202303,12320,40531,11255,39016,496,2284,9630,33184,10126,35468
120070,202303,4338,11883,3719,11039,657,1818,2256,7155,2913,8973
120080,202303,7021,16146,6286,15146,729,1728,4780,11541,5509,13269
130002,202303,4158,13243,3657,12576,385,992,2965,10753,3350,11745
130006,202303,3209,9940,2667,9113,595,1853,1518,5722,2113,7575
130008,202303,3287,9875,2820,9231,176,589,2219,7524,2395,8113
130010,202303,5479,12749,4721,11890,157,367,4272,10768,4429,11135
130014,202303,4957,12378,3691,10494,742,2138,1999,5977,2741,8115
130020,202303,3418,12003,2985,11403,131,718,2425,9140,2556,9858
130030,202303,20082,40876,18751,39403,191,482,17976,37436,18167,37918
130040,202303,4958,13332,4083,12240,586,1666,2917,9063,3503,10729
130050,202303,9014,29196,7636,27442,440,1492,6498,23910,6938,25402
130060,202303,9042,32147,7705,30445,383,2148,6431,25015,6814,27163
130063,202303,7877,22779,6952,21740,206,879,6317,19674,6523,20553
130068,202303,4718,13419,3967,12452,215,833,3166,9884,3381,10717
130070,202303,9253,23555,7602,21748,772,1846,5768,17235,6540,19081
130080,202303,9510,28017,8168,26491,399,1165,7019,23229,7418,24394
130083,202303,3552,10078,3100,9526,275,840,2472,7825,2747,8665
130090,202303,5153,12548,4577,11895,102,220,4035,10816,4137,11036
130100,202303,9215,25463,7688,23847,159,428,7075,22256,7234,22684
130110,202303,11133,26486,9068,23951,1784,4203,5620,16324,7404,20527
130115,202303,6346,17292,5457,16279,151,431,4716,14288,4867,14719
130120,202303,20592,56502,18323,53659,1539,4905,15202,44387,16741,49292
130130,202303,7354,19343,5695,17249,641,1832,4053,13050,4694,14882
130140,202303,8891,27068,7788,25812,343,1343,6749,22460,7092,23803
130150,202303,4805,14384,4517,14067,80,385,4185,13005,4265,13390
130160,202303,8112,21554,7008,20221,380,917,6095,17901,6475,18818
130165,202303,4147,13468,3899,13187,160,608,3474,11795,3634,12403
130170,202303,17904,40137,14962,36922,438,1336,13448,32891,13886,34227
130180,202303,5400,15247,5156,14983,39,228,4989,14426,5028,14654
130185,202303,25545,53203,21124,48480,1749,2265,17792,43203,19541,45468
130190,202303,26233,72636,21529,66031,1969,5803,16273,50552,18242,56355
130195,202303,3044,9886,2571,9317,115,454,2153,7934,2268,8388
130200,202303,3812,8861,3117,7963,205,637,2484,6189,2689,6826
130210,202303,2000,6522,1797,6279,155,674,1443,4983,1598,5657
130220,202303,3228,8862,2666,8206,91,290,2373,7439,2464,7729
130230,202303,6256,21760,5461,20711,204,1063,4820,18304,5024,19367
130240,202303,18123,40251,15124,36593,145,662,14129,33671,14274,34333
130250,202303,32612,85737,27849,80265,1708,4160,22884,68017,24592,72177
130255,202303,6197,16476,5291,14987,259,656,4307,12196,4566,12852
130260,202303,477485,1043004,408597,954476,73778,186090,268379,610558,342157,796648
130270,202303,12354,37605,10247,34521,2021,6214,6413,22776,8434,28990
130280,202303,4646,15114,4230,14643,145,565,3898,13537,4043,14102
130290,202303,21902,51634,19731,49120,617,1650,18177,45061,18794,46711
130300,202303,6217,17639,5517,16728,141,606,4753,14264,4894,14870
130310,202303,10908,24951,9664,23495,491,1122,8454,20572,8945,21694
130320,202303,4330,12766,3601,11770,484,1487,2523,8580,3007,10067
130330,202303,5667,15656,4553,14354,226,784,3801,12207,4027,12991
130340,202303,31522,79954,27117,75094,1609,3790,22953,65493,24562,69283
130350,202303,4628,15118,4135,14493,158,720,3591,12580,3749,13300
130353,202303,9924,23537,8082,21189,1277,3064,5387,14785,6664,17849
130356,202303,7098,19130,6016,17546,1160,3304,3554,10862,4714,14166
130360,202303,3656,10835,2947,9962,96,418,2602,8790,2698,9208
130370,202303,6192,24483,5192,23035,762,4052,3094,13780,3856,17832
130380,202303,9708,37761,9078,36854,763,3571,7261,29456,8024,33027
130390,202303,9067,30422,7948,28827,397,1815,7028,25366,7425,27181
130395,202303,3109,8575,2575,7756,174,607,2092,6161,2266,6768
130400,202303,3637,9630,3090,8920,102,319,2731,7899,2833,8218
130406,202303,14671,45164,12464,42471,2645,8180,8013,28847,10658,37027
130410,202303,5549,16863,4802,15750,1283,4295,2588,8864,3871,13159
130420,202303,19192,56257,16172,52555,2135,6694,11449,38352,13584,45046
130423,202303,5394,15268,4681,14425,216,886,4111,12458,4327,13344
130426,202303,3928,12166,3523,11726,68,200,3105,10892,3173,11092
130430,202303,6248,13591,5382,12527,203,466,4803,11054,5006,11520
130440,202303,7355,17330,6308,16098,138,414,5896,15017,6034,15431
140002,202303,3078,8063,2653,7564,235,603,2066,6126,2301,6729
140005,202303,4140,10737,3596,10099,1127,3143,1990,5875,3117,9018
140010,202303,66791,170424,54143,152320,13385,39697,21208,60664,34593,100361
140015,202303,6974,14587,6026,13562,333,666,5356,12244,5689,12910
140017,202303,7388,16694,6492,15618,413,939,5411,13202,5824,14141
140020,202303,7172,17370,6149,16129,477,1268,4775,12684,5252,13952
140023,202303,3524,8902,2826,7959,317,960,2144,6082,2461,7042
140028,202303,2579,5978,2158,5466,139,363,1671,4252,1810,4615
140030,202303,8012,16292,7266,15453,344,476,6609,14366,6953,14842
140040,202303,3623,12318,3323,11942,108,533,3029,10852,3137,11385
140045,202303,4645,14563,4042,13772,1104,2991,2197,8664,3301,11655
140047,202303,7768,19793,6499,17980,877,2482,4396,12412,5273,14894
140050,202303,2225,5624,1883,5147,325,783,1224,3519,1549,4302
140060,202303,2801,5942,2505,5560,257,489,2073,4669,2330,5158
140070,202303,2516,11827,2430,11677,156,1044,2072,9762,2228,10806
150010,202303,66301,134579,59594,126330,1372,2629,53819,112849,55191,115478
150013,202303,2788,5694,2353,5225,142,239,1993,4513,2135,4752
150020,202303,19283,48101,17683,45984,1756,3579,14150,38106,15906,41685
150030,202303,11537,35785,10382,34460,794,2067,8385,29910,9179,31977
150034,202303,5503,11670,4444,10385,263,576,3670,8673,3933,9249
150040,202303,20366,46996,17847,44234,1144,1518,15746,40939,16890,42457
150050,202303,9975,26567,9008,25333,240,638,8178,23263,8418,23901
150060,202303,30317,72869,24561,64535,3607,9636,15453,40979,19060,50615
150070,202303,11036,30627,9773,29162,228,842,9067,27004,9295,27846
150080,202303,116857,246440,96500,219956,26046,59032,33323,85644,59369,144676
150085,202303,12337,27413,11207,26113,165,380,10589,24710,10754,25090
150090,202303,15975,40221,14879,38533,577,1507,13134,33605,13711,35112
150095,202303,9273,19631,8127,18264,930,1221,6635,15739,7565,16960
150100,202303,3683,11275,3223,10565,213,682,2635,8745,2848,9427
150110,202303,5802,19458,5389,19011,170,638,4972,17818,5142,18456
150120,202303,10094,26779,9323,25866,372,688,8279,23458,8651,24146
150125,202303,1123,2590,821,2173,100,304,520,1341,620,1645
150130,202303,31399,78216,26858,71610,5273,12511,16148,45751,21421,58262
150140,202303,383837,732090,328798,663432,29583,60258,241675,474004,271258,534262
150145,202303,5180,14763,4235,13292,1622,5054,1328,4931,2950,9985
150150,202303,23013,49669,19490,45329,1622,3561,14689,34105,16311,37666
150157,202303,4517,11029,3554,9722,467,1287,2248,6307,2715,7594
150160,202303,5126,10693,4738,10193,388,947,3852,8032,4240,8979
150170,202303,36575,91059,32612,84960,5514,12488,21081,58434,26595,70922
150172,202303,7309,16040,5924,14220,344,856,4682,11174,5026,12030
150175,202303,2537,6191,2151,5593,177,609,1657,4077,1834,4686
150178,202303,16025,33288,12260,29019,1233,1630,9655,24809,10888,26439
150180,202303,36353,91052,32782,87133,2837,4654,26549,76325,29386,80979
150190,202303,9808,23838,9018,22926,130,408,8440,21314,8570,21722
150195,202303,6525,17579,6045,16932,182,620,5506,15315,5688,15935
150200,202303,7367,18473,6631,17644,55,165,6096,16254,6151,16419
150210,202303,41784,106282,39365,103426,1448,3435,35187,93495,36635,96930
150215,202303,13707,34871,11702,31689,1981,5579,7064,18898,9045,24477
150220,202303,17597,41447,15380,38506,869,2061,11915,29474,12784,31535
150230,202303,18000,41915,15957,39243,1206,2572,12338,30729,13544,33301
150240,202303,46098,110968,38644,99222,8229,21643,17965,44039,26194,65682
150250,202303,5354,17567,5011,17197,417,1461,4358,15138,4775,16599
150260,202303,3620,9605,3159,8945,109,334,2668,7510,2777,7844
150270,202303,11255,28717,7949,22987,2223,6703,2229,6541,4452,13244
150275,202303,9768,24359,8928,23282,192,686,7992,20381,8184,21067
150276,202303,2939,7141,2560,6689,301,708,1799,5077,2100,5785
150277,202303,7177,15430,5693,13735,719,1748,4069,10007,4788,11755
150280,202303,9274,29701,8899,29161,672,1719,7429,25372,8101,27091
150285,202303,4411,12769,3799,11799,249,717,2941,9191,3190,9908
150290,202303,13984,32194,12632,30777,528,778,11401,28476,11929,29254
150293,202303,12353,26884,9676,23463,1064,2655,6735,16224,7799,18879
150295,202303,9300,22425,6510,18552,2152,6034,2180,7093,4332,13127
150300,202303,4296,8718,3944,8305,33,88,3746,7823,3779,7911
150304,202303,5487,14042,4589,12702,710,1806,3064,8798,3774,10604
150307,202303,7154,19962,6419,18811,296,833,5163,15138,5459,15971
150309,202303,8083,20510,6498,18023,925,2489,3995,11292,4920,13781
150310,202303,9017,30879,8456,30184,300,1286,7401,26773,7701,28059
150320,202303,11825,27477,10683,25907,945,2114,7986,19475,8931,21589
150330,202303,19138,50253,17599,48218,2403,5061,12190,36638,14593,41699
150340,202303,2988,7986,2617,7473,317,839,1893,5439,2210,6278
150345,202303,11566,27212,10198,25484,393,1084,8950,22177,9343,23261
150350,202303,12948,26194,11622,24535,943,1488,9764,20931,10707,22419
150360,202303,32052,77827,25752,70084,2544,4857,19409,55383,21953,60240
150370,202303,14424,36834,11806,33390,1547,3674,8374,25271,9921,28945
150375,202303,4921,17587,4444,16937,274,1028,3879,14938,4153,15966
150380,202303,13081,28915,10533,25611,285,826,8986,21527,9271,22353
150390,202303,9647,34062,8487,32182,1875,5994,5044,21143,6919,27137
150400,202303,8188,25414,7726,24698,137,479,6625,21761,6762,22240
150405,202303,11248,25459,9647,23564,792,1313,7605,19348,8397,20661
150410,202303,2416,6485,2039,5904,194,495,1419,4165,1613,4660
150420,202303,59657,142748,46982,124907,10663,29835,22748,61505,33411,91340
150430,202303,10272,25785,9296,24596,675,1291,7857,21212,8532,22503
150440,202303,8533,19974,7702,18925,484,1136,6490,15877,6974,17013
150442,202303,39542,78854,33356,71619,2013,4333,26678,56021,28691,60354
150445,202303,10224,23734,9178,22332,166,440,8444,20377,8610,20817
150450,202303,8065,23951,7512,23255,298,1415,6891,20812,7189,22227
150460,202303,10913,29510,9854,28203,533,1240,8198,24341,8731,25581
150470,202303,25948,61159,23106,57758,447,1501,21017,51848,21464,53349
150475,202303,6957,18774,5868,17113,975,2525,3784,11613,4759,14138
150480,202303,18040,47678,16180,45098,3709,8831,10046,30643,13755,39474
150490,202303,10123,31176,9089,29746,703,1939,7164,24346,7867,26285
150495,202303,6899,18761,6453,18191,163,634,5888,16433,6051,17067
150497,202303,3428,9592,2720,8408,544,1740,1456,4704,2000,6444
150500,202303,3909,9105,3433,8434,211,531,2712,6496,2923,7027
150503,202303,7210,17022,5203,14485,1701,4259,1952,6055,3653,10314
150506,202303,16937,41416,14474,38177,2430,5887,9783,27336,12213,33223
150510,202303,16066,41610,13977,38308,1120,2853,10999,30195,12119,33048
150520,202303,10226,30902,9767,30364,148,821,9240,28470,9388,29291
150530,202303,15441,46177,13329,43216,1247,3351,10260,34254,11507,37605
150540,202303,6632,14834,5689,13475,340,762,4722,11079,5062,11841
150543,202303,9243,23008,7613,20952,689,1906,5692,16042,6381,17948
150548,202303,13192,34876,11673,32778,532,1414,10091,28529,10623,29943
150549,202303,2403,5984,1997,5419,92,286,1601,4306,1693,4592
150550,202303,25733,67635,20868,60022,5760,17066,7740,22882,13500,39948
150553,202303,48916,121498,37610,103114,9740,27572,15759,42877,25499,70449
150555,202303,2530,5953,1966,5128,181,442,1315,3525,1496,3967
150560,202303,2455,6039,2171,5572,223,546,1468,3742,1691,4288
150563,202303,3339,8783,2701,7681,572,1706,1414,3973,1986,5679
150565,202303,5565,15954,4902,14958,156,524,3883,12073,4039,12597
150570,202303,9987,23397,9146,22302,274,820,8194,19734,8468,20554
150580,202303,14335,48448,12208,46100,1668,4899,9288,37598,10956,42497
150590,202303,10546,30345,9028,28567,258,945,8145,25895,8403,26840
150600,202303,13173,34390,12156,33174,404,1005,10979,30220,11383,31225
150610,202303,4087,9115,3634,8468,142,405,3130,7088,3272,7493
150611,202303,4101,9652,3549,8904,81,279,3114,7623,3195,7902
150613,202303,18675,46414,14225,39264,2841,8424,6917,18324,9758,26748
150616,202303,4782,12051,3456,9813,668,2060,1599,4337,2267,6397
150618,202303,9177,23013,7431,20370,1077,3189,4534,12316,5611,15505
150619,202303,8240,20859,6683,18734,933,2267,4531,13238,5464,15505
150620,202303,9555,27384,8370,25439,1795,5015,4598,14784,6393,19799
150630,202303,8945,18745,8172,17824,148,371,7483,16052,7631,16423
150635,202303,6905,16254,5764,14481,698,1600,3777,9583,4475,11183
150640,202303,2579,6824,2321,6502,55,161,2088,5864,2143,6025
150650,202303,15323,36623,13272,33584,3773,9247,5798,15561,9571,24808
150655,202303,7003,17328,6303,16360,99,343,5670,14496,5769,14839
150658,202303,5553,14678,4016,12138,1055,3370,1662,5038,2717,8408
150660,202303,7007,17750,6064,16399,1298,3390,3383,9134,4681,12524
150670,202303,12883,24784,10261,21802,1039,2213,7890,17018,8929,19231
150680,202303,99842,246072,79847,216807,17371,44265,41787,120899,59158,165164
150690,202303,3326,7099,2847,6532,142,263,2450,5725,2592,5988
150700,202303,8665,21646,7693,20466,953,1905,5637,15923,6590,17828
150710,202303,4765,13471,4254,12720,607,1726,2861,8785,3468,10511
150715,202303,6867,16169,5605,14417,321,810,4570,11715,4891,12525
150720,202303,10648,26048,9800,24933,345,1051,8698,21852,9043,22903
150730,202303,16723,44431,14192,40791,2070,6230,9632,28083,11702,34313
150740,202303,5041,12338,4344,11314,510,1075,3142,8454,3652,9529
150745,202303,7001,17180,5625,15255,736,2108,3837,10496,4573,12604
150746,202303,2183,5478,1933,5133,64,164,1605,4188,1669,4352
150747,202303,6899,16734,6134,15667,477,1065,4833,12452,5310,13517
150750,202303,4778,12615,3853,11300,429,1262,2685,8201,3114,9463
150760,202303,14761,37599,13222,35501,2576,6303,8208,23294,10784,29597
150770,202303,8913,26092,8153,25227,262,567,7408,23646,7670,24213
150775,202303,1508,3496,1187,3101,142,415,817,2115,959,2530
150780,202303,6257,16375,5539,15544,301,809,4904,14003,5205,14812
150790,202303,7842,18211,6601,16878,609,1177,4350,13262,4959,14439
150795,202303,21160,53666,18279,49640,3356,9075,11347,31514,14703,40589
150796,202303,5313,10556,4553,9698,211,400,3954,8428,4165,8828
150797,202303,5662,14431,4783,13209,552,1418,3696,10277,4248,11695
150800,202303,18423,49265,16377,46611,2859,7528,10563,31555,13422,39083
150803,202303,10972,25158,10079,24012,275,728,9151,21494,9426,22222
150805,202303,4531,12252,3807,11285,392,1114,2803,8494,3195,9608
150808,202303,8303,22096,6141,18592,2080,7051,879,2730,2959,9781
150810,202303,27419,60755,20903,53020,4715,11627,10746,29942,15461,41569
150812,202303,8344,18872,7396,17480,468,1410,5907,13271,6375,14681
150815,202303,11861,31204,9877,28860,1440,4232,7334,21789,8774,26021
150820,202303,19217,38710,16874,36002,1922,2867,13150,29804,15072,32671
150830,202303,16448,45776,15276,44361,635,1551,13600,40261,14235,41812
150835,202303,4467,11678,3816,10706,420,1211,2680,7458,3100,8669
150840,202303,10910,26900,8889,23849,1224,3691,5492,14172,6716,17863
160005,202303,1871,3885,1640,3618,64,167,1458,3178,1522,3345
160010,202303,2759,6692,2546,6469,22,93,2459,6205,2481,6298
160015,202303,5187,10419,4697,9872,87,220,4452,9275,4539,9495
160020,202303,3224,8161,2775,7584,368,851,1992,5768,2360,6619
160021,202303,1567,5074,1374,4842,66,280,1001,3669,1067,3949
160023,202303,1756,5226,1550,4895,281,835,944,3143,1225,3978
160025,202303,2469,6186,2299,6003,63,102,2184,5761,2247,5863
160027,202303,14814,29798,13378,28085,818,1745,11563,24126,12381,25871
160030,202303,114398,266122,95363,242158,17729,42866,56506,150489,74235,193355
160040,202303,7801,22019,6857,20772,532,1482,5770,17743,6302,19225
160050,202303,8222,19423,6918,17783,2505,5553,3302,9891,5807,15444
160053,202303,5503,14009,4821,13088,286,693,3991,11070,4277,11763
160055,202303,2156,4074,2073,3984,30,80,1995,3804,2025,3884
160060,202303,39684,82999,33659,76294,3343,6100,26624,62432,29967,68532
160070,202303,3906,11696,3398,10965,440,1163,2430,8435,2870,9598
160080,202303,4072,10546,3548,9976,54,167,3274,9316,3328,9483
170025,202303,765,1919,462,1363,92,267,125,350,217,617
170030,202303,1369,3792,1008,3136,185,569,383,1223,568,1792
170035,202303,1779,4192,1294,3457,119,345,748,1886,867,2231
170040,202303,2277,5516,1746,4793,275,759,904,2598,1179,3357
170070,202303,2351,4979,1655,4108,107,278,950,2367,1057,2645
170100,202303,3029,7431,2442,6535,358,862,1513,4126,1871,4988
170105,202303,785,2081,502,1530,103,322,164,425,267,747
170110,202303,1280,3325,962,2824,80,311,567,1562,647,1873
170130,202303,1790,4395,1327,3651,121,374,851,2261,972,2635
170190,202303,1932,4472,1499,3833,208,666,908,2164,1116,2830
170200,202303,2451,5378,1601,4075,282,740,616,1465,898,2205
170210,202303,34198,84921,25849,71759,7077,21092,4813,13512,11890,34604
170215,202303,1542,3705,1207,3255,66,235,887,2330,953,2565
170220,202303,6975,19579,5650,17335,2364,7410,1250,4402,3614,11812
170230,202303,1530,3959,1147,3286,261,790,408,1100,669,1890
170240,202303,3621,8221,2891,7123,211,582,2125,5084,2336,5666
170255,202303,4585,12103,3378,10116,573,1796,1622,4817,2195,6613
170270,202303,1028,2355,695,1841,86,232,382,962,468,1194
170290,202303,3842,9354,3285,8618,294,554,2495,6843,2789,7397
170300,202303,2641,5947,2133,5224,149,343,1601,3809,1750,4152
170305,202303,804,1991,648,1724,81,213,345,920,426,1133
170307,202303,1326,3639,1101,3263,152,495,693,1941,845,2436
170310,202303,1930,4354,1363,3516,178,480,710,1794,888,2274
170320,202303,1286,3124,945,2590,121,374,554,1501,675,1875
170330,202303,1201,3197,1083,3030,29,122,947,2575,976,2697
170360,202303,702,1617,511,1332,29,90,329,781,358,871
170370,202303,1613,3661,1128,2907,176,499,582,1371,758,1870
170380,202303,2208,5692,1665,4874,136,424,967,2903,1103,3327
170382,202303,603,1602,486,1416,25,93,338,938,363,1031
170384,202303,2105,6370,1750,5755,347,1132,942,3068,1289,4200
170386,202303,1127,2902,692,2079,77,286,253,693,330,979
170388,202303,885,2139,633,1749,112,322,318,837,430,1159
170389,202303,980,2833,770,2469,95,329,459,1506,554,1835
170390,202303,2220,4330,1666,3681,40,106,1457,3221,1497,3327
170410,202303,736,1670,535,1349,33,105,359,827,392,932
170460,202303,491,1250,384,1080,50,149,239,665,289,814
170510,202303,1095,2751,780,2230,39,149,503,1303,542,1452
170550,202303,8299,19922,6284,16899,1670,4891,2076,5281,3746,10172
170555,202303,1651,3977,1295,3447,154,368,619,1695,773,2063
170560,202303,1200,2978,897,2564,111,293,502,1495,613,1788
170600,202303,1688,4081,1317,3553,219,528,753,2098,972,2626
170610,202303,2027,4621,1500,3860,113,348,1005,2452,1118,2800
170625,202303,535,1290,365,993,52,132,139,343,191,475
170650,202303,1827,4464,1485,3954,136,422,1000,2544,1136,2966
170700,202303,4372,11596,3324,9666,672,2037,1441,3959,2113,5996
170710,202303,2090,4460,1588,3768,179,445,1058,2407,1237,2852
170720,202303,2235,4881,1639,3979,127,349,1201,2819,1328,3168
170730,202303,1345,3229,1017,2760,115,238,625,1729,740,1967
170740,202303,2420,7101,2059,6483,151,566,1537,4726,1688,5292
170755,202303,1022,2478,712,1992,137,418,316,817,453,1235
170765,202303,1397,3254,986,2630,163,429,473,1232,636,1661
170770,202303,2253,5725,1811,5075,145,427,1318,3609,1463,4036
170820,202303,4788,12405,3662,10558,738,2170,1765,4970,2503,7140
170825,202303,1312,2654,1080,2370,106,236,812,1751,918,1987
170830,202303,1654,3866,1207,3154,301,915,558,1262,859,2177
170900,202303,3656,9793,3138,9102,411,1020,2358,7057,2769,8077
170930,202303,4906,12085,3732,10049,835,2391,1273,3169,2108,5560
170950,202303,14246,36662,10136,29666,2979,9445,1329,3795,4308,13240
170980,202303,634,1443,418,1088,48,145,225,544,273,689
171050,202303,2021,5641,1722,5146,140,452,1302,3923,1442,4375
171070,202303,1627,4040,1370,3683,291,678,674,2108,965,2786
171090,202303,1188,2864,914,2459,150,435,469,1238,619,1673
171110,202303,672,1707,458,1321,64,180,211,560,275,740
171150,202303,1168,2676,712,1940,57,188,427,1109,484,1297
171180,202303,855,2211,533,1617,96,276,204,636,300,912
171190,202303,2399,6792,2000,6120,309,974,1160,3543,1469,4517
171195,202303,1004,2801,787,2407,107,403,472,1342,579,1745
171200,202303,749,1939,540,1595,132,448,164,436,296,884
171215,202303,481,1140,375,972,43,124,197,481,240,605
171240,202303,903,2636,697,2288,14,77,482,1523,496,1600
171245,202303,918,2419,702,2013,69,213,380,993,449,1206
171250,202303,1155,2947,801,2352,128,410,335,956,463,1366
171270,202303,581,1843,445,1556,66,267,213,713,279,980
171280,202303,1055,2829,842,2491,68,202,528,1560,596,1762
171320,202303,4739,12180,3589,10190,760,2193,1326,3720,2086,5913
171330,202303,3515,8735,2644,7286,699,2007,1140,3040,1839,5047
171360,202303,1848,4549,1358,3860,145,391,856,2602,1001,2993
171370,202303,850,1971,642,1686,76,200,386,984,462,1184
171380,202303,1721,4239,1390,3783,189,480,915,2600,1104,3080
171395,202303,1212,2866,815,2223,107,310,486,1297,593,1607
171420,202303,2421,5959,1818,4928,326,932,941,2433,1267,3365
171430,202303,1322,3411,1076,2983,79,257,693,1789,772,2046
171488,202303,3027,7596,2315,6471,412,1170,1190,3266,1602,4436
171500,202303,1045,2453,725,1931,90,275,411,1045,501,1320
171510,202303,1014,2841,854,2572,76,281,579,1668,655,1949
171515,202303,582,1297,405,1027,33,101,263,608,296,709
171525,202303,857,2070,637,1720,80,229,384,983,464,1212
171550,202303,405,1041,299,900,41,164,145,384,186,548
171570,202303,1333,3470,1109,3104,163,485,656,1818,819,2303
171575,202303,1986,4778,1322,3687,127,367,726,1946,853,2313
171610,202303,7344,19073,5436,15962,1330,4334,1102,3351,2432,7685
171620,202303,3678,8087,3143,7373,168,419,2609,6090,2777,6509
171630,202303,1337,3157,995,2676,146,418,616,1660,762,2078
171650,202303,2756,7188,2082,6063,519,1657,475,1354,994,3011
171660,202303,2795,6383,1978,5135,163,463,1292,3250,1455,3713
171665,202303,1504,3853,1172,3328,263,825,485,1334,748,2159
171670,202303,2253,5456,1665,4501,258,747,767,1963,1025,2710
171700,202303,1397,3486,1034,2858,135,374,578,1548,713,1922
171720,202303,902,2125,679,1786,75,216,453,1176,528,1392
171750,202303,1684,4672,1210,3803,251,810,335,1221,586,2031
171780,202303,1560,3501,1102,2817,105,319,710,1724,815,2043
171790,202303,1674,4959,1333,4287,193,614,689,2181,882,2795
171800,202303,867,2100,660,1807,66,182,377,975,443,1157
171820,202303,14569,37271,10793,31274,2499,7839,2789,8165,5288,16004
171830,202303,1881,5288,1601,4842,361,1022,761,2506,1122,3528
171840,202303,848,2040,637,1722,21,75,379,960,400,1035
171845,202303,831,1828,622,1533,57,167,414,953,471,1120
171850,202303,1214,3218,1032,2868,36,146,827,2198,863,2344
171855,202303,1246,3471,1026,3093,107,331,603,1773,710,2104
171865,202303,590,1517,497,1378,68,221,293,743,361,964
171870,202303,950,2372,663,1883,127,382,300,823,427,1205
171875,202303,1768,4196,1454,3739,58,234,1151,2814,1209,3048
171880,202303,1802,4198,1561,3881,54,142,1257,3093,1311,3235
171884,202303,1371,3186,1033,2653,211,515,547,1397,758,1912
171886,202303,1794,4495,1306,3801,334,1072,322,995,656,2067
171888,202303,677,1809,454,1365,38,137,253,712,291,849
171889,202303,513,1439,333,1077,81,286,105,313,186,599
171890,202303,1483,3885,1095,3259,139,454,664,1905,803,2359
171900,202303,665,2015,516,1729,72,209,241,820,313,1029
172000,202303,673,1853,514,1564,99,312,197,578,296,890
172010,202303,1529,4230,1278,3841,127,350,795,2416,922,2766
172015,202303,435,1375,332,1182,65,237,139,479,204,716
172020,202303,3497,8692,3014,8096,293,790,2137,5886,2430,6676
172025,202303,863,2116,614,1734,46,133,423,1158,469,1291
172030,202303,1453,3912,1168,3450,85,286,832,2391,917,2677
172049,202303,1455,3360,946,2646,120,323,485,1386,605,1709
172065,202303,1785,4004,1394,3515,155,308,913,2577,1068,2885
172080,202303,2844,7487,2276,6532,126,416,1526,4277,1652,4693
172085,202303,516,1299,323,914,55,153,112,288,167,441
172090,202303,5039,10722,3932,9292,146,381,3191,7328,3337,7709
172093,202303,543,1506,387,1228,31,139,227,670,258,809
172097,202303,790,1890,515,1438,86,273,177,462,263,735
172100,202303,63815,144482,47505,120331,8748,24700,20520,49790,29268,74490
172110,202303,2090,6416,1777,5968,117,476,1384,4617,1501,5093
172120,202303,6336,16384,4935,14192,505,1584,3011,8446,3516,10030
172125,202303,493,1217,369,1024,36,126,199,482,235,608
172130,202303,695,1634,518,1342,16,57,335,783,351,840
172208,202303,3068,6664,2361,5761,196,445,1715,4138,1911,4583
172210,202303,3215,7089,2478,6194,255,586,1630,4208,1885,4794
210005,202303,23863,61273,17867,51932,4767,14610,7254,21182,12021,35792
210010,202303,2678,6561,2458,6314,40,191,2273,5739,2313,5930
210015,202303,3795,10218,3258,9512,147,432,2698,7909,2845,8341
210020,202303,9940,19107,8603,17557,552,731,7590,15789,8142,16520
210030,202303,5382,16168,4886,15419,495,1656,3835,12131,4330,13787
210040,202303,2607,5081,2276,4690,58,162,2071,4168,2129,4330
210043,202303,6943,17734,5802,16215,388,1150,4543,12691,4931,13841
210047,202303,8294,21942,6512,19638,152,606,5610,16856,5762,17462
210050,202303,3001,8149,2391,7086,156,610,1806,5145,1962,5755
210055,202303,2522,6483,2198,6040,55,152,1907,5329,1962,5481
210060,202303,8821,29053,7779,27255,844,3088,5210,18677,6054,21765
210070,202303,8162,18972,7537,18196,108,270,7054,16965,7162,17235
210080,202303,5317,14564,4995,14221,37,202,4664,13223,4701,13425
210083,202303,7306,16701,6154,15457,100,324,5797,14482,5897,14806
210087,202303,3194,8174,2689,7514,117,348,2232,6211,2349,6559
210090,202303,10904,29835,10027,28459,364,933,8693,24605,9057,25538
210095,202303,7471,22698,6727,21716,616,1857,5163,17376,5779,19233
210100,202303,7628,21065,6590,19309,914,2600,4282,12738,5196,15338
210110,202303,3698,9335,3370,8933,46,202,3075,8055,3121,8257
210120,202303,35524,75460,30245,69006,1526,2902,24451,56069,25977,58971
210125,202303,5484,12976,4753,12155,905,1738,3236,9024,4141,10762
210130,202303,5008,11425,4063,10276,76,179,3581,9021,3657,9200
210135,202303,2165,4730,1792,4210,56,122,1565,3652,1621,3774
210140,202303,25819,61128,20215,53886,2786,7311,12719,34126,15505,41437
210150,202303,5641,11934,4905,10955,113,308,4235,9221,4348,9529
210160,202303,26679,59744,22747,54879,1806,3761,17871,43843,19677,47604
210170,202303,21459,53533,19488,50959,1952,4201,15071,40732,17023,44933
210173,202303,2714,9018,2553,8769,94,415,2244,7637,2338,8052
210177,202303,3806,9558,3256,8861,461,1135,2399,6751,2860,7886
210180,202303,1860,4116,1628,3841,35,83,1472,3473,1507,3556
210190,202303,6859,15054,5771,13636,96,250,5000,11624,5096,11874
210193,202303,1617,4050,1378,3689,49,139,1078,2866,1127,3005
210197,202303,2326,6522,2090,6200,159,431,1657,5029,1816,5460
210200,202303,9698,26594,8463,24815,579,1800,6643,19424,7222,21224
210203,202303,8414,22134,7024,20358,546,1544,5473,16249,6019,17793
210207,202303,4572,10068,3731,9105,154,346,3105,7665,3259,8011
210210,202303,8747,24790,7811,23514,123,628,6736,20025,6859,20653
210215,202303,2886,8086,2497,7540,146,591,2041,6077,2187,6668
210220,202303,8426,23214,7918,22525,142,807,7183,19896,7325,20703
210230,202303,6797,17129,6213,16246,146,366,5668,14807,5814,15173
210232,202303,14558,38987,11956,35272,1661,4796,8011,24447,9672,29243
210235,202303,4054,10908,3518,10157,160,564,2913,8371,3073,8935
210237,202303,4970,10720,4261,9932,35,124,4049,9330,4084,9454
210240,202303,2993,8163,2676,7689,84,237,2182,6233,2266,6470
210250,202303,7333,17947,6621,17064,106,394,6081,15532,6187,15926
210255,202303,3167,8622,2668,7752,315,995,1653,4620,1968,5615
210260,202303,6376,16816,5500,15568,429,1305,4413,12378,4842,13683
210270,202303,5796,13896,5073,13007,75,341,4595,11619,4670,11960
210275,202303,4013,9086,3389,8347,173,374,2778,6888,2951,7262
210280,202303,7655,17343,6325,15495,139,577,5282,12358,5421,12935
210290,202303,9975,21644,8916,20389,110,309,8439,19174,8549,19483
210300,202303,39015,98098,31592,87734,6634,17772,14948,46396,21582,64168
210310,202303,3615,8005,3139,7368,36,106,2867,6658,2903,6764
210312,202303,3510,7247,3116,6821,27,83,2872,6175,2899,6258
210315,202303,4381,9404,3925,8907,118,261,3639,8252,3757,8513
210317,202303,5215,14345,4712,13752,101,427,4293,12461,4394,12888
210320,202303,33920,71428,31624,68661,238,1093,29950,63854,30188,64947
210325,202303,4114,10631,3384,9651,453,1336,2394,6862,2847,8198
210330,202303,31849,75510,25636,68096,3904,8372,16921,49550,20825,57922
210340,202303,15360,33416,13812,31541,714,1313,11620,27045,12334,28358
210350,202303,11713,27916,10264,26156,130,406,9315,23530,9445,23936
210355,202303,4491,13676,3939,12826,106,490,3291,10667,3397,11157
210360,202303,14678,42034,13112,39590,521,2117,9842,28651,10363,30768
210370,202303,14552,27094,10887,23265,304,467,10026,21714,10330,22181
210375,202303,3886,9759,2810,8152,984,3040,641,1934,1625,4974
210380,202303,6711,15211,5757,14075,245,653,4984,12061,5229,12714
210390,202303,3859,9719,3589,9335,63,266,3296,8447,3359,8713
210400,202303,5526,13983,4850,13210,281,533,4262,11957,4543,12490
210405,202303,9074,20898,7380,18643,1180,2664,4566,12045,5746,14709
210407,202303,2458,6966,2060,6295,156,451,1538,4740,1694,5191
210408,202303,3229,10409,2983,10095,180,750,2387,8116,2567,8866
210409,202303,4492,13658,4006,12977,208,756,3216,10652,3424,11408
210410,202303,4368,11371,3660,10126,76,311,3024,8111,3100,8422
210420,202303,4465,12856,3931,11938,213,615,3223,9810,3436,10425
210430,202303,2685,7013,2327,6532,199,556,1901,5364,2100,5920
210440,202303,5076,12277,4403,11464,175,365,3930,10278,4105,10643
210450,202303,2692,7119,2310,6585,276,664,1677,4979,1953,5643
210455,202303,5934,13550,4584,11881,1064,2920,2194,5676,3258,8596
210460,202303,4118,10821,3426,9904,112,388,2850,8162,2962,8550
210462,202303,1952,5345,1627,4861,64,183,1268,3811,1332,3994
210465,202303,3133,8044,2695,7463,110,399,2288,6229,2398,6628
210467,202303,7375,19266,6323,17927,692,1811,4864,14166,5556,15977
210470,202303,2185,5517,1621,4745,204,544,1101,3308,1305,3852
210480,202303,20238,53693,16625,49271,2223,4736,11499,37722,13722,42458
210490,202303,3911,8817,3085,7715,89,223,2619,6513,2708,6736
210500,202303,7503,24891,6916,23963,365,1500,5795,19956,6160,21456
210510,202303,8147,20893,7278,19977,119,332,6749,18649,6868,18981
210515,202303,4455,11807,3755,10946,203,614,3107,9190,3310,9804
210520,202303,3047,8005,2722,7589,141,434,2268,6247,2409,6681
210530,202303,68629,153715,53872,133035,10128,26661,23788,61491,33916,88152
210535,202303,4416,12106,3999,11537,144,488,3506,10099,3650,10587
210540,202303,18278,46977,15179,42557,2263,5625,9739,29039,12002,34664
210542,202303,7673,16612,5949,14666,528,1244,4620,11480,5148,12724
210545,202303,2515,7132,2299,6781,49,185,1962,5720,2011,5905
210547,202303,4384,13940,3880,13103,226,751,3000,10351,3226,11102
210550,202303,6966,19397,5340,16863,697,2328,3185,10308,3882,12636
210560,202303,4337,12174,3814,11371,92,332,3254,9561,3346,9893
210565,202303,1787,4699,1455,4250,107,358,1080,3189,1187,3547
210570,202303,12913,32113,11404,30269,278,739,10174,27160,10452,27899
210580,202303,3458,8086,2713,7175,199,478,1969,5456,2168,5934
210590,202303,4846,13153,4107,12226,88,431,3634,10737,3722,11168
210592,202303,3378,8199,3134,7840,27,127,2785,6793,2812,6920
210594,202303,2880,7383,2248,6427,219,583,1543,4564,1762,5147
210596,202303,3451,10374,3048,9699,362,1137,2238,7318,2600,8455
210598,202303,2422,5838,2162,5504,87,248,1895,4804,1982,5052
210600,202303,3553,8970,2852,7983,363,941,1842,5194,2205,6135
210610,202303,3701,8449,3133,7771,56,215,2723,6632,2779,6847
210620,202303,3588,7814,2916,6990,145,298,2477,5887,2622,6185
210630,202303,3740,10664,3295,9937,170,597,2607,7785,2777,8382
210632,202303,7249,16391,6455,15379,189,608,5773,13437,5962,14045
210635,202303,1891,6179,1759,5945,203,610,1303,4547,1506,5157
210637,202303,3135,8831,2629,8129,158,556,1998,6277,2156,6833
210640,202303,5964,17004,5531,16525,61,309,5154,15317,5215,15626
210650,202303,8202,20728,7345,19687,111,395,6554,17509,6665,17904
210660,202303,9557,24676,8531,23116,154,670,7401,19456,7555,20126
210663,202303,3602,8147,3182,7660,333,525,2355,6183,2688,6708
210667,202303,2243,6459,1988,6080,57,190,1706,5328,1763,5518
210670,202303,6873,17143,6181,16113,124,478,5569,14239,5693,14717
210675,202303,6508,14430,5434,13108,697,1404,4080,10180,4777,11584
210680,202303,5843,11807,4922,10751,84,147,4613,10063,4697,10210
210690,202303,11383,25414,9627,23446,260,741,8803,21207,9063,21948
210700,202303,3270,7995,2615,7068,172,424,2004,5462,2176,5886
210710,202303,6393,16462,5610,15467,110,421,5032,13745,5142,14166
210720,202303,3588,10089,3117,9520,104,426,2729,8309,2833,8735
210725,202303,1534,4420,1312,4090,52,166,931,3021,983,3187
210730,202303,1721,3539,1426,3149,59,105,1248,2764,1307,2869
210735,202303,5419,13699,4556,12638,327,788,3688,10641,4015,11429
210740,202303,6241,14139,5278,13054,132,286,4510,11071,4642,11357
210745,202303,4960,12123,4468,11524,59,202,4016,10267,4075,10469
210750,202303,31605,74355,27388,68987,4257,9326,17418,46460,21675,55786
210760,202303,7645,15499,6489,14278,115,205,6044,13478,6159,13683
210770,202303,7442,16376,6334,15131,54,218,5912,13948,5966,14166
210780,202303,8820,24308,7585,22332,526,1556,5902,17323,6428,18879
210790,202303,5200,14151,4562,13306,282,751,3716,11140,3998,11891
210800,202303,5826,13756,4983,12644,72,276,4499,11207,4571,11483
210805,202303,4935,15303,4511,14690,211,699,3749,12301,3960,13000
210810,202303,5838,15132,5235,14383,448,1066,4241,11996,4689,13062
210820,202303,8551,22058,7090,19796,1034,2712,4195,12103,5229,14815
210825,202303,10174,23440,9254,22299,230,645,8499,20283,8729,20928
210830,202303,10698,24608,9687,23416,930,1547,7867,19970,8797,21517
210840,202303,5992,10311,5514,9757,27,110,5250,9060,5277,9170
210845,202303,7310,17371,6416,16380,67,176,6097,15625,6164,15801
210850,202303,8422,22122,7004,20126,477,1351,5603,16136,6080,17487
210860,202303,25569,55948,21124,50668,928,2060,17609,43117,18537,45177
210870,202303,8920,19483,7084,17423,182,403,6308,15484,6490,15887
210880,202303,4905,13140,4323,12386,221,664,3436,9782,3657,10446
210890,202303,5995,13024,5486,12449,189,473,4948,11058,5137,11531
210900,202303,5843,15249,4552,13053,1617,4673,922,2979,2539,7652
210905,202303,2709,5657,2308,5173,47,79,2164,4855,2211,4934
210910,202303,8815,24743,7268,22308,1087,3299,4445,13754,5532,17053
210920,202303,3745,10351,3289,9760,63,268,2994,8785,3057,9053
210923,202303,2328,5201,1998,4747,99,235,1639,3804,1738,4039
210927,202303,5440,16279,4706,15384,688,2210,3084,10532,3772,12742
210930,202303,3446,8925,3024,8200,84,346,2626,6864,2710,7210
210940,202303,4189,11009,3765,10489,322,1433,3055,7825,3377,9258
210945,202303,9970,22558,8901,21353,789,1284,7151,18005,7940,19289
210950,202303,6492,15945,4991,13866,619,1313,3333,9943,3952,11256
210955,202303,1804,4964,1499,4493,256,747,901,2732,1157,3479
210960,202303,10926,29344,9308,26871,3268,9308,3409,10907,6677,20215
210970,202303,2077,4771,1717,4216,92,274,1440,3390,1532,3664
210975,202303,2008,5574,1804,5271,217,632,1281,3737,1498,4369
210980,202303,12927,24797,11500,23318,175,260,10885,22086,11060,22346
210990,202303,21381,52358,16606,46346,1731,4179,11702,34006,13433,38185
211000,202303,17436,44174,14305,40330,2936,7299,9134,27597,12070,34896
211003,202303,7534,17529,6286,16089,104,392,5579,14242,5683,14634
211010,202303,8312,23569,7492,22573,74,335,6876,20799,6950,21134
211020,202303,10926,25778,9593,24314,203,591,8551,21971,8754,22562
211023,202303,2462,7033,2246,6758,141,395,1817,5475,1958,5870
211027,202303,4672,11397,4398,10993,100,327,4082,10052,4182,10379
211030,202303,4571,11363,4034,10701,418,1041,2992,8098,3410,9139
211040,202303,5192,16532,4744,15787,121,613,4211,13890,4332,14503
211050,202303,10971,24557,9788,23115,124,381,8925,20950,9049,21331
211060,202303,9173,22372,8302,21246,172,611,7482,18830,7654,19441
211065,202303,2981,6786,2486,6187,125,254,2131,5387,2256,5641
211070,202303,10140,27089,8598,24866,362,1114,7255,20903,7617,22017
211080,202303,1582,3781,1242,3276,31,159,963,2352,994,2511
211085,202303,2597,6422,2149,5862,212,406,1657,4795,1869,5201
211090,202303,3713,9090,3333,8666,29,117,3083,7955,3112,8072
211100,202303,9029,18319,8334,17537,42,107,7878,16481,7920,16588
211102,202303,3961,11119,3576,10583,412,1262,2747,8135,3159,9397
211105,202303,2795,7789,2350,7047,115,356,1818,5352,1933,5708
211107,202303,5565,15729,4720,14514,164,544,3748,12005,3912,12549
211110,202303,7765,17836,6163,15544,269,776,5054,12394,5323,13170
211120,202303,61135,132591,50357,119993,8275,18200,32192,79358,40467,97558
211125,202303,2223,6056,1874,5548,39,177,1583,4645,1622,4822
211130,202303,226695,485499,195837,445676,25844,52784,131606,305297,157450,358081
211140,202303,5505,14709,4743,13743,174,522,3978,11614,4152,12136
211150,202303,11621,27192,9696,24828,588,1143,7763,20501,8351,21644
211153,202303,3568,8596,2439,7179,466,1193,1485,4678,1951,5871
211157,202303,1519,4170,1288,3756,102,312,923,2656,1025,2968
211160,202303,6467,14049,5271,12463,132,452,4395,9827,4527,10279
211163,202303,1734,5013,1562,4777,61,193,1325,4106,1386,4299
211167,202303,2075,5259,1903,5035,31,109,1770,4643,1801,4752
211170,202303,8783,17051,8116,16307,61,158,7714,15312,7775,15470
211172,202303,3046,7662,2550,6937,78,245,2056,5364,2134,5609
211174,202303,3396,8529,3052,8155,29,139,2895,7672,2924,7811
211176,202303,4999,12762,3905,11223,291,908,3043,8681,3334,9589
211178,202303,6464,12204,5580,11278,32,112,5383,10776,5415,10888
211180,202303,4929,14361,4485,13740,172,684,3691,11178,3863,11862
211190,202303,3920,9539,3304,8676,32,165,3002,7744,3034,7909
211195,202303,1930,4422,1675,4063,60,140,1473,3562,1533,3702
211200,202303,2514,6776,1959,5906,202,631,1349,3999,1551,4630
211210,202303,7242,20052,6443,18969,532,1544,5101,15111,5633,16655
211220,202303,53194,112521,44390,101876,4139,8852,33679,77207,37818,86059
211223,202303,6328,15307,5085,13663,658,1792,3255,8759,3913,10551
211227,202303,2006,5624,1716,5213,49,173,1421,4339,1470,4512
211230,202303,10311,24975,8824,22936,321,679,7629,19918,7950,20597
211240,202303,12396,27761,11680,26911,136,530,11148,25270,11284,25800
211245,202303,9331,20090,8223,18930,178,401,7799,17877,7977,18278
211250,202303,18418,46910,16628,44312,1351,3563,13047,34607,14398,38170
211260,202303,9867,26936,8469,25353,170,659,7619,22887,7789,23546
211270,202303,12070,33513,10270,31254,388,1418,8390,25694,8778,27112
211280,202303,19323,40510,17294,38083,356,775,15956,34944,16312,35719
211285,202303,2408,6673,2118,6306,181,571,1556,4659,1737,5230
211290,202303,8558,22888,7615,21611,342,1026,6221,17538,6563,18564
211300,202303,8473,22650,7323,20809,470,1398,5564,15523,6034,16921
211400,202303,14132,34631,11435,31000,1554,3978,7489,21210,9043,25188
220005,202303,2367,5277,2149,4996,56,123,1788,4030,1844,4153
220010,202303,1772,4466,1431,3907,69,155,1097,2993,1166,3148
220020,202303,5560,11649,4809,10683,285,577,4122,9049,4407,9626
220025,202303,2779,5414,2361,4823,63,111,1985,3913,2048,4024
220027,202303,1668,3535,1440,3239,27,73,1243,2714,1270,2787
220030,202303,4720,9725,4337,9248,95,238,3872,8057,3967,8295
220040,202303,9858,26172,8565,23863,1598,4147,4858,13942,6456,18089
220045,202303,1935,4851,1594,4341,20,97,1370,3613,1390,3710
220050,202303,6817,14297,5963,13270,60,199,5603,12247,5663,12446
220060,202303,3552,5951,3063,5402,67,92,2880,5059,2947,5151
220070,202303,2837,6515,2316,5783,66,149,1949,4786,2015,4935
220080,202303,876,2254,751,2076,18,73,633,1710,651,1783
220090,202303,2042,4336,1651,3766,62,95,1382,3152,1444,3247
220095,202303,1201,2124,1143,2063,22,39,1070,1918,1092,1957
220100,202303,1696,4025,1334,3498,34,121,1078,2689,1112,2810
220105,202303,2433,6568,2082,5984,176,530,1515,4330,1691,4860
220110,202303,4273,9947,3675,8998,43,173,3275,7874,3318,8047
220115,202303,3472,8731,3164,8341,163,469,2745,7154,2908,7623
220117,202303,1665,3505,1301,3015,17,56,1089,2425,1106,2481
220120,202303,20954,39574,19409,37735,81,260,18475,35345,18556,35605
220130,202303,1330,3110,1102,2809,26,114,977,2403,1003,2517
220140,202303,2881,5149,2456,4670,83,152,2182,4201,2265,4353
220150,202303,7837,19580,7066,18346,151,529,5932,14956,6083,15485
220155,202303,1402,3647,1112,3143,22,79,792,2149,814,2228
220157,202303,1325,2768,1110,2464,29,62,905,1958,934,2020
220160,202303,3376,8182,2859,7296,52,179,2330,5719,2382,5898
220170,202303,1837,4455,1527,4010,30,107,1310,3397,1340,3504
220173,202303,2483,6244,1971,5372,44,162,1543,4075,1587,4237
220177,202303,2882,6143,2733,5983,7,24,2690,5865,2697,5889
220180,202303,1423,2889,1161,2482,3,17,966,1916,969,1933
220190,202303,10264,20271,8736,18382,678,1189,6683,14433,7361,15622
220191,202303,1963,5166,1780,4879,140,410,1294,3448,1434,3858
220192,202303,2429,5725,1770,4636,42,125,1427,3665,1469,3790
220194,202303,2237,5302,1943,4850,45,164,1630,3873,1675,4037
220196,202303,2602,5833,2354,5479,17,78,2029,4618,2046,4696
220198,202303,1593,3516,1343,3210,13,26,1227,2952,1240,2978
220200,202303,6025,15684,5241,14633,150,538,4383,12088,4533,12626
220202,202303,2597,6247,2193,5630,28,115,1862,4660,1890,4775
220205,202303,3290,7579,2920,6971,87,240,2496,5793,2583,6033
220207,202303,930,2430,789,2205,81,195,499,1445,580,1640
220208,202303,2131,5890,1719,5156,318,1020,844,2481,1162,3501
220209,202303,1867,4920,1546,4348,41,147,1163,3165,1204,3312
220210,202303,2319,4647,2016,4224,23,60,1767,3582,1790,3642
220211,202303,2055,4223,1868,3985,17,58,1641,3424,1658,3482
220213,202303,2169,5029,1846,4513,29,93,1486,3435,1515,3528
220217,202303,2909,6928,2681,6669,168,251,2368,6102,2536,6353
220220,202303,16692,32953,14378,29765,457,1008,12207,24610,12664,25618
220225,202303,1222,2687,993,2404,2,12,937,2241,939,2253
220230,202303,7050,15295,6056,13975,431,809,5039,11732,5470,12541
220240,202303,3881,9632,3140,8400,94,369,2556,6608,2650,6977
220245,202303,2518,4367,1944,3702,10,37,1819,3398,1829,3435
220250,202303,3682,8807,3214,8239,26,97,2994,7615,3020,7712
220253,202303,1991,4803,1671,4327,33,108,1417,3580,1450,3688
220255,202303,2386,4912,2011,4404,41,138,1736,3637,1777,3775
220260,202303,6218,15114,5371,13714,266,653,4319,10945,4585,11598
220265,202303,1857,4763,1680,4532,81,266,1411,3702,1492,3968
220270,202303,7340,21045,6877,20266,179,848,5781,16348,5960,17196
220271,202303,1833,4018,1599,3707,55,126,1374,3147,1429,3273
220272,202303,2046,5339,1766,4837,48,163,1351,3530,1399,3693
220273,202303,1516,3935,1230,3423,64,208,913,2496,977,2704
220275,202303,3205,6022,2588,5222,75,105,2317,4654,2392,4759
220277,202303,2877,5941,2427,5338,94,181,2021,4354,2115,4535
220280,202303,2404,4352,2022,3889,24,42,1835,3463,1859,3505
220285,202303,2052,4069,1769,3732,11,47,1693,3513,1704,3560
220290,202303,8467,20585,6729,18242,621,1498,4680,13174,5301,14672
220300,202303,2339,6039,1817,5369,39,178,1466,4293,1505,4471
220310,202303,3913,9030,3077,8072,51,180,2683,6977,2734,7157
220320,202303,3745,9436,2840,7910,62,262,2255,6010,2317,6272
220323,202303,2073,5070,1592,4326,47,164,1343,3526,1390,3690
220325,202303,1441,3936,1192,3508,35,139,953,2748,988,2887
220327,202303,2016,4856,1768,4480,73,240,1468,3597,1541,3837
220330,202303,6621,12808,5704,11748,86,249,5259,10601,5345,10850
220335,202303,2263,5535,2063,5274,131,231,1716,4477,1847,4708
220340,202303,2116,5230,1576,4342,90,307,990,2602,1080,2909
220342,202303,1506,3706,1339,3477,120,207,1003,2704,1123,2911
220345,202303,3716,7404,2821,6206,19,60,2520,5427,2539,5487
220350,202303,3952,9081,3148,7920,232,522,2189,5462,2421,5984
220360,202303,1598,3570,1220,2970,13,46,999,2339,1012,2385
220370,202303,11002,27026,9916,25421,395,1010,8371,21205,8766,22215
220375,202303,2072,4819,1832,4534,16,25,1758,4367,1774,4392
220380,202303,1889,3772,1498,3251,24,39,1298,2803,1322,2842
220385,202303,1141,2236,929,1891,4,6,840,1668,844,1674
220390,202303,15824,33356,12682,28979,2017,4735,7170,15995,9187,20730
220400,202303,1816,3865,1386,3218,18,51,1084,2377,1102,2428
220410,202303,1444,3505,1156,3033,28,96,950,2431,978,2527
220415,202303,1006,2327,806,2000,22,40,622,1510,644,1550
220420,202303,2219,5786,1771,4942,87,275,1252,3395,1339,3670
220430,202303,3558,7494,3140,6964,39,90,2850,6216,2889,6306
220435,202303,2502,5277,2154,4757,29,88,1842,3916,1871,4004
220440,202303,3979,8983,3371,8150,53,240,3007,6948,3060,7188
220450,202303,3352,7327,2777,6625,52,176,2455,5732,2507,5908
220455,202303,1732,4221,1628,4093,18,58,1490,3759,1508,3817
220460,202303,1413,2806,1287,2638,26,59,1141,2254,1167,2313
220465,202303,2912,7841,2556,7315,192,556,1997,5716,2189,6272
220470,202303,4690,11096,4128,10244,217,417,3154,7776,3371,8193
220480,202303,3181,7524,2505,6527,237,440,1658,4350,1895,4790
220490,202303,2911,6467,2475,5934,25,118,2168,5071,2193,5189
220500,202303,4007,8574,3354,7622,129,233,2591,5759,2720,5992
220510,202303,3275,7653,2644,6620,116,276,2059,5194,2175,5470
220515,202303,2182,4431,1981,4159,63,77,1713,3580,1776,3657
220520,202303,6248,13839,5645,13016,112,241,4841,11065,4953,11306
220525,202303,1695,3620,1405,3275,37,78,1247,2922,1284,3000
220527,202303,1995,4215,1648,3702,67,140,1446,3248,1513,3388
220530,202303,2025,4059,1673,3622,169,348,1256,2810,1425,3158
220535,202303,1014,2450,928,2320,26,92,756,1808,782,1900
220540,202303,3869,10753,3529,10107,223,606,2810,8007,3033,8613
220545,202303,1802,4654,1607,4367,89,315,1344,3582,1433,3897
220550,202303,10559,29697,9228,27290,558,1774,6651,19084,7209,20858
220551,202303,1774,4176,1523,3775,24,69,1272,3082,1296,3151
220552,202303,1929,5019,1552,4387,24,118,1247,3361,1271,3479
220553,202303,2579,5040,2167,4519,23,40,1974,4065,1997,4105
220554,202303,1178,2563,906,2170,79,156,645,1512,724,1668
220555,202303,4764,8530,4230,7915,30,72,3821,7100,3851,7172
220556,202303,1581,3947,1333,3535,42,182,973,2400,1015,2582
220557,202303,2169,5754,1620,4623,119,362,1162,3177,1281,3539
220558,202303,1763,4025,1415,3556,27,99,1209,2932,1236,3031
220559,202303,2250,4763,1902,4248,132,194,1458,3329,1590,3523
220560,202303,2394,4451,2015,4002,18,33,1898,3730,1916,3763
220570,202303,9931,25176,8872,23651,730,1739,6862,18293,7592,20032
220580,202303,8149,19461,7340,18297,98,279,6519,16135,6617,16414
220585,202303,2502,6882,2057,6067,62,148,1653,4861,1715,5009
220590,202303,2029,4226,1682,3757,104,207,1373,3011,1477,3218
220595,202303,3372,7949,3012,7474,83,275,2565,6198,2648,6473
220600,202303,2255,3794,1947,3452,25,41,1837,3221,1862,3262
220605,202303,1733,4631,1454,4131,21,106,1153,3158,1174,3264
220610,202303,3611,8515,3359,8177,12,67,3180,7656,3192,7723
220620,202303,10950,26068,9962,24772,128,602,9149,22256,9277,22858
220630,202303,421,1115,318,939,27,77,197,556,224,633
220635,202303,2147,5614,1871,5092,60,163,1504,3985,1564,4148
220640,202303,2877,7105,2449,6510,86,287,1957,5107,2043,5394
220650,202303,2947,6535,2509,5900,65,143,2102,4910,2167,5053
220660,202303,3110,8587,2580,7742,73,328,2119,6170,2192,6498
220665,202303,1683,4152,1442,3784,30,135,1252,3178,1282,3313
220667,202303,1947,5088,1760,4787,76,242,1426,3820,1502,4062
220669,202303,1985,5142,1884,5002,37,148,1685,4357,1722,4505
220670,202303,2876,6020,2314,5260,28,71,2036,4534,2064,4605
220672,202303,4180,9034,3444,8163,94,311,3055,7065,3149,7376
220675,202303,1540,3780,1364,3479,80,229,1037,2587,1117,2816
220680,202303,3768,7878,3569,7637,212,324,3149,6820,3361,7144
220690,202303,1887,4424,1611,4016,109,296,1215,2957,1324,3253
220695,202303,1122,2770,1007,2579,17,51,842,2120,859,2171
220700,202303,15306,29375,12511,25806,455,968,10331,20554,10786,21522
220710,202303,1052,2534,760,2059,28,85,569,1474,597,1559
220720,202303,2760,5454,2457,5084,26,69,2196,4425,2222,4494
220730,202303,1687,3885,1447,3524,16,60,1262,2980,1278,3040
220735,202303,1240,2471,959,2060,41,74,729,1521,770,1595
220740,202303,1649,3772,1298,3317,56,127,1053,2710,1109,2837
220750,202303,5340,10961,4704,10138,271,429,4146,9025,4417,9454
220755,202303,1826,3660,1523,3251,33,71,1279,2665,1312,2736
220760,202303,4288,9069,3728,8355,45,149,3499,7775,3544,7924
220770,202303,34537,85898,29732,78353,7880,22208,12644,32614,20524,54822
220775,202303,1726,3480,1540,3259,3,14,1504,3154,1507,3168
220777,202303,1900,4286,1497,3702,47,88,1040,2692,1087,2780
220779,202303,1476,3547,1261,3226,41,117,1040,2608,1081,2725
220780,202303,7218,15429,6442,14354,395,875,5046,11179,5441,12054
220785,202303,1752,3405,1535,3140,18,37,1444,2923,1462,2960
220790,202303,12721,30625,11327,28744,228,725,9735,24271,9963,24996
220793,202303,1190,2631,964,2266,15,33,824,1902,839,1935
220795,202303,1673,3819,1471,3550,29,82,1283,3080,1312,3162
220800,202303,26825,49877,23090,45141,972,1794,18856,35758,19828,37552
220810,202303,3747,8994,3146,8045,70,145,2562,6605,2632,6750
220820,202303,7436,15347,6535,14117,306,500,5498,11873,5804,12373
220830,202303,9432,20857,8343,19354,443,992,6784,15381,7227,16373
220840,202303,16520,41333,14062,37083,1856,4789,9059,23277,10915,28066
220850,202303,3617,9828,3185,9298,55,257,2829,8238,2884,8495
220855,202303,1049,1961,914,1795,21,54,837,1624,858,1678
220860,202303,1476,2856,1267,2572,27,71,1172,2331,1199,2402
220865,202303,2715,6767,2063,5658,52,203,1526,3998,1578,4201
220870,202303,4045,8870,3318,7956,34,139,3030,7140,3064,7279
220880,202303,8273,14577,7136,13233,146,294,6571,12051,6717,12345
220885,202303,1840,4403,1529,3953,93,258,1217,3119,1310,3377
220887,202303,1997,3632,1681,3226,39,49,1554,2965,1593,3014
220890,202303,1710,4540,1448,4163,55,197,1158,3305,1213,3502
220900,202303,2648,5211,2229,4675,25,64,2006,4110,2031,4174
220910,202303,2204,4696,1872,4227,274,437,1343,3197,1617,3634
220915,202303,1087,2687,857,2304,15,50,628,1594,643,1644
220920,202303,1961,4961,1687,4618,115,297,1378,3802,1493,4099
220930,202303,2424,5067,2033,4560,18,52,1844,4190,1862,4242
220935,202303,1264,3316,988,2755,19,78,668,1745,687,1823
220937,202303,1766,4116,1483,3673,36,113,1177,2820,1213,2933
220940,202303,2288,4795,1871,4130,40,108,1600,3385,1640,3493
220945,202303,590,1797,465,1578,24,122,320,1051,344,1173
220950,202303,1657,3410,1132,2639,7,17,917,2026,924,2043
220955,202303,2053,4363,1691,3787,19,34,1490,3280,1509,3314
220960,202303,895,2107,649,1705,39,130,438,1057,477,1187
220965,202303,2264,5106,1955,4664,18,82,1725,3986,1743,4068
220970,202303,2632,5055,1962,4138,7,25,1734,3524,1741,3549
220975,202303,925,2098,785,1926,14,54,689,1629,703,1683
220980,202303,1574,3583,1393,3348,34,88,1217,2854,1251,2942
220985,202303,1778,3761,1536,3409,95,167,1193,2599,1288,2766
220987,202303,1841,4630,1629,4301,50,167,1362,3534,1412,3701
220990,202303,1982,4899,1735,4544,27,93,1446,3735,1473,3828
220995,202303,1722,3815,1416,3326,13,44,1223,2814,1236,2858
220997,202303,2945,7466,2666,7025,48,179,2355,6038,2403,6217
221000,202303,5934,13523,5128,12430,193,535,4266,10161,4459,10696
221005,202303,2030,4355,1844,4072,25,98,1601,3353,1626,3451
221010,202303,1574,2976,1241,2581,38,55,1086,2229,1124,2284
221020,202303,1809,4967,1620,4663,25,102,1268,3603,1293,3705
221030,202303,2102,4179,1795,3811,25,65,1617,3431,1642,3496
221035,202303,1924,4161,1615,3758,46,69,1401,3280,1447,3349
221037,202303,842,2026,702,1800,10,39,522,1246,532,1285
221038,202303,621,1549,486,1336,27,80,339,904,366,984
221039,202303,1011,2465,823,2170,28,91,657,1679,685,1770
221040,202303,5387,13646,4588,12372,246,654,3615,9721,3861,10375
221050,202303,5686,11061,5095,10342,68,192,4684,9381,4752,9573
221060,202303,11924,28200,9805,24841,491,1101,7781,19475,8272,20576
221062,202303,1635,4078,1399,3734,122,256,1069,2903,1191,3159
221063,202303,1509,3462,1313,3187,59,164,1089,2564,1148,2728
221065,202303,3562,7462,3053,6653,16,51,2761,5895,2777,5946
221070,202303,4001,11034,3198,9450,480,1401,1883,5623,2363,7024
221080,202303,4436,9459,3624,8287,49,171,3048,6661,3097,6832
221090,202303,1717,3685,1427,3269,14,34,1245,2773,1259,2807
221093,202303,2055,4551,1848,4221,184,355,1372,3054,1556,3409
221095,202303,1091,2510,896,2238,31,80,724,1788,755,1868
221097,202303,999,2257,745,1845,23,58,569,1333,592,1391
221100,202303,183942,404900,156487,363065,10391,27594,115810,253844,126201,281438
221110,202303,14108,33130,12772,31481,382,848,11278,27684,11660,28532
221120,202303,6040,15282,5367,14320,218,648,4574,12087,4792,12735
221130,202303,7416,15707,5856,13078,1130,2241,3535,7694,4665,9935
221135,202303,2443,5028,2101,4597,92,169,1805,4012,1897,4181
221140,202303,1954,3535,1609,3124,48,78,1424,2731,1472,2809
221150,202303,1368,3009,1026,2464,26,98,806,1821,832,1919
221160,202303,897,1970,793,1841,38,50,622,1452,660,1502
221170,202303,1287,2933,1192,2784,8,19,1099,2516,1107,2535
230010,202303,3672,8637,2942,7429,79,218,2383,5793,2462,6011
230015,202303,4446,11612,3865,10493,229,659,2740,7305,2969,7964
230020,202303,18804,47486,17384,45367,976,2483,14256,37157,15232,39640
230030,202303,15869,34655,13198,31102,565,1170,10570,25190,11135,26360
230040,202303,5734,12189,4772,10760,52,195,3840,8823,3892,9018
230050,202303,3113,8853,2392,7284,321,1054,1186,3279,1507,4333
230060,202303,3006,7027,2313,5885,35,136,1874,4606,1909,4742
230070,202303,5450,12046,4294,10107,581,1323,2750,6431,3331,7754
230075,202303,12104,31990,10948,30119,540,1763,8848,23655,9388,25418
230080,202303,3784,6881,2903,5815,12,26,2696,5335,2708,5361
230090,202303,5694,11707,4749,10289,157,334,3968,8309,4125,8643
230100,202303,27745,58723,24145,54130,2197,5035,17189,37864,19386,42899
230110,202303,17144,44914,14489,40130,2353,6870,7902,20891,10255,27761
230120,202303,9989,23053,8549,20895,895,2170,5813,14111,6708,16281
230125,202303,3782,8754,3144,7764,57,217,2606,6142,2663,6359
230130,202303,6880,18561,5530,15821,353,967,3819,10713,4172,11680
230140,202303,4343,11240,3602,9873,106,403,2806,7338,2912,7741
230150,202303,1969,5165,1619,4486,216,569,938,2601,1154,3170
230160,202303,9037,18071,7757,16279,242,460,6666,13661,6908,14121
230170,202303,7504,19334,6053,16554,478,1218,4098,10965,4576,12183
230180,202303,2029,4890,1636,4200,15,62,1330,3262,1345,3324
230185,202303,5716,13354,4699,11790,453,1157,3342,8371,3795,9528
230190,202303,18003,48569,14617,42275,2048,6028,7942,22314,9990,28342
230195,202303,7103,17953,6352,16749,329,854,4862,12700,5191,13554
230200,202303,5957,14844,4898,12976,326,848,3548,9116,3874,9964
230205,202303,5774,13344,5038,12335,476,952,3793,9340,4269,10292
230210,202303,13370,27028,11379,24465,463,984,9232,19316,9695,20300
230220,202303,19186,40913,16803,37689,1003,2266,13626,29890,14629,32156
230230,202303,8861,21964,7962,20346,606,1422,5977,15093,6583,16515
230240,202303,17095,37949,14424,33783,879,1707,11124,25765,12003,27472
230250,202303,11640,28006,10788,26784,611,1541,7972,19173,8583,20714
230260,202303,18778,47076,16064,42600,2239,5719,9811,25603,12050,31322
230270,202303,8841,21141,6719,17490,869,2085,3866,10309,4735,12394
230280,202303,24914,56288,20615,49606,416,1579,16847,38169,17263,39748
230290,202303,6329,14310,5442,12755,242,536,4355,9857,4597,10393
230300,202303,6184,13801,5522,12928,80,210,4851,11300,4931,11510
230310,202303,5709,14499,4672,12644,159,561,3383,8766,3542,9327
230320,202303,9309,23862,7667,21126,237,872,5940,15761,6177,16633
230330,202303,5917,14033,4557,11616,163,493,3423,8342,3586,8835
230340,202303,4719,13044,4042,11745,289,873,2763,7760,3052,8633
230350,202303,23844,54429,20713,50123,1060,2984,15256,35619,16316,38603
230360,202303,3816,8619,2954,7226,157,355,2177,5291,2334,5646
230365,202303,3753,7932,3103,7030,75,213,2730,6083,2805,6296
230370,202303,102615,215669,90408,199536,4998,12912,72329,151952,77327,164864
230380,202303,7572,18586,5944,15719,127,426,4495,11329,4622,11755
230390,202303,4129,10444,3511,9502,75,311,2799,7310,2874,7621
230393,202303,4191,10295,3326,8676,80,389,2693,6614,2773,7003
230395,202303,6845,16850,5783,15106,533,1394,3816,9711,4349,11105
230400,202303,6999,16536,6134,15243,81,326,4979,11754,5060,12080
230410,202303,16283,43318,13423,38448,1064,3105,9140,25886,10204,28991
230420,202303,37956,89855,31093,78853,3110,8332,19591,47211,22701,55543
230423,202303,5525,14624,4826,13394,308,916,3456,9261,3764,10177
230425,202303,7602,19928,6978,18802,732,1893,4830,12856,5562,14749
230426,202303,3274,7548,2351,5884,41,148,1786,4245,1827,4393
230427,202303,2157,5482,1560,4352,139,429,871,2211,1010,2640
230428,202303,12393,30076,10622,27613,1564,4111,6194,15514,7758,19625
230430,202303,5936,15163,4634,12935,186,528,3450,9400,3636,9928
230435,202303,7870,17606,6406,15246,914,2107,3718,8676,4632,10783
230440,202303,622307,1261408,533150,1142235,35210,83946,398858,813915,434068,897861
230445,202303,5018,12426,4094,10930,234,637,2777,7065,3011,7702
230450,202303,4666,11330,4042,10458,198,690,3060,7475,3258,8165
230460,202303,2764,6395,2353,5766,64,223,1986,4721,2050,4944
230465,202303,5148,12419,4273,10855,148,411,3305,8073,3453,8484
230470,202303,14287,39952,12781,37302,804,2728,9472,26556,10276,29284
230480,202303,1886,4583,1538,3998,56,215,1177,2861,1233,3076
230490,202303,3335,8230,2759,7164,210,634,1836,4382,2046,5016
230495,202303,7558,18356,6548,16718,848,2290,4089,10026,4937,12316
230500,202303,11371,32382,9948,29943,457,1400,7804,23461,8261,24861
230510,202303,2182,5232,1722,4389,158,427,1104,2648,1262,3075
230520,202303,5958,14035,5110,12670,416,982,3725,8972,4141,9954
230523,202303,20698,54438,16143,45600,3633,9954,4200,12208,7833,22162
230526,202303,4870,11564,4093,10379,324,635,2882,7546,3206,8181
230530,202303,6729,18960,5617,16946,1213,3788,3056,9153,4269,12941
230533,202303,6112,11542,4874,9771,64,168,4219,8054,4283,8222
230535,202303,6045,15536,5087,14042,355,1084,3362,9082,3717,10166
230540,202303,18600,45798,15916,41925,269,933,13121,33873,13390,34806
230550,202303,28476,63975,23418,56116,1964,4804,16208,37351,18172,42155
230560,202303,9381,19555,7436,16710,165,328,6296,14048,6461,14376
230565,202303,3797,9180,3146,8058,90,282,2503,6200,2593,6482
230570,202303,4105,9356,3419,8416,70,213,2819,6759,2889,6972
230580,202303,15052,32382,12910,29431,517,1133,10864,24373,11381,25506
230590,202303,11739,28735,9750,25488,740,1829,7052,18132,7792,19961
230600,202303,4580,10154,3609,8593,149,356,2519,5953,2668,6309
230610,202303,8296,19754,7283,18168,483,1214,5733,14084,6216,15298
230620,202303,2540,6025,1980,5033,85,264,1352,3181,1437,3445
230625,202303,12696,29961,10925,27128,2144,5617,5227,12244,7371,17861
230630,202303,14451,35630,12684,32647,1564,3684,8131,21017,9695,24701
230640,202303,32560,88693,29426,83803,1463,4892,23323,64817,24786,69709
230650,202303,6369,14999,5321,13312,188,641,4336,10338,4524,10979
230655,202303,11985,33556,11263,32447,865,2283,9001,26263,9866,28546
230660,202303,7313,19035,5848,16533,174,702,4701,12920,4875,13622
230670,202303,7259,15313,5207,12210,150,392,4170,9410,4320,9802
230680,202303,3417,8174,2748,7081,153,307,1918,4897,2071,5204
230690,202303,8443,22328,7089,19833,546,1570,4422,12283,4968,13853
230700,202303,12994,28089,10348,23526,399,958,8083,17671,8482,18629
230710,202303,8082,22874,7041,20841,648,1955,4661,13381,5309,15336
230720,202303,2313,6116,1916,5438,139,384,1266,3480,1405,3864
230725,202303,5858,14949,5273,14025,361,1124,3664,9271,4025,10395
230730,202303,75846,176063,59750,153825,12643,32887,25084,65305,37727,98192
230740,202303,7307,18196,6081,16295,170,470,4790,12690,4960,13160
230750,202303,10257,24124,8345,21150,141,476,6730,16403,6871,16879
230760,202303,14369,33209,12370,30322,475,1457,9532,22295,10007,23752
230763,202303,5857,13978,4782,12251,91,348,3808,9306,3899,9654
230765,202303,58201,135239,49862,123043,4869,13025,32556,75851,37425,88876
230770,202303,36471,71858,31032,65154,1985,4303,24243,49130,26228,53433
230780,202303,8111,24481,7281,22679,975,2804,4395,13821,5370,16625
230790,202303,3895,9384,3446,8705,119,385,2737,6571,2856,6956
230800,202303,10857,29433,9390,26703,1103,3319,5725,15409,6828,18728
230810,202303,13058,35333,11548,32948,566,1709,8849,24683,9415,26392
230820,202303,4284,12367,3543,10909,344,1244,2193,6357,2537,7601
230830,202303,9407,22060,7970,19830,324,692,6295,15311,6619,16003
230835,202303,5067,10650,3974,9069,119,270,3244,7159,3363,7429
230837,202303,4819,10805,4348,10084,77,297,3812,8450,3889,8747
230840,202303,11536,30264,9813,27395,810,2274,7124,19678,7934,21952
230850,202303,12527,30267,10572,26919,599,1400,7824,19639,8423,21039
230860,202303,8020,14927,6760,13265,194,302,5996,11564,6190,11866
230870,202303,22800,44819,19510,39822,744,1436,16115,31878,16859,33314
230880,202303,2430,6535,2195,6151,72,300,1710,4599,1782,4899
230890,202303,5585,15496,5028,14584,231,790,3706,10527,3937,11317
230900,202303,4037,10030,3351,8760,128,453,2446,6041,2574,6494
230910,202303,4263,9265,3310,7880,63,239,2784,6454,2847,6693
230920,202303,5709,14158,4540,12257,130,392,3482,9091,3612,9483
230930,202303,8384,20855,6826,18227,377,1108,4709,12160,5086,13268
230940,202303,10140,22186,8760,20270,194,424,7507,17104,7701,17528
230945,202303,7920,19834,6727,17761,318,921,4871,12355,5189,13276
230950,202303,7759,16785,6832,15568,145,336,5831,13210,5976,13546
230960,202303,15867,40794,13677,36950,2156,5912,6954,17926,9110,23838
230970,202303,19520,45059,16552,40751,1672,4329,10854,25697,12526,30026
230980,202303,4342,9220,3752,8303,321,680,2804,6064,3125,6744
230990,202303,2084,5138,1719,4480,70,258,1266,3085,1336,3343
231000,202303,3388,7731,2649,6409,73,223,2042,4651,2115,4874
231010,202303,4602,8989,3520,7312,34,126,3132,6244,3166,6370
231020,202303,11088,28096,9817,25910,1628,3954,5924,15844,7552,19798
231025,202303,10565,23844,9371,22092,630,1378,7346,17074,7976,18452
231030,202303,8736,23552,6641,19459,846,2448,3825,11075,4671,13523
231040,202303,3832,8860,3250,7896,88,248,2715,6320,2803,6568
231050,202303,15071,32793,12209,28188,498,1272,9631,21341,10129,22613
231060,202303,3542,8542,3135,7942,106,325,2514,6291,2620,6616
231070,202303,9933,25184,8582,22935,762,2001,5841,15256,6603,17257
231080,202303,4627,11636,3798,10307,230,637,2630,7039,2860,7676
231085,202303,9112,19078,7224,16833,266,646,5681,12911,5947,13557
231090,202303,5218,12263,3847,9746,118,411,2711,6410,2829,6821
231095,202303,2648,7267,2070,6078,186,535,1365,3949,1551,4484
231100,202303,3594,9295,2944,8151,159,486,2213,5930,2372,6416
231110,202303,4480,11803,4091,11127,389,1247,2848,7314,3237,8561
231120,202303,2986,7361,2503,6592,107,272,1883,4836,1990,5108
231123,202303,2357,5466,1840,4597,100,243,1299,3187,1399,3430
231126,202303,6741,16355,5436,14056,293,686,4007,10207,4300,10893
231130,202303,31091,62801,25964,56475,1159,3137,20595,42321,21754,45458
231135,202303,5101,12747,4192,11113,163,455,3046,7890,3209,8345
231140,202303,21934,51904,17837,45478,875,2645,13096,31575,13971,34220
231150,202303,7125,17416,5061,13494,849,2335,1898,4857,2747,7192
231160,202303,8640,21903,7668,20225,771,2014,5097,13183,5868,15197
231170,202303,5676,14321,4695,12601,295,855,3371,8610,3666,9465
231180,202303,19312,47209,15754,40559,2337,5987,8447,20976,10784,26963
231190,202303,5048,12271,3952,10399,96,306,3044,7737,3140,8043
231195,202303,5973,16198,4877,14148,305,981,3446,9911,3751,10892
231200,202303,10324,25233,9021,22936,144,635,7596,18376,7740,19011
231210,202303,5879,15068,4907,13503,146,583,3931,10408,4077,10991
231220,202303,16437,35391,12975,29534,616,1306,9680,21007,10296,22313
231230,202303,12226,34124,10721,31463,819,2510,7839,22689,8658,25199
231240,202303,14672,38695,12870,35577,1733,4686,7885,21427,9618,26113
231250,202303,2539,5476,1688,3810,60,140,1188,2473,1248,2613
231260,202303,4113,9691,3432,8663,364,790,2333,5953,2697,6743
231270,202303,7943,17801,6412,15415,156,553,4921,11118,5077,11671
231280,202303,2172,5973,1870,5457,157,456,1292,3760,1449,4216
231290,202303,44929,120243,37821,107878,5117,14591,19852,54275,24969,68866
231300,202303,5085,12363,3925,10179,189,595,2705,6632,2894,7227
231310,202303,10445,21897,8292,18325,561,1434,6190,12865,6751,14299
231320,202303,8267,20951,6414,17691,179,461,4982,13564,5161,14025
231325,202303,2917,6800,2278,5803,140,266,1638,4135,1778,4401
231330,202303,13678,34051,11296,29852,1379,3528,7292,19076,8671,22604
231335,202303,6764,15776,5611,14049,145,438,4781,11758,4926,12196
231340,202303,22936,61845,20429,57907,1595,4376,15134,43259,16729,47635
231350,202303,19768,47045,17942,44559,301,906,16014,39229,16315,40135
231355,202303,5362,13889,4737,12814,233,674,3703,9803,3936,10477
231360,202303,9742,25838,8374,23656,436,1318,6535,18124,6971,19442
231370,202303,2468,6154,1954,5272,42,124,1491,3945,1533,4069
231375,202303,4945,13400,4395,12523,210,565,3445,9863,3655,10428
231380,202303,7452,16824,6536,15634,190,373,5444,12919,5634,13292
231390,202303,4086,10712,3608,9958,123,473,2717,7184,2840,7657
231395,202303,5372,13388,4490,12034,337,843,3117,8196,3454,9039
231400,202303,12023,29732,10012,26273,301,1140,7739,19313,8040,20453
231410,202303,20254,49972,18324,47210,838,2074,15247,39012,16085,41086
240010,202303,3097,7259,2399,6097,361,930,1202,2911,1563,3841
240020,202303,17593,40759,14581,35814,847,2473,10415,24256,11262,26729
240030,202303,4797,8829,4316,8175,80,229,3943,7180,4023,7409
240040,202303,935,2467,767,2175,23,71,499,1348,522,1419
240050,202303,4203,9912,3271,8312,63,155,2528,6226,2591,6381
240060,202303,1804,4175,1405,3495,49,120,1099,2664,1148,2784
240070,202303,3241,7924,2853,7156,224,634,2040,4772,2264,5406
240080,202303,3551,8581,2771,7280,126,369,1938,4919,2064,5288
240090,202303,2816,5852,2309,5083,42,83,1986,4273,2028,4356
240100,202303,13787,28359,11036,23982,227,665,8996,18380,9223,19045
240110,202303,6047,14937,5035,13172,191,645,3810,9464,4001,10109
240120,202303,4081,10299,3401,9381,255,821,2416,6435,2671,7256
240130,202303,4908,8470,4004,7342,26,59,3659,6577,3685,6636
240140,202303,2178,5978,1825,5359,203,694,1128,3153,1331,3847
240145,202303,8452,21234,6778,18460,741,2094,4355,11611,5096,13705
240150,202303,1293,3021,1070,2617,56,170,841,1954,897,2124
240160,202303,1771,4560,1450,3996,42,184,1074,2817,1116,3001
240165,202303,1180,2822,976,2474,22,87,805,1959,827,2046
240170,202303,3498,8024,2928,7093,300,731,1940,4580,2240,5311
240180,202303,3706,9814,2987,8409,619,1734,1362,3928,1981,5662
240185,202303,1685,4533,1497,4211,51,191,1184,3183,1235,3374
240190,202303,1402,3321,1146,2926,36,129,914,2253,950,2382
240200,202303,16275,34442,13160,29596,1477,3447,8132,17329,9609,20776
240210,202303,4287,8619,3524,7429,26,107,3102,6232,3128,6339
240220,202303,8652,23361,7744,21986,523,1761,5904,16384,6427,18145
240230,202303,7107,15906,5543,13442,321,637,4029,9870,4350,10507
240240,202303,2121,5635,1480,4294,199,629,513,1244,712,1873
240250,202303,3797,8350,3252,7568,60,193,2751,6159,2811,6352
240260,202303,19899,50517,17281,46410,4977,12919,7264,21608,12241,34527
240270,202303,3028,7689,2487,6856,114,329,1703,4789,1817,5118
240280,202303,1961,4536,1616,3992,68,154,1259,3054,1327,3208
240290,202303,1387,3580,1138,3106,30,120,773,1900,803,2020
240300,202303,2688,6250,1968,5079,95,248,1216,3003,1311,3251
240310,202303,10511,25186,8296,21488,1158,2948,4169,10448,5327,13396
240320,202303,2269,5689,1591,4401,97,294,1065,2781,1162,3075
240325,202303,47277,106484,39052,93686,4455,12068,24122,53802,28577,65870
240330,202303,2168,5315,1684,4477,72,238,1153,2869,1225,3107
240340,202303,2546,4930,2042,4208,57,131,1694,3316,1751,3447
240350,202303,3058,6250,2705,5843,67,166,2462,5264,2529,5430
240360,202303,15805,36930,14098,34406,2164,5083,9004,21875,11168,26958
240370,202303,2691,5756,2064,4677,96,257,1533,3240,1629,3497
240375,202303,1172,2494,943,2137,36,108,689,1396,725,1504
240380,202303,2787,6982,2146,5722,218,557,1249,3212,1467,3769
240390,202303,1156,2581,782,1916,28,55,490,1100,518,1155
240400,202303,1717,3869,1266,3135,33,111,895,2068,928,2179
240410,202303,705,1911,575,1676,61,223,316,845,377,1068
240420,202303,6316,18382,5647,17132,439,1691,3922,11301,4361,12992
240430,202303,4293,9677,3583,8533,111,350,2796,6313,2907,6663
240440,202303,3414,6791,2904,6100,276,528,2207,4555,2483,5083
240450,202303,5366,13094,4219,11099,317,1013,2667,6400,2984,7413
240460,202303,4248,9740,3806,9076,301,655,3029,7240,3330,7895
240470,202303,4062,11317,3067,9309,655,1737,1346,4312,2001,6049
240480,202303,690,1711,417,1144,27,55,202,541,229,596
240485,202303,2549,6499,2011,5576,156,458,1269,3498,1425,3956
240490,202303,1973,4351,1494,3551,91,169,1075,2496,1166,2665
240500,202303,2636,6310,2265,5722,114,277,1809,4501,1923,4778
240510,202303,2031,4869,1737,4434,75,233,1396,3424,1471,3657
240520,202303,1953,3937,1485,3331,101,209,1158,2585,1259,2794
240530,202303,2886,6799,2554,6294,154,289,2045,5000,2199,5289
240540,202303,2833,6064,2525,5616,44,113,2268,4987,2312,5100
240550,202303,1081,2325,958,2135,18,59,852,1832,870,1891
240560,202303,4854,10028,4184,9185,147,258,3534,7697,3681,7955
240570,202303,3348,8159,2241,5877,309,841,867,1985,1176,2826
240580,202303,10669,26577,9416,24502,516,1446,7640,19511,8156,20957
240590,202303,1140,2180,991,1979,22,36,818,1565,840,1601
240600,202303,2124,5124,1546,4040,57,154,1065,2620,1122,2774
240610,202303,5545,12601,4706,11194,284,739,3327,7421,3611,8160
240615,202303,1570,3525,1254,3020,94,251,929,2105,1023,2356
240620,202303,2388,5665,2021,5079,60,180,1685,4105,1745,4285
240630,202303,2844,6239,2549,5793,210,335,1935,4482,2145,4817
240640,202303,1114,2619,869,2223,35,107,646,1591,681,1698
240650,202303,4835,12850,3986,11205,323,850,2649,7414,2972,8264
240660,202303,5329,9380,4876,8812,75,132,4573,8171,4648,8303
240670,202303,3118,7566,2458,6318,223,605,1587,3884,1810,4489
240680,202303,1942,4481,1548,3846,54,166,1201,2835,1255,3001
240690,202303,1479,3076,1149,2549,20,71,968,2006,988,2077
240700,202303,2855,7560,2291,6581,112,331,1669,4721,1781,5052
240710,202303,24966,51396,21408,46108,1743,3895,16114,33265,17857,37160
240720,202303,6357,14350,5313,12888,656,1643,3443,8129,4099,9772
240725,202303,1301,3381,982,2820,41,116,622,1711,663,1827
240730,202303,2724,6744,2119,5664,78,250,1597,4111,1675,4361
240740,202303,2285,5696,1820,4803,95,292,1272,3155,1367,3447
240750,202303,2618,7624,2259,6898,253,837,1366,3984,1619,4821
240760,202303,2088,4170,1515,3366,114,163,1115,2587,1229,2750
240770,202303,4073,9623,3413,8736,129,420,2830,7028,2959,7448
240780,202303,6568,15671,5479,13929,745,1890,3534,8768,4279,10658
240790,202303,1066,2655,870,2328,25,112,635,1598,660,1710
240800,202303,73604,148206,59436,128170,5555,12683,39414,79098,44969,91781
240810,202303,137693,293423,120918,268675,11276,25777,87000,186193,98276,211970
240820,202303,7822,20536,6822,18777,1040,2928,4061,11070,5101,13998
240830,202303,10541,26359,9092,24286,362,1152,7220,18923,7582,20075
240840,202303,1318,2972,1038,2538,49,94,727,1726,776,1820
240850,202303,1663,4149,1133,3073,76,203,681,1735,757,1938
240860,202303,1794,3865,1354,3139,38,120,1113,2458,1151,2578
240870,202303,1254,2870,964,2416,169,406,479,1217,648,1623
240880,202303,1562,4443,1339,4027,104,395,964,2793,1068,3188
240890,202303,6674,14737,5272,12416,467,1277,3523,7496,3990,8773
240895,202303,3590,9549,3243,9015,387,1040,2371,6650,2758,7690
240910,202303,4186,10131,3432,8855,62,208,2773,6901,2835,7109
240920,202303,1300,2833,1048,2487,114,194,677,1657,791,1851
240930,202303,4419,8978,3559,7937,277,429,2323,5675,2600,6104
240933,202303,1932,4351,1622,3916,42,174,1359,3130,1401,3304
240940,202303,9009,18647,7202,15862,688,1482,4879,10207,5567,11689
240950,202303,1334,3571,1133,3179,27,116,888,2372,915,2488
240960,202303,859,2141,764,1952,16,54,595,1447,611,1501
240970,202303,2429,5143,1967,4440,59,169,1639,3550,1698,3719
240980,202303,4854,11020,4340,10243,69,282,3840,8712,3909,8994
240990,202303,3618,8265,3179,7529,231,674,2363,5200,2594,5874
241000,202303,1267,2740,987,2273,14,49,804,1741,818,1790
241010,202303,3852,9901,3483,9219,136,446,2839,7226,2975,7672
241020,202303,2541,6062,1902,4881,96,275,1352,3249,1448,3524
241025,202303,1920,5024,1538,4373,38,152,1094,2981,1132,3133
241030,202303,3023,8424,2439,7303,245,736,1620,4731,1865,5467
241040,202303,2591,7195,2204,6561,115,434,1656,4871,1771,5305
241050,202303,1736,4308,1366,3656,39,122,1023,2659,1062,2781
241060,202303,996,2419,830,2090,40,102,590,1390,630,1492
241070,202303,850,2011,706,1792,17,43,548,1321,565,1364
241080,202303,1323,3355,1041,2820,36,123,730,1882,766,2005
241090,202303,2505,6280,1986,5442,73,277,1480,3873,1553,4150
241100,202303,1400,3509,1068,2881,60,126,694,1822,754,1948
241105,202303,1314,3433,1067,3001,202,594,509,1354,711,1948
241110,202303,1080,2783,806,2232,48,143,510,1338,558,1481
241120,202303,9174,23399,7776,21154,802,2200,5081,13683,5883,15883
241140,202303,4004,9604,3037,7771,141,392,2156,5329,2297,5721
241142,202303,901,2209,685,1825,59,136,391,959,450,1095
241150,202303,7120,16374,6195,14999,259,616,4867,11591,5126,12207
241160,202303,1388,3542,1059,2948,159,492,546,1407,705,1899
241170,202303,1594,3620,1339,3191,31,90,1096,2501,1127,2591
241180,202303,1251,2848,925,2298,85,214,521,1223,606,1437
241190,202303,1446,3245,1183,2791,23,74,874,1940,897,2014
241200,202303,32453,68459,28683,62924,3081,7157,19996,41395,23077,48552
241210,202303,2022,4526,1451,3539,110,286,921,2161,1031,2447
241220,202303,12466,30725,10957,28362,2498,6452,5336,13873,7834,20325
241230,202303,3532,8254,3029,7544,108,254,2474,6087,2582,6341
241240,202303,1436,3700,876,2534,98,309,310,832,408,1141
241250,202303,7663,18010,6149,15452,136,562,4886,11584,5022,12146
241255,202303,3266,8567,2757,7658,166,533,2007,5361,2173,5894
241260,202303,6006,13842,4807,11949,173,517,3651,8643,3824,9160
241270,202303,1910,5032,1577,4423,110,341,1104,2998,1214,3339
241280,202303,3147,6211,2744,5556,95,177,2369,4668,2464,4845
241290,202303,3884,8499,2831,6899,100,307,2243,5238,2343,5545
241300,202303,1912,4449,1556,3902,44,153,1108,2612,1152,2765
241310,202303,2877,5811,2472,5273,63,129,2142,4493,2205,4622
241320,202303,1142,3368,969,3049,110,373,572,1741,682,2114
241330,202303,2093,4716,1668,4164,25,71,1476,3644,1501,3715
241335,202303,4502,10960,3936,10020,130,424,3199,7842,3329,8266
241340,202303,2138,5018,1682,4196,216,640,941,2131,1157,2771
241350,202303,2632,6260,2275,5658,107,264,1757,4274,1864,4538
241355,202303,1661,3948,1318,3315,52,110,978,2412,1030,2522
241360,202303,2484,5674,1796,4396,59,171,1327,3065,1386,3236
241370,202303,1631,3883,1253,3201,58,173,914,2156,972,2329
241380,202303,869,2030,685,1721,66,168,421,1039,487,1207
241390,202303,3307,8489,2897,7885,151,477,2237,6006,2388,6483
241400,202303,4382,10826,3837,10021,216,672,2966,7503,3182,8175
241410,202303,3000,8042,2408,6879,242,743,1533,4291,1775,5034
241415,202303,2308,5461,1933,4828,67,213,1519,3572,1586,3785
241420,202303,3855,9815,3450,9185,601,1677,2070,5490,2671,7167
241430,202303,856,1914,566,1390,17,41,389,873,406,914
241440,202303,10527,27310,9465,25622,260,850,7769,20547,8029,21397
241445,202303,1667,3383,1436,3080,29,64,1281,2714,1310,2778
241450,202303,3731,7578,3005,6504,215,415,2348,5011,2563,5426
241460,202303,4753,11431,3722,9468,317,872,2444,5829,2761,6701
241470,202303,1754,4099,1385,3573,39,138,1173,2964,1212,3102
241475,202303,1457,3517,1132,2945,21,73,849,2069,870,2142
241480,202303,3763,10305,3101,8984,839,2426,1103,3408,1942,5834
241490,202303,907,1827,646,1449,15,40,530,1147,545,1187
241500,202303,970,2329,859,2199,11,27,760,1938,771,1965
250010,202303,3311,8426,2656,7165,69,226,2017,5225,2086,5451
250020,202303,1927,4534,1424,3655,83,141,1064,2724,1147,2865
250030,202303,8676,20690,7529,19025,964,2541,5137,12793,6101,15334
250040,202303,5815,14734,5029,13427,811,2091,2970,7840,3781,9931
250050,202303,4517,10435,3983,9773,182,454,3257,8091,3439,8545
250053,202303,1569,3946,1404,3707,143,302,930,2453,1073,2755
250057,202303,916,2476,829,2356,14,50,753,2131,767,2181
250060,202303,7607,16789,6662,15470,517,1189,5044,11621,5561,12810
250070,202303,4889,11902,4041,10505,41,170,3252,8091,3293,8261
250073,202303,981,2262,773,1939,7,21,630,1532,637,1553
250077,202303,3259,6848,2517,5738,33,100,2142,4699,2175,4799
250080,202303,7442,14201,6146,12675,62,143,5652,11454,5714,11597
250090,202303,4783,8961,4204,8252,65,137,3741,7131,3806,7268
250100,202303,4146,11234,3722,10508,266,668,2759,7655,3025,8323
250110,202303,6117,14890,5525,14090,367,1056,4220,10503,4587,11559
250115,202303,944,1933,710,1603,12,39,573,1232,585,1271
250120,202303,2159,5683,1915,5295,23,113,1560,4153,1583,4266
250130,202303,7662,15979,6519,14480,46,197,5817,12509,5863,12706
250135,202303,1647,3887,1412,3495,182,490,985,2337,1167,2827
250140,202303,2751,7081,2501,6783,174,512,1978,5452,2152,5964
250150,202303,5735,15956,5136,15017,193,669,4058,11536,4251,12205
250153,202303,1677,3980,1377,3553,71,139,1068,2726,1139,2865
250157,202303,2688,6115,2369,5631,47,144,2000,4591,2047,4735
250160,202303,4719,10151,3763,8882,82,208,3216,7491,3298,7699
250170,202303,2270,5281,2021,4937,39,125,1711,4063,1750,4188
250180,202303,31311,60660,27076,55472,1382,3435,21848,42551,23230,45986
250190,202303,5236,11973,4392,10805,452,1046,3048,7278,3500,8324
250200,202303,3239,6021,2755,5424,32,63,2493,4756,2525,4819
250205,202303,983,2791,814,2512,21,89,631,1924,652,2013
250210,202303,1716,4665,1507,4331,78,267,1142,3197,1220,3464
250215,202303,1955,4810,1644,4393,98,267,950,2555,1048,2822
250220,202303,829,2034,648,1760,28,103,462,1176,490,1279
250230,202303,2009,4052,1413,3221,22,55,1115,2450,1137,2505
250240,202303,3803,8230,3363,7555,37,143,2997,6523,3034,6666
250250,202303,5932,13814,5219,12862,425,696,4035,10490,4460,11186
250260,202303,1898,4889,1569,4306,75,196,1180,3241,1255,3437
250270,202303,1433,3865,1307,3716,87,248,922,2745,1009,2993
250280,202303,4943,10509,4368,9779,275,474,3406,7757,3681,8231
250290,202303,2307,4738,1927,4208,29,66,1619,3388,1648,3454
250300,202303,7514,15941,6719,15017,229,717,5635,12148,5864,12865
250310,202303,1486,3791,1203,3309,62,153,866,2346,928,2499
250320,202303,18523,33905,16253,31393,185,502,15018,28294,15203,28796
250330,202303,3271,7342,2757,6651,68,227,2390,5535,2458,5762
250340,202303,1537,3181,1315,2891,18,44,1182,2568,1200,2612
250350,202303,4621,11935,3962,10802,333,697,2935,8260,3268,8957
250355,202303,2747,6428,2428,6051,17,63,2250,5573,2267,5636
250360,202303,2196,5066,1947,4741,89,268,1603,3736,1692,4004
250370,202303,20796,41540,17757,37256,245,755,15791,31869,16036,32624
250375,202303,1575,3308,1258,2945,6,13,1125,2681,1131,2694
250380,202303,2219,4611,2038,4402,45,142,1827,3796,1872,3938
250390,202303,2401,5201,2033,4659,136,308,1571,3567,1707,3875
250400,202303,92879,208585,71271,176880,20935,55278,21428,51776,42363,107054
250403,202303,2973,5997,2637,5632,53,244,2284,4554,2337,4798
250407,202303,1906,3756,1356,2984,141,240,880,2056,1021,2296
250410,202303,866,2006,748,1821,21,57,614,1435,635,1492
250415,202303,2452,5684,2136,5220,25,75,1883,4494,1908,4569
250420,202303,1754,3615,1579,3385,12,27,1474,3109,1486,3136
250430,202303,9528,18607,8204,16932,273,561,7013,13975,7286,14536
250435,202303,1945,4913,1499,4181,33,107,1126,3023,1159,3130
250440,202303,5357,12897,4620,11937,107,249,3990,10197,4097,10446
250450,202303,2232,5078,1820,4536,89,174,1427,3621,1516,3795
250460,202303,9743,23239,8480,21472,590,1606,6506,16169,7096,17775
250470,202303,2210,4628,1823,4047,63,137,1500,3208,1563,3345
250480,202303,4724,11417,3952,10466,111,245,3317,8813,3428,9058
250485,202303,849,1752,628,1447,65,100,420,955,485,1055
250490,202303,7068,13611,6261,12711,112,320,5640,11100,5752,11420
250500,202303,2481,6082,2153,5545,49,143,1763,4430,1812,4573
250510,202303,7222,14826,6200,13480,264,356,5148,11360,5412,11716
250520,202303,2231,5399,1896,4957,75,218,1494,3794,1569,4012
250523,202303,2791,5786,2448,5332,194,459,1899,3986,2093,4445
250527,202303,2099,4490,1895,4267,24,61,1714,3814,1738,3875
250530,202303,811,1862,692,1694,19,50,559,1323,578,1373
250535,202303,1652,4244,1469,3943,25,104,1183,3051,1208,3155
250540,202303,4165,7553,3523,6869,410,458,2835,5833,3245,6291
250550,202303,924,2714,804,2496,49,158,546,1660,595,1818
250560,202303,2073,5053,1770,4630,51,184,1470,3712,1521,3896
250570,202303,3333,8651,2847,7825,170,493,2129,5779,2299,6272
250580,202303,1268,2984,1116,2786,66,206,893,2155,959,2361
250590,202303,1284,2648,1164,2492,28,74,1041,2152,1069,2226
250600,202303,9244,22427,7621,20191,287,803,5872,15186,6159,15989
250610,202303,3457,8812,3056,8230,129,404,2439,6509,2568,6913
250620,202303,1142,2388,949,2098,41,115,759,1595,800,1710
250625,202303,2786,7313,2465,6811,46,215,2094,5643,2140,5858
250630,202303,15531,34187,13126,30503,1150,2918,9417,20752,10567,23670
250640,202303,4587,10482,4073,9829,87,308,3513,8260,3600,8568
250650,202303,1299,2732,1017,2366,11,43,865,1960,876,2003
250660,202303,1882,4151,1490,3600,35,83,1224,2825,1259,2908
250670,202303,2957,7772,2674,7293,46,193,2325,6151,2371,6344
250680,202303,7606,14591,6840,13738,34,135,6426,12564,6460,12699
250690,202303,8852,17206,7430,15531,156,302,6437,13212,6593,13514
250700,202303,5665,14176,4926,13035,717,1954,3234,8331,3951,10285
250710,202303,5201,13557,4488,12584,381,1112,3197,8945,3578,10057
250720,202303,3436,8215,3024,7636,68,256,2610,6436,2678,6692
250730,202303,5500,12330,4809,11431,217,589,4071,9371,4288,9960
250740,202303,2517,5492,2069,4914,133,288,1563,3715,1696,4003
250750,202303,164307,341765,142261,312233,8958,22290,110146,230644,119104,252934
250760,202303,3695,6898,3309,6365,140,226,2952,5585,3092,5811
250770,202303,4963,13324,4396,12570,660,1624,2855,8520,3515,10144
250780,202303,2326,5217,1968,4633,59,167,1619,3674,1678,3841
250790,202303,3181,8082,2767,7492,102,380,2223,5783,2325,6163
250800,202303,3004,6949,2595,6320,106,209,2113,5070,2219,5279
250810,202303,1793,3864,1484,3452,164,238,1091,2698,1255,2936
250820,202303,2587,5860,2370,5613,49,166,2133,4966,2182,5132
250830,202303,7471,19836,6142,17310,228,822,4417,11790,4645,12612
250840,202303,891,2606,778,2405,38,138,564,1745,602,1883
250850,202303,2223,5646,1932,5166,29,123,1567,4058,1596,4181
250855,202303,1392,3309,1239,3099,40,114,1026,2485,1066,2599
250860,202303,4277,11049,3544,9909,485,1395,2019,5491,2504,6886
250870,202303,1263,2973,1054,2657,64,144,795,2003,859,2147
250880,202303,1963,4448,1601,3920,136,323,1182,2851,1318,3174
250890,202303,14864,30065,13049,27798,249,999,11448,23010,11697,24009
250900,202303,4026,9115,3502,8277,75,218,3001,6858,3076,7076
250905,202303,3073,7492,2818,7173,43,160,2552,6431,2595,6591
250910,202303,9263,17508,7935,16057,80,237,7237,14378,7317,14615
250915,202303,2666,5332,1943,4553,30,54,1711,4016,1741,4070
250920,202303,4801,10092,4309,9415,278,554,3548,7578,3826,8132
250930,202303,2828,6788,2496,6373,149,448,1960,4814,2109,5262
250933,202303,1511,3913,1311,3582,50,185,1017,2683,1067,2868
250937,202303,996,2321,823,2061,26,83,673,1666,699,1749
250939,202303,2508,5481,2178,5056,45,112,1825,4138,1870,4250
250940,202303,4787,11059,4133,10200,59,163,3629,8845,3688,9008
250950,202303,2031,4812,1623,4264,46,145,1277,3271,1323,3416
250960,202303,1384,3505,1211,3234,30,124,994,2543,1024,2667
250970,202303,11409,24837,9766,22258,393,803,7887,17587,8280,18390
250980,202303,2894,6720,2599,6324,21,89,2262,5320,2283,5409
250990,202303,2603,6874,2202,6197,117,383,1653,4510,1770,4893
251000,202303,2378,6049,1913,5287,50,167,1526,4169,1576,4336
251010,202303,3034,7418,2654,6867,36,158,2303,5810,2339,5968
251020,202303,1914,4684,1710,4373,30,137,1485,3685,1515,3822
251030,202303,1239,2971,1015,2596,74,164,682,1711,756,1875
251040,202303,2231,5457,1893,4927,25,106,1615,4132,1640,4238
251050,202303,1181,3078,981,2709,42,154,687,1782,729,1936
251060,202303,1373,2701,1003,2219,35,77,741,1627,776,1704
251065,202303,566,1426,419,1154,12,37,294,773,306,810
251070,202303,924,2038,768,1826,14,47,639,1451,653,1498
251080,202303,26915,57535,22170,50817,3617,8378,12859,29493,16476,37871
251090,202303,3459,8825,2886,7888,67,188,2359,6298,2426,6486
251100,202303,958,2764,817,2492,30,96,596,1716,626,1812
251110,202303,2266,5193,1871,4498,145,331,1377,3219,1522,3550
251120,202303,9910,22648,8356,20737,513,1452,6326,15198,6839,16650
251130,202303,6047,10196,5358,9436,49,107,5057,8762,5106,8869
251140,202303,4856,12451,4247,11598,133,441,3332,9001,3465,9442
251150,202303,3420,8586,3104,8113,57,270,2647,6708,2704,6978
251160,202303,2974,6910,2569,6328,25,129,2319,5561,2344,5690
251170,202303,2292,4903,2017,4571,30,78,1825,4027,1855,4105
251180,202303,3427,7690,2833,6898,294,569,1916,4830,2210,5399
251190,202303,6904,13537,6251,12814,53,213,5707,11224,5760,11437
251200,202303,5545,13449,4910,12636,159,338,4128,10705,4287,11043
251203,202303,1230,3504,1073,3156,54,164,720,2019,774,2183
251207,202303,1361,3271,1017,2725,21,91,693,1785,714,1876
251210,202303,10014,21992,8146,19446,666,1281,5681,13988,6347,15269
251220,202303,1672,3398,1201,2775,91,199,915,2102,1006,2301
251230,202303,5743,14360,4896,12897,107,367,3896,9878,4003,10245
251240,202303,4498,11530,3757,10294,316,769,2455,6770,2771,7539
251250,202303,15130,34007,13204,30902,848,2096,10121,22667,10969,24763
251260,202303,660,1519,581,1393,14,57,469,1059,483,1116
251270,202303,5574,14413,4944,13565,271,675,3873,10868,4144,11543
251272,202303,1765,3930,1618,3753,46,168,1433,3194,1479,3362
251274,202303,1012,2595,796,2223,61,209,464,1254,525,1463
251275,202303,1952,4050,1659,3609,81,193,1364,2840,1445,3033
251276,202303,1629,3945,1391,3623,34,136,1121,2806,1155,2942
251278,202303,812,1875,711,1722,33,87,566,1335,599,1422
251280,202303,3464,7069,3153,6660,53,168,2839,5790,2892,5958
251290,202303,10333,17990,9442,16987,293,589,8438,14806,8731,15395
251300,202303,1048,2669,913,2464,17,64,762,2025,779,2089
251310,202303,3447,8543,2949,7779,45,204,2461,6287,2506,6491
251315,202303,2249,6166,2013,5742,110,297,1557,4377,1667,4674
251320,202303,2026,4731,1534,3916,40,141,1160,2822,1200,2963
251330,202303,2642,5245,2107,4618,33,71,1830,3971,1863,4042
251335,202303,1354,3339,1209,3131,19,85,1079,2720,1098,2805
251340,202303,4767,9837,3789,8607,139,332,3009,6655,3148,6987
251350,202303,1332,3325,1197,3118,32,84,986,2532,1018,2616
251360,202303,2234,5381,1739,4659,27,78,1366,3571,1393,3649
251365,202303,952,2250,690,1763,20,54,533,1338,553,1392
251370,202303,35625,80622,30677,74024,4925,11559,17908,43680,22833,55239
251380,202303,1910,4058,1642,3663,57,130,1397,3045,1454,3175
251385,202303,950,2201,713,1795,28,81,503,1194,531,1275
251390,202303,9760,22345,8643,20736,736,1800,6314,14805,7050,16605
251392,202303,1278,3072,1056,2733,39,102,818,2090,857,2192
251394,202303,824,2088,677,1842,68,183,442,1149,510,1332
251396,202303,869,2128,725,1886,25,73,505,1243,530,1316
251398,202303,1220,2879,842,2212,22,79,598,1489,620,1568
251400,202303,1821,3479,1456,3004,67,117,1178,2326,1245,2443
251410,202303,1948,3891,1524,3284,14,49,1300,2646,1314,2695
251420,202303,2598,5738,2097,5163,52,166,1693,4023,1745,4189
251430,202303,1810,4825,1628,4521,57,192,1350,3679,1407,3871
251440,202303,1322,3201,1075,2786,72,155,784,2055,856,2210
251445,202303,2112,4887,1924,4646,28,89,1662,3879,1690,3968
251450,202303,5730,14171,5092,13229,56,212,4416,11223,4472,11435
251455,202303,1054,2768,939,2576,31,95,747,1990,778,2085
251460,202303,1185,2924,942,2533,84,224,657,1751,741,1975
251465,202303,621,1523,511,1337,9,39,396,977,405,1016
251470,202303,1385,3551,1039,2875,126,411,541,1348,667,1759
251480,202303,1251,2909,952,2411,18,53,714,1703,732,1756
251490,202303,2503,5651,2031,5033,137,250,1517,3750,1654,4000
251500,202303,2699,6040,2424,5676,87,205,2053,4639,2140,4844
251510,202303,3163,8684,2615,7648,127,413,1771,4985,1898,5398
251520,202303,1218,2858,909,2338,71,142,585,1456,656,1598
251530,202303,19460,38970,15992,34778,162,673,14285,30103,14447,30776
251540,202303,3643,9305,3208,8573,83,318,2642,6810,2725,7128
251550,202303,5481,10195,4477,8999,123,204,3820,7559,3943,7763
251560,202303,661,1821,585,1713,39,156,435,1193,474,1349
251570,202303,1121,2868,914,2468,22,103,711,1847,733,1950
251580,202303,2825,5429,2484,4952,25,97,2179,4094,2204,4191
251590,202303,2033,4263,1717,3891,62,146,1466,3220,1528,3366
251593,202303,1155,3081,1027,2871,88,298,698,1881,786,2179
251597,202303,2791,6323,2509,5966,15,68,2315,5397,2330,5465
251600,202303,7754,18911,6721,17384,275,778,5467,13864,5742,14642
251610,202303,4240,10239,3645,9179,295,699,2666,6569,2961,7268
251615,202303,1689,3547,1336,3045,20,45,1133,2484,1153,2529
251620,202303,24969,48291,19491,41759,248,474,16968,36242,17216,36716
251630,202303,6558,12819,5292,11105,295,651,4164,8292,4459,8943
251640,202303,2692,6358,2387,5924,20,77,2143,5207,2163,5284
251650,202303,5197,11496,4457,10555,123,290,3801,8811,3924,9101
251660,202303,4464,11323,3909,10408,60,252,3281,8429,3341,8681
251670,202303,5873,12611,5226,11772,53,209,4812,10550,4865,10759
251675,202303,1118,2322,1004,2177,41,109,884,1870,925,1979
251680,202303,3236,7306,2716,6642,115,204,2185,5381,2300,5585
251690,202303,3975,9971,3357,8970,141,391,2506,6609,2647,7000
251700,202303,2789,6737,2311,6091,45,178,1932,4878,1977,5056
251710,202303,967,2229,698,1734,41,114,445,1005,486,1119
251720,202303,1582,3981,1254,3446,18,82,968,2540,986,2622
251740,202303,826,1998,657,1720,32,99,494,1240,526,1339
260005,202303,39336,73530,32933,65661,1863,3827,26511,51038,28374,54865
260010,202303,12844,29803,10551,26260,630,1717,6776,16109,7406,17826
260020,202303,8584,16891,7003,14754,69,244,6032,12279,6101,12523
260030,202303,10136,19815,8609,17726,70,262,7666,15202,7736,15464
260040,202303,9018,20267,7588,18375,422,1085,5651,13578,6073,14663
260050,202303,18202,38175,15668,35338,251,655,14608,32687,14859,33342
260060,202303,5265,11055,4500,9931,389,652,3323,7585,3712,8237
260070,202303,14802,29571,12816,26885,203,693,11149,22387,11352,23080
260080,202303,8665,16233,7556,14867,132,297,6572,12527,6704,12824
260090,202303,6877,14582,6103,13603,440,876,4834,10797,5274,11673
260100,202303,4093,8683,3518,7909,32,142,3145,6846,3177,6988
260105,202303,6224,14531,5571,13677,103,372,4746,11283,4849,11655
260110,202303,26702,67118,23557,62662,1150,3434,18910,49205,20060,52639
260120,202303,20107,43737,17135,39678,1891,3984,11953,27572,13844,31556
260130,202303,4090,8767,3507,7971,87,193,2892,6324,2979,6517
260140,202303,17386,32216,15073,29526,412,898,13132,25026,13544,25924
260150,202303,4770,9003,4183,8304,111,217,3757,7390,3868,7607
260160,202303,9431,17969,8197,16524,141,283,7523,15041,7664,15324
260170,202303,28023,55842,24034,50660,1172,2617,19537,39948,20709,42565
260180,202303,4435,9960,3744,9004,72,259,3182,7477,3254,7736
260190,202303,27329,44413,23380,39924,181,354,21593,35930,21774,36284
260200,202303,13775,29077,11878,26671,476,908,10373,23220,10849,24128
260210,202303,13849,34400,11622,30953,396,1196,9281,24378,9677,25574
260220,202303,15436,28672,14248,27235,340,561,12753,23943,13093,24504
260230,202303,16562,30743,14433,28129,330,628,12540,23865,12870,24493
260240,202303,3426,8796,2940,7938,64,259,2356,6146,2420,6405
260250,202303,2958,6417,2510,5754,99,238,2010,4448,2109,4686
260260,202303,17895,39198,15823,36368,1204,2492,12056,28055,13260,30547
260270,202303,6405,11756,5708,10992,76,214,5190,9734,5266,9948
260280,202303,16701,39590,15154,37437,330,1192,13530,32377,13860,33569
260290,202303,55653,122929,48223,112886,4164,10302,34855,79012,39019,89314
260300,202303,13432,28571,11566,26020,269,781,9952,21761,10221,22542
260310,202303,8262,16387,7422,15373,388,641,6274,13023,6662,13664
260320,202303,9005,23570,7482,21125,145,529,6184,17158,6329,17687
260330,202303,2940,8098,2475,7182,59,206,1977,5562,2036,5768
260340,202303,2765,6165,2409,5662,39,146,2122,4781,2161,4927
260345,202303,38504,82956,32906,75424,3046,7539,22552,48748,25598,56287
260350,202303,8005,14334,6977,13198,26,92,6504,12015,6530,12107
260360,202303,2971,6891,2586,6210,100,282,1849,4272,1949,4554
260370,202303,6978,16610,5923,14916,153,516,4791,11483,4944,11999
260380,202303,6187,15785,5245,14297,229,544,4001,10838,4230,11382
260390,202303,5681,15178,4536,13019,234,648,3018,8437,3252,9085
260392,202303,4996,12117,4524,11541,51,290,4009,10059,4060,10349
260400,202303,28295,52447,24754,47962,353,1015,21370,39031,21723,40046
260410,202303,105006,221879,84580,194380,14701,36449,43395,97636,58096,134085
260415,202303,5894,12629,5079,11488,30,116,4479,9821,4509,9937
260420,202303,17214,28750,14810,26147,70,221,14173,24606,14243,24827
260430,202303,3240,9217,2715,8233,159,516,1835,5457,1994,5973
260440,202303,5362,10784,4760,10028,31,114,4390,9058,4421,9172
260450,202303,6990,15568,6225,14589,372,684,5158,12245,5530,12929
260460,202303,7042,17107,6041,15500,437,1320,4237,10267,4674,11587
260470,202303,6355,13135,5352,12012,148,301,4669,10765,4817,11066
260480,202303,4690,10680,3921,9638,323,841,2804,6807,3127,7648
260490,202303,7137,13349,6247,12187,35,121,5805,11055,5840,11176
260500,202303,7578,16565,6483,15084,510,1142,4591,10607,5101,11749
260510,202303,14449,27890,12374,25080,145,450,11176,21996,11321,22446
260515,202303,5729,12984,4501,10850,93,265,3405,7609,3498,7874
260520,202303,20576,41577,18006,38397,1028,2211,14782,30745,15810,32956
260530,202303,12796,29621,10958,27011,91,408,9835,23607,9926,24015
260540,202303,9947,17522,8910,16291,120,245,8299,14935,8419,15180
260545,202303,166,420,108,306,19,62,39,86,58,148
260550,202303,3848,9332,3067,8054,187,633,2057,5006,2244,5639
260560,202303,6986,15843,5759,14045,138,416,4865,11534,5003,11950
260570,202303,11730,23455,10286,21679,197,543,9177,18763,9374,19306
260580,202303,6528,12016,5916,11241,19,39,5546,10369,5565,10408
260590,202303,10087,17277,8693,15762,101,241,7986,14170,8087,14411
260600,202303,44636,95551,37446,85302,1233,3424,30417,65870,31650,69294
260610,202303,9742,22160,8483,20540,382,1013,6580,15593,6962,16606
260620,202303,28235,55767,25257,51971,1178,3215,20925,40615,22103,43830
260630,202303,2899,6870,2372,6054,58,154,1949,4853,2007,5007
260640,202303,33033,60166,28453,55023,1003,1952,24473,46420,25476,48372
260650,202303,7835,17292,6299,15420,484,845,5177,12767,5661,13612
260660,202303,9683,20014,8510,18594,276,741,7662,16407,7938,17148
260670,202303,2838,6394,2313,5569,80,224,1799,4112,1879,4336
260680,202303,40350,81698,34290,73709,2098,4814,26251,53812,28349,58626
260690,202303,4221,9580,3467,8467,84,288,2764,6528,2848,6816
260700,202303,9381,18909,8781,18269,65,204,8525,17664,8590,17868
260710,202303,1665,3862,1382,3435,56,187,1108,2675,1164,2862
260720,202303,39531,76711,34337,70588,1796,4087,28312,56496,30108,60583
260730,202303,10318,25096,8937,23223,200,720,7779,19710,7979,20430
260740,202303,1664,3973,1343,3457,25,102,1111,2809,1136,2911
260750,202303,9768,21146,7675,18635,219,385,6729,16743,6948,17128
260760,202303,8711,16542,7647,15328,119,334,6925,13554,7044,13888
260765,202303,10750,25970,9423,24197,674,1934,6806,16918,7480,18852
260770,202303,4803,10597,3915,9222,93,282,3182,7245,3275,7527
260775,202303,7646,16742,6735,15414,154,518,5559,11954,5713,12472
260780,202303,4716,11858,4156,10988,367,1164,2706,6573,3073,7737
260790,202303,195539,363017,166872,327485,19829,40266,118790,223853,138619,264119
260795,202303,4687,8817,4037,8016,143,305,3476,6760,3619,7065
260800,202303,8064,14406,7286,13413,255,404,6446,11617,6701,12021
260805,202303,4764,10952,4122,9956,136,433,3359,7738,3495,8171
260810,202303,8395,19232,7335,17387,293,778,5867,13258,6160,14036
260820,202303,6169,11470,5500,10731,72,213,4902,9433,4974,9646
260825,202303,3584,9392,3132,8667,125,387,2421,6561,2546,6948
260830,202303,5373,13525,4497,12089,534,1173,3014,8292,3548,9465
260840,202303,5880,12028,5239,11207,228,437,4574,9660,4802,10097
260845,202303,5742,12916,5068,11863,202,587,4053,9015,4255,9602
260850,202303,6217,14523,5187,12767,388,1022,3544,8174,3932,9196
260860,202303,4139,10539,3526,9480,160,476,2791,7292,2951,7768
260870,202303,5822,11266,5021,10313,143,264,4427,9020,4570,9284
260875,202303,10705,20882,8842,18370,687,1361,6447,13264,7134,14625
260880,202303,14436,31831,12716,29217,285,769,10989,24458,11274,25227
260890,202303,17081,36854,14694,33450,1257,2924,9973,22197,11230,25121
260900,202303,7029,17355,5803,15672,584,1572,3626,9696,4210,11268
260910,202303,4363,9649,3809,8872,139,308,3040,6940,3179,7248
260915,202303,7360,15267,6681,14485,28,107,6323,13525,6351,13632
260920,202303,4452,8387,3820,7723,114,193,3402,6821,3516,7014
260930,202303,5046,12829,4297,11613,169,575,3404,8878,3573,9453
260940,202303,19980,39797,17359,36296,1164,2586,13523,27247,14687,29833
260950,202303,9748,21534,7931,18724,368,1045,5632,12232,6000,13277
260960,202303,120076,215102,102088,193434,7363,14858,78720,141782,86083,156640
260970,202303,6998,15862,6054,14670,382,683,4562,11214,4944,11897
260980,202303,5991,14255,5222,13319,75,195,4747,12108,4822,12303
260990,202303,21062,51307,17694,46778,725,2190,14002,36131,14727,38321
261000,202303,21894,42176,18442,37944,566,1405,15534,30742,16100,32147
261010,202303,2769,6086,2368,5562,93,239,2026,4703,2119,4942
261020,202303,8587,18821,7561,17255,319,760,6199,13572,6518,14332
261030,202303,5123,12762,4471,11697,102,369,3641,9089,3743,9458
261040,202303,6783,16511,5545,14406,168,547,4389,10861,4557,11408
261050,202303,10028,21901,9043,20540,204,423,7664,17132,7868,17555
261060,202303,18995,40071,16555,37222,394,959,14043,30804,14437,31763
261070,202303,95917,182620,80942,163655,7539,15309,59318,116038,66857,131347
261080,202303,9031,18020,8156,16983,88,190,7693,15874,7781,16064
261090,202303,26542,50396,23630,46758,755,1399,20640,40152,21395,41551
261100,202303,11164,25694,9690,23637,584,1411,7458,17767,8042,19178
261110,202303,99153,232097,84221,206915,9994,26741,53249,124663,63243,151404
261120,202303,5024,10015,4391,9176,102,232,3841,7763,3943,7995
261130,202303,9899,19733,8729,18234,188,362,7623,15659,7811,16021
261140,202303,5011,9603,4403,8827,297,527,3432,6831,3729,7358
261150,202303,7203,15026,6335,13847,228,437,5393,11621,5621,12058
261153,202303,2336,6222,1904,5427,78,234,1349,3769,1427,4003
261160,202303,320840,638113,267422,569568,65710,142634,117378,251579,183088,394213
261170,202303,9895,18700,8614,17058,233,462,7573,14515,7806,14977
261180,202303,11970,25545,10482,23722,482,1037,8252,18399,8734,19436
261190,202303,6670,14907,5983,13908,149,584,5057,11191,5206,11775
261200,202303,4460,8517,3849,7740,134,280,3242,6334,3376,6614
261210,202303,2311,4955,1979,4511,139,219,1603,3666,1742,3885
261220,202303,19119,43935,16342,39567,1419,3644,11495,26263,12914,29907
261230,202303,4809,11793,3957,10702,42,154,3347,9004,3389,9158
261240,202303,8096,15411,7192,14187,202,413,6363,12235,6565,12648
261245,202303,4797,11226,3902,9770,63,264,3222,7651,3285,7915
261247,202303,3799,9919,3139,8792,339,910,2025,5697,2364,6607
261250,202303,38868,70969,34491,66036,3161,6337,27836,52514,30997,58851
261255,202303,4922,12719,3968,10974,159,517,3001,8044,3160,8561
261260,202303,20524,39878,18235,37095,236,792,17095,33866,17331,34658
261270,202303,6732,12402,5958,11511,213,392,5333,10105,5546,10497
261280,202303,3265,7739,2819,7042,108,350,2258,5364,2366,5714
261290,202303,3746,7993,3134,7324,87,242,2590,6056,2677,6298
261300,202303,17321,38500,14925,34914,378,1216,12221,27071,12599,28287
261310,202303,12783,26585,11025,24296,903,2040,8300,17694,9203,19734
261320,202303,7620,18298,6582,16714,100,303,5611,13914,5711,14217
261330,202303,8161,15801,7386,14843,187,455,6634,13006,6821,13461
261340,202303,7710,15238,6940,14339,97,309,6410,12894,6507,13203
261350,202303,10322,27311,8958,25072,306,833,6949,19251,7255,20084
261360,202303,11312,22042,9621,19761,394,817,7869,15582,8263,16399
261370,202303,32486,69386,27686,63255,2264,5431,20189,44605,22453,50036
261380,202303,5585,13289,4812,12073,481,1192,3372,8391,3853,9583
261390,202303,21529,53563,17986,48231,1259,3807,12417,32064,13676,35871
261400,202303,6308,15324,5492,13869,206,670,4409,10519,4615,11189
261410,202303,12677,26328,10485,23188,291,822,8892,18777,9183,19599
261420,202303,10860,25764,9817,24567,573,1728,7894,19322,8467,21050
261430,202303,5557,11160,4806,10095,32,115,4374,8866,4406,8981
261440,202303,1673,4507,1363,3947,49,211,984,2703,1033,2914
261450,202303,19166,42623,16863,39358,625,1450,13645,31437,14270,32887
261460,202303,9728,22569,8221,20334,277,687,6674,16330,6951,17017
261470,202303,4726,10445,4052,9527,51,187,3422,7823,3473,8010
261480,202303,6891,17554,5850,15899,232,833,4600,11979,4832,12812
261485,202303,7146,16999,6253,15710,429,1260,4742,11449,5171,12709
261500,202303,8739,18590,7541,17008,625,1143,5355,12454,5980,13597
261510,202303,2200,5839,1899,5367,67,235,1461,4083,1528,4318
261520,202303,2947,7584,2620,6988,133,378,1928,4970,2061,5348
261530,202303,15534,38377,12717,33858,705,2506,8123,19742,8828,22248
261540,202303,12315,29962,11245,28532,2864,6590,5538,15620,8402,22210
261550,202303,4708,10760,4094,9846,226,638,3091,7067,3317,7705
261560,202303,12041,26944,10619,25005,339,930,8954,20505,9293,21435
261570,202303,4508,10765,3495,9119,288,790,2364,5930,2652,6720
261580,202303,9227,19536,8116,18109,63,280,7575,16586,7638,16866
261590,202303,3512,7442,2834,6489,69,220,2332,5101,2401,5321
261600,202303,7838,14834,6746,13375,165,332,5762,10950,5927,11282
261610,202303,2761,7084,2210,6116,229,638,1289,3579,1518,4217
261618,202303,3656,6848,3236,6305,72,209,2855,5317,2927,5526
261620,202303,6052,14064,5558,13391,588,1265,4112,10270,4700,11535
261630,202303,7446,18860,6344,16851,497,1446,4100,10250,4597,11696
261640,202303,50391,95033,43065,86478,2246,3604,34242,69072,36488,72676
261650,202303,5569,11055,4715,10050,221,434,3902,8247,4123,8681
270010,202303,5156,15319,4417,14126,148,718,3501,10840,3649,11558
270020,202303,5204,10588,4540,9788,109,420,4025,8211,4134,8631
270030,202303,44786,107663,38084,97635,2515,6877,29306,73253,31821,80130
270040,202303,12560,29361,10600,27048,660,1794,8440,21358,9100,23152
270050,202303,6794,13700,5806,12605,148,353,5351,11525,5499,11878
270060,202303,2744,6309,2331,5811,156,413,1860,4558,2016,4971
270070,202303,6558,14410,5715,13292,87,333,5101,11412,5188,11745
270080,202303,1699,4107,1416,3681,87,224,1067,2703,1154,2927
270090,202303,2244,5760,2031,5402,30,133,1796,4663,1826,4796
270100,202303,8891,16495,7793,15090,158,366,7010,13194,7168,13560
270110,202303,4071,8559,3321,7702,215,340,2633,6384,2848,6724
270120,202303,3086,7610,2700,7098,89,273,2209,5716,2298,5989
270130,202303,6188,13975,5299,12934,151,467,4575,10978,4726,11445
270135,202303,2415,5068,2050,4672,24,108,1893,4244,1917,4352
270140,202303,10644,23481,8494,20626,327,1016,6632,15236,6959,16252
270150,202303,3937,8673,3639,8282,21,68,3494,7910,3515,7978
270160,202303,6345,15921,5443,14826,169,591,4877,13128,5046,13719
270170,202303,3865,10230,3218,9325,204,800,2284,6242,2488,7042
270180,202303,2827,7523,2542,7167,34,177,2261,6224,2295,6401
270190,202303,3106,6086,2840,5785,30,75,2687,5382,2717,5457
270200,202303,3187,8339,2744,7711,392,972,1775,5117,2167,6089
270210,202303,7305,14568,6281,13410,86,257,5854,12288,5940,12545
270220,202303,2098,4531,1713,4023,113,314,1315,2917,1428,3231
270230,202303,12440,29663,10528,26897,966,2679,7837,19458,8803,22137
270235,202303,7337,20083,6419,18676,266,803,5209,14980,5475,15783
270240,202303,14322,33794,11755,30283,996,2754,8614,21622,9610,24376
270250,202303,4186,8261,3784,7735,152,298,3373,6796,3525,7094
270255,202303,5278,13505,4164,11644,145,488,3256,8835,3401,9323
270260,202303,6468,17812,5849,16821,96,440,5068,14283,5164,14723
270270,202303,1205,2839,1001,2599,117,286,735,1894,852,2180
270280,202303,4594,9733,3636,8587,297,586,2701,6574,2998,7160
270290,202303,9678,26847,8732,25417,169,719,7773,22340,7942,23059
270300,202303,4960,11569,3864,10367,186,411,3114,8497,3300,8908
270310,202303,8195,20531,6984,18788,160,538,5856,15532,6016,16070
270320,202303,6598,17529,5627,15801,233,810,4236,11282,4469,12092
270330,202303,5248,14326,4593,13411,182,781,3858,11029,4040,11810
270340,202303,1987,4646,1683,4232,81,162,1417,3560,1498,3722
270350,202303,2325,4671,1867,4148,154,293,1366,3107,1520,3400
270360,202303,4281,8064,3893,7636,46,120,3737,7262,3783,7382
270370,202303,1614,4506,1454,4220,35,157,1228,3514,1263,3671
270375,202303,4860,8683,4243,8026,17,53,4093,7678,4110,7731
270380,202303,6879,15854,5802,14589,617,1382,4319,11102,4936,12484
270390,202303,1510,3275,1201,2916,11,62,1024,2455,1035,2517
270400,202303,7875,18389,6529,16426,271,727,5076,12427,5347,13154
270410,202303,6007,14908,5226,13784,146,494,4484,11642,4630,12136
270420,202303,8364,19395,7623,18384,163,586,6868,16092,7031,16678
270430,202303,211186,428152,169794,376848,20068,46533,108271,231279,128339,277812
270440,202303,5742,13701,4952,12717,139,414,4326,11063,4465,11477
270450,202303,11268,23405,10023,21954,496,886,8460,18782,8956,19668
270460,202303,4718,9242,4007,8388,228,361,3525,7442,3753,7803
270470,202303,14693,35279,12782,32711,664,1972,10291,25731,10955,27703
270480,202303,3747,8515,3124,7676,174,507,2576,6110,2750,6617
270490,202303,1081,2687,936,2514,34,116,779,2040,813,2156
270500,202303,6007,15790,5337,14724,280,834,4292,11694,4572,12528
270510,202303,7922,17118,6665,15575,324,920,5382,12053,5706,12973
270520,202303,4981,12265,3972,10757,742,2126,1949,5218,2691,7344
270530,202303,1614,4190,1369,3814,98,249,947,2669,1045,2918
270540,202303,2759,6549,2303,5970,72,216,1996,5091,2068,5307
270550,202303,7993,18338,6251,16422,631,1505,4524,12156,5155,13661
270560,202303,3631,8128,3020,7339,161,473,2433,5737,2594,6210
270570,202303,6955,14435,6085,13260,614,1414,4900,10302,5514,11716
270580,202303,2944,7018,2654,6634,110,301,2312,5691,2422,5992
270590,202303,1748,4780,1603,4579,18,74,1501,4275,1519,4349
270600,202303,3339,8951,3034,8507,58,211,2684,7427,2742,7638
270610,202303,4438,10377,3871,9654,131,260,3422,8505,3553,8765
270620,202303,1425,3895,1298,3682,27,94,1112,3065,1139,3159
270630,202303,24086,49030,21036,45043,701,1885,18328,37926,19029,39811
270640,202303,6692,16612,5521,14779,136,521,4501,11789,4637,12310
270642,202303,3112,8729,2722,8103,201,652,2020,5859,2221,6511
270644,202303,4880,10613,4062,9596,275,649,3243,7570,3518,8219
270650,202303,4602,10610,4054,9933,263,799,3408,8157,3671,8956
270660,202303,2421,5315,2081,4864,90,210,1631,3726,1721,3936
270670,202303,23741,45332,20202,41080,692,1439,17581,34762,18273,36201
270680,202303,8005,14574,7274,13790,309,407,6689,12839,6998,13246
270690,202303,12720,27155,10613,24468,253,742,8960,20029,9213,20771
270700,202303,692,1814,596,1667,60,185,417,1123,477,1308
270710,202303,6983,18316,6117,17035,391,1120,4770,13113,5161,14233
270720,202303,4554,11188,4042,10379,93,300,3582,8985,3675,9285
270730,202303,9675,19227,8343,17835,1013,1300,6241,14627,7254,15927
270740,202303,2790,6762,2435,6349,78,249,2038,5233,2116,5482
270750,202303,6901,15585,6079,14558,94,376,5485,12820,5579,13196
270760,202303,4072,9817,3368,8879,52,226,2866,7392,2918,7618
270770,202303,29532,64571,24118,57837,3330,8139,15734,37137,19064,45276
270780,202303,2512,5387,2315,5135,43,138,2135,4649,2178,4787
270790,202303,2162,4974,1841,4574,136,330,1473,3609,1609,3939
270800,202303,14783,32788,13276,30766,553,1365,11147,25422,11700,26787
270810,202303,4121,9868,3272,8646,174,538,2486,6366,2660,6904
270820,202303,1941,5194,1652,4761,56,232,1335,3765,1391,3997
270830,202303,6335,13649,5158,12239,201,564,4220,9783,4421,10347
270840,202303,9855,26471,8557,24534,344,1449,6946,19145,7290,20594
270850,202303,11068,22249,9713,20716,669,1572,8235,17350,8904,18922
270860,202303,18017,35626,14359,31557,554,1293,11991,25779,12545,27072
270870,202303,2779,7146,2229,6237,215,610,1449,3992,1664,4602
270880,202303,9383,25462,8377,23981,208,822,6973,19488,7181,20310
270890,202303,4276,10349,3615,9412,469,1201,2143,5498,2612,6699
270895,202303,4708,10980,4201,10358,133,384,3709,8989,3842,9373
270900,202303,1887,4418,1453,3761,21,75,1207,3040,1228,3115
270910,202303,5322,13229,4623,12251,249,531,3819,10065,4068,10596
270915,202303,11576,28971,9366,25576,847,2739,6377,16503,7224,19242
270920,202303,7326,18291,6370,16930,124,461,5463,14132,5587,14593
270930,202303,22521,45198,17725,39768,2069,4186,12817,29418,14886,33604
270940,202303,7287,17382,6055,15951,172,701,4979,12632,5151,13333
280010,202303,699,1832,543,1527,20,80,377,955,397,1035
280020,202303,6624,13962,5598,12455,414,950,4270,9117,4684,10067
280030,202303,126559,245427,105664,217545,16138,34335,64199,127404,80337,161739
280040,202303,3795,8659,3285,7953,161,478,2554,5902,2715,6380
280050,202303,5159,13147,4300,11776,949,2571,2135,5780,3084,8351
280060,202303,9653,20591,7858,18037,1002,2598,4984,10973,5986,13571
280067,202303,9100,18569,7724,16582,634,1032,5701,12177,6335,13209
280070,202303,2097,5732,1924,5476,123,414,1507,4150,1630,4564
280100,202303,5409,12057,4554,10801,556,1155,2916,7146,3472,8301
280110,202303,1988,4160,1702,3771,22,59,1555,3363,1577,3422
280120,202303,9886,23650,8735,21921,1179,2578,6104,15675,7283,18253
280130,202303,10715,22409,9332,20557,640,1438,7351,15896,7991,17334
280140,202303,7784,14929,6871,13700,690,1135,5178,10498,5868,11633
280150,202303,4907,11154,4215,10182,495,1082,2974,7079,3469,8161
280160,202303,1628,3888,1387,3520,132,367,968,2311,1100,2678
280170,202303,7388,15157,6626,14221,202,458,5725,11998,5927,12456
280190,202303,2117,3450,1925,3210,35,97,1807,2928,1842,3025
280200,202303,1520,3593,1247,3199,80,254,906,2196,986,2450
280210,202303,22497,46946,19493,42901,2186,4816,13170,28079,15356,32895
280220,202303,2125,4774,1810,4374,112,255,1441,3495,1553,3750
280230,202303,5058,11483,4086,10041,263,502,2817,6926,3080,7428
280240,202303,3946,9274,3443,8555,29,148,3002,7228,3031,7376
280250,202303,1253,2393,1057,2121,58,126,840,1604,898,1730
280260,202303,3099,5983,2737,5544,41,90,2536,5085,2577,5175
280270,202303,3031,7058,2666,6561,115,349,2289,5470,2404,5819
280280,202303,4755,12448,4192,11660,586,1386,2873,8227,3459,9613
280290,202303,28010,59445,23956,53949,2492,5875,15096,34155,17588,40030
280300,202303,16812,31798,14569,29388,1143,1562,11546,24330,12689,25892
280310,202303,1695,3854,1402,3405,47,123,1112,2600,1159,2723
280320,202303,11497,25942,9967,23763,949,2374,7349,16687,8298,19061
280330,202303,5630,12419,4661,11086,351,789,3404,7893,3755,8682
280340,202303,6494,12005,5430,10842,197,301,4798,9588,4995,9889
280350,202303,40722,73990,36077,68083,1046,2384,31201,56560,32247,58944
280360,202303,7015,17325,6041,15820,655,1869,3847,9804,4502,11673
280370,202303,2923,5987,2358,5098,142,249,1769,3741,1911,3990
280380,202303,1294,2978,1093,2712,102,226,766,1899,868,2125
280390,202303,5224,10286,4408,9101,278,453,3582,7339,3860,7792
280400,202303,5175,10650,4490,9786,420,836,3405,7366,3825,8202
280410,202303,3507,8186,2936,7299,297,779,1877,4401,2174,5180
280420,202303,5553,12349,4970,11650,114,273,4490,10505,4604,10778
280430,202303,2951,5866,2614,5440,62,166,2301,4628,2363,4794
280440,202303,5624,12320,4951,11374,199,514,4225,9368,4424,9882
280445,202303,2680,6338,2406,5897,57,166,1936,4556,1993,4722
280450,202303,12228,26900,10539,24637,2270,5397,5418,12862,7688,18259
280460,202303,8893,18101,8041,16983,437,1049,6817,13959,7254,15008
280470,202303,2022,5021,1667,4382,148,421,1191,2992,1339,3413
280480,202303,64918,130678,56450,119439,5489,12427,40351,82038,45840,94465
280490,202303,4230,11055,3524,9870,130,522,2636,6989,2766,7511
280500,202303,1309,2630,1077,2349,28,79,894,1944,922,2023
280510,202303,4489,7564,3977,6936,55,155,3676,6163,3731,6318
280520,202303,2355,4795,2057,4401,165,291,1572,3358,1737,3649
280530,202303,2854,6442,2468,5931,114,271,1967,4634,2081,4905
280540,202303,10329,24723,9250,23232,399,979,7883,19658,8282,20637
280550,202303,8396,16804,6999,14924,115,427,5975,12104,6090,12531
280560,202303,9241,21575,8585,20661,128,394,7733,18284,7861,18678
280570,202303,8885,17837,7378,16041,307,707,5906,12419,6213,13126
280580,202303,7784,16286,6871,15057,453,878,5564,11989,6017,12867
280590,202303,3416,7140,2874,6489,165,421,2164,4637,2329,5058
280600,202303,5312,11258,4665,10355,155,363,3706,8009,3861,8372
280610,202303,3511,6913,3128,6441,132,306,2697,5347,2829,5653
280620,202303,7875,15865,6740,14465,567,835,4961,11035,5528,11870
280630,202303,5159,11452,4730,10926,432,848,3633,8550,4065,9398
280640,202303,3048,6669,2643,6224,96,216,2354,5534,2450,5750
280650,202303,1471,3439,1215,3073,121,288,836,2037,957,2325
280660,202303,4883,8988,4278,8297,161,293,3779,7203,3940,7496
280670,202303,25972,52884,22362,48308,3376,7166,14482,30999,17858,38165
280680,202303,3594,7546,3073,6823,295,544,2109,4829,2404,5373
280690,202303,1287,2583,1091,2345,50,131,914,1879,964,2010
280700,202303,1465,3037,1249,2740,28,67,1041,2212,1069,2279
280710,202303,19229,36701,16393,33544,1028,1541,14006,28896,15034,30437
280720,202303,3268,6357,2686,5681,52,117,2236,4703,2288,4820
280730,202303,1247,2859,1051,2568,93,230,746,1759,839,1989
280740,202303,21656,40492,18720,36511,990,2155,15321,28580,16311,30735
280750,202303,4139,10378,3537,9382,233,664,2525,6528,2758,7192
280760,202303,9227,19419,7851,17613,761,1524,5695,12728,6456,14252
290010,202303,3917,7090,2595,5167,25,56,2270,4319,2295,4375
290020,202303,7621,15307,6946,14518,523,800,5803,12337,6326,13137
290030,202303,5685,11231,4656,10058,353,652,3633,8013,3986,8665
290035,202303,6618,12202,5365,10620,262,432,4370,8546,4632,8978
290040,202303,7276,12256,6281,11114,294,397,5489,9691,5783,10088
290050,202303,2540,7263,2143,6480,151,488,1457,4284,1608,4772
290060,202303,1926,3679,1403,2979,165,368,1018,2075,1183,2443
290070,202303,53706,100504,46193,91181,2928,5588,36230,69477,39158,75065
290080,202303,8458,19315,7331,17759,738,1832,5276,12679,6014,14511
290090,202303,2859,4504,2095,3692,33,64,1943,3367,1976,3431
290100,202303,12266,27869,9861,24460,1721,4066,5065,12913,6786,16979
290110,202303,6986,15776,5978,14224,802,1790,3618,8562,4420,10352
290115,202303,4901,12921,4158,11682,385,1104,3171,8822,3556,9926
290120,202303,8415,17614,7046,15767,202,547,6047,13155,6249,13702
290130,202303,5617,11711,4351,10081,291,570,3096,7383,3387,7953
290135,202303,5746,11515,4678,9822,164,409,3821,7544,3985,7953
290140,202303,5496,12435,4244,10816,219,499,3435,8820,3654,9319
290150,202303,4219,7798,3681,7200,153,382,3150,5942,3303,6324
290160,202303,4455,8526,3948,7854,190,332,3346,6563,3536,6895
290170,202303,4679,9288,4140,8716,134,269,3683,7749,3817,8018
290180,202303,3706,8661,3098,7740,64,220,2636,6384,2700,6604
290190,202303,6284,13181,5611,12329,117,319,4927,10579,5044,10898
290195,202303,3410,6761,2692,5865,165,312,2209,4808,2374,5120
290200,202303,5010,12446,3886,10544,259,565,2703,7355,2962,7920
290205,202303,4614,9814,4047,9005,168,410,3314,7198,3482,7608
290210,202303,18125,39917,15924,36717,1572,3041,12109,28282,13681,31323
290220,202303,4220,7765,3736,7201,91,219,3320,6207,3411,6426
290225,202303,4002,6878,3094,5950,43,116,2869,5370,2912,5486
290230,202303,3922,7510,3580,7133,176,250,2970,6064,3146,6314
290240,202303,5324,10405,4358,9271,74,229,3859,8009,3933,8238
290250,202303,5035,12134,4107,10837,154,357,3403,9116,3557,9473
290260,202303,6710,14165,5683,12729,262,673,4771,10298,5033,10971
290265,202303,3970,10608,3180,9189,305,918,2045,5747,2350,6665
290270,202303,13221,39615,12027,37652,865,2761,9174,28762,10039,31523
290280,202303,7452,20378,6366,18318,573,1870,4285,11823,4858,13693
290290,202303,11909,31305,9457,27009,1098,3374,5810,16063,6908,19437
290300,202303,5127,12368,3738,9883,200,588,2644,6710,2844,7298
290310,202303,2875,4966,2364,4384,21,68,2216,4014,2237,4082
290320,202303,37541,83064,30573,73196,5107,12674,17983,41875,23090,54549
290323,202303,4725,11369,3970,10194,102,266,3120,7935,3222,8201
290327,202303,5178,12958,4337,11434,409,976,2896,7513,3305,8489
290330,202303,3132,5088,2536,4456,23,29,2367,4149,2390,4178
290340,202303,8054,16286,6288,14217,471,1003,5029,11304,5500,12307
290350,202303,5763,14543,4758,12877,256,772,3453,9103,3709,9875
290360,202303,6776,13910,5918,12804,94,240,5251,11144,5345,11384
290370,202303,5805,12642,4187,10523,176,428,2964,7353,3140,7781
290380,202303,7340,15504,6101,13872,181,306,5185,11830,5366,12136
290390,202303,19107,47409,15714,42102,1459,3911,10883,28793,12342,32704
290395,202303,3599,8770,2840,7526,68,252,2244,5771,2312,6023
290400,202303,4578,11134,3645,9660,177,545,2734,6986,2911,7531
290405,202303,5511,14172,4606,12645,496,1296,3009,8436,3505,9732
290410,202303,6788,16106,5161,13647,173,629,3923,9982,4096,10611
290420,202303,3785,9135,3032,8002,113,296,2335,6123,2448,6419
290430,202303,4605,9742,3812,8641,164,454,3080,6621,3244,7075
290440,202303,3450,7657,2496,6187,174,391,1774,4405,1948,4796
290450,202303,5412,10107,4363,8690,88,214,3891,7438,3979,7652
290460,202303,15596,39986,12826,35017,2791,7848,5016,13359,7807,21207
290470,202303,6214,12134,4730,10216,417,936,3250,6767,3667,7703
290475,202303,8085,20041,6662,17731,86,390,5628,14594,5714,14984
290480,202303,2318,4926,1883,4316,75,233,1434,3058,1509,3291
290485,202303,5717,14301,4958,13244,227,670,3996,10631,4223,11301
290490,202303,12184,23680,11057,22243,454,911,9245,18380,9699,19291
290500,202303,5102,13722,3941,11462,710,2211,1549,4284,2259,6495
290510,202303,4537,9279,3796,8355,106,233,3327,7346,3433,7579
290515,202303,4245,10422,3662,9620,29,89,3312,8728,3341,8817
290520,202303,15288,37707,11725,31093,507,1648,8001,19558,8508,21206
290530,202303,5926,15171,4938,13625,92,361,4173,11348,4265,11709
290540,202303,4755,10655,4348,10212,173,461,3862,9028,4035,9489
290550,202303,5272,11587,4575,10773,51,105,4199,9956,4250,10061
290560,202303,7872,17868,6049,15304,573,1619,3854,9147,4427,10766
290570,202303,73852,154339,66241,144818,4743,11289,53215,112879,57958,124168
290580,202303,11489,26034,10010,24080,966,2025,7364,18093,8330,20118
290590,202303,8346,23163,6961,20828,160,545,5713,17093,5873,17638
290600,202303,23215,57381,19999,52392,1114,3081,15788,40575,16902,43656
290610,202303,2953,8306,2306,7079,96,312,1608,4848,1704,5160
290620,202303,7329,19054,6309,17450,433,1116,5003,13844,5436,14960
290630,202303,13374,25374,11050,22518,796,1601,8866,17902,9662,19503
290640,202303,3411,7378,2660,6368,261,496,1813,4537,2074,5033
290650,202303,23786,44636,21785,42420,911,2073,19629,37423,20540,39496
290660,202303,4607,10698,3603,9086,194,535,2526,6322,2720,6857
290670,202303,10868,21315,9514,19493,218,562,8408,16774,8626,17336
290680,202303,13741,32205,11301,28768,219,846,9490,23508,9709,24354
290682,202303,6870,13803,5955,12641,493,669,4421,10158,4914,10827
290685,202303,4360,8804,3154,7117,494,1013,1774,4163,2268,5176
290687,202303,10371,21839,8634,19271,1200,2521,5530,12450,6730,14971
290689,202303,3433,8392,2598,6989,345,920,1633,4382,1978,5302
290690,202303,7145,16158,5830,14343,387,944,4280,10293,4667,11237
290700,202303,3947,7838,3500,7311,70,184,3129,6399,3199,6583
290710,202303,11414,25521,9642,23183,203,634,8484,20015,8687,20649
290720,202303,26052,58269,23267,54210,1626,3344,18309,42002,19935,45346
290730,202303,8758,18387,7368,16765,530,976,5260,12328,5790,13304
290740,202303,1325,3019,1005,2530,29,64,860,2130,889,2194
290750,202303,17741,34424,15181,30750,332,870,12765,24247,13097,25117
290755,202303,2395,6185,1911,5358,113,294,1320,3711,1433,4005
290760,202303,4616,11874,3816,10512,217,496,2685,7511,2902,8007
290770,202303,3832,8780,3540,8446,76,197,3166,7511,3242,7708
290780,202303,9514,21261,7981,19201,347,673,6076,14648,6423,15321
290790,202303,6355,14951,5438,13671,280,700,4478,11227,4758,11927
290800,202303,8634,15169,6237,12453,393,638,4634,9359,5027,9997
290810,202303,7101,15078,5698,13126,231,539,4436,10105,4667,10644
290820,202303,6583,14683,5662,13314,313,677,4046,9261,4359,9938
290830,202303,5324,11694,4651,10645,106,356,3750,7988,3856,8344
290840,202303,22748,52781,19136,47353,2105,4390,12412,32278,14517,36668
290850,202303,11425,20508,9906,18885,475,706,8342,15719,8817,16425
290860,202303,8069,18859,7007,17626,380,852,5920,15115,6300,15967
290870,202303,5888,14375,4475,11804,354,852,2963,7709,3317,8561
290880,202303,1720,3729,1346,3266,206,445,760,1995,966,2440
290890,202303,12235,21187,10751,19542,359,613,9672,17447,10031,18060
290900,202303,2786,6748,2124,5632,202,503,1282,3335,1484,3838
290910,202303,6322,13008,4814,10827,48,121,4186,9264,4234,9385
290920,202303,6434,13747,5539,12686,154,228,4716,11350,4870,11578
290930,202303,8806,22379,6960,19247,295,995,5157,13802,5452,14797
290940,202303,4124,10523,3382,9422,165,533,2626,7155,2791,7688
290950,202303,1730,3862,1383,3361,120,278,897,2193,1017,2471
290960,202303,7527,16040,6655,14994,303,546,5564,12482,5867,13028
290970,202303,3708,10302,3011,9025,134,468,2264,6694,2398,7162
290980,202303,18300,36997,15890,33587,850,1988,11557,23030,12407,25018
290990,202303,12150,27935,10778,25893,336,1061,9062,20928,9398,21989
291000,202303,4035,9062,3098,7928,167,426,2465,6360,2632,6786
291005,202303,21977,46241,19374,43032,1074,2316,15959,34864,17033,37180
291010,202303,3567,10099,2790,8456,149,497,1791,5232,1940,5729
291020,202303,1576,3504,1268,3020,31,91,920,2024,951,2115
291030,202303,3092,6514,2276,5238,221,454,1419,3171,1640,3625
291040,202303,6447,15538,5214,13833,261,746,4004,10632,4265,11378
291050,202303,14680,28456,12985,26225,1505,2946,9574,18977,11079,21923
291060,202303,11053,24043,9679,22315,963,2062,7290,16720,8253,18782
291070,202303,22765,48743,19337,43659,345,1096,16825,36673,17170,37769
291072,202303,36531,77637,28023,64816,4077,9499,16035,35579,20112,45078
291075,202303,6499,14388,5810,13350,91,244,4836,10642,4927,10886
291077,202303,2018,4778,1557,4006,92,176,1088,2800,1180,2976
291080,202303,171901,356655,139724,314557,28263,64528,69547,152561,97810,217089
291085,202303,6864,15269,5532,13283,245,650,4486,10486,4731,11136
291090,202303,2651,4380,1950,3610,45,76,1681,3029,1726,3105
291100,202303,4087,7490,2898,6097,126,250,2289,4738,2415,4988
291110,202303,7027,19232,5863,17340,372,1295,4391,12593,4763,13888
291120,202303,10655,21067,9143,19246,572,1164,7229,15043,7801,16207
291125,202303,2906,4426,2214,3661,97,139,1925,3143,2022,3282
291130,202303,3813,9672,2839,7894,80,282,2188,5817,2268,6099
291140,202303,5802,13810,4157,10945,710,1676,2328,6128,3038,7804
291150,202303,3506,5939,2768,5137,65,99,2578,4762,2643,4861
291160,202303,6177,15179,5072,13616,591,1615,3183,8299,3774,9914
291165,202303,2481,6276,1775,4947,26,119,1207,3208,1233,3327
291170,202303,27634,62292,22984,54893,1689,4121,15159,34285,16848,38406
291180,202303,9973,17020,7832,14352,254,507,6915,12296,7169,12803
291185,202303,4378,9271,3875,8561,220,451,3106,6800,3326,7251
291190,202303,9531,20242,7886,18214,320,702,6141,14366,6461,15068
291200,202303,3308,8267,2415,6629,89,314,1623,4149,1712,4463
291210,202303,9611,17119,7146,14357,381,655,5546,11090,5927,11745
291220,202303,6221,14325,5528,13321,556,1272,3774,8985,4330,10257
291230,202303,6226,10480,4962,9120,67,102,4628,8451,4695,8553
291240,202303,5066,11740,4280,10475,80,232,3702,8882,3782,9114
291250,202303,3893,10458,2991,8879,187,533,1800,5431,1987,5964
291260,202303,1798,3621,1456,3185,35,66,1196,2645,1231,2711
291270,202303,6915,15059,5391,13019,559,1243,3811,9372,4370,10615
291280,202303,3482,7480,2589,6203,173,431,1799,4098,1972,4529
291290,202303,6865,16170,5224,13718,501,1377,3449,8796,3950,10173
291300,202303,4819,11303,3818,9710,206,506,2817,7030,3023,7536
291310,202303,6470,14881,5561,13406,138,395,4778,11235,4916,11630
291320,202303,8093,19305,6320,16439,1340,3359,3255,8612,4595,11971
291330,202303,2262,5187,1835,4498,69,187,1388,3284,1457,3471
291340,202303,5143,11803,4063,10095,216,426,2742,6739,2958,7165
291345,202303,3649,8989,3246,8411,202,562,2581,6643,2783,7205
291350,202303,8856,18250,6974,15969,201,499,5844,13114,6045,13613
291360,202303,56095,105803,45119,93268,5532,11252,29910,62231,35442,73483
291370,202303,10234,24131,9002,22307,698,1980,6719,15848,7417,17828
291380,202303,5916,11565,5290,10769,113,307,4743,9410,4856,9717
291390,202303,17296,31232,13372,26900,670,1163,11360,22573,12030,23736
291400,202303,20961,42105,17472,37140,1679,3350,12189,25843,13868,29193
291410,202303,3635,8486,2828,7155,61,197,2108,5126,2169,5323
291420,202303,2317,4955,1813,4346,20,60,1563,3698,1583,3758
291430,202303,3168,7855,2686,7085,102,360,2108,5336,2210,5696
291440,202303,8147,20098,6936,18268,536,1324,5018,13456,5554,14780
291450,202303,13865,25158,11510,22504,312,446,10308,20305,10620,20751
291460,202303,22918,49007,20008,44878,1904,4003,14540,31904,16444,35907
291465,202303,10904,23388,8631,20789,270,912,7361,17223,7631,18135
291470,202303,26259,47311,22414,42971,1175,2065,17964,34087,19139,36152
291480,202303,55334,107468,44537,92882,5034,10604,27475,54796,32509,65400
291490,202303,9341,17870,8324,16758,282,642,7536,14988,7818,15630
291500,202303,6918,13020,5830,11677,166,380,5355,10625,5521,11005
291510,202303,5950,11405,4559,9671,75,215,4015,8311,4090,8526
291520,202303,5657,11373,4328,9733,272,621,3467,7681,3739,8302
291530,202303,2895,5825,2112,4835,228,512,1432,3313,1660,3825
291535,202303,4721,11407,3949,10128,217,484,3132,8087,3349,8571
291540,202303,2732,5176,1927,4225,58,137,1652,3591,1710,3728
291550,202303,8428,15193,6654,13088,532,921,4936,9549,5468,10470
291560,202303,22573,48197,16844,40883,3824,9023,7750,19404,11574,28427
291570,202303,2974,5816,2288,5035,79,174,2011,4423,2090,4597
291580,202303,7906,17523,6210,15380,325,941,4738,11287,5063,12228
291590,202303,3515,6350,3127,5912,67,174,2893,5319,2960,5493
291600,202303,6953,14026,5356,11747,506,1217,3583,7585,4089,8802
291610,202303,8777,16778,7816,15713,708,975,6191,12929,6899,13904
291620,202303,3706,7218,2804,6234,219,392,2075,4724,2294,5116
291630,202303,4403,8060,3373,6827,588,868,2370,5074,2958,5942
291640,202303,23148,46322,17988,39447,1496,3441,11607,24038,13103,27479
291650,202303,12963,25735,11470,24018,907,1273,9395,20346,10302,21619
291660,202303,2449,5294,1805,4359,114,342,1251,2786,1365,3128
291670,202303,2438,5831,1996,5192,203,470,1336,3573,1539,4043
291680,202303,5092,10916,4131,9656,601,1403,2503,5885,3104,7288
291685,202303,5731,12779,4559,11174,216,470,3464,8415,3680,8885
291690,202303,5644,9952,4078,7915,149,313,3541,6651,3690,6964
291700,202303,11949,27695,10521,25487,328,1011,9047,21239,9375,22250
291710,202303,6980,13645,5344,11504,347,763,4061,8374,4408,9137
291720,202303,5406,14574,4432,12777,900,2724,2332,6545,3232,9269
291730,202303,10057,18528,8672,16804,412,818,7405,14168,7817,14986
291733,202303,3620,8055,2963,7186,123,225,2185,5508,2308,5733
291735,202303,3160,7954,2384,6586,54,141,1665,4588,1719,4729
291740,202303,4781,11227,3243,8442,110,230,2286,5831,2396,6061
291750,202303,27903,56582,23224,49979,3065,5885,15373,33159,18438,39044
291760,202303,14034,34842,10933,30252,3415,11017,2663,6607,6078,17624
291770,202303,9431,22035,7794,19279,389,1211,5964,13892,6353,15103
291780,202303,6556,14689,5890,13816,172,436,5063,11630,5235,12066
291790,202303,3820,8215,3479,7811,393,592,2571,6069,2964,6661
291800,202303,45544,94059,36498,81857,4307,10355,23202,49121,27509,59476
291810,202303,13649,27848,11668,25547,489,889,9722,21438,10211,22327
291820,202303,4922,11106,4250,10256,139,341,3475,8282,3614,8623
291830,202303,6104,11516,4987,10105,372,514,3884,7966,4256,8480
291835,202303,7875,21290,6261,18448,711,2145,4024,11866,4735,14011
291840,202303,66738,154023,58175,141509,6223,16247,41353,98076,47576,114323
291845,202303,4264,8172,3553,7338,270,427,2842,6036,3112,6463
291850,202303,5588,13047,4703,11732,134,336,3990,9918,4124,10254
291855,202303,2976,4750,2400,4137,32,53,2266,3874,2298,3927
291860,202303,2532,6251,1724,4732,42,106,1163,3087,1205,3193
291870,202303,1502,3490,996,2620,54,163,663,1684,717,1847
291875,202303,3478,9592,2947,8528,67,268,2171,6012,2238,6280
291880,202303,6766,16463,5671,14757,339,808,4284,11261,4623,12069
291890,202303,2164,3886,1415,3020,220,449,893,1867,1113,2316
291900,202303,1670,3450,1270,2859,37,85,1017,2190,1054,2275
291905,202303,2718,6446,2198,5653,104,329,1640,4031,1744,4360
291910,202303,4551,8432,3928,7713,83,171,3514,6843,3597,7014
291915,202303,8974,22485,7201,19620,273,693,5275,14707,5548,15400
291920,202303,46037,97625,40600,90706,1955,5386,32919,70300,34874,75686
291930,202303,3451,7516,2923,6810,305,672,2097,4944,2402,5616
291940,202303,4550,10452,3057,8078,279,703,1841,4754,2120,5457
291950,202303,11105,30882,9232,27563,525,1579,6110,18132,6635,19711
291955,202303,25875,54732,23179,51366,1499,3586,18562,40352,20061,43938
291960,202303,4780,9463,4002,8504,308,482,3167,6938,3475,7420
291970,202303,6246,12650,5281,11522,199,479,4274,9140,4473,9619
291980,202303,12467,31131,10067,27317,937,2386,6726,18390,7663,20776
291990,202303,2769,6248,2301,5684,33,120,2120,5164,2153,5284
291992,202303,6068,11869,5142,10706,209,464,4319,8673,4528,9137
291995,202303,2870,6298,2368,5565,80,251,1967,4449,2047,4700
292000,202303,3464,6770,2878,6091,89,222,2457,5104,2546,5326
292010,202303,7283,14378,5929,12478,108,347,5109,10345,5217,10692
292020,202303,5946,14105,5040,12683,140,495,4168,10031,4308,10526
292030,202303,2590,6616,2230,6013,157,452,1478,3837,1635,4289
292040,202303,5827,12266,4640,10632,169,406,3847,8677,4016,9083
292045,202303,5747,11170,4571,9536,26,64,4295,8908,4321,8972
292050,202303,7944,19524,6357,16908,269,816,4350,11145,4619,11961
292060,202303,16563,31043,15309,29582,497,870,13667,25869,14164,26739
292070,202303,8851,17431,7798,16215,559,1090,6597,13654,7156,14744
292080,202303,4770,8828,3966,7845,48,146,3691,7168,3739,7314
292090,202303,5284,10157,3744,8293,216,516,2964,6503,3180,7019
292100,202303,16379,34354,14016,31440,2076,4688,8685,19442,10761,24130
292105,202303,4032,9235,3464,8457,48,157,2914,7022,2962,7179
292110,202303,8530,16694,6207,13625,754,1808,4133,8746,4887,10554
292120,202303,8955,19845,7339,17269,805,1628,5025,11738,5830,13366
292130,202303,4177,8801,3389,7834,221,548,2504,5630,2725,6178
292140,202303,7258,13912,6129,12374,182,385,5439,10772,5621,11157
292145,202303,3252,7696,2707,6850,158,291,2028,5247,2186,5538
292150,202303,19947,43216,17172,38948,374,973,14763,32423,15137,33396
292160,202303,3586,7542,2698,6451,33,103,2122,5324,2155,5427
292170,202303,10837,25548,8959,22637,558,1629,6664,16253,7222,17882
292180,202303,3503,8751,2614,7169,195,555,1637,4303,1832,4858
292190,202303,3793,8508,3181,7645,281,708,2235,5323,2516,6031
292200,202303,11841,25763,8942,21784,1917,4829,4200,10270,6117,15099
292205,202303,4735,11309,4117,10438,112,299,3510,8875,3622,9174
292210,202303,8409,15880,6994,14167,78,258,6522,12946,6600,13204
292220,202303,2796,5593,2387,5012,202,404,1727,3478,1929,3882
292225,202303,3840,9881,3322,9141,67,260,2852,7710,2919,7970
292230,202303,10912,22582,9523,20799,314,808,7997,17026,8311,17834
292240,202303,6151,15522,5241,13921,320,788,3723,9821,4043,10609
292250,202303,7818,16955,6948,15773,321,807,5583,12263,5904,13070
292260,202303,4145,9585,3632,8959,57,170,3235,7920,3292,8090
292265,202303,4530,10374,3738,9171,69,263,3178,7538,3247,7801
292270,202303,6288,11383,5155,10060,197,322,4351,8368,4548,8690
292273,202303,3489,6651,2766,5782,162,271,1986,4365,2148,4636
292275,202303,2376,5115,1940,4559,52,160,1623,3726,1675,3886
292280,202303,3419,6861,2716,6059,114,198,2299,5203,2413,5401
292285,202303,3216,6576,2519,5672,116,208,2035,4643,2151,4851
292290,202303,9344,20583,7471,18008,195,479,6276,14877,6471,15356
292300,202303,13190,29158,10366,25342,1553,3808,6219,15249,7772,19057
292303,202303,4214,9294,3663,8488,57,136,3272,7451,3329,7587
292305,202303,2814,6711,2549,6352,54,175,2275,5586,2329,5761
292310,202303,8709,18371,7526,16950,147,437,6606,14504,6753,14941
292320,202303,7124,16922,5663,14523,170,506,4422,11002,4592,11508
292330,202303,4062,6755,3404,6035,157,231,2873,5140,3030,5371
292335,202303,6317,14378,5533,13240,295,674,4548,10890,4843,11564
292340,202303,6222,16024,5071,13836,371,928,3530,9570,3901,10498
292350,202303,3423,7794,2865,7075,147,389,2364,5763,2511,6152
292360,202303,6129,14367,5082,12722,275,731,3716,9088,3991,9819
292370,202303,13831,27344,11878,24847,86,326,11253,23123,11339,23449
292380,202303,8437,20611,7463,18986,452,1214,5807,14385,6259,15599
292390,202303,6198,9720,4777,8127,116,200,4349,7334,4465,7534
292400,202303,29574,70724,25363,64533,2464,6141,17729,44564,20193,50705
292405,202303,5611,11910,4640,10450,152,334,3634,8290,3786,8624
292410,202303,3116,5719,2694,5236,89,153,2394,4630,2483,4783
292420,202303,6269,12005,5602,11123,144,260,5060,9842,5204,10102
292430,202303,6015,16053,4511,13377,343,1097,3016,8738,3359,9835
292440,202303,11557,29389,10573,28003,121,570,9594,25002,9715,25572
292450,202303,4992,12549,3760,10284,93,266,2918,7831,3011,8097
292460,202303,8038,16265,6800,14482,157,439,5964,12283,6121,12722
292465,202303,3181,7071,2650,6396,129,266,1779,4557,1908,4823
292467,202303,2699,6189,2385,5787,317,628,1674,4294,1991,4922
292470,202303,3410,8018,2554,6709,155,355,1774,4694,1929,5049
292480,202303,8525,15501,7032,13752,169,325,6366,12322,6535,12647
292490,202303,3495,6643,2874,5865,80,171,2335,4740,2415,4911
292500,202303,9126,20077,7261,17262,408,874,5396,12536,5804,13410
292510,202303,17736,39598,13965,33989,1057,2500,9875,23760,10932,26260
292520,202303,9380,20575,8264,19013,417,1119,6647,14834,7064,15953
292525,202303,8277,16308,6840,14689,140,325,6155,13137,6295,13462
292530,202303,46368,103724,37339,90194,7201,18608,19291,44726,26492,63334
292540,202303,5435,8810,4348,7668,147,229,3918,6927,4065,7156
292550,202303,10516,24962,8164,22135,674,1675,5563,15875,6237,17550
292560,202303,5660,12395,4659,11029,177,514,3586,8098,3763,8612
292570,202303,4634,10465,3845,9158,58,219,3272,7453,3330,7672
292575,202303,8250,21256,7461,20195,1065,2856,5180,14175,6245,17031
292580,202303,9996,20368,8285,18002,508,697,6844,14957,7352,15654
292590,202303,8905,21087,7471,18608,309,1004,6160,14772,6469,15776
292593,202303,3581,7867,2819,6619,82,209,2328,5344,2410,5553
292595,202303,7096,15918,6136,14755,319,638,5028,12309,5347,12947
292600,202303,14019,32644,12017,29796,678,1535,9469,23469,10147,25004
292610,202303,5674,12219,4775,10819,155,345,3895,8602,4050,8947
292620,202303,8531,18810,7057,17047,118,277,6468,15602,6586,15879
292630,202303,11738,24258,9427,20765,1025,2504,6448,13442,7473,15946
292640,202303,9782,25082,8133,22390,488,1343,5547,15254,6035,16597
292650,202303,5161,11497,4550,10704,65,207,4162,9645,4227,9852
292660,202303,13182,32756,11231,29943,639,1546,8425,22650,9064,24196
292665,202303,2455,6411,2054,5880,118,272,1590,4690,1708,4962
292670,202303,4149,10529,3209,8844,255,825,2071,5428,2326,6253
292680,202303,4819,11281,3823,9632,100,248,2955,7190,3055,7438
292690,202303,2998,7164,2046,5661,219,558,1247,3530,1466,4088
292700,202303,13169,29946,11259,27179,648,1380,8472,20205,9120,21585
292710,202303,4286,9009,4017,8692,92,161,3804,8232,3896,8393
292720,202303,10913,22218,9125,20164,474,881,6989,15915,7463,16796
292730,202303,7000,13195,6292,12242,347,569,5325,10232,5672,10801
292740,202303,528816,1040661,472668,966771,49824,105104,340474,671129,390298,776233
292750,202303,9008,18702,7806,17171,296,613,6623,14423,6919,15036
292760,202303,4810,11994,4115,10836,193,560,3133,8060,3326,8620
292770,202303,9755,20879,8039,18586,1011,2378,5566,12909,6577,15287
292780,202303,2642,4460,1958,3671,48,112,1682,2978,1730,3090
292790,202303,4712,8695,3589,7493,303,554,2823,5960,3126,6514
292800,202303,15058,31695,12904,28578,947,1911,10001,22142,10948,24053
292805,202303,4762,9387,3812,8245,136,323,3209,6756,3345,7079
292810,202303,17152,32956,14125,28649,458,1208,12000,22983,12458,24191
292820,202303,8286,21170,6037,17445,524,1682,4081,11466,4605,13148
292830,202303,3678,7455,3144,6835,154,309,2573,5684,2727,5993
292840,202303,12879,25708,11083,23421,151,458,10114,20793,10265,21251
292850,202303,3245,7382,2735,6692,243,549,1906,4592,2149,5141
292860,202303,23262,43047,20795,40114,412,1011,18417,34444,18829,35455
292870,202303,29424,59987,25444,54613,1751,3679,18212,37435,19963,41114
292880,202303,13684,34089,11378,30521,434,1487,8182,20804,8616,22291
292890,202303,10978,23502,9742,21833,223,671,8534,18540,8757,19211
292895,202303,4259,7628,3319,6304,245,387,2657,5036,2902,5423
292900,202303,3759,8115,3377,7610,56,199,2852,6136,2908,6335
292905,202303,5525,12343,4383,10681,164,456,3392,7934,3556,8390
292910,202303,7064,15330,6203,14238,176,365,5080,11368,5256,11733
292920,202303,12467,28945,11428,27564,350,1045,9823,23098,10173,24143
292925,202303,6329,16399,5158,14253,456,1035,3480,9643,3936,10678
292930,202303,8761,22261,7521,20040,1032,2783,4258,10988,5290,13771
292935,202303,3484,6228,2809,5489,24,83,2576,4959,2600,5042
292937,202303,3354,7722,2759,6936,187,532,1454,4146,1641,4678
292940,202303,3742,8215,2995,7123,491,1069,1810,4401,2301,5470
292950,202303,11379,26397,9872,24273,597,1397,7385,17762,7982,19159
292960,202303,6837,14208,5757,12765,210,388,4650,10148,4860,10536
292970,202303,4961,12060,4361,11237,120,309,3614,9376,3734,9685
292975,202303,5408,10369,4807,9700,102,229,4406,8802,4508,9031
292980,202303,4909,9181,4111,8103,58,166,3698,7083,3756,7249
292990,202303,14008,34497,11620,30538,413,1295,9094,23040,9507,24335
293000,202303,3320,7145,2775,6316,169,331,2082,4764,2251,5095
293010,202303,23910,52054,19332,45476,2512,6185,12268,28238,14780,34423
293015,202303,10501,28244,8271,24177,711,2118,5552,16164,6263,18282
293020,202303,12909,30318,11677,28629,167,565,10621,25765,10788,26330
293030,202303,6270,14809,4820,12617,413,750,3152,8648,3565,9398
293040,202303,5305,11990,4262,10574,129,346,3560,8727,3689,9073
293050,202303,32452,62945,28527,57531,1950,3856,22115,43197,24065,47053
293060,202303,4710,10996,3769,9345,238,611,2736,6493,2974,7104
293070,202303,43068,81318,38500,75760,2280,4760,31224,59317,33504,64077
293075,202303,4403,11806,3807,10880,63,318,3264,9266,3327,9584
293076,202303,4249,9031,3839,8564,107,208,3393,7622,3500,7830
293077,202303,8170,19202,6615,16893,985,2242,3794,10271,4779,12513
293080,202303,5507,14393,4608,12867,88,361,3782,10294,3870,10655
293090,202303,3738,10047,2871,8591,203,623,1960,5762,2163,6385
293100,202303,7188,16861,5765,14486,331,696,4391,11001,4722,11697
293105,202303,4654,13180,3928,11777,251,773,2705,8066,2956,8839
293110,202303,3181,6453,2682,5773,129,262,2147,4538,2276,4800
293120,202303,6616,13531,6034,12750,517,721,4850,10626,5367,11347
293130,202303,4523,10610,3895,9822,121,380,3372,8329,3493,8709
293135,202303,40470,86419,29923,72318,5678,15118,12002,27807,17680,42925
293140,202303,3669,6103,3225,5600,103,137,2871,4913,2974,5050
293150,202303,6299,16593,5166,14576,421,1280,3499,9533,3920,10813
293160,202303,5252,10518,4625,9816,572,766,3554,8206,4126,8972
293170,202303,6977,11160,5959,10014,110,237,5298,8665,5408,8902
293180,202303,5713,13624,4694,11893,100,329,3841,9406,3941,9735
293190,202303,21283,42567,18804,39242,123,478,17320,35156,17443,35634
293200,202303,11867,23203,9743,20092,600,926,7969,16387,8569,17313
293210,202303,6814,14856,5749,13357,594,1224,4132,9711,4726,10935
293220,202303,7652,15303,5767,12429,774,1630,3824,7874,4598,9504
293230,202303,6048,11697,4611,9948,411,750,3421,7464,3832,8214
293240,202303,5613,12557,4483,10848,208,372,3332,8395,3540,8767
293245,202303,4988,11524,4492,10845,280,647,3660,8688,3940,9335
293250,202303,7169,15145,5746,13228,436,1052,4295,9672,4731,10724
293260,202303,6049,13371,4907,11708,175,335,3595,8597,3770,8932
293270,202303,9623,17871,7681,15820,613,755,6186,13496,6799,14251
293280,202303,5754,12695,4993,11681,316,675,3973,9247,4289,9922
293290,202303,21934,52223,19362,48395,1809,4677,13861,33931,15670,38608
293300,202303,8522,16934,7308,15223,576,1178,5572,11203,6148,12381
293305,202303,5493,10998,4620,9925,43,106,4196,8950,4239,9056
293310,202303,2770,6087,2326,5432,32,114,1931,4355,1963,4469
293315,202303,5874,11130,4879,9785,485,681,3853,7875,4338,8556
293317,202303,3532,7193,3126,6631,316,489,2267,4894,2583,5383
293320,202303,18009,34126,16071,32031,209,506,14771,28833,14980,29339
293325,202303,2307,4922,1792,4286,202,485,1181,2793,1383,3278
293330,202303,99348,225637,82225,198603,9689,26370,50049,111759,59738,138129
293340,202303,2675,6619,2168,5772,183,494,1462,3835,1645,4329
293345,202303,4770,10853,3820,9485,553,1045,2362,6523,2915,7568
293350,202303,7318,17813,6240,16477,218,529,5350,14227,5568,14756
293360,202303,19616,40718,16811,37130,557,1148,14629,32470,15186,33618
310010,202303,1252,2584,873,2099,117,313,377,781,494,1094
310020,202303,4072,9612,3052,7868,520,1447,1280,2985,1800,4432
310030,202303,2483,6217,1966,5346,261,761,1274,3304,1535,4065
310040,202303,1040,2413,803,2024,72,235,470,1032,542,1267
310050,202303,2082,5122,1741,4611,149,474,1158,2920,1307,3394
310060,202303,3898,9328,3223,8418,143,431,2331,6104,2474,6535
310070,202303,450,980,343,836,10,35,258,604,268,639
310080,202303,951,2375,701,1955,102,317,339,885,441,1202
310090,202303,6711,14059,5566,12375,200,566,4524,9607,4724,10173
310100,202303,4694,10500,3894,9321,103,362,3323,7665,3426,8027
310110,202303,6067,14166,4751,12014,618,1809,2900,6843,3518,8652
310120,202303,858,1906,571,1491,92,311,290,638,382,949
310130,202303,547,1232,470,1122,32,103,358,795,390,898
310140,202303,458,1167,352,1018,80,260,164,411,244,671
310150,202303,8143,17933,6199,14725,512,1505,3749,7927,4261,9432
310160,202303,13392,29264,10391,24735,1685,4686,5220,11195,6905,15881
310163,202303,1481,4035,1142,3386,268,881,315,765,583,1646
310170,202303,12500,26910,10215,23593,942,2229,7290,16373,8232,18602
310180,202303,2573,5486,1869,4420,206,551,1213,2715,1419,3266
310190,202303,3329,8682,2653,7532,590,1816,543,1380,1133,3196
310200,202303,2493,6393,1890,5370,462,1413,746,1918,1208,3331
310205,202303,1460,3588,1178,3183,149,418,752,2041,901,2459
310210,202303,2984,7257,2396,6224,131,318,1685,4220,1816,4538
310220,202303,1427,3554,1050,2866,91,288,646,1641,737,1929
310230,202303,2974,6932,2457,6064,291,850,1535,3494,1826,4344
310240,202303,1295,3291,1090,2971,67,222,731,1892,798,2114
310250,202303,1547,3267,1290,2900,36,102,1041,2245,1077,2347
310260,202303,4809,11488,3274,8714,749,2329,1096,2306,1845,4635
310270,202303,3684,7023,2989,6150,108,247,2490,5069,2598,5316
310280,202303,3654,7030,2846,5974,144,386,2149,4147,2293,4533
310285,202303,2278,6386,1871,5670,204,670,1100,3303,1304,3973
310290,202303,2017,4773,1708,4238,200,586,1065,2367,1265,2953
310300,202303,2110,5265,1600,4385,168,556,850,2039,1018,2595
310310,202303,425,902,288,686,53,134,145,312,198,446
310320,202303,591,1369,401,1054,25,75,221,551,246,626
310330,202303,619,1362,360,904,61,152,141,325,202,477
310340,202303,10382,23570,8051,19744,965,2415,4281,10134,5246,12549
310350,202303,17647,39276,12728,31596,1846,5168,6710,15207,8556,20375
310360,202303,794,1529,654,1359,28,69,460,901,488,970
310370,202303,1515,4342,1296,3976,257,875,430,1353,687,2228
310375,202303,1101,2502,777,2044,234,607,246,629,480,1236
310380,202303,462,1011,271,729,24,65,143,357,167,422
310390,202303,733,1999,591,1728,109,355,243,629,352,984
310400,202303,16262,36185,12305,30317,937,2733,8148,18694,9085,21427
310410,202303,1334,3509,833,2483,93,318,345,869,438,1187
310420,202303,6117,14738,4667,12216,564,1629,2460,5836,3024,7465
310430,202303,2172,5424,1553,4336,262,766,674,1592,936,2358
310440,202303,812,1893,539,1420,87,216,245,601,332,817
310445,202303,1670,4207,1274,3463,97,239,890,2353,987,2592
310450,202303,6159,12810,4679,10607,272,806,3596,7614,3868,8420
310460,202303,2196,5419,1623,4407,226,660,458,1027,684,1687
310470,202303,4200,8742,3228,7480,474,1003,2001,4722,2475,5725
310480,202303,1262,2927,951,2433,106,344,558,1274,664,1618
310490,202303,3799,9112,2972,7795,392,1209,1610,3783,2002,4992
310500,202303,1961,4541,1556,3917,223,588,967,2310,1190,2898
310510,202303,3069,7076,2278,5699,393,1060,1008,2346,1401,3406
310520,202303,1414,3326,974,2529,146,418,449,1101,595,1519
310530,202303,1071,2544,785,2074,110,342,320,692,430,1034
310540,202303,3613,9541,2944,8291,539,1670,1296,3308,1835,4978
310550,202303,1588,3472,1147,2758,84,261,734,1570,818,1831
310560,202303,21831,51413,16190,41580,1780,5402,8460,18555,10240,23957
310570,202303,1575,3299,1230,2859,57,174,1024,2290,1081,2464
310590,202303,5442,12584,4331,10631,276,800,2661,5884,2937,6684
310600,202303,1773,4534,1441,3910,165,479,783,1943,948,2422
310610,202303,604,1539,372,1144,92,301,77,217,169,518
310620,202303,303000,674268,234296,556384,22870,65525,140855,295258,163725,360783
310630,202303,5904,14555,4462,11839,533,1460,2613,6535,3146,7995
310640,202303,1969,4444,1601,3859,113,368,1157,2505,1270,2873
310650,202303,2930,7125,2144,5727,140,438,1273,3194,1413,3632
310660,202303,1805,4123,1461,3661,24,66,1264,3127,1288,3193
310665,202303,1762,3778,1481,3419,42,138,1196,2709,1238,2847
310670,202303,87099,193265,73028,171008,6554,17736,50643,110207,57197,127943
310680,202303,998,2066,828,1829,19,72,684,1432,703,1504
310690,202303,3273,6784,2436,5615,250,593,1662,3584,1912,4177
310700,202303,677,1253,526,1067,12,29,440,860,452,889
310710,202303,7943,20208,5674,16720,1296,4288,933,2386,2229,6674
310720,202303,1492,2998,1191,2615,45,128,906,1904,951,2032
310730,202303,13092,29813,11104,26873,537,1607,8312,18985,8849,20592
310740,202303,8935,21648,6856,17905,792,2471,3576,8184,4368,10655
310750,202303,1751,3700,1331,3103,153,414,777,1594,930,2008
310760,202303,900,2026,647,1644,64,130,404,1036,468,1166
310770,202303,1354,3335,948,2701,124,419,471,1158,595,1577
310780,202303,5208,10812,4190,9417,302,737,2976,6524,3278,7261
310790,202303,2336,6697,1996,6025,417,1433,486,1185,903,2618
310800,202303,2872,8015,2054,6364,457,1569,118,283,575,1852
310810,202303,1918,4031,1574,3517,84,230,1176,2481,1260,2711
310820,202303,1507,3454,903,2463,153,420,283,712,436,1132
310825,202303,3317,8153,2628,7106,42,207,2186,5632,2228,5839
310830,202303,2746,6658,2112,5591,387,1151,1039,2435,1426,3586
310840,202303,2840,7016,2170,5929,455,1390,699,1622,1154,3012
310850,202303,1625,4015,1322,3580,60,221,933,2378,993,2599
310855,202303,4174,9612,3283,8265,234,627,2401,5816,2635,6443
310860,202303,8529,21833,6925,19019,839,2112,4059,11265,4898,13377
310870,202303,1164,2546,921,2215,53,134,666,1519,719,1653
310880,202303,1071,2911,804,2359,94,283,429,1209,523,1492
310890,202303,2789,7416,1854,5612,350,1120,278,718,628,1838
310900,202303,5478,13970,4116,11316,736,2280,1766,4228,2502,6508
310910,202303,2744,6173,1878,4826,272,781,520,1146,792,1927
310920,202303,2343,5450,1774,4639,229,686,1109,2742,1338,3428
310925,202303,1366,3058,1073,2631,55,163,795,1834,850,1997
310930,202303,6791,15863,4673,12603,874,2474,2169,5963,3043,8437
310940,202303,8715,17898,7030,15562,267,721,5530,11663,5797,12384
310945,202303,1703,3887,1323,3286,160,443,761,1733,921,2176
310950,202303,2293,6312,1469,4510,245,858,382,907,627,1765
310960,202303,887,2234,516,1503,77,238,141,379,218,617
310970,202303,1441,4038,1049,3252,258,825,188,549,446,1374
310980,202303,422,928,253,645,23,66,124,289,147,355
310990,202303,1894,4429,1539,3877,175,519,927,2108,1102,2627
311000,202303,5502,13353,4201,11270,722,2169,2284,5587,3006,7756
311010,202303,1241,2941,1012,2572,236,623,503,1243,739,1866
311020,202303,1455,3343,949,2493,66,197,531,1300,597,1497
311030,202303,2366,5374,1735,4380,434,1264,702,1573,1136,2837
311040,202303,357,1027,272,848,76,267,63,168,139,435
311050,202303,3986,8958,3048,7600,453,1339,1566,3512,2019,4851
311060,202303,4648,10659,3473,8664,438,1263,1620,3536,2058,4799
311070,202303,3208,6998,2297,5652,328,989,1207,2650,1535,3639
311080,202303,1446,2841,1137,2406,38,110,898,1767,936,1877
311090,202303,2906,8137,2378,7221,547,1727,708,2093,1255,3820
311100,202303,3120,8024,2067,6074,384,1282,576,1395,960,2677
311110,202303,4640,9200,2468,6019,577,1418,421,954,998,2372
311115,202303,1813,3376,1503,2988,43,101,1304,2511,1347,2612
311120,202303,9208,21797,7071,18133,1011,2949,3157,6844,4168,9793
311130,202303,2334,5634,1787,4869,171,583,1034,2606,1205,3189
311140,202303,2001,4534,1520,3875,212,572,911,2252,1123,2824
311150,202303,1788,5145,1435,4495,202,701,745,2165,947,2866
311160,202303,5279,13466,3870,11015,655,2140,1612,4134,2267,6274
311170,202303,1188,2760,976,2496,64,182,603,1610,667,1792
311180,202303,1905,3895,1286,3028,193,449,685,1521,878,1970
311190,202303,1069,2793,796,2252,113,358,345,826,458,1184
311200,202303,2897,6985,2171,5711,394,1150,907,1977,1301,3127
311205,202303,1136,2971,898,2533,41,126,583,1541,624,1667
311210,202303,1274,3354,1125,3151,137,340,779,2275,916,2615
311220,202303,1120,2475,984,2246,28,89,776,1619,804,1708
311230,202303,9769,26643,7249,21621,1467,4573,2501,7301,3968,11874
311240,202303,1479,3305,1170,2877,159,468,691,1532,850,2000
311250,202303,1701,4229,1323,3611,236,696,548,1315,784,2011
311260,202303,3319,7482,2155,5552,285,857,1054,2315,1339,3172
311265,202303,1736,3700,1264,2987,49,151,962,2144,1011,2295
311270,202303,3786,9869,3227,9022,209,802,2216,5808,2425,6610
311280,202303,1551,3777,949,2656,212,652,246,567,458,1219
311290,202303,2194,6122,1968,5696,120,359,1280,3610,1400,3969
311300,202303,5513,13407,4548,11870,193,619,3673,9289,3866,9908
311310,202303,673,1694,564,1510,45,121,345,880,390,1001
311320,202303,3898,10586,3231,9155,330,1069,1669,4116,1999,5185
311330,202303,7926,17066,6117,14400,739,1873,3067,7161,3806,9034
311340,202303,13571,33994,10828,29361,2323,6738,3551,8838,5874,15576
311350,202303,2844,6413,2039,5028,256,701,958,2012,1214,2713
311360,202303,1412,3129,1016,2596,267,730,447,1116,714,1846
311370,202303,5778,12771,4203,10349,523,1475,2279,5111,2802,6586
311380,202303,494,1392,377,1162,54,178,192,567,246,745
311390,202303,2163,5941,1730,5360,649,2167,430,1129,1079,3296
311400,202303,2069,5073,1507,4074,248,732,495,1040,743,1772
311410,202303,2393,6434,1922,5665,275,918,892,2410,1167,3328
311420,202303,2062,5400,1561,4517,315,969,491,1165,806,2134
311430,202303,5784,13866,3889,10333,543,1533,1599,3918,2142,5451
311440,202303,3880,9772,2907,8102,879,2799,537,1157,1416,3956
311450,202303,3073,8216,1957,5879,476,1650,449,1019,925,2669
311455,202303,1371,2865,978,2311,101,248,592,1334,693,1582
311460,202303,740,2030,481,1489,88,316,108,253,196,569
311470,202303,598,1690,406,1299,97,368,64,162,161,530
311480,202303,1475,2969,1207,2590,82,187,975,2035,1057,2222
311490,202303,343,931,262,768,45,164,117,286,162,450
311500,202303,634,1431,497,1231,59,175,300,691,359,866
311510,202303,4506,9867,3267,7939,293,867,1886,4033,2179,4900
311520,202303,838,2036,726,1841,59,178,458,1125,517,1303
311530,202303,11758,24811,8250,19599,1836,5073,2879,5995,4715,11068
311535,202303,1143,2758,836,2187,119,351,419,995,538,1346
311540,202303,668,1758,584,1622,78,241,407,1100,485,1341
311545,202303,2409,6191,2076,5690,99,305,1599,4293,1698,4598
311547,202303,2223,4297,1925,3899,48,96,1660,3263,1708,3359
311550,202303,3699,8998,2989,7829,434,1330,1382,3170,1816,4500
311560,202303,379,754,232,527,33,86,82,154,115,240
311570,202303,1645,3485,1110,2754,78,205,736,1872,814,2077
311580,202303,2828,4956,1990,3976,182,355,1376,2637,1558,2992
311590,202303,773,1771,638,1587,61,189,417,973,478,1162
311600,202303,1837,4113,1489,3655,171,505,1034,2421,1205,2926
311610,202303,2819,7485,2234,6458,146,489,1438,3920,1584,4409
311615,202303,4556,10299,3684,8955,134,424,2995,6972,3129,7396
311620,202303,718,1760,540,1468,60,189,299,752,359,941
311630,202303,1578,4032,1235,3321,95,290,739,1906,834,2196
311640,202303,980,2353,773,2033,111,319,434,1051,545,1370
311650,202303,2315,5134,1858,4476,236,614,1095,2468,1331,3082
311660,202303,3940,10249,2927,8350,384,1268,860,1841,1244,3109
311670,202303,2077,4619,1539,3731,172,476,812,1841,984,2317
311680,202303,2905,6779,2212,5666,145,355,1560,3971,1705,4326
311690,202303,789,1473,577,1210,46,109,382,790,428,899
311700,202303,2494,5363,1894,4519,25,95,1578,3592,1603,3687
311710,202303,2004,5346,1474,4411,392,1303,428,1153,820,2456
311720,202303,518,1424,421,1250,47,167,241,690,288,857
311730,202303,5864,13129,4215,10267,846,2328,2064,4455,2910,6783
311740,202303,1183,2865,964,2556,66,156,729,1972,795,2128
311750,202303,4938,13012,3959,11318,332,1141,2540,6672,2872,7813
311760,202303,924,2320,725,1962,115,402,301,596,416,998
311770,202303,2776,7072,2171,6070,469,1391,766,1912,1235,3303
311780,202303,1909,4866,1446,4051,288,854,517,1258,805,2112
311783,202303,2884,6561,2343,5729,44,169,1936,4501,1980,4670
311787,202303,976,2606,753,2150,117,387,290,677,407,1064
311790,202303,1921,4920,1303,3768,260,837,309,757,569,1594
311800,202303,6441,17497,5077,14765,1086,3267,973,2205,2059,5472
311810,202303,1273,3086,1062,2757,57,173,802,1961,859,2134
311820,202303,1269,2672,972,2242,76,195,678,1471,754,1666
311830,202303,11490,29427,8503,23466,2314,6708,1661,4199,3975,10907
311840,202303,4928,10838,3929,9482,294,758,2828,6775,3122,7533
311850,202303,432,987,340,836,15,59,239,539,254,598
311860,202303,99223,216921,79050,184222,8005,21645,51030,108813,59035,130458
311870,202303,2289,5586,1613,4483,248,816,693,1657,941,2473
311880,202303,7700,17909,6407,16134,468,1111,4647,11798,5115,12909
311890,202303,2381,4739,1906,4115,58,178,1524,3056,1582,3234
311900,202303,798,1859,594,1591,102,252,315,857,417,1109
311910,202303,5477,12251,4288,10707,691,1903,2414,5653,3105,7556
311920,202303,2779,6125,2251,5391,141,345,1584,3701,1725,4046
311930,202303,6245,12449,4777,10529,766,2000,2805,5498,3571,7498
311940,202303,19701,46688,14365,37228,2022,5667,6302,14757,8324,20424
311950,202303,2938,6801,2193,5562,183,498,1339,3335,1522,3833
311960,202303,592,1370,451,1154,54,159,211,466,265,625
311970,202303,477,1458,359,1171,69,260,85,221,154,481
311980,202303,574,1414,317,938,38,116,120,314,158,430
311990,202303,656,1475,430,1136,68,224,182,396,250,620
311995,202303,1176,3137,580,1787,43,151,97,188,140,339
312000,202303,982,2045,751,1727,37,87,563,1253,600,1340
312010,202303,1409,3152,1137,2774,67,178,772,1797,839,1975
312015,202303,1636,4051,1405,3696,65,246,1118,2828,1183,3074
312020,202303,2292,6313,1571,4705,265,848,370,940,635,1788
312030,202303,2714,5298,2282,4805,75,205,2047,4220,2122,4425
312040,202303,1031,2797,748,2247,114,347,328,908,442,1255
312050,202303,1500,4182,1236,3717,231,848,435,1132,666,1980
312060,202303,1259,2798,803,2178,193,551,289,744,482,1295
312070,202303,1121,2926,766,2174,33,123,485,1263,518,1386
312080,202303,3763,8160,2946,6986,142,407,2076,4463,2218,4870
312083,202303,1403,2881,1106,2457,58,175,892,1873,950,2048
312087,202303,3095,6801,2503,5937,91,238,2021,4699,2112,4937
312090,202303,14983,34391,11855,29606,1190,3591,7146,16147,8336,19738
312100,202303,2086,5060,1613,4284,108,353,1013,2433,1121,2786
312110,202303,1224,3466,1005,3017,169,622,485,1273,654,1895
312120,202303,1328,3347,914,2634,229,769,280,647,509,1416
312125,202303,2522,5483,2152,4987,102,271,1751,3915,1853,4186
312130,202303,1491,3143,1103,2538,75,225,655,1285,730,1510
312140,202303,922,2439,749,2102,188,560,310,768,498,1328
312150,202303,674,1627,551,1384,35,97,380,875,415,972
312160,202303,12248,28468,9528,23954,1045,3141,5116,11406,6161,14547
312170,202303,1090,2527,838,2090,57,155,540,1274,597,1429
312180,202303,1723,4063,1399,3526,152,433,825,1929,977,2362
312190,202303,1046,2497,806,2104,78,239,426,1009,504,1248
312200,202303,5831,14114,4530,12104,570,1606,2676,6802,3246,8408
312210,202303,1828,3374,1392,2796,78,169,1128,2167,1206,2336
312220,202303,2057,5584,1749,5062,174,536,1134,3259,1308,3795
312230,202303,26470,60126,19455,48279,3639,10323,7202,14580,10841,24903
312235,202303,2775,5689,2268,5021,129,334,1782,3729,1911,4063
312240,202303,999,2896,771,2452,157,521,228,674,385,1195
312245,202303,4115,7579,3537,6804,45,108,3264,6137,3309,6245
312247,202303,1282,2671,885,2092,109,266,534,1186,643,1452
312250,202303,1130,2780,725,2019,94,290,253,647,347,937
312260,202303,1276,2935,1035,2555,68,183,799,1871,867,2054
312270,202303,912,2262,692,1823,28,102,434,1009,462,1111
312280,202303,547,1504,450,1342,104,350,176,463,280,813
312290,202303,1203,3114,1015,2823,173,560,396,981,569,1541
312300,202303,1499,4036,1094,3137,239,736,269,608,508,1344
312310,202303,1278,3431,988,2853,124,427,509,1340,633,1767
312320,202303,2665,6104,1890,4785,339,877,602,1340,941,2217
312330,202303,1166,2958,945,2572,144,449,539,1349,683,1798
312340,202303,301,701,208,556,29,103,117,270,146,373
312350,202303,310,602,229,511,14,41,157,310,171,351
312352,202303,1831,5264,1614,4878,285,922,750,2431,1035,3353
312360,202303,4520,11441,3382,9375,670,2038,1406,3411,2076,5449
312370,202303,2633,5875,2097,5080,255,719,1295,2902,1550,3621
312380,202303,2682,5337,2180,4681,24,65,1871,3867,1895,3932
312385,202303,1542,3751,1200,3182,408,1109,285,773,693,1882
312390,202303,2368,6085,1770,4978,268,854,516,1197,784,2051
312400,202303,3864,10004,3275,9101,1133,3456,635,1688,1768,5144
312410,202303,19783,45253,16339,39989,1880,5002,10635,24537,12515,29539
312420,202303,5084,12240,4094,10687,806,2435,1930,4619,2736,7054
312430,202303,11285,24324,9294,21097,285,848,7289,15549,7574,16397
312440,202303,1318,3763,1109,3376,543,1770,206,559,749,2329
312450,202303,1723,4554,1315,3838,350,1102,480,1374,830,2476
312460,202303,619,1335,450,1101,23,64,306,714,329,778
312470,202303,571,1316,364,969,54,150,116,248,170,398
312480,202303,1323,3025,964,2508,89,268,526,1266,615,1534
312490,202303,3317,6555,2593,5553,205,494,1626,3248,1831,3742
312500,202303,1364,2844,1155,2576,52,150,913,1969,965,2119
312510,202303,6473,15693,4379,11728,794,2100,1277,3048,2071,5148
312520,202303,462,1050,361,897,63,194,223,511,286,705
312530,202303,908,1846,762,1675,46,104,583,1265,629,1369
312540,202303,1921,4696,1309,3571,154,410,710,1824,864,2234
312550,202303,1006,2314,718,1803,36,104,458,1032,494,1136
312560,202303,2202,5198,1667,4371,99,269,1178,3011,1277,3280
312570,202303,3438,7155,2569,6076,416,1000,1344,3118,1760,4118
312580,202303,811,1998,540,1456,49,155,278,662,327,817
312590,202303,1852,4804,1421,3972,174,557,762,1917,936,2474
312595,202303,2654,6707,2179,5997,329,847,1183,3485,1512,4332
312600,202303,1744,3938,1174,2770,176,504,400,889,576,1393
312610,202303,8755,20638,5976,15648,1015,2973,1956,4270,2971,7243
312620,202303,3116,6872,2369,5862,59,247,1940,4673,1999,4920
312630,202303,408,1041,299,854,54,189,123,305,177,494
312640,202303,674,1706,509,1450,66,215,258,666,324,881
312650,202303,2577,5680,1777,4303,54,175,1322,2935,1376,3110
312660,202303,1659,3541,1295,2976,102,247,918,1969,1020,2216
312670,202303,7612,15822,6374,13976,123,504,5271,10743,5394,11247
312675,202303,1470,3360,1203,2988,69,193,936,2245,1005,2438
312680,202303,1982,4258,1792,4008,35,128,1620,3490,1655,3618
312690,202303,3729,6929,2795,5774,117,255,2266,4554,2383,4809
312695,202303,1271,2904,1072,2610,53,93,892,2152,945,2245
312700,202303,2551,6286,1833,5034,205,659,967,2419,1172,3078
312705,202303,2099,3823,1831,3479,14,43,1736,3254,1750,3297
312707,202303,1647,4201,1167,3383,49,207,766,2015,815,2222
312710,202303,9490,20338,6249,15483,1630,4073,1851,4608,3481,8681
312720,202303,1339,3183,1052,2744,102,300,690,1678,792,1978
312730,202303,1935,4203,1393,3483,121,313,899,2178,1020,2491
312733,202303,1580,3852,1178,3132,48,161,783,1906,831,2067
312735,202303,987,2283,757,1873,52,149,487,1090,539,1239
312737,202303,1031,2081,746,1686,74,187,516,1115,590,1302
312738,202303,1019,2277,722,1778,64,185,473,1030,537,1215
312740,202303,542,1325,345,994,76,233,88,182,164,415
312750,202303,1755,4530,1281,3669,149,489,581,1511,730,2000
312760,202303,2274,6072,1650,4880,246,760,619,1679,865,2439
312770,202303,57966,128365,38243,95693,6291,17725,15729,35420,22020,53145
312780,202303,3287,8230,2737,7331,368,979,1603,4193,1971,5172
312790,202303,292,658,145,415,6,17,32,54,38,71
312800,202303,7420,17626,5968,15110,516,1635,3803,8768,4319,10403
312810,202303,2027,5136,1358,4015,380,1234,408,1052,788,2286
312820,202303,2156,5104,1733,4427,112,291,1207,3026,1319,3317
312825,202303,1928,3638,1609,3236,36,75,1392,2737,1428,2812
312830,202303,3435,8718,2308,6625,543,1655,723,1769,1266,3424
312840,202303,1841,4263,1434,3631,157,458,750,1715,907,2173
312850,202303,1448,2747,1091,2273,20,62,831,1543,851,1605
312860,202303,1321,3169,909,2526,241,699,268,652,509,1351
312870,202303,7404,18369,4807,13577,803,2438,1424,3522,2227,5960
312880,202303,1905,4204,1483,3546,251,562,741,1766,992,2328
312890,202303,2927,6351,2160,5175,143,339,1313,2945,1456,3284
312900,202303,1645,3771,1305,3304,391,1030,544,1349,935,2379
312910,202303,1814,3193,1099,2286,150,297,606,1230,756,1527
312920,202303,1155,2864,823,2343,130,439,273,628,403,1067
312930,202303,3038,6612,2199,5377,355,933,1140,2736,1495,3669
312940,202303,1224,2991,968,2642,93,298,516,1283,609,1581
312950,202303,4303,9295,3143,7592,445,1267,1804,3933,2249,5200
312960,202303,2129,5020,1754,4470,120,289,1257,3288,1377,3577
312965,202303,2011,4847,1619,4237,167,412,1026,2691,1193,3103
312970,202303,2038,5041,1632,4430,182,633,949,2325,1131,2958
312980,202303,33218,81958,26836,70953,5062,14146,11829,28986,16891,43132
312990,202303,644,1457,432,1117,79,235,191,448,270,683
313000,202303,604,1536,457,1289,29,120,288,721,317,841
313005,202303,2950,7652,2428,6809,115,338,1752,4758,1867,5096
313010,202303,7622,18332,6177,16089,948,2813,3603,8811,4551,11624
313020,202303,1233,3431,971,2939,187,614,195,479,382,1093
313030,202303,1527,3115,1068,2483,80,212,769,1685,849,1897
313040,202303,1109,3040,933,2718,40,165,582,1583,622,1748
313050,202303,2299,5795,1617,4768,254,847,405,1018,659,1865
313055,202303,2298,5586,1945,5047,680,1988,900,2136,1580,4124
313060,202303,1352,3027,987,2421,191,571,250,526,441,1097
313065,202303,2132,5149,1885,4760,27,117,1614,3909,1641,4026
313070,202303,1078,2666,846,2294,104,315,416,1047,520,1362
313080,202303,496,1247,373,1036,66,220,148,335,214,555
313090,202303,6912,15606,5693,13759,258,696,4110,9607,4368,10303
313100,202303,1654,3842,1320,3375,59,205,953,2306,1012,2511
313110,202303,1867,4537,1319,3566,131,400,672,1624,803,2024
313115,202303,3555,8835,2861,7600,267,838,1662,3912,1929,4750
313120,202303,4603,10096,3338,8431,271,734,2189,5474,2460,6208
313130,202303,41488,95682,31650,78838,3233,9213,18550,42120,21783,51333
313140,202303,990,1886,668,1480,43,100,508,1099,551,1199
313150,202303,1742,4564,1255,3667,347,1149,197,456,544,1605
313160,202303,1790,3946,1339,3291,32,92,1028,2398,1060,2490
313170,202303,14699,37731,11007,30854,1740,5334,4299,10477,6039,15811
313180,202303,3237,7520,2456,5996,175,461,1668,3857,1843,4318
313190,202303,5861,14953,4414,12259,750,2294,1815,4387,2565,6681
313200,202303,1382,3188,1174,2845,32,95,951,2211,983,2306
313210,202303,5330,12266,4396,10878,417,1166,2995,6967,3412,8133
313220,202303,2473,5906,1668,4390,223,662,792,1750,1015,2412
313230,202303,3455,8458,2779,7597,56,182,2278,6221,2334,6403
313240,202303,14706,32356,10666,26195,1074,3282,6094,13433,7168,16715
313250,202303,7798,20529,5978,16828,1118,3367,2715,7024,3833,10391
313260,202303,1010,2270,708,1805,66,239,394,846,460,1085
313270,202303,8614,16603,7218,14825,515,1055,5864,11859,6379,12914
313280,202303,567,1392,383,1051,46,147,179,455,225,602
313290,202303,1289,3818,1011,3305,263,969,349,1050,612,2019
313300,202303,2332,5775,1785,4854,364,1072,625,1519,989,2591
313310,202303,1876,5010,1524,4293,269,847,492,1084,761,1931
313320,202303,2523,6110,1841,5070,410,1224,607,1656,1017,2880
313330,202303,5233,11923,3873,9928,279,809,2550,6328,2829,7137
313340,202303,2174,4377,1677,3724,113,291,1252,2635,1365,2926
313350,202303,3732,9338,2554,6894,302,960,1189,2660,1491,3620
313360,202303,2163,4793,1502,3746,251,733,786,1725,1037,2458
313370,202303,2090,5128,1589,4215,329,959,596,1344,925,2303
313375,202303,2359,5716,1523,4226,275,869,427,971,702,1840
313380,202303,8791,20089,6555,16191,990,2877,3213,6822,4203,9699
313390,202303,974,2707,837,2467,46,189,572,1603,618,1792
313400,202303,4658,10156,3471,8417,157,443,2586,6037,2743,6480
313410,202303,1795,4109,1348,3390,336,851,727,1742,1063,2593
313420,202303,19838,41424,11518,28240,2629,7274,3125,6652,5754,13926
313430,202303,1580,3526,1327,3093,63,238,1039,2205,1102,2443
313440,202303,9342,17151,6931,14264,176,443,5601,11048,5777,11491
313450,202303,901,2215,635,1726,106,333,228,481,334,814
313460,202303,3021,7681,2433,6768,426,1336,1136,2996,1562,4332
313470,202303,3448,7729,2775,6775,157,424,2136,5100,2293,5524
313480,202303,1448,3777,904,2659,86,282,392,1011,478,1293
313490,202303,3801,9195,2155,6130,383,1178,542,1324,925,2502
313500,202303,698,1654,477,1246,69,166,215,510,284,676
313505,202303,13269,29932,11280,27245,511,1274,9051,21450,9562,22724
313507,202303,1671,3787,1321,3262,48,152,1018,2407,1066,2559
313510,202303,19637,46377,15319,38433,1410,3874,8948,20348,10358,24222
313520,202303,19970,45515,16251,39683,691,2082,12741,29632,13432,31714
313530,202303,713,1960,525,1569,73,270,218,544,291,814
313535,202303,2793,7115,2207,6016,247,652,1315,3481,1562,4133
313540,202303,1114,2855,868,2331,114,354,410,940,524,1294
313545,202303,1390,4101,1155,3669,167,552,538,1629,705,2181
313550,202303,2651,6777,2193,5824,229,655,1461,3758,1690,4413
313560,202303,3822,6062,2915,5012,38,58,2611,4418,2649,4476
313570,202303,1238,3197,977,2756,207,616,431,1101,638,1717
313580,202303,7863,16267,6252,13788,344,931,4607,9480,4951,10411
313590,202303,1460,3429,1161,3012,239,655,603,1583,842,2238
313600,202303,5607,11638,4780,10456,94,314,4294,9072,4388,9386
313610,202303,1233,2789,1002,2400,76,218,662,1445,738,1663
313620,202303,7270,17462,5980,15242,574,1757,3861,9232,4435,10989
313630,202303,11356,25034,8295,20586,835,2469,5067,11774,5902,14243
313640,202303,1676,3090,1172,2459,93,231,870,1772,963,2003
313650,202303,2014,5533,1562,4766,148,490,930,2851,1078,3341
313652,202303,1109,2796,970,2551,65,214,702,1721,767,1935
313655,202303,1488,3154,1166,2762,65,171,890,2053,955,2224
313657,202303,1356,3203,1045,2713,40,157,752,1779,792,1936
313660,202303,1501,3420,1238,3001,78,269,925,2067,1003,2336
313665,202303,7367,16941,5898,14488,514,1552,3892,8719,4406,10271
313670,202303,72811,162190,51275,127641,6555,17973,25994,59221,32549,77194
313680,202303,1363,3114,1092,2693,48,121,725,1677,773,1798
313690,202303,1243,3441,923,2827,167,579,196,512,363,1091
313695,202303,2184,5211,1621,4309,128,320,1050,2828,1178,3148
313700,202303,3505,9655,3001,9010,234,745,2380,7161,2614,7906
313710,202303,1815,3772,1290,3093,124,380,822,1859,946,2239
313720,202303,8255,20455,6117,16249,789,2313,2938,6868,3727,9181
313730,202303,1729,3322,1289,2763,76,141,864,1813,940,1954
313740,202303,2064,6799,1739,6046,367,1441,454,1350,821,2791
313750,202303,2986,6861,2411,5971,336,1002,1477,3294,1813,4296
313753,202303,2597,5904,1723,4528,366,1054,590,1452,956,2506
313760,202303,7879,19713,6312,16905,976,2998,3092,7364,4068,10362
313770,202303,5086,12995,3996,11270,583,1580,2610,7482,3193,9062
313780,202303,5115,12043,3769,10030,682,1793,1228,3174,1910,4967
313790,202303,761,1934,631,1683,67,209,394,981,461,1190
313800,202303,1694,3488,1217,2838,116,318,706,1502,822,1820
313810,202303,2313,4802,1845,4135,69,217,1491,3166,1560,3383
313820,202303,21867,51485,14768,37341,2315,6211,4684,10435,6999,16646
313830,202303,491,1329,366,1075,69,234,140,366,209,600
313835,202303,1170,2877,861,2387,73,241,458,1151,531,1392
313840,202303,10462,24492,8222,21090,1862,5008,2384,5775,4246,10783
313850,202303,1248,2675,993,2328,167,425,527,1109,694,1534
313860,202303,3617,8468,2754,7032,370,1022,1377,3153,1747,4175
313862,202303,1507,3103,783,2051,61,182,382,950,443,1132
313865,202303,3266,7425,2691,6571,73,218,2093,4852,2166,5070
313867,202303,1684,4828,1352,4189,305,975,585,1846,890,2821
313868,202303,2069,5591,1637,4823,62,244,1230,3439,1292,3683
313870,202303,1322,3073,888,2319,123,335,391,904,514,1239
313880,202303,2825,6532,2161,5461,307,934,1113,2384,1420,3318
313890,202303,3012,5291,2232,4311,59,133,1804,3336,1863,3469
313900,202303,6929,17542,4904,13617,1255,3696,1435,3340,2690,7036
313910,202303,971,2592,738,2156,150,459,189,511,339,970
313920,202303,3534,9317,2896,8126,538,1561,1433,3948,1971,5509
313925,202303,2069,4631,1605,3859,208,445,974,2267,1182,2712
313930,202303,6375,15377,5075,13310,421,1040,3344,8690,3765,9730
313940,202303,12770,33867,9860,29170,2176,7051,2227,6931,4403,13982
313950,202303,7134,13684,5531,11699,290,704,4072,8272,4362,8976
313960,202303,7317,15920,4993,12210,693,1999,2263,4784,2956,6783
313970,202303,2043,4676,1709,4143,52,136,1201,2729,1253,2865
313980,202303,1890,4480,1347,3681,246,746,556,1392,802,2138
313990,202303,2794,7248,2185,6109,348,1197,1241,3004,1589,4201
314000,202303,13560,30201,10810,25657,719,2111,6998,15837,7717,17948
314010,202303,1673,3621,1308,3128,84,238,948,2140,1032,2378
314015,202303,3121,7484,2485,6422,258,803,1512,3514,1770,4317
314020,202303,645,1571,420,1213,143,500,33,83,176,583
314030,202303,1056,2702,767,2152,103,298,314,824,417,1122
314040,202303,790,1998,668,1787,87,287,383,969,470,1256
314050,202303,2565,5906,1934,4845,116,347,1258,2841,1374,3188
314053,202303,2590,6583,2062,5616,324,841,1197,3337,1521,4178
314055,202303,2914,6368,2450,5736,77,221,2031,4739,2108,4960
314060,202303,1602,3768,1154,3039,40,119,830,2111,870,2230
314070,202303,6374,15098,5211,13167,734,1980,2932,6893,3666,8873
314080,202303,2378,5770,1788,4764,161,510,886,2084,1047,2594
314085,202303,2901,6967,2297,6102,237,680,1477,3873,1714,4553
314090,202303,6274,14635,5345,13357,558,1522,3386,8498,3944,10020
314100,202303,3681,8122,2793,6907,84,213,2067,5076,2151,5289
314110,202303,6294,15893,5148,13851,677,2014,2663,6436,3340,8450
314120,202303,848,1861,419,1110,74,222,158,376,232,598
314130,202303,882,2069,641,1638,22,76,451,1070,473,1146
314140,202303,5752,13825,4552,11757,506,1441,2548,6168,3054,7609
314150,202303,1760,4034,1250,3189,131,377,763,1861,894,2238
314160,202303,2995,6753,2041,5167,219,546,829,1994,1048,2540
314170,202303,1198,2934,933,2436,61,208,626,1450,687,1658
314180,202303,6812,16631,5275,14218,672,1829,2643,6990,3315,8819
314190,202303,796,1792,606,1521,72,237,351,776,423,1013
314200,202303,3715,9263,3034,8196,293,785,1932,5102,2225,5887
314210,202303,2440,5792,1880,4825,307,835,643,1500,950,2335
314220,202303,2163,5273,1698,4560,262,834,775,1842,1037,2676
314225,202303,1264,3329,995,2839,113,358,594,1589,707,1947
314230,202303,1100,2607,861,2269,139,405,467,1152,606,1557
314240,202303,1361,3419,1060,2967,229,656,436,1222,665,1878
314250,202303,508,1368,330,1001,42,145,127,330,169,475
314260,202303,1380,3246,1091,2876,394,1095,316,723,710,1818
314270,202303,4071,9932,3322,8759,87,255,2540,6511,2627,6766
314280,202303,4537,9671,3161,7708,328,921,1891,4263,2219,5184
314290,202303,5724,12861,4849,11428,249,661,3613,8095,3862,8756
314300,202303,2447,6361,1586,4573,358,1125,435,1023,793,2148
314310,202303,4849,11876,3405,9516,902,2883,455,1016,1357,3899
314315,202303,1225,3349,966,2824,61,223,668,1823,729,2046
314320,202303,4254,10234,2967,7941,451,1410,1261,2964,1712,4374
314330,202303,71214,183296,54871,155496,12870,37365,15241,41263,28111,78628
314340,202303,3444,7967,2396,6197,427,1347,1002,2102,1429,3449
314345,202303,2053,4924,1663,4273,121,307,1190,2941,1311,3248
314350,202303,1178,3025,771,2267,121,368,163,349,284,717
314360,202303,698,1840,444,1321,67,190,131,347,198,537
314370,202303,940,2122,747,1854,75,194,505,1189,580,1383
314380,202303,1543,3868,1106,3130,251,796,348,903,599,1699
314390,202303,19982,44600,14113,34992,1975,5643,6392,13500,8367,19143
314400,202303,4943,13583,3795,11421,1246,3996,1040,3169,2286,7165
314410,202303,3783,9888,2585,7534,617,2117,494,1187,1111,3304
314420,202303,938,2113,681,1730,25,90,444,1054,469,1144
314430,202303,10014,21453,7190,17109,1043,2614,3487,7765,4530,10379
314435,202303,2291,5560,1781,4778,321,903,886,2231,1207,3134
314437,202303,1109,2491,822,2055,66,182,542,1285,608,1467
314440,202303,748,2001,545,1619,122,422,156,362,278,784
314450,202303,1834,4321,1483,3746,187,531,815,1848,1002,2379
314460,202303,4408,11855,3391,9889,746,2434,1328,3331,2074,5765
314465,202303,2852,7065,2299,6077,55,185,1769,4429,1824,4614
314467,202303,1212,2811,980,2442,113,326,640,1520,753,1846
314470,202303,2924,7416,2424,6534,450,1326,1152,2784,1602,4110
314480,202303,11330,27970,8689,22826,1212,3557,4065,9298,5277,12855
314490,202303,1313,3062,945,2409,85,240,591,1413,676,1653
314500,202303,2406,5284,1703,4349,498,1259,415,1054,913,2313
314505,202303,2916,5701,2389,5010,155,260,1851,3806,2006,4066
314510,202303,2685,6566,1977,5558,612,2024,594,1498,1206,3522
314520,202303,9823,26509,7922,22968,1655,5129,1876,4858,3531,9987
314530,202303,6762,18118,5966,16729,355,1214,4413,11803,4768,13017
314535,202303,3603,7571,2908,6615,162,405,2326,5190,2488,5595
314537,202303,1501,3730,1142,3158,80,208,746,1991,826,2199
314540,202303,527,1196,382,978,18,50,218,507,236,557
314545,202303,2351,4880,2082,4571,65,184,1666,3652,1731,3836
314550,202303,929,2042,602,1501,47,146,310,662,357,808
314560,202303,6203,16033,4732,13127,602,1971,2244,5285,2846,7256
314570,202303,407,1055,303,882,40,133,143,399,183,532
314580,202303,612,1631,479,1376,100,297,163,453,263,750
314585,202303,935,2529,703,2061,62,221,333,891,395,1112
314587,202303,2835,6762,2218,5824,669,1759,1041,2634,1710,4393
314590,202303,5342,12901,4183,10898,498,1468,2140,5063,2638,6531
314600,202303,2244,5736,1460,4288,313,1036,179,464,492,1500
314610,202303,12384,28090,9761,24084,1105,3286,4856,11742,5961,15028
314620,202303,3130,6119,2521,5381,166,275,1982,4298,2148,4573
314625,202303,2010,4413,1706,4005,42,176,1474,3322,1516,3498
314630,202303,6194,13916,4939,12225,191,565,3898,9433,4089,9998
314640,202303,1070,2070,826,1708,27,80,646,1226,673,1306
314650,202303,1058,2315,723,1802,76,221,406,892,482,1113
314655,202303,1823,4521,1289,3621,155,423,692,1910,847,2333
314660,202303,457,870,348,706,12,29,270,506,282,535
314670,202303,1963,3998,1349,3150,34,97,952,2099,986,2196
314675,202303,2073,4728,1750,4234,105,237,1344,3192,1449,3429
314690,202303,2598,6508,1985,5591,529,1539,707,1926,1236,3465
314700,202303,14984,36821,10485,28896,1594,4825,4712,11928,6306,16753
314710,202303,9906,25412,7543,20574,1108,3292,2971,6975,4079,10267
314720,202303,2983,8121,2120,6412,421,1407,411,992,832,2399
314730,202303,3200,7701,2232,5962,390,1170,805,1820,1195,2990
314740,202303,4126,10334,3260,8891,576,1723,1619,4013,2195,5736
314750,202303,380,906,298,745,26,82,181,386,207,468
314760,202303,2274,6136,1489,4443,233,822,425,899,658,1721
314770,202303,1265,3432,727,2177,111,330,161,435,272,765
314780,202303,455,1046,321,836,29,87,194,471,223,558
314790,202303,15209,36831,11134,29784,1943,5814,4680,11428,6623,17242
314795,202303,1855,4236,1562,3768,68,191,1205,2769,1273,2960
314800,202303,15190,35867,10466,27715,1701,4998,3976,9020,5677,14018
314810,202303,13611,32393,10381,27153,2497,6954,4043,9735,6540,16689
314820,202303,1556,3426,1209,2927,77,236,778,1769,855,2005
314830,202303,2194,5443,1797,4792,160,441,1135,2837,1295,3278
314840,202303,1112,2998,871,2580,82,321,587,1616,669,1937
314850,202303,3456,5764,2879,5082,38,78,2660,4634,2698,4712
314860,202303,4182,10262,3467,9078,139,497,2589,6455,2728,6952
314870,202303,8710,16878,6713,14524,303,620,5106,11142,5409,11762
314875,202303,2236,6055,1955,5654,206,549,1399,4070,1605,4619
314880,202303,961,2167,726,1800,46,133,450,1053,496,1186
314890,202303,646,1799,466,1397,62,212,233,615,295,827
314900,202303,1157,2485,889,2075,102,275,510,1088,612,1363
314910,202303,2064,5404,1536,4559,282,1011,673,1772,955,2783
314915,202303,2566,6763,2067,5927,193,552,1254,3547,1447,4099
314920,202303,716,1600,521,1335,27,80,376,952,403,1032
314930,202303,8253,20638,6489,17477,1044,3207,2980,7002,4024,10209
314940,202303,527,1122,425,973,45,116,264,561,309,677
314950,202303,851,1915,578,1497,60,215,314,723,374,938
314960,202303,1189,2543,929,2135,78,174,632,1416,710,1590
314970,202303,1434,3900,1117,3300,199,655,455,1162,654,1817
314980,202303,2747,6254,2262,5576,206,554,1600,3830,1806,4384
314990,202303,3472,9207,2458,7018,405,1198,671,1618,1076,2816
314995,202303,2115,5210,1628,4360,75,260,1043,2562,1118,2822
315000,202303,1348,3102,954,2501,83,245,624,1567,707,1812
315010,202303,514,1264,410,1109,36,120,255,641,291,761
315015,202303,3147,7577,2746,6954,261,819,1932,4634,2193,5453
315020,202303,964,2537,694,2033,64,225,333,850,397,1075
315030,202303,853,2010,593,1568,185,464,141,337,326,801
315040,202303,1243,2887,1045,2584,161,454,668,1532,829,1986
315050,202303,1438,3366,1050,2789,93,288,502,1225,595,1513
315053,202303,1534,3461,1128,2794,146,363,632,1488,778,1851
315057,202303,2247,5652,1769,4880,163,384,1118,3277,1281,3661
315060,202303,889,2398,649,1914,118,382,187,503,305,885
315070,202303,1137,2197,874,1831,80,213,649,1219,729,1432
315080,202303,4163,9780,3124,7935,156,447,2236,5355,2392,5802
315090,202303,1020,2730,775,2305,109,358,357,945,466,1303
315100,202303,1789,4792,1211,3557,150,526,515,1278,665,1804
315110,202303,2829,5973,2079,4910,172,397,1195,2741,1367,3138
315120,202303,16146,33893,11851,27636,1222,2871,7012,15857,8234,18728
315130,202303,2271,5511,1938,4971,199,604,1057,2391,1256,2995
315140,202303,4205,10371,3392,9022,570,1647,1855,4571,2425,6218
315150,202303,5680,13423,4066,10791,705,2071,1804,4452,2509,6523
315160,202303,2510,5461,1781,4360,249,663,1017,2349,1266,3012
315170,202303,1798,5247,1271,4046,243,822,350,1030,593,1852
315180,202303,22717,51932,13689,35994,1845,5487,5003,11066,6848,16553
315190,202303,2775,5594,2110,4725,211,463,1563,3498,1774,3961
315200,202303,5999,14641,4529,12289,1308,3848,1550,3716,2858,7564
315210,202303,10865,26086,7752,20107,820,2369,3721,8283,4541,10652
315213,202303,1274,3082,1093,2827,22,87,905,2256,927,2343
315217,202303,3299,8415,2443,7001,89,374,1711,4645,1800,5019
315220,202303,10543,26009,8132,22019,631,1476,4552,12362,5183,13838
315230,202303,3691,7193,3021,6333,154,254,2222,4613,2376,4867
315240,202303,3146,8005,2550,7018,627,1831,1127,2958,1754,4789
315250,202303,19453,47270,14754,38939,2216,6541,6806,15905,9022,22446
315260,202303,1207,3005,747,2130,135,394,151,341,286,735
315270,202303,1244,3170,971,2708,123,415,463,1064,586,1479
315280,202303,4103,9454,2778,7200,709,1940,795,1874,1504,3814
315290,202303,1541,3456,998,2628,196,584,415,973,611,1557
315300,202303,811,1804,597,1507,33,96,414,1001,447,1097
315310,202303,1598,3588,1200,2933,80,257,823,1787,903,2044
315320,202303,788,2099,554,1644,77,236,210,569,287,805
315330,202303,907,2667,554,1808,61,217,223,627,284,844
315340,202303,3471,7916,2378,6260,585,1587,864,2143,1449,3730
315350,202303,2438,5379,2048,4810,149,412,1585,3542,1734,3954
315360,202303,2125,5574,1672,4736,215,647,782,2015,997,2662
315370,202303,772,1887,607,1613,83,242,284,668,367,910
315380,202303,298,775,207,593,39,114,29,55,68,169
315390,202303,1601,4055,1313,3585,133,447,759,1831,892,2278
315400,202303,5222,12452,4170,10719,516,1467,2416,5791,2932,7258
315410,202303,2931,6059,2087,4838,399,1101,602,1220,1001,2321
315415,202303,1863,4716,1506,4144,437,1430,297,677,734,2107
315420,202303,1907,4886,1375,3961,326,1010,350,824,676,1834
315430,202303,4437,10016,3067,8016,525,1512,1404,3442,1929,4954
315440,202303,1279,2976,1003,2566,105,301,613,1436,718,1737
315445,202303,2871,5539,2124,4550,120,256,1666,3508,1786,3764
315450,202303,2710,6619,2191,5802,210,600,1453,3649,1663,4249
315460,202303,60650,143178,51462,128199,4909,14821,34048,77520,38957,92341
315470,202303,835,2130,598,1609,53,163,295,692,348,855
315480,202303,1935,4815,1391,3728,192,546,660,1577,852,2123
315490,202303,3549,8142,2477,6478,391,1112,931,2195,1322,3307
315500,202303,646,1585,405,1099,22,62,238,576,260,638
315510,202303,1719,3705,1400,3253,18,80,1190,2595,1208,2675
315520,202303,1378,3080,1152,2754,42,110,965,2220,1007,2330
315530,202303,1017,2240,863,1999,61,190,669,1415,730,1605
315540,202303,2098,5009,1383,3719,121,390,610,1458,731,1848
315550,202303,2298,5775,1608,4560,285,949,516,1401,801,2350
315560,202303,8227,21317,7069,19369,476,1221,5109,13818,5585,15039
315570,202303,3129,7146,2222,5576,314,957,1179,2481,1493,3438
315580,202303,4139,8568,3244,7265,415,1062,1510,3024,1925,4086
315590,202303,1630,3049,1367,2679,41,161,1133,1991,1174,2152
315600,202303,3051,8296,2126,6580,523,1569,821,2673,1344,4242
315610,202303,1237,2819,915,2275,114,368,478,991,592,1359
315620,202303,647,1561,484,1316,33,102,264,710,297,812
315630,202303,1517,3672,1160,3007,171,471,550,1281,721,1752
315640,202303,506,1123,397,989,34,92,260,609,294,701
315645,202303,1218,2917,864,2379,150,442,265,665,415,1107
315650,202303,2269,4507,1838,3919,89,184,1467,3056,1556,3240
315660,202303,2502,5961,1881,4877,223,576,1045,2609,1268,3185
315670,202303,21206,50396,16683,42601,2823,7716,8390,19717,11213,27433
315680,202303,3940,9859,2927,8108,398,1205,1503,3911,1901,5116
315690,202303,4827,11062,2987,8008,602,1579,833,2330,1435,3909
315700,202303,10920,26270,8362,21506,756,2219,4853,11323,5609,13542
315710,202303,2191,4759,1555,3860,78,219,1033,2399,1111,2618
315720,202303,5565,13452,4567,11798,207,741,3269,7865,3476,8606
315725,202303,2835,6432,2234,5555,216,513,1464,3774,1680,4287
315727,202303,779,1812,579,1496,67,208,298,698,365,906
315730,202303,744,2029,622,1803,131,401,229,586,360,987
315733,202303,1891,4274,1474,3658,225,596,687,1547,912,2143
315737,202303,1440,3500,1050,2776,31,110,741,1841,772,1951
315740,202303,1075,2688,881,2315,75,238,595,1428,670,1666
315750,202303,1637,3700,1233,3135,96,243,788,2018,884,2261
315760,202303,1517,3064,1240,2707,26,85,1043,2177,1069,2262
315765,202303,2579,5379,2114,4803,28,99,1916,4321,1944,4420
315770,202303,1531,3899,1244,3516,413,1252,320,899,733,2151
315780,202303,40356,97924,33798,86672,2207,6823,22434,53350,24641,60173
315790,202303,4298,12052,3618,10835,315,940,2132,6677,2447,7617
315800,202303,1672,4851,1291,4009,157,588,573,1502,730,2090
315810,202303,1749,3678,1445,3217,57,162,1164,2473,1221,2635
315820,202303,3686,7941,2984,7029,282,637,2102,4890,2384,5527
315830,202303,1542,4198,1048,3124,120,397,296,685,416,1082
315840,202303,1073,2364,768,1878,65,169,409,881,474,1050
315850,202303,1468,3812,1161,3311,174,537,599,1614,773,2151
315860,202303,705,1780,530,1490,98,304,184,420,282,724
315870,202303,552,1388,443,1224,22,69,312,822,334,891
315880,202303,1422,3167,1040,2553,117,346,520,1062,637,1408
315890,202303,2254,5693,1852,5162,579,1806,679,1819,1258,3625
315895,202303,8002,19853,5976,16135,689,2117,2789,6710,3478,8827
315900,202303,1083,2615,906,2378,126,368,516,1254,642,1622
315910,202303,787,1767,683,1626,47,140,547,1264,594,1404
315920,202303,1766,4119,1027,2786,155,540,377,829,532,1369
315930,202303,1441,2882,1015,2313,72,176,602,1290,674,1466
315935,202303,1429,3768,1139,3248,207,610,515,1421,722,2031
315940,202303,747,1806,588,1579,82,248,311,767,393,1015
315950,202303,1596,3821,1354,3453,135,380,1010,2553,1145,2933
315960,202303,6623,17185,4583,13166,990,3148,957,1945,1947,5093
315970,202303,695,1722,563,1549,73,221,365,994,438,1215
315980,202303,5414,10964,3226,7491,556,1385,1605,3307,2161,4692
315990,202303,4323,10155,3385,8594,477,1281,1762,4130,2239,5411
316000,202303,973,2050,767,1764,67,192,489,1024,556,1216
316010,202303,812,2169,634,1833,91,272,268,633,359,905
316020,202303,1130,2839,915,2466,88,289,564,1413,652,1702
316030,202303,3372,8208,2560,6838,371,1035,1489,3998,1860,5033
316040,202303,3165,8494,2221,6738,366,1264,601,1489,967,2753
316045,202303,2812,5696,2583,5414,166,248,2233,4778,2399,5026
316050,202303,516,1231,389,1034,29,87,244,570,273,657
316060,202303,900,1892,654,1572,30,87,474,1072,504,1159
316070,202303,7596,18371,6204,15870,996,2541,3061,7351,4057,9892
316080,202303,1012,2781,806,2383,171,554,298,765,469,1319
316090,202303,658,1591,547,1389,47,148,342,770,389,918
316095,202303,1551,4407,1157,3481,251,822,401,1086,652,1908
316100,202303,3065,7892,2233,6219,336,1098,976,2385,1312,3483
316105,202303,862,2065,669,1760,52,135,425,1137,477,1272
316110,202303,18616,43043,15442,38071,915,2798,11587,26923,12502,29721
316120,202303,1515,3794,998,2755,154,490,345,754,499,1244
316130,202303,1607,3284,1072,2450,96,262,635,1301,731,1563
316140,202303,1300,3236,806,2322,142,421,280,747,422,1168
316150,202303,2747,5709,2151,4831,156,439,1265,2592,1421,3031
316160,202303,1228,2924,987,2531,41,146,716,1751,757,1897
316165,202303,1110,2384,880,2074,81,212,581,1289,662,1501
316170,202303,1803,3617,1412,3082,66,199,1070,2136,1136,2335
316180,202303,1987,5110,1380,3948,270,830,430,1052,700,1882
316190,202303,3326,8728,1932,5559,226,707,840,2016,1066,2723
316200,202303,4792,11700,3848,10197,581,1782,1963,4696,2544,6478
316210,202303,7129,18983,5184,14737,1554,4759,545,1317,2099,6076
316220,202303,883,2464,619,1967,120,408,124,368,244,776
316225,202303,1998,4044,1521,3336,53,186,1183,2347,1236,2533
316230,202303,634,1494,496,1275,109,309,250,601,359,910
316240,202303,7047,17812,6098,16161,433,1263,4488,11472,4921,12735
316245,202303,3906,10801,3470,10108,195,848,2565,6977,2760,7825
316250,202303,14578,31868,11180,26481,1971,5078,4779,10653,6750,15731
316255,202303,3614,9379,3100,8552,182,524,2235,6152,2417,6676
316257,202303,1957,3995,1478,3281,142,299,1037,2216,1179,2515
316260,202303,3393,6673,2654,5604,269,515,1748,3625,2017,4140
316265,202303,1332,3261,1046,2785,26,75,749,1906,775,1981
316270,202303,4723,12794,3989,11312,500,1548,2230,5828,2730,7376
316280,202303,3795,9096,3140,7973,380,1031,1768,4276,2148,5307
316290,202303,5109,12252,3937,10145,476,1305,1661,3833,2137,5138
316292,202303,7754,18520,6301,16284,687,2012,4158,10115,4845,12127
316294,202303,1190,3239,903,2762,185,655,279,732,464,1387
316295,202303,4629,11483,3811,10166,297,957,2494,6143,2791,7100
316300,202303,1388,3231,1115,2855,56,166,825,2000,881,2166
316310,202303,993,2489,698,1986,149,484,217,553,366,1037
316320,202303,822,2124,629,1836,115,377,133,334,248,711
316330,202303,1296,2986,1007,2529,55,158,763,1852,818,2010
316340,202303,1322,3112,1024,2611,86,282,657,1510,743,1792
316350,202303,1796,4158,1530,3733,164,418,1093,2540,1257,2958
316360,202303,796,1912,662,1712,68,165,493,1304,561,1469
316370,202303,7642,17477,5883,14573,625,1935,3240,6832,3865,8767
316380,202303,2184,4530,1757,3961,97,197,1301,2868,1398,3065
316390,202303,935,2340,698,1949,252,808,150,345,402,1153
316400,202303,1560,4047,989,2954,114,374,341,868,455,1242
316410,202303,1547,3467,1296,3093,35,112,1089,2486,1124,2598
316420,202303,2332,5648,1951,5104,35,134,1572,3948,1607,4082
316430,202303,1148,2754,802,2175,128,405,328,781,456,1186
316440,202303,1047,2995,845,2662,147,536,235,662,382,1198
316443,202303,698,1776,491,1391,99,334,166,417,265,751
316447,202303,2764,6022,2351,5422,34,97,2082,4678,2116,4775
316450,202303,2584,6755,1936,5512,239,717,1121,3057,1360,3774
316460,202303,1712,4102,1418,3650,126,362,908,2174,1034,2536
316470,202303,9435,24220,7153,19932,989,3134,3192,7726,4181,10860
316480,202303,276,634,230,577,32,91,135,306,167,397
316490,202303,426,1099,300,875,51,178,96,228,147,406
316500,202303,1666,4611,1164,3499,204,650,345,895,549,1545
316510,202303,994,2886,815,2553,135,433,392,1201,527,1634
316520,202303,1716,3806,1283,3080,202,535,511,1040,713,1575
316530,202303,1454,3295,1097,2696,91,320,675,1430,766,1750
316540,202303,1348,3025,1078,2661,181,525,486,1066,667,1591
316550,202303,1842,4451,1554,3979,57,190,1292,3210,1349,3400
316553,202303,6191,16146,4600,12709,595,1861,2170,5108,2765,6969
316555,202303,3350,8642,2890,8056,92,340,2427,6644,2519,6984
316556,202303,693,1477,520,1197,40,102,294,566,334,668
316557,202303,1529,4135,1312,3796,434,1380,527,1413,961,2793
316560,202303,506,1415,358,1127,57,207,98,248,155,455
316570,202303,1790,4527,1474,3995,365,905,467,1384,832,2289
316580,202303,482,987,319,735,38,91,144,301,182,392
316590,202303,1615,3656,1108,2744,130,291,656,1518,786,1809
316600,202303,1240,3158,1083,2878,157,476,673,1632,830,2108
316610,202303,778,2029,623,1779,62,199,381,1027,443,1226
316620,202303,2865,6347,2471,5783,171,373,1944,4482,2115,4855
316630,202303,1933,5225,1625,4679,458,1292,614,2001,1072,3293
316640,202303,213,529,167,450,32,100,70,162,102,262
316650,202303,1425,3535,1155,3133,87,242,776,2015,863,2257
316660,202303,221,504,109,284,11,31,40,85,51,116
316670,202303,1992,4593,1493,3853,384,1038,473,1078,857,2116
316680,202303,2920,6858,2192,5538,182,510,1456,3545,1638,4055
316690,202303,1670,4435,1205,3566,207,656,215,464,422,1120
316695,202303,1162,3099,934,2713,20,68,632,1764,652,1832
316700,202303,650,1111,558,1011,13,28,502,878,515,906
316710,202303,4459,12014,3603,10395,405,1414,2099,5445,2504,6859
316720,202303,29348,71352,23143,60379,3325,9601,12042,28484,15367,38085
316730,202303,689,1483,551,1274,58,144,319,652,377,796
316740,202303,1101,2675,968,2493,154,443,650,1632,804,2075
316750,202303,502,1273,378,1068,69,216,168,431,237,647
316760,202303,5041,13902,4277,12564,1404,4691,1621,4555,3025,9246
316770,202303,1935,3889,1445,3255,48,129,1140,2558,1188,2687
316780,202303,757,2026,613,1778,204,672,121,249,325,921
316790,202303,895,2207,663,1784,109,322,187,470,296,792
316800,202303,8384,20870,6684,18064,902,2630,3359,8532,4261,11162
316805,202303,1525,2742,1245,2422,30,80,1073,2019,1103,2099
316810,202303,956,2319,744,1961,82,235,523,1346,605,1581
316820,202303,486,950,293,651,17,56,196,381,213,437
316830,202303,1136,2587,865,2160,95,246,536,1283,631,1529
316840,202303,3775,8329,3066,7271,155,479,2405,5404,2560,5883
316850,202303,2910,6343,2223,5261,186,533,1457,3118,1643,3651
316860,202303,29975,65977,23148,56078,2997,8677,12592,28074,15589,36751
316870,202303,11355,27046,8668,22297,957,2882,4753,10794,5710,13676
316880,202303,1473,3374,1249,3080,151,440,784,1769,935,2209
316890,202303,1445,3059,923,2398,111,370,578,1370,689,1740
316900,202303,3334,7867,2680,6736,408,1145,1297,2853,1705,3998
316905,202303,606,1653,491,1443,230,682,108,340,338,1022
316910,202303,1319,3144,913,2492,223,655,222,540,445,1195
316920,202303,2537,5148,1933,4306,185,555,1370,2719,1555,3274
316930,202303,12313,30861,9809,26749,1931,5841,4035,9791,5966,15632
316935,202303,5594,13273,4201,10851,690,1997,1983,4564,2673,6561
316940,202303,7721,20463,6198,17640,1060,3302,2759,6897,3819,10199
316950,202303,2548,5041,1982,4303,89,186,1669,3539,1758,3725
316960,202303,6970,13562,5129,11217,390,970,3727,7840,4117,8810
316970,202303,5336,12791,4482,11412,600,1703,2338,5334,2938,7037
316980,202303,1126,2863,868,2459,240,766,356,915,596,1681
316990,202303,16632,40118,12582,32537,2978,8264,3025,6591,6003,14855
317000,202303,3329,8048,2921,7535,173,387,2353,6064,2526,6451
317005,202303,3275,8283,2564,6937,409,1242,1317,3287,1726,4529
317010,202303,38185,83058,27472,67133,4049,11112,15119,34603,19168,45715
317020,202303,97065,214725,63406,158671,11801,32327,23361,51496,35162,83823
317030,202303,834,2017,667,1781,16,58,495,1276,511,1334
317040,202303,14686,34182,10152,26830,2462,7021,2667,7009,5129,14030
317043,202303,1202,2311,894,1919,39,86,711,1499,750,1585
317047,202303,1406,2973,986,2329,48,133,703,1566,751,1699
317050,202303,1524,4411,1096,3442,175,594,383,954,558,1548
317052,202303,3105,7229,2458,6271,217,622,1667,4013,1884,4635
317057,202303,2837,5263,2196,4365,34,104,1828,3399,1862,3503
317060,202303,606,1523,370,1057,67,208,131,329,198,537
317065,202303,1370,3576,1135,3135,72,254,736,1824,808,2078
317070,202303,10588,27155,8544,23458,1269,4097,4183,10214,5452,14311
317075,202303,1425,3208,1123,2745,162,417,656,1477,818,1894
317080,202303,8522,18061,6504,14946,1208,2962,3176,6942,4384,9904
317090,202303,5873,14780,5108,13617,389,952,3715,9844,4104,10796
317100,202303,3261,7206,2237,5620,443,1198,966,2224,1409,3422
317103,202303,3132,6516,2666,5895,152,432,2175,4562,2327,4994
317107,202303,1855,4253,1385,3427,52,167,935,1981,987,2148
317110,202303,844,1824,488,1281,81,246,199,483,280,729
317115,202303,1396,3561,1145,3138,146,428,664,1782,810,2210
317120,202303,25170,58257,20711,51419,1463,4506,13857,31613,15320,36119
317130,202303,14632,31423,10414,24677,1404,3689,4235,9590,5639,13279
317140,202303,1183,2560,899,2128,74,178,619,1425,693,1603
317150,202303,1323,2683,1019,2292,28,98,878,1884,906,1982
317160,202303,4237,9443,2713,7006,294,696,1324,3619,1618,4315
317170,202303,2595,5859,2028,4883,88,267,1388,2954,1476,3221
317180,202303,2300,6530,1676,5168,315,1019,345,982,660,2001
317190,202303,1340,3355,997,2795,183,564,470,1214,653,1778
317200,202303,8228,20050,6114,16102,1310,3621,1493,3415,2803,7036
317210,202303,1532,3225,1189,2785,42,141,851,1943,893,2084
317220,202303,420,1054,371,977,66,202,219,513,285,715
320010,202303,5993,16272,4556,13411,755,2460,2073,5826,2828,8286
320013,202303,2624,6517,1858,5093,326,969,825,2241,1151,3210
320016,202303,3619,8529,2777,7244,222,610,1828,4642,2050,5252
320020,202303,6289,14215,4873,11870,653,1916,2702,6073,3355,7989
320030,202303,2223,5571,1469,4083,209,661,673,1636,882,2297
320035,202303,2439,5846,2030,5198,341,1019,1188,2893,1529,3912
320040,202303,5745,14490,4805,12920,655,1871,2625,6567,3280,8438
320050,202303,2383,4853,2052,4397,211,595,1387,2677,1598,3272
320060,202303,18973,46924,14134,37813,2491,7150,6239,15095,8730,22245
320070,202303,2481,5881,1890,4829,204,671,1035,2283,1239,2954
320080,202303,7136,16586,5073,12765,848,2290,2196,4922,3044,7212
320090,202303,10499,25989,7158,19578,1450,4378,2554,6100,4004,10478
320100,202303,4395,10094,3629,8862,439,1246,2305,5293,2744,6539
320110,202303,3061,6212,2254,5055,253,683,1421,2827,1674,3510
320115,202303,2779,7938,2366,7270,786,2520,843,2675,1629,5195
320120,202303,34371,78353,25301,63197,3287,9092,12943,29162,16230,38254
320130,202303,77281,181373,63722,158937,7780,21432,38983,90962,46763,112394
320140,202303,5304,12937,3925,10353,568,1777,1925,4523,2493,6300
320150,202303,18335,43390,13253,34631,3097,9171,2212,4398,5309,13569
320160,202303,8329,20537,6221,16883,820,2467,3174,8104,3994,10571
320170,202303,2344,6010,1677,4777,434,1272,528,1571,962,2843
320180,202303,928,2695,721,2291,216,765,154,429,370,1194
320190,202303,4068,11583,3015,9390,617,2171,608,1584,1225,3755
320200,202303,1686,4264,1152,3299,236,733,307,856,543,1589
320210,202303,5910,13525,4598,11406,701,1903,2506,5717,3207,7620
320220,202303,4756,10802,3560,8909,704,1847,1563,3607,2267,5454
320225,202303,1968,5506,1335,4133,352,1213,294,847,646,2060
320230,202303,7235,17276,5469,14461,1324,3673,1479,4001,2803,7674
320240,202303,22969,53168,17396,44742,4379,12441,5173,12341,9552,24782
320245,202303,4172,11327,3022,8909,786,2487,362,944,1148,3431
320250,202303,3721,8799,2559,6402,386,1061,1275,2740,1661,3801
320255,202303,2790,7436,2391,6756,364,1124,1587,4426,1951,5550
320260,202303,1810,4728,1182,3480,276,829,300,755,576,1584
320265,202303,2867,8152,2101,6580,739,2522,241,665,980,3187
320270,202303,2886,7298,2171,6005,556,1740,666,1715,1222,3455
320280,202303,11263,25483,9325,22472,1004,2889,6348,14188,7352,17077
320290,202303,1662,4592,1092,3318,267,903,289,799,556,1702
320300,202303,5711,15075,4581,13011,1242,3940,1494,3975,2736,7915
320305,202303,7004,17592,5334,14577,925,2842,2532,6396,3457,9238
320310,202303,2657,6570,1938,5132,348,1028,862,1993,1210,3021
320313,202303,3240,7267,2209,5462,423,1178,822,1665,1245,2843
320316,202303,1986,5164,1505,4369,220,642,809,2352,1029,2994
320320,202303,28442,69138,21008,57063,5077,14692,6860,17925,11937,32617
320330,202303,3725,8993,2924,7693,450,1215,1645,4285,2095,5500
320332,202303,11121,26166,9010,22712,1622,4504,4856,11443,6478,15947
320334,202303,2509,6443,1724,4965,288,994,409,896,697,1890
320335,202303,2385,6283,1599,4610,317,1052,481,1216,798,2268
320340,202303,7397,15332,6157,13615,442,1123,4350,9276,4792,10399
320350,202303,6846,14904,4831,11546,519,1398,2698,5802,3217,7200
320360,202303,1743,4107,1238,3190,142,404,600,1408,742,1812
320370,202303,3716,10051,2895,8389,776,2576,1035,2696,1811,5272
320380,202303,4000,8704,3361,7697,247,766,2473,5174,2720,5940
320390,202303,10414,24784,7778,19872,1525,4141,3156,7333,4681,11474
320400,202303,4155,10840,3090,8692,833,2597,1116,2874,1949,5471
320405,202303,6872,15872,5225,13205,731,1975,2816,6715,3547,8690
320410,202303,6043,14464,4574,12211,797,2146,2198,5837,2995,7983
320420,202303,5438,12112,4220,10281,916,2432,1726,3930,2642,6362
320425,202303,2769,5848,2123,4864,149,373,1465,3111,1614,3484
320430,202303,3976,9192,3167,7869,420,1099,1943,4573,2363,5672
320435,202303,3124,8784,2521,7591,816,2706,792,2388,1608,5094
320440,202303,1956,4906,1461,3983,249,748,641,1517,890,2265
320450,202303,2807,6739,2267,5826,316,1032,1330,3004,1646,4036
320455,202303,5745,16150,3998,12283,883,3067,980,2484,1863,5551
320460,202303,2751,7528,2035,6115,574,1950,551,1440,1125,3390
320465,202303,2054,5255,1476,4181,364,1120,568,1571,932,2691
320470,202303,5581,13459,4186,10902,737,2165,1448,3240,2185,5405
320480,202303,3243,6900,2624,5934,296,708,1811,3876,2107,4584
320490,202303,34380,77778,25733,63726,4659,11713,11432,27621,16091,39334
320495,202303,1752,4388,1279,3506,289,925,208,394,497,1319
320500,202303,90844,210791,73773,183065,8498,24013,45905,105189,54403,129202
320501,202303,6391,16594,4653,13488,1280,4043,1126,3049,2406,7092
320503,202303,3325,8721,2290,6695,638,2067,603,1544,1241,3611
320506,202303,3588,9711,2704,7872,728,2367,638,1525,1366,3892
320510,202303,16204,38334,12780,32725,1948,5101,6716,16494,8664,21595
320515,202303,2330,5875,1721,4672,495,1445,519,1293,1014,2738
320517,202303,2897,7721,2356,6680,649,2010,909,2456,1558,4466
320520,202303,63153,143489,50068,122719,7164,19568,25439,57500,32603,77068
320530,202303,47791,108342,38623,93647,2722,8230,26065,57364,28787,65594
330010,202303,37812,82673,31873,73655,2380,6374,23703,51835,26083,58209
330015,202303,2328,4827,1823,4069,225,635,1160,2345,1385,2980
330020,202303,31388,66901,26721,60342,2673,6959,19676,42563,22349,49522
330022,202303,2593,6385,1985,5405,391,1128,825,2164,1216,3292
330023,202303,9740,20424,7869,17680,1043,2650,5087,10628,6130,13278
330025,202303,10302,20867,7205,16089,1119,2771,3463,6940,4582,9711
330030,202303,15963,35442,12708,30528,933,2833,8901,19588,9834,22421
330040,202303,25466,56560,21451,50322,910,2815,16558,36170,17468,38985
330045,202303,148210,278384,127331,253154,5334,12029,109217,210710,114551,222739
330050,202303,4841,10677,3932,9310,602,1775,2464,5124,3066,6899
330060,202303,8288,18416,6265,15176,1122,3125,2594,5571,3716,8696
330070,202303,44662,93188,37766,83912,4404,10632,25816,55574,30220,66206
330080,202303,14853,30320,12691,27447,1555,3425,8844,18731,10399,22156
330090,202303,4610,8520,3408,6959,305,530,2315,4783,2620,5313
330093,202303,4131,8469,3183,7217,195,523,2571,5610,2766,6133
330095,202303,1983,4813,1565,4107,162,492,934,2225,1096,2717
330100,202303,109384,236525,96316,218796,4318,12102,78172,170961,82490,183063
330110,202303,3330,7711,2761,6821,277,815,1903,4350,2180,5165
330115,202303,3821,8130,2738,6494,431,1181,1571,3332,2002,4513
330120,202303,4907,9276,3842,8000,171,450,3070,6017,3241,6467
330130,202303,7760,17893,6489,16066,846,2204,4187,9969,5033,12173
330140,202303,6201,12197,5207,10925,180,549,4452,8868,4632,9417
330150,202303,3594,8164,2882,7086,463,1260,1599,3703,2062,4963
330160,202303,2222,5113,1764,4366,289,849,1043,2273,1332,3122
330170,202303,230749,442576,199095,402198,20856,45370,150442,294535,171298,339905
330180,202303,3166,6133,2619,5408,97,278,2140,4158,2237,4436
330185,202303,17535,34079,15062,30946,479,1352,13129,25872,13608,27224
330187,202303,8356,17328,6625,14738,785,2058,4429,9037,5214,11095
330190,202303,68038,131119,59529,120011,2453,6082,50080,97057,52533,103139
330200,202303,28409,58828,23781,53175,2832,6670,17263,37726,20095,44396
330205,202303,3026,6682,2320,5577,154,447,1586,3493,1740,3940
330210,202303,4483,9702,3328,7907,416,1108,1959,4214,2375,5322
330220,202303,20658,43937,15735,36297,2331,6206,8224,16752,10555,22958
330225,202303,6248,13646,4933,11756,352,973,3429,7724,3781,8697
330227,202303,29640,58352,26089,54120,535,1510,23610,47514,24145,49024
330230,202303,2487,5246,1679,4150,155,412,777,1882,932,2294
330240,202303,41318,88996,35378,80257,2968,7837,26098,56141,29066,63978
330245,202303,2222,5038,1395,3630,270,780,597,1338,867,2118
330250,202303,69514,140714,59892,127638,6174,14359,44426,91403,50600,105762
330260,202303,9681,19152,7885,16831,422,1066,6325,12958,6747,14024
330270,202303,48153,101713,31805,75965,3870,10328,16894,36878,20764,47206
330280,202303,4007,8433,3214,7237,191,561,2300,4720,2491,5281
330285,202303,45810,87093,38548,77362,1432,3813,32583,61960,34015,65773
330290,202303,6936,13192,5720,11665,299,877,4720,8971,5019,9848
330300,202303,8401,16721,6320,13923,430,1079,4723,9884,5153,10963
330310,202303,3879,7942,2974,6609,134,349,2256,4732,2390,5081
330320,202303,27605,54146,22362,47720,2497,5072,16668,34849,19165,39921
330330,202303,76718,144772,63846,128330,4391,9851,50523,97343,54914,107194
330340,202303,28531,59193,22170,49971,2797,7630,13281,26790,16078,34420
330350,202303,253204,469265,218393,428335,8289,18152,192674,368716,200963,386868
330360,202303,11281,22273,9907,20652,360,731,8753,17935,9113,18666
330370,202303,8161,19231,6544,16678,1158,3336,3357,7916,4515,11252
330380,202303,10560,22548,8662,19488,583,1690,6466,13487,7049,15177
330385,202303,6265,14614,5143,13020,827,2405,2783,6592,3610,8997
330390,202303,52976,114723,42092,97383,3753,10807,29110,61247,32863,72054
330395,202303,5092,10456,4257,9439,144,441,3441,7223,3585,7664
330400,202303,5122,11499,4315,10262,201,666,3328,7298,3529,7964
330410,202303,4859,10430,3715,8644,403,1199,2598,5476,3001,6675
330411,202303,3985,9559,3238,8328,184,611,2260,5363,2444,5974
330412,202303,2455,5684,2042,5068,153,469,1450,3314,1603,3783
330414,202303,36403,77950,30528,70146,1978,5181,23804,52697,25782,57878
330415,202303,6400,15184,4788,12531,444,1285,2841,6954,3285,8239
330420,202303,18528,40873,14152,34130,1429,4046,8563,18699,9992,22745
330430,202303,16333,30668,14038,27719,500,1208,11901,22486,12401,23694
330440,202303,4252,9538,3262,7885,313,926,2259,5002,2572,5928
330450,202303,2054,4891,1639,4236,125,362,1035,2486,1160,2848
330452,202303,30518,65125,25401,57794,2014,5691,19055,40617,21069,46308
330455,202303,1085514,2077949,919872,1858147,86732,191504,687864,1335353,774596,1526857
330460,202303,1743,4061,1361,3518,207,585,742,1852,949,2437
330470,202303,8762,18453,6386,15017,1380,3672,2633,5664,4013,9336
330475,202303,13689,29664,11190,26481,1421,3868,7532,17061,8953,20929
330480,202303,8091,18082,6909,16413,582,1493,4806,10783,5388,12276
330490,202303,177078,348036,149115,311984,12147,27166,113682,230059,125829,257225
330500,202303,12055,25262,10207,22863,587,1503,8003,17294,8590,18797
330510,202303,73442,151895,59958,134076,5239,13343,45257,96553,50496,109896
330513,202303,1834,4033,1490,3583,216,578,859,1992,1075,2570
330515,202303,4054,9272,3291,8217,462,1360,1747,3931,2209,5291
330520,202303,21457,46251,18261,41722,1564,4274,13130,28295,14694,32569
330530,202303,2284,4939,1651,4003,297,788,792,1859,1089,2647
330540,202303,4414,10060,3468,8546,705,1864,1698,3903,2403,5767
330550,202303,27037,52765,19990,42769,2462,6026,12896,25679,15358,31705
330555,202303,31783,54617,27192,49302,969,2057,23447,41718,24416,43775
330560,202303,5652,12489,4632,10947,635,1555,3009,6782,3644,8337
330570,202303,4485,9933,3953,9226,529,1458,2773,6234,3302,7692
330575,202303,9349,19482,8236,17684,305,852,6989,14134,7294,14986
330580,202303,34087,74211,28812,65758,3805,9382,18276,38458,22081,47840
330590,202303,2241,4879,1884,4443,237,544,1235,2926,1472,3470
330600,202303,19241,41949,16093,37214,858,2526,11862,25503,12720,28029
330610,202303,14496,31439,12021,27722,1041,2804,8507,18363,9548,21167
330615,202303,3025,6886,2503,6210,436,967,1603,4098,2039,5065
330620,202303,6465,15211,5288,13377,770,2240,3111,7234,3881,9474
330630,202303,45248,94872,35690,80317,1437,4365,27541,57736,28978,62101
350010,202303,3095,7420,1953,5180,346,990,506,1051,852,2041
350020,202303,856,2074,530,1474,75,227,188,444,263,671
350030,202303,5046,12406,4016,10731,819,2475,1990,4811,2809,7286
350040,202303,995,2636,624,1869,85,313,198,435,283,748
350050,202303,1994,4506,1387,3539,212,636,480,940,692,1576
350055,202303,1243,2760,1002,2411,134,372,597,1274,731,1646
350060,202303,414,912,226,548,42,106,90,196,132,302
350070,202303,4402,10512,3157,8341,459,1361,1424,3237,1883,4598
350075,202303,884,2302,667,1917,208,600,121,356,329,956
350080,202303,860,2097,574,1561,46,153,303,706,349,859
350090,202303,802,1593,536,1213,69,188,334,674,403,862
350100,202303,3499,8021,2561,6531,150,517,1715,3929,1865,4446
350110,202303,650,1404,488,1139,16,46,358,790,374,836
350115,202303,1468,4002,1215,3518,196,645,572,1460,768,2105
350120,202303,825,1806,487,1245,45,136,264,607,309,743
350130,202303,4507,10691,3611,9144,418,1211,2103,4666,2521,5877
350140,202303,894,2257,647,1821,48,178,379,946,427,1124
350150,202303,584,1645,472,1440,96,325,152,391,248,716
350160,202303,16808,39217,12317,31154,1633,4623,7244,16792,8877,21415
350170,202303,3850,9457,3273,8285,527,1426,1823,4148,2350,5574
350180,202303,1310,2889,834,2091,90,243,458,1041,548,1284
350190,202303,5060,12865,3829,10169,453,1506,2234,4990,2687,6496
350200,202303,719,1680,553,1399,40,114,349,801,389,915
350210,202303,8847,18430,6402,14661,448,1315,4569,9568,5017,10883
350220,202303,4169,10392,3026,8300,523,1546,1324,3168,1847,4714
350230,202303,1490,3352,1172,2928,150,455,696,1626,846,2081
350240,202303,749,1962,463,1323,75,216,125,292,200,508
350250,202303,4760,11701,3656,9985,945,2678,1115,2909,2060,5587
350260,202303,1109,2372,708,1737,86,243,412,898,498,1141
350270,202303,5802,13714,4687,11752,570,1612,2759,6269,3329,7881
350275,202303,4000,9267,3326,8320,220,713,2515,5891,2735,6604
350280,202303,25505,54213,17337,41453,2341,6149,9059,19644,11400,25793
350290,202303,4677,11709,3397,9252,575,1752,1496,3535,2071,5287
350300,202303,930,2103,733,1775,90,249,477,1043,567,1292
350310,202303,1281,3241,999,2737,144,463,484,1174,628,1637
350315,202303,785,1754,561,1422,27,100,337,729,364,829
350320,202303,23203,54514,18127,45880,2915,8385,9210,20711,12125,29096
350330,202303,18623,41646,14128,33728,1204,3343,9695,21258,10899,24601
350335,202303,467,1216,340,975,34,102,151,419,185,521
350340,202303,1743,4230,1116,3030,154,480,532,1261,686,1741
350350,202303,924,2098,731,1889,119,296,429,1113,548,1409
350360,202303,1568,4064,1298,3553,217,643,587,1493,804,2136
350370,202303,932,2089,684,1656,191,456,260,565,451,1021
350380,202303,6310,16141,4714,12906,1042,3001,1666,4125,2708,7126
350390,202303,15538,36149,12218,30815,1540,4321,7468,17254,9008,21575
350395,202303,529,1241,270,767,27,78,92,224,119,302
350400,202303,11631,26565,8404,21249,2070,5697,2668,6179,4738,11876
350410,202303,14671,37206,11274,31132,2101,6393,4609,11646,6710,18039
350420,202303,1535,3647,1093,2854,196,518,381,822,577,1340
350430,202303,853,2039,678,1781,103,326,364,836,467,1162
350440,202303,2793,6178,2231,5325,156,474,1530,3316,1686,3790
350450,202303,9784,24325,7802,21014,1516,4695,3748,8950,5264,13645
350460,202303,3080,7245,2029,5338,302,881,953,2209,1255,3090
350470,202303,330,731,258,624,8,20,195,448,203,468
350480,202303,1200,2840,796,2144,187,578,165,357,352,935
350490,202303,2644,5996,1956,4970,291,862,981,2122,1272,2984
350500,202303,795,1987,571,1596,84,249,224,574,308,823
350510,202303,1603,3627,1241,3030,114,300,778,1752,892,2052
350520,202303,3183,8489,2537,7357,355,1126,1209,3162,1564,4288
350530,202303,4239,9731,3261,7946,253,748,2051,4479,2304,5227
350535,202303,1953,4673,1634,4235,232,669,1032,2539,1264,3208
350540,202303,2651,5273,2048,4445,224,612,1471,2863,1695,3475
350550,202303,13078,29272,9452,23370,892,2645,5746,12705,6638,15350
350560,202303,6198,13916,5246,12491,229,743,4112,9151,4341,9894
350570,202303,42400,103928,35016,91231,5437,15670,19074,45853,24511,61523
350580,202303,2887,7017,1904,5201,546,1653,512,1036,1058,2689
350590,202303,6995,16990,5370,13630,651,1935,3327,7581,3978,9516
350600,202303,45177,98911,29686,73122,4436,12586,14160,30593,18596,43179
350610,202303,9577,23595,7275,19227,795,2436,4285,10234,5080,12670
350620,202303,517,1244,347,980,40,117,192,504,232,621
350630,202303,2361,4966,1738,3962,105,303,1259,2600,1364,2903
350635,202303,15419,32713,12085,27801,1233,3151,8489,18373,9722,21524
350640,202303,1168,2930,650,1854,102,301,184,438,286,739
350650,202303,11358,27918,8508,22628,1452,4269,3765,8868,5217,13137
350660,202303,6641,15084,5229,12920,613,1515,3308,7914,3921,9429
350670,202303,2408,5931,1817,4928,299,861,934,2428,1233,3289
350680,202303,1511,3688,1043,2862,148,435,467,1127,615,1562
350690,202303,1912,4552,1427,3720,249,703,722,1750,971,2453
350700,202303,6991,15795,5499,13558,1074,3117,3002,6639,4076,9756
350710,202303,4148,9694,3491,8663,586,1706,1931,4304,2517,6010
350715,202303,927,2463,782,2213,168,552,370,887,538,1439
350720,202303,212,489,149,394,20,58,46,102,66,160
350730,202303,830,2211,638,1852,48,162,362,943,410,1105
350740,202303,2110,5148,1470,3888,241,690,491,1132,732,1822
350745,202303,805,1947,499,1383,41,139,249,615,290,754
350750,202303,15745,37164,12796,32462,2082,6116,6426,14563,8508,20679
350760,202303,24948,54126,19174,44749,2423,6889,11584,23802,14007,30691
350770,202303,1374,3046,914,2286,92,258,568,1301,660,1559
350775,202303,927,1953,626,1509,83,204,341,766,424,970
350780,202303,3003,6694,2234,5677,560,1317,855,2361,1415,3678
350790,202303,2725,6754,1774,5062,389,1118,432,974,821,2092
350800,202303,4547,11475,3879,10394,390,1207,2533,6297,2923,7504
350810,202303,3801,8292,2851,6908,646,1641,1284,2864,1930,4505
350820,202303,1192,2568,753,1785,52,147,474,1011,526,1158
350830,202303,1089,2704,651,1812,110,343,224,477,334,820
350840,202303,4547,12122,3539,10326,643,2113,1569,4062,2212,6175
350850,202303,11348,27842,9037,23881,1421,4130,4977,12162,6398,16292
350860,202303,5317,12084,4610,11135,462,1232,3192,7479,3654,8711
350870,202303,3592,8854,2636,7381,440,1286,1299,3453,1739,4739
350880,202303,2132,5241,1779,4610,437,1215,746,1670,1183,2885
350890,202303,659,1600,441,1175,73,201,145,327,218,528
350900,202303,13122,31111,9694,24572,1381,3965,5439,12252,6820,16217
350910,202303,1250,2632,1046,2348,95,222,785,1714,880,1936
350920,202303,17353,39082,14595,34747,696,1984,11455,25837,12151,27821
350925,202303,5853,13877,4374,11477,692,2084,2383,5459,3075,7543
350930,202303,1868,4525,1303,3480,94,267,705,1782,799,2049
350940,202303,3682,8253,2999,7207,242,699,2215,4922,2457,5621
350945,202303,1262,3160,932,2539,174,487,391,952,565,1439
350950,202303,135360,310621,106645,259967,12978,35237,65721,148038,78699,183275
350960,202303,9785,23427,7707,19639,1139,3316,4046,9203,5185,12519
350970,202303,5281,13371,3964,11029,1006,3196,1292,2773,2298,5969
350980,202303,1025,2330,855,2053,125,355,542,1177,667,1532
350990,202303,2860,6687,2262,5776,497,1491,1107,2524,1604,4015
350995,202303,1130,3058,1029,2877,67,247,710,1843,777,2090
351000,202303,3982,10044,2565,7237,539,1623,741,1953,1280,3576
351010,202303,512,1197,318,839,49,155,156,372,205,527
351015,202303,1304,3490,1080,3058,195,614,470,1128,665,1742
351020,202303,10981,26392,8459,22105,1527,4371,4345,10227,5872,14598
351030,202303,4135,10900,3308,9318,571,1850,1615,4132,2186,5982
351040,202303,7832,16504,6544,14618,266,748,5356,11338,5622,12086
351050,202303,24065,54145,18703,46280,3041,8259,10357,23937,13398,32196
351060,202303,68341,153965,53334,129675,4558,12805,37038,84773,41596,97578
351070,202303,1945,4471,1153,3155,292,878,237,541,529,1419
351080,202303,3752,8124,2849,7040,350,1006,1807,4140,2157,5146
351090,202303,432,1079,333,912,61,165,129,336,190,501
351100,202303,3803,9259,2510,6737,474,1416,890,2181,1364,3597
351110,202303,7537,18118,5528,14562,871,2610,2850,6804,3721,9414
351120,202303,989,2339,665,1742,118,341,233,512,351,853
351130,202303,1488,3907,691,2063,123,407,157,374,280,781
351140,202303,2999,7510,2312,6318,477,1449,962,2283,1439,3732
351150,202303,3838,9863,2755,7758,437,1410,1033,2530,1470,3940
351160,202303,1842,5172,1318,4030,246,813,261,653,507,1466
351170,202303,2181,5141,1890,4664,146,452,1352,3047,1498,3499
351190,202303,1285,3323,907,2608,214,650,252,650,466,1300
351200,202303,2016,4617,1495,3855,161,467,911,2150,1072,2617
351210,202303,1991,4449,1339,3368,89,278,831,1875,920,2153
351220,202303,5091,11907,4389,10832,490,1163,2894,6909,3384,8072
351230,202303,2963,6866,2302,5799,424,1180,1057,2291,1481,3471
351240,202303,3019,7420,1913,5210,450,1212,417,950,867,2162
351250,202303,1317,3336,777,2224,103,290,264,703,367,993
351260,202303,1061,2441,741,1893,152,382,281,670,433,1052
351270,202303,682,1696,489,1327,53,154,243,537,296,691
351280,202303,5117,12478,3853,10161,875,2421,1455,3472,2330,5893
351290,202303,1978,4301,1365,3297,115,329,981,2222,1096,2551
351300,202303,30612,74029,23058,60657,4054,11661,11372,27403,15426,39064
351310,202303,5149,11238,4028,9455,195,588,3008,6582,3203,7170
351320,202303,1022,2770,720,2192,125,396,190,496,315,892
351330,202303,397,965,264,716,22,74,127,276,149,350
351340,202303,11076,24776,9391,21945,1559,4420,5982,12259,7541,16679
351350,202303,18277,40751,15229,35835,1087,3095,11708,25766,12795,28861
351360,202303,5301,12215,4369,10901,759,2216,2303,5124,3062,7340
351370,202303,2576,6659,1715,4927,403,1250,374,858,777,2108
351380,202303,63748,138655,46905,111498,4711,12547,30396,67487,35107,80034
351385,202303,474,1181,204,596,28,79,89,246,117,325
351390,202303,1878,4167,1339,3437,68,213,1086,2695,1154,2908
351400,202303,1542,3820,1251,3290,218,550,634,1588,852,2138
351410,202303,3507,8727,2665,7199,477,1373,1177,2917,1654,4290
351420,202303,628,1411,396,1033,49,134,234,555,283,689
351430,202303,1359,3104,1133,2760,72,198,850,1953,922,2151
351440,202303,4788,11464,3334,8698,553,1537,1082,2316,1635,3853
351450,202303,2233,5416,1544,4202,294,976,475,998,769,1974
351460,202303,1349,3159,1114,2810,170,457,680,1624,850,2081
351470,202303,1594,3706,1259,3170,84,253,814,1898,898,2151
351480,202303,3221,8229,2561,7221,434,1404,1244,3169,1678,4573
351490,202303,2995,7408,2595,6717,84,316,2070,5127,2154,5443
351492,202303,472,1095,405,973,9,29,320,727,329,756
351495,202303,295,725,240,627,25,55,137,342,162,397
351500,202303,60466,129020,47797,109603,5775,14896,32150,68457,37925,83353
351510,202303,18605,40169,14039,32781,1512,3986,9202,20126,10714,24112
351512,202303,602,1507,425,1140,81,226,132,320,213,546
351515,202303,4281,9324,2753,6750,537,1381,651,1615,1188,2996
351518,202303,2544,6199,1766,4835,303,937,709,1634,1012,2571
351519,202303,770,1962,472,1396,110,358,99,235,209,593
351520,202303,1476,3448,745,2089,79,269,349,837,428,1106
351530,202303,453,1102,283,770,42,110,127,284,169,394
351535,202303,2178,4979,1546,3913,242,656,679,1572,921,2228
351540,202303,3465,7671,2386,5879,241,709,1269,2719,1510,3428
351550,202303,9955,22591,7027,17596,843,2321,3895,8764,4738,11085
351560,202303,681,1814,536,1533,95,303,200,521,295,824
351565,202303,355,879,271,742,37,123,116,270,153,393
351570,202303,31669,74294,25327,62889,1995,5810,17400,40251,19395,46061
351580,202303,276,686,166,491,24,65,59,186,83,251
351590,202303,552,1221,297,781,23,68,157,363,180,431
351600,202303,1726,4267,1325,3525,211,608,607,1423,818,2031
351610,202303,852,1868,544,1350,52,146,301,678,353,824
351620,202303,32670,79575,24652,66827,3581,11200,11642,28400,15223,39600
351630,202303,39588,90606,32516,79660,2651,7651,23322,53463,25973,61114
351640,202303,27427,61677,22371,53553,1452,4239,16490,36866,17942,41105
351650,202303,485,1262,228,685,39,127,47,113,86,240
351660,202303,782,2071,545,1577,90,282,139,334,229,616
351670,202303,8140,20280,5444,14582,1123,2990,2304,5477,3427,8467
351680,202303,525,1358,354,1023,59,161,115,302,174,463
351685,202303,608,1559,482,1367,88,244,195,482,283,726
351690,202303,1522,3603,893,2423,99,332,369,876,468,1208
351700,202303,1764,3978,1320,3256,226,626,711,1568,937,2194
351710,202303,997,2357,750,1934,60,192,429,962,489,1154
351720,202303,2022,4810,1450,3846,251,677,676,1647,927,2324
351730,202303,1330,3013,1083,2654,76,206,683,1540,759,1746
351740,202303,4353,10012,3556,8692,458,1265,2128,4707,2586,5972
351750,202303,2427,5896,1542,4246,200,588,768,1934,968,2522
351760,202303,4313,10724,3324,8940,578,1827,1564,3689,2142,5516
351770,202303,2692,6476,2209,5645,580,1449,1142,2766,1722,4215
351780,202303,1385,3256,824,2195,107,320,345,841,452,1161
351790,202303,2023,4349,1551,3688,253,596,932,2135,1185,2731
351800,202303,552,1222,290,751,34,97,111,233,145,330
351810,202303,1474,3503,1209,3126,314,927,536,1232,850,2159
351820,202303,4115,9967,3126,8205,620,1805,1229,2763,1849,4568
351830,202303,6726,15296,5178,12829,400,1209,3524,7985,3924,9194
351840,202303,12732,31277,10122,26780,978,2944,6460,15619,7438,18563
351850,202303,1927,5034,1272,3768,200,669,378,864,578,1533
351860,202303,3573,9271,2800,7966,689,2195,1307,3367,1996,5562
351870,202303,37866,86926,29917,74330,5958,15574,14486,34657,20444,50231
351880,202303,232215,507343,185533,433411,25503,71577,119096,252291,144599,323868
351885,202303,1375,3093,1138,2754,50,157,852,1931,902,2088
351890,202303,1042,2515,671,1913,120,386,160,379,280,765
351900,202303,1630,3959,1241,3382,114,317,802,2119,916,2436
351905,202303,807,2113,612,1726,74,230,269,644,343,874
351907,202303,31114,73713,24577,62671,2635,7745,15694,37009,18329,44754
351910,202303,2266,5200,1674,4115,155,454,1006,2118,1161,2572
351920,202303,1166,2785,900,2315,139,402,374,847,513,1249
351925,202303,1306,3149,1040,2710,103,328,607,1439,710,1767
351930,202303,5911,12976,5391,12150,553,1473,4255,9137,4808,10610
351940,202303,1437,3428,1063,2792,193,542,422,1076,615,1618
351950,202303,2128,4158,1634,3492,81,217,1203,2396,1284,2613
351960,202303,7375,16946,5654,14124,1334,3572,2367,5251,3701,8823
351970,202303,14422,33873,12133,30292,1375,4314,8321,19020,9696,23334
351980,202303,1398,3130,906,2320,134,389,412,927,546,1316
351990,202303,1856,4044,1376,3378,62,210,761,1625,823,1835
352000,202303,3604,8853,3100,7889,256,789,2156,5044,2412,5833
352010,202303,3104,7390,2464,6387,700,1851,664,1708,1364,3559
352020,202303,2274,5289,1780,4474,247,735,1008,2268,1255,3003
352030,202303,8332,18605,6769,16203,792,2326,4485,9899,5277,12225
352040,202303,5810,13524,4277,10798,705,1991,1729,3789,2434,5780
352042,202303,4990,10642,3542,8494,382,1032,2332,5345,2714,6377
352044,202303,2627,6501,1591,4586,243,791,361,803,604,1594
352050,202303,17624,43138,12304,33183,3439,9996,2782,5937,6221,15933
352060,202303,1017,2425,770,2010,153,436,358,830,511,1266
352070,202303,1220,2380,829,1868,63,156,486,993,549,1149
352080,202303,579,1385,368,998,45,118,124,276,169,394
352090,202303,2040,5345,1686,4716,200,642,879,2159,1079,2801
352100,202303,5046,12817,3949,10845,674,2132,1779,4433,2453,6565
352110,202303,972,2459,730,1997,150,423,313,744,463,1167
352115,202303,621,1572,508,1418,141,450,239,576,380,1026
352120,202303,1085,2811,852,2371,77,220,535,1360,612,1580
352130,202303,2516,6600,1610,4402,206,591,746,1803,952,2394
352140,202303,1798,4426,1328,3509,261,676,549,1375,810,2051
352150,202303,1114,2664,826,2189,107,310,501,1244,608,1554
352160,202303,1214,2768,874,2218,94,261,429,1024,523,1285
352170,202303,3829,9525,2965,7805,474,1451,1403,3205,1877,4656
352180,202303,3645,9099,2845,7751,584,1704,1143,2841,1727,4545
352190,202303,2201,4988,1763,4333,321,830,935,2230,1256,3060
352200,202303,425,1251,312,1014,45,156,114,333,159,489
352210,202303,32175,64043,26004,55922,1361,3427,21076,43427,22437,46854
352215,202303,795,1940,602,1603,102,300,314,788,416,1088
352220,202303,38241,81250,29648,67653,3666,9769,19124,39214,22790,48983
352230,202303,21005,53865,16618,46201,4170,12807,6398,15351,10568,28158
352240,202303,14088,32716,11001,27876,2079,5916,5942,13477,8021,19393
352250,202303,33486,85464,27804,76278,3610,10891,18061,47234,21671,58125
352260,202303,6799,15728,4869,12060,799,2256,2542,5397,3341,7653
352265,202303,1130,2977,999,2793,176,546,550,1437,726,1983
352270,202303,2663,6875,2139,5852,390,1160,932,2290,1322,3450
352280,202303,3145,6949,2413,5878,344,957,1352,2930,1696,3887
352290,202303,2052,5114,1672,4424,195,585,970,2290,1165,2875
352300,202303,1236,2941,796,2069,84,228,421,990,505,1218
352310,202303,54765,131411,43104,113200,6532,18335,26245,66151,32777,84486
352320,202303,8978,20396,7204,17379,862,2480,4478,9467,5340,11947
352330,202303,3534,7793,2824,6828,267,851,1915,4201,2182,5052
352340,202303,10424,25060,8022,20753,1244,3632,4240,9774,5484,13406
352350,202303,3377,8142,2766,6962,138,410,2027,4838,2165,5248
352360,202303,2037,4724,1644,4068,159,427,1119,2561,1278,2988
352370,202303,1350,3399,1143,3062,51,158,854,2202,905,2360
352380,202303,1263,2958,960,2469,196,534,339,788,535,1322
352390,202303,18803,43209,13814,34460,2035,5863,8117,18265,10152,24128
352400,202303,4914,12787,3839,10782,911,2791,1305,3190,2216,5981
352410,202303,5086,11386,3997,9666,456,1187,2474,5600,2930,6787
352420,202303,1101,2548,762,2005,127,343,295,692,422,1035
352430,202303,12013,25596,9193,21114,1172,3117,5384,11310,6556,14427
352440,202303,26172,64720,20293,54140,4539,12813,7303,18240,11842,31053
352450,202303,1017,2404,585,1670,88,288,241,591,329,879
352460,202303,3505,8754,2611,7222,468,1440,1183,2955,1651,4395
352470,202303,3876,9476,3095,8240,263,840,1995,4846,2258,5686
352480,202303,5981,13051,4121,9884,530,1519,2149,4431,2679,5950
352490,202303,1097,2743,870,2369,173,513,361,921,534,1434
352500,202303,14970,35468,10500,27693,3664,11263,2205,3620,5869,14883
352510,202303,6150,14589,4972,12603,537,1512,3355,7963,3892,9475
352520,202303,3869,9444,3003,8033,524,1595,1616,3843,2140,5438
352530,202303,15848,36788,11386,28925,2244,6515,4258,8751,6502,15266
352540,202303,734,1869,547,1505,71,192,288,721,359,913
352550,202303,1340,3327,897,2553,186,624,329,771,515,1395
352560,202303,861,2048,720,1807,43,145,522,1209,565,1354
352570,202303,2722,7022,1825,5334,418,1420,282,453,700,1873
352580,202303,994,2223,837,1971,108,303,560,1197,668,1500
352585,202303,485,1244,361,1029,37,138,186,453,223,591
352590,202303,16933,41711,12725,34305,2324,7139,6872,16700,9196,23839
352600,202303,2541,6042,2083,5282,231,673,1378,3172,1609,3845
352610,202303,3878,9295,2991,7884,459,1424,1481,3523,1940,4947
352620,202303,7945,17468,6092,14901,1342,3451,2899,6801,4241,10252
352630,202303,1093,2453,830,2099,142,404,404,949,546,1353
352640,202303,4427,10138,3317,8220,284,813,2118,4736,2402,5549
352650,202303,714,1862,469,1361,73,221,177,453,250,674
352660,202303,1452,3719,1193,3253,99,336,790,1954,889,2290
352670,202303,13699,32706,10367,26417,1834,5200,5029,11308,6863,16508
352680,202303,4293,11420,3218,9112,636,2180,1543,3474,2179,5654
352690,202303,35428,81774,28319,70515,1259,3940,20971,49166,22230,53106
352700,202303,1063,2496,809,2083,113,310,405,954,518,1264
352710,202303,7267,17181,5414,14007,1376,4072,2240,5010,3616,9082
352720,202303,13623,30838,11190,26733,1603,4362,6538,14214,8141,18576
352725,202303,665,1466,383,995,17,49,228,530,245,579
352730,202303,5635,15788,5102,14645,645,2106,2492,5954,3137,8060
352740,202303,3091,6916,2345,5842,304,863,1206,2747,1510,3610
352750,202303,522,1221,341,931,39,117,152,361,191,478
352760,202303,2003,5011,1584,4281,201,557,853,2170,1054,2727
352770,202303,1219,2937,858,2295,118,339,449,1106,567,1445
352780,202303,824,2179,574,1664,132,362,163,451,295,813
352790,202303,508,1234,383,996,53,141,160,349,213,490
352800,202303,1680,4609,1196,3577,224,709,225,460,449,1169
352810,202303,1502,3373,1021,2534,186,458,522,1231,708,1689
352820,202303,565,1491,420,1245,88,270,100,252,188,522
352830,202303,689,1650,350,986,32,88,111,276,143,364
352840,202303,5071,13100,4141,11507,939,2857,1821,4741,2760,7598
352850,202303,17883,38009,13422,31332,2351,6264,7530,15690,9881,21954
352860,202303,1509,3823,1140,3167,211,625,421,1080,632,1705
352870,202303,1066,2553,741,1909,82,240,441,1051,523,1291
352880,202303,2146,4766,1527,3717,243,627,626,1319,869,1946
352885,202303,473,1152,367,967,45,148,234,563,279,711
352890,202303,891,1923,608,1394,55,135,401,813,456,948
352900,202303,25724,61135,17975,46826,2889,7903,7334,17502,10223,25405
352910,202303,457,1138,257,749,20,62,103,259,123,321
352920,202303,3648,8425,2823,7067,148,460,2072,4862,2220,5322
352930,202303,7462,17811,5899,14824,884,2630,3025,6521,3909,9151
352940,202303,36513,87747,29698,74774,4270,11938,17968,41794,22238,53732
352950,202303,671,1704,435,1277,83,273,136,328,219,601
352960,202303,940,2343,567,1578,70,212,186,395,256,607
352965,202303,281,740,195,577,41,118,59,161,100,279
352970,202303,5124,9544,4249,8299,116,296,3688,6843,3804,7139
352980,202303,1932,4330,1511,3748,368,959,804,1899,1172,2858
352990,202303,5844,13561,4465,11396,779,2178,2414,5828,3193,8006
353000,202303,552,1377,305,856,40,125,105,243,145,368
353010,202303,3447,7799,2455,6059,423,1169,1179,2592,1602,3761
353020,202303,4179,9999,2626,7029,382,1181,1047,2494,1429,3675
353030,202303,6205,14685,4372,11628,1013,2895,1289,3125,2302,6020
353040,202303,968,2043,723,1675,77,205,486,1027,563,1232
353050,202303,6889,17696,5013,14026,850,2637,2538,6559,3388,9196
353060,202303,67912,153268,56584,136186,3355,10192,43185,97593,46540,107785
353070,202303,14901,37608,11300,30375,1842,5545,5395,12777,7237,18322
353080,202303,6464,15598,4663,12267,924,2745,1980,4360,2904,7105
353090,202303,747,2037,603,1774,58,180,337,943,395,1123
353100,202303,378,921,170,497,32,104,52,112,84,216
353110,202303,10945,25005,8840,22154,1995,5017,4382,11337,6377,16354
353120,202303,642,1502,501,1282,64,217,263,565,327,782
353130,202303,3996,8706,2767,6611,619,1673,1271,2590,1890,4263
353140,202303,4076,8817,3122,7358,361,1065,1987,4252,2348,5317
353150,202303,2222,5111,1656,4214,333,914,705,1656,1038,2570
353160,202303,803,1928,554,1502,70,216,249,570,319,786
353170,202303,854,1994,669,1734,79,230,370,899,449,1129
353180,202303,12571,29156,9940,24755,2301,6305,4420,9929,6721,16234
353190,202303,4578,11049,3589,9194,424,1230,2059,4749,2483,5979
353200,202303,2243,5606,1472,4149,197,646,579,1411,776,2057
353205,202303,609,1588,514,1390,42,141,297,694,339,835
353210,202303,1218,2383,798,1725,28,74,611,1218,639,1292
353215,202303,499,1235,395,1059,52,159,177,420,229,579
353220,202303,967,2501,678,1936,109,304,213,537,322,841
353230,202303,1084,2760,845,2381,206,666,208,522,414,1188
353240,202303,3300,7794,2768,7006,370,1065,1668,3945,2038,5010
353250,202303,1774,3609,1258,2829,158,385,767,1638,925,2023
353260,202303,1389,2998,791,2045,165,481,318,716,483,1197
353270,202303,1087,2463,880,2119,99,291,544,1156,643,1447
353280,202303,945,2305,705,1931,141,399,253,665,394,1064
353282,202303,2156,5525,1774,4844,155,500,1080,2706,1235,3206
353284,202303,456,1037,259,681,18,53,109,232,127,285
353286,202303,206,502,119,349,23,67,31,65,54,132
353290,202303,1575,3906,936,2632,177,471,250,639,427,1110
353300,202303,2843,6915,2107,5581,341,1034,969,2138,1310,3172
353310,202303,520,1158,394,962,29,94,258,556,287,650
353320,202303,839,2045,688,1814,47,159,428,1021,475,1180
353325,202303,1017,2608,740,2069,121,342,336,852,457,1194
353330,202303,825,1877,536,1380,78,217,263,585,341,802
353340,202303,4500,11227,3569,9516,569,1761,1917,4548,2486,6309
353350,202303,5799,13016,4311,10482,1036,2729,1330,2758,2366,5487
353360,202303,896,2278,744,2009,73,257,471,1165,544,1422
353370,202303,758,1988,630,1789,55,172,395,1080,450,1252
353380,202303,385,976,309,846,38,129,175,419,213,548
353390,202303,8502,19497,6418,16188,554,1639,3934,9099,4488,10738
353400,202303,735,1781,572,1505,102,317,248,488,350,805
353410,202303,683,1638,510,1324,137,388,225,497,362,885
353420,202303,612,1461,433,1128,63,170,111,234,174,404
353430,202303,3025,7609,2432,6585,482,1379,1117,2809,1599,4188
353440,202303,104647,249911,80278,203587,10220,29624,49251,112974,59471,142598
353450,202303,493,1135,352,911,45,139,174,394,219,533
353460,202303,4260,10616,3055,8356,610,1912,719,1565,1329,3477
353470,202303,12190,28993,9094,23528,1498,4378,4213,9540,5711,13918
353475,202303,2072,4760,1413,3594,159,470,722,1567,881,2037
353480,202303,2096,4805,1749,4309,106,326,1258,2891,1364,3217
353490,202303,1385,3307,1040,2718,132,361,529,1249,661,1610
353500,202303,1589,3548,1170,2887,251,684,589,1315,840,1999
353510,202303,1294,3365,961,2653,169,495,374,856,543,1351
353520,202303,1376,3306,899,2481,135,415,371,852,506,1267
353530,202303,3361,7743,2737,6709,307,884,1704,3764,2011,4648
353540,202303,2822,6796,2324,6066,389,1096,1338,3272,1727,4368
353550,202303,8254,18421,6649,15888,992,2562,4025,8861,5017,11423
353560,202303,3027,7384,2400,6483,668,1960,855,1984,1523,3944
353570,202303,819,2052,537,1522,89,279,204,497,293,776
353580,202303,3192,7605,2548,6479,453,1131,1400,3402,1853,4533
353590,202303,955,2228,713,1847,103,267,390,953,493,1220
353600,202303,1982,4709,1455,3815,189,545,720,1768,909,2313
353610,202303,1048,2764,807,2295,118,365,366,938,484,1303
353620,202303,3874,9119,2819,7470,610,1740,891,1995,1501,3735
353625,202303,793,1820,462,1236,54,182,248,594,302,776
353630,202303,2063,5448,1771,4902,246,754,995,2470,1241,3224
353640,202303,1828,4287,1411,3585,182,471,899,2145,1081,2616
353650,202303,9395,23486,7428,20114,997,2971,4119,10230,5116,13201
353657,202303,465,1158,358,990,33,109,160,398,193,507
353660,202303,1763,3356,1266,2720,168,409,872,1764,1040,2173
353670,202303,5794,14392,4543,12099,815,2535,2161,5017,2976,7552
353680,202303,944,2197,704,1863,103,300,404,981,507,1281
353690,202303,569,1452,273,810,30,87,71,174,101,261
353700,202303,2892,6635,2375,5853,226,595,1596,3742,1822,4337
353710,202303,5300,11470,4082,9522,660,1549,2243,4561,2903,6110
353715,202303,527,1324,313,894,26,85,133,331,159,416
353720,202303,2553,6068,1978,5197,383,1114,892,2202,1275,3316
353730,202303,6746,15782,5341,13411,694,2078,3235,7362,3929,9440
353740,202303,2846,6758,2109,5496,387,1110,959,2206,1346,3316
353750,202303,1172,3236,883,2710,211,659,211,603,422,1262
353760,202303,19984,39609,15705,34203,2785,6719,9059,18766,11844,25485
353770,202303,797,2139,456,1427,62,230,60,144,122,374
353780,202303,9216,21516,7635,18813,1255,3495,4400,9981,5655,13476
353790,202303,3763,10240,2856,8472,639,2099,634,1503,1273,3602
353800,202303,24855,58565,20402,51868,2879,7740,12180,29330,15059,37070
353810,202303,1563,3782,1119,2915,188,512,458,1105,646,1617
353820,202303,2360,5775,1679,4539,451,1235,457,1056,908,2291
353830,202303,783,1817,593,1534,86,256,310,720,396,976
353850,202303,2083,5094,1617,4285,293,807,717,1726,1010,2533
353860,202303,3634,8764,2806,7418,642,1993,1327,2948,1969,4941
353870,202303,39603,94788,29304,76070,4084,11677,14486,33339,18570,45016
353880,202303,3945,9688,3213,8372,227,723,2110,5020,2337,5743
353890,202303,4232,8042,2980,6222,202,525,2115,3921,2317,4446
353900,202303,961,2467,720,2018,86,275,299,744,385,1019
353910,202303,4204,9736,3609,8867,255,745,2678,6326,2933,7071
353920,202303,2582,6438,1897,5217,545,1663,444,912,989,2575
353930,202303,7267,17222,5301,13592,959,2762,2353,5213,3312,7975
353940,202303,1719,4532,1237,3596,198,629,477,1211,675,1840
353950,202303,4581,11073,3541,9254,917,2639,1146,2606,2063,5245
353960,202303,965,2363,674,1848,167,436,147,377,314,813
353970,202303,886,1832,697,1567,65,180,518,1087,583,1267
353980,202303,23208,51311,18280,43459,771,2402,14115,31274,14886,33676
353990,202303,1276,2776,911,2193,167,431,509,1119,676,1550
354000,202303,3333,7558,1979,5092,329,893,739,1652,1068,2545
354010,202303,430,1038,328,879,52,171,189,464,241,635
354020,202303,5326,12557,4267,10648,806,2236,2013,4373,2819,6609
354025,202303,933,2371,624,1784,96,308,174,414,270,722
354030,202303,675,1423,368,918,58,154,170,380,228,534
354040,202303,1020,2137,696,1664,44,136,489,1065,533,1201
354050,202303,1372,3560,977,2894,185,625,379,1032,564,1657
354060,202303,5525,13694,4141,10890,629,1882,2148,4875,2777,6757
354070,202303,5388,12513,3825,9612,603,1688,1785,3856,2388,5544
354075,202303,3785,9415,3096,8288,505,1510,1807,4395,2312,5905
354080,202303,1912,4896,1349,3847,186,571,619,1561,805,2132
354085,202303,532,991,415,846,1,4,310,574,311,578
354090,202303,2274,5634,1958,5010,110,318,1513,3671,1623,3989
354100,202303,32658,80018,24235,66272,4585,13770,11663,29501,16248,43271
354105,202303,1479,3496,1113,2889,158,499,571,1284,729,1783
354110,202303,598,1531,470,1311,84,267,204,523,288,790
354120,202303,1881,4691,1275,3452,243,712,455,1020,698,1732
354130,202303,7869,18737,5478,14300,1489,4035,1241,2652,2730,6687
354140,202303,24700,57382,18595,46409,2564,7244,9920,21842,12484,29086
354150,202303,3714,8207,2949,7068,744,1847,931,2157,1675,4004
354160,202303,3712,9573,3042,8405,717,2132,1301,3292,2018,5424
354165,202303,944,2454,751,2095,82,309,465,1141,547,1450
354170,202303,2585,6429,2101,5587,295,912,1065,2434,1360,3346
354180,202303,577,1470,452,1228,41,127,256,627,297,754
354190,202303,1990,5124,1440,4054,97,331,792,2042,889,2373
354200,202303,1187,2655,895,2199,92,266,563,1249,655,1515
354210,202303,1388,3285,1102,2816,101,313,704,1612,805,1925
354220,202303,4092,9814,3096,8014,580,1635,1405,3309,1985,4944
354230,202303,1039,2325,843,2086,43,131,629,1497,672,1628
354240,202303,2414,6163,1691,4717,303,883,634,1496,937,2379
354250,202303,830,1948,572,1529,133,344,203,497,336,841
354260,202303,11884,27023,9349,22981,1360,3666,4791,10951,6151,14617
354270,202303,1298,3435,1072,3034,163,491,522,1313,685,1804
354280,202303,1039,2288,857,2016,42,128,635,1343,677,1471
354290,202303,1243,3509,1034,3100,148,486,573,1634,721,2120
354300,202303,4347,11505,3657,10300,919,2616,1702,4584,2621,7200
354310,202303,1043,2643,895,2408,139,421,531,1318,670,1739
354320,202303,1234,2739,824,2098,127,339,389,823,516,1162
354323,202303,599,1329,388,970,47,127,194,429,241,556
354325,202303,1690,4774,1057,3296,185,580,165,448,350,1028
354330,202303,13226,30093,9682,23528,1095,3063,5948,13055,7043,16118
354340,202303,54876,125589,41295,103295,5832,16204,23656,55329,29488,71533
354350,202303,1529,3438,1229,2968,138,443,806,1707,944,2150
354360,202303,825,1816,520,1357,121,318,175,410,296,728
354370,202303,1286,3266,1064,2934,158,473,626,1617,784,2090
354380,202303,673,1650,499,1379,70,242,194,453,264,695
354390,202303,20514,45187,14580,35338,2054,5531,8007,17514,10061,23045
354400,202303,2087,6097,1639,5128,279,927,527,1523,806,2450
354410,202303,9424,21372,7441,18008,1082,3005,4360,9542,5442,12547
354420,202303,1854,4459,1326,3480,178,524,682,1576,860,2100
354425,202303,3754,8260,2772,6648,490,1236,1485,3348,1975,4584
354430,202303,2281,5273,1772,4499,144,438,1153,2689,1297,3127
354440,202303,765,1812,515,1339,59,171,268,610,327,781
354450,202303,624,1572,348,1046,48,156,111,259,159,415
354460,202303,1034,2480,691,1900,170,511,202,471,372,982
354470,202303,514,1275,342,944,28,100,125,265,153,365
354480,202303,1746,3668,1200,2798,90,253,787,1677,877,1930
354490,202303,1041,2794,792,2282,157,452,355,935,512,1387
354500,202303,3016,7482,2401,6496,629,1852,833,2019,1462,3871
354510,202303,974,2470,774,2123,84,270,424,1018,508,1288
354515,202303,569,1492,390,1128,69,211,131,339,200,550
354520,202303,10946,26826,8193,21418,1020,3076,4712,11009,5732,14085
354530,202303,6876,16875,5547,14516,1407,3684,2141,5251,3548,8935
354540,202303,1645,3953,1204,3205,205,600,539,1319,744,1919
354550,202303,739,1873,590,1607,77,231,300,728,377,959
354560,202303,2729,6105,1533,3969,168,459,885,2064,1053,2523
354570,202303,1166,2768,534,1505,96,273,82,213,178,486
354580,202303,10902,27264,7768,21415,1110,3446,4214,10627,5324,14073
354600,202303,2680,6552,2087,5471,325,860,1157,2876,1482,3736
354610,202303,580,1444,317,911,32,97,144,374,176,471
354620,202303,627,1648,392,1196,32,113,179,501,211,614
354625,202303,384,1010,229,713,29,100,69,187,98,287
354630,202303,3189,8191,2704,7347,792,2210,797,1946,1589,4156
354640,202303,5140,12778,4057,10753,475,1507,2232,5246,2707,6753
354650,202303,1131,2685,921,2353,206,479,443,1090,649,1569
354660,202303,4603,10091,2747,7199,348,1074,1214,2819,1562,3893
354670,202303,1520,3826,1092,2994,224,685,367,821,591,1506
354680,202303,8525,19204,6851,16638,1061,2844,4098,9387,5159,12231
354690,202303,683,1920,498,1534,79,249,194,535,273,784
354700,202303,1162,2791,845,2200,103,303,472,1115,575,1418
354710,202303,607,1486,406,1103,42,120,193,452,235,572
354720,202303,397,880,201,524,65,161,57,138,122,299
354730,202303,15065,39077,11998,33526,1676,5141,7026,18379,8702,23520
354740,202303,406,1048,187,562,35,109,26,56,61,165
354750,202303,3099,7454,2158,5693,329,985,944,2116,1273,3101
354760,202303,2914,7028,2161,5740,436,1263,804,1850,1240,3113
354765,202303,437,1102,203,602,18,68,70,164,88,232
354770,202303,3251,7395,2423,5951,473,1269,1108,2432,1581,3701
354780,202303,86366,190224,68235,157348,4505,12811,49298,103489,53803,116300
354790,202303,1177,2978,924,2584,78,238,574,1528,652,1766
354800,202303,3613,8509,2685,6976,582,1636,1051,2386,1633,4022
354805,202303,1860,3973,1397,3329,108,284,960,2063,1068,2347
354810,202303,712,1973,440,1415,79,300,127,342,206,642
354820,202303,1225,3263,885,2630,174,558,267,641,441,1199
354830,202303,696,1563,401,1032,80,229,148,303,228,532
354840,202303,1085,2639,661,1756,53,165,364,851,417,1016
354850,202303,30618,68953,22826,56188,1955,5886,15541,34944,17496,40830
354860,202303,1922,4819,1329,3703,181,558,562,1381,743,1939
354870,202303,93007,208434,73892,175448,5630,15884,51162,111192,56792,127076
354880,202303,8279,19221,4797,12183,581,1684,2257,4541,2838,6225
354890,202303,24886,55777,20120,47840,2438,6836,11988,26360,14426,33196
354900,202303,466,1103,313,851,73,216,109,246,182,462
354910,202303,8024,19516,5143,14506,1082,3271,1486,3586,2568,6857
354920,202303,612,1549,326,978,39,128,85,199,124,327
354925,202303,356,961,206,648,22,67,42,116,64,183
354930,202303,453,1058,314,814,35,94,166,383,201,477
354940,202303,3463,9221,2694,7630,739,2255,1020,2446,1759,4701
354950,202303,2059,4595,1704,4146,107,348,1240,2793,1347,3141
354960,202303,1067,2606,766,2126,86,304,363,878,449,1182
354970,202303,5787,14265,4643,12452,361,1236,3231,8110,3592,9346
354980,202303,47978,104957,34538,82808,3632,10573,22567,48895,26199,59468
354990,202303,106532,237084,78974,189937,5133,15386,54816,119984,59949,135370
354995,202303,4521,8459,3566,7258,156,382,2913,5670,3069,6052
355000,202303,1980,4486,1505,3801,237,721,770,1701,1007,2422
355010,202303,5335,13209,3658,9819,1167,3049,830,2108,1997,5157
355020,202303,4090,10932,3285,9594,766,2506,1293,3338,2059,5844
355030,202303,1838215,4146132,1402025,3363629,187365,501973,789360,1711717,976725,2213690
355040,202303,4751,10183,3766,8897,372,977,2792,6333,3164,7310
355050,202303,1435,3018,1063,2517,267,651,394,861,661,1512
355060,202303,9157,22288,7013,18556,1069,3236,3846,9197,4915,12433
355070,202303,14424,32586,12065,29016,1334,3772,8002,17692,9336,21464
355080,202303,1273,3331,828,2541,181,586,138,349,319,935
355090,202303,1808,4451,1468,3895,258,748,775,1850,1033,2598
355100,202303,41834,94324,35207,84766,3622,9968,25228,57416,28850,67384
355110,202303,1289,3246,928,2729,178,546,70,158,248,704
355120,202303,933,2258,656,1856,83,273,320,828,403,1101
355130,202303,1088,2194,645,1428,26,72,467,918,493,990
355140,202303,3024,5535,2615,4997,79,198,2308,4253,2387,4451
355150,202303,6604,15214,5426,13300,598,1633,3532,8141,4130,9774
355160,202303,3149,7790,2272,6333,492,1467,686,1684,1178,3151
355170,202303,16309,36996,13018,31745,2050,5631,7490,16977,9540,22608
355180,202303,3732,8556,2811,7205,539,1617,1437,3305,1976,4922
355190,202303,2425,5912,1920,5131,750,2091,518,1470,1268,3561
355200,202303,1146,3154,975,2892,276,943,335,905,611,1848
355210,202303,4274,10485,3303,8574,814,2158,1318,3171,2132,5329
355220,202303,72590,169857,59874,147192,7714,21834,35629,78808,43343,100642
355230,202303,1557,3698,867,2345,148,431,330,733,478,1164
355240,202303,32877,79865,24327,64145,2562,7621,14849,36112,17411,43733
355250,202303,55520,132037,43403,110030,8863,24327,21761,50182,30624,74509
355255,202303,815,1914,439,1244,48,134,155,397,203,531
355260,202303,2063,4349,1538,3574,116,343,1084,2303,1200,2646
355270,202303,1624,4302,1313,3724,328,931,524,1381,852,2312
355280,202303,44328,100926,33377,82122,3915,10724,19522,44071,23437,54795
355290,202303,1226,2972,971,2576,192,501,477,1171,669,1672
355300,202303,1853,4858,1536,4288,258,767,693,1700,951,2467
355310,202303,1189,2935,892,2432,120,352,488,1253,608,1605
355320,202303,731,1797,549,1464,114,354,218,470,332,824
355330,202303,3998,9153,3168,7772,144,447,2411,5524,2555,5971
355340,202303,5354,11082,4116,9504,788,1876,1923,4552,2711,6428
355350,202303,1837,4633,1420,3889,256,808,637,1531,893,2339
355360,202303,1678,3858,1308,3303,162,445,742,1677,904,2122
355365,202303,454,1056,246,710,40,112,77,195,117,307
355370,202303,7499,17263,5947,14917,1287,2930,2831,7309,4118,10239
355380,202303,3910,9460,3003,7874,568,1628,1156,2576,1724,4204
355385,202303,1795,4226,1467,3748,118,371,948,2188,1066,2559
355390,202303,1027,2604,760,2082,110,336,366,863,476,1199
355395,202303,2284,6099,1663,4883,270,897,666,1674,936,2571
355400,202303,12830,33201,10521,28946,2232,6975,4490,10820,6722,17795
355410,202303,32871,82428,22753,62659,4274,13028,8932,22202,13206,35230
355420,202303,769,2245,637,2005,127,459,207,593,334,1052
355430,202303,4865,11215,3830,9464,610,1671,2123,4929,2733,6600
355440,202303,934,2319,596,1674,94,268,141,334,235,602
355450,202303,4806,11331,3401,8766,451,1306,1703,3809,2154,5115
355460,202303,621,1448,427,1130,41,124,194,473,235,597
355465,202303,547,1295,442,1135,62,157,277,693,339,850
355470,202303,1509,3529,893,2374,225,662,317,738,542,1400
355475,202303,432,939,354,837,18,49,262,582,280,631
355480,202303,5539,13985,4413,12277,631,2007,2727,7228,3358,9235
355490,202303,1138,2868,660,1933,72,226,295,772,367,998
355495,202303,1213,2952,894,2440,116,394,419,978,535,1372
355500,202303,9375,21816,6387,16407,825,2455,3026,6709,3851,9164
355510,202303,1763,4091,1201,3138,192,522,535,1240,727,1762
355520,202303,385,879,191,544,36,113,35,91,71,204
355530,202303,379,814,168,426,10,31,94,210,104,241
355535,202303,679,1707,545,1493,115,374,265,610,380,984
355540,202303,17832,38603,15127,34996,1524,3927,10987,24297,12511,28224
355550,202303,863,2307,745,2112,88,286,432,1095,520,1381
355560,202303,1411,3461,816,2330,165,522,34,101,199,623
355570,202303,375,916,212,584,46,137,69,163,115,300
355580,202303,1534,3503,905,2385,164,465,201,469,365,934
355590,202303,214,518,159,433,17,48,87,223,104,271
355600,202303,1685,3984,1111,2963,168,497,305,708,473,1205
355610,202303,2607,5925,1797,4558,285,782,972,2216,1257,2998
355620,202303,6736,16299,5270,13663,545,1731,3143,7249,3688,8980
355630,202303,3417,8278,2489,6598,282,820,1504,3623,1786,4443
355635,202303,1279,3376,933,2712,137,423,338,864,475,1287
355640,202303,4514,11576,3065,8867,747,2162,506,1454,1253,3616
355645,202303,4875,12536,3598,10303,515,1633,1921,5133,2436,6766
355650,202303,10560,25433,8657,22236,1653,4502,4427,10395,6080,14897
355660,202303,1726,4233,1146,3234,194,497,195,481,389,978
355670,202303,5855,14177,4312,11067,535,1677,2233,4820,2768,6497
355680,202303,3448,8940,1802,5361,464,1494,135,350,599,1844
355690,202303,909,2478,631,1964,196,633,13,22,209,655
355695,202303,336,860,213,612,16,49,45,86,61,135
355700,202303,11521,28786,9815,25452,1163,3462,6080,14456,7243,17918
355710,202303,13520,29678,9537,22574,1262,3521,5107,10268,6369,13789
355715,202303,591,1524,344,982,89,259,74,187,163,446
355720,202303,1895,4676,1500,4033,248,742,803,1956,1051,2698
355730,202303,1401,3412,1131,2982,98,299,667,1605,765,1904
410010,202303,1530,3983,1153,3220,242,705,272,665,514,1370
410020,202303,1407,3682,1039,2943,299,835,252,647,551,1482
410030,202303,2181,5230,1821,4708,262,714,949,2399,1211,3113
410040,202303,19209,48020,14370,39436,2977,8734,4644,11403,7621,20137
410045,202303,884,2268,658,1809,134,391,178,415,312,806
410050,202303,2748,6668,1976,5402,328,1008,665,1615,993,2623
410060,202303,2580,6720,2072,5838,529,1649,574,1423,1103,3072
410070,202303,2462,5774,1797,4630,335,959,699,1548,1034,2507
410080,202303,1693,4220,1233,3455,268,768,268,669,536,1437
410090,202303,1425,3135,1150,2756,159,343,522,1364,681,1707
410100,202303,2650,6974,1824,5226,301,946,136,349,437,1295
410105,202303,704,1590,476,1188,26,82,276,589,302,671
410110,202303,3887,8842,2889,7182,352,1012,1578,3519,1930,4531
410115,202303,681,1665,492,1339,60,185,186,425,246,610
410120,202303,4133,9639,3611,8866,600,1421,2312,5575,2912,6996
410130,202303,1660,3952,1461,3623,189,495,894,2133,1083,2628
410140,202303,22304,50614,15177,38543,2765,7744,5031,11250,7796,18994
410150,202303,20732,46514,11745,29966,1877,5311,3950,8363,5827,13674
410160,202303,3726,9759,3034,8583,672,2184,1081,2770,1753,4954
410165,202303,758,1923,592,1587,85,257,293,716,378,973
410170,202303,3681,8872,2267,6002,397,1129,410,870,807,1999
410180,202303,22522,57167,17716,48021,2945,8831,8588,20531,11533,29362
410185,202303,573,1532,429,1205,78,236,158,379,236,615
410190,202303,2792,6551,1984,5161,394,1048,492,1075,886,2123
410200,202303,7250,15481,4111,10377,824,2226,802,1727,1626,3953
410210,202303,3878,9228,2435,6721,362,1133,810,1842,1172,2975
410220,202303,734,1806,468,1266,93,263,163,383,256,646
410230,202303,2513,6230,1903,5060,295,874,790,1761,1085,2635
410240,202303,6321,15672,4441,12286,871,2818,721,1638,1592,4456
410250,202303,2853,6470,2090,5288,262,672,940,2253,1202,2925
410260,202303,2527,5721,1626,4129,319,862,808,1811,1127,2673
410270,202303,617,1515,446,1215,58,183,189,434,247,617
410275,202303,733,1896,508,1434,84,277,203,498,287,775
410280,202303,2905,7123,1997,5449,263,824,879,2074,1142,2898
410290,202303,3999,10295,2803,7957,940,2623,667,1838,1607,4461
410300,202303,858,1962,680,1697,68,204,362,778,430,982
410302,202303,416,994,257,719,30,98,111,283,141,381
410304,202303,1854,4029,1573,3600,176,428,938,2121,1114,2549
410305,202303,2155,4758,1527,3870,178,505,966,2283,1144,2788
410310,202303,4001,9227,3304,8087,259,826,2243,5044,2502,5870
410315,202303,931,1976,603,1481,158,403,197,457,355,860
410320,202303,1182,3148,794,2408,95,314,120,312,215,626
410322,202303,785,2001,397,1127,56,168,124,274,180,442
410330,202303,1834,4196,1287,3244,216,550,424,939,640,1489
410335,202303,1037,2573,776,2115,139,396,264,634,403,1030
410337,202303,973,2308,680,1762,88,245,243,535,331,780
410340,202303,557,1461,381,1053,24,79,160,337,184,416
410345,202303,3422,8385,2176,5902,509,1405,784,1870,1293,3275
410347,202303,954,2304,714,1905,107,289,189,474,296,763
410350,202303,2056,4674,1472,3775,140,421,832,1858,972,2279
410360,202303,4926,11723,3640,9537,663,1836,1100,2652,1763,4488
410370,202303,18308,45901,12173,32153,1373,4163,5288,11442,6661,15605
410380,202303,2216,5011,1514,3829,206,579,531,1175,737,1754
410390,202303,3640,8028,2472,6192,503,1533,1017,2095,1520,3628
410395,202303,1118,2945,875,2485,185,524,307,887,492,1411
410400,202303,10200,23166,7886,19228,844,2401,4996,10956,5840,13357
410405,202303,1126,2454,782,1969,108,306,392,896,500,1202
410410,202303,1992,4694,1736,4290,132,378,1154,2794,1286,3172
410420,202303,15862,38763,12116,31905,1961,5692,5543,12797,7504,18489
410425,202303,4767,12002,3340,9249,590,1738,1205,2931,1795,4669
410430,202303,17030,39382,12210,31162,1847,5246,4920,11101,6767,16347
410440,202303,3043,7829,2642,7126,400,1216,1472,3692,1872,4908
410442,202303,3080,8292,2450,7055,675,2028,574,1545,1249,3573
410445,202303,2797,7375,1919,5715,412,1340,249,770,661,2110
410450,202303,1951,4534,1450,3792,255,692,472,1134,727,1826
410460,202303,3160,7162,2276,5699,333,949,1120,2426,1453,3375
410465,202303,3758,9911,2870,8311,604,1785,855,2094,1459,3879
410470,202303,3024,7671,2163,6242,674,2186,170,465,844,2651
410480,202303,51604,116635,30571,81640,4342,13087,9395,20807,13737,33894
410490,202303,15014,37726,11047,30020,1764,5245,5067,12154,6831,17399
410500,202303,2282,5478,1498,4052,280,771,315,644,595,1415
410510,202303,2293,5297,1616,4171,344,874,501,1233,845,2107
410520,202303,3810,10661,3382,9915,1076,3367,1258,3546,2334,6913
410530,202303,1911,4464,944,2543,124,382,256,524,380,906
410540,202303,3518,8723,2488,6793,411,1280,1077,2588,1488,3868
410550,202303,9774,24399,6844,18508,1124,3400,2087,4575,3211,7975
410560,202303,1901,4579,1400,3637,295,865,387,800,682,1665
410570,202303,3412,8352,2398,6647,828,2666,238,586,1066,3252
410580,202303,37612,88236,28723,73003,4244,12184,15000,34377,19244,46561
410590,202303,2105,5439,1440,3970,183,529,417,907,600,1436
410600,202303,2285,5452,1793,4575,360,934,700,1678,1060,2612
410610,202303,864,2043,645,1663,60,175,328,742,388,917
410620,202303,3620,8930,2611,6899,642,1831,725,1630,1367,3461
410630,202303,3144,7564,2125,5687,420,1328,465,908,885,2236
410640,202303,6498,14156,4519,10867,974,2572,740,1713,1714,4285
410645,202303,1775,4027,1495,3695,132,364,1176,2858,1308,3222
410650,202303,3213,8036,2220,6094,446,1330,898,2133,1344,3463
410655,202303,1054,2412,723,1859,98,301,284,610,382,911
410657,202303,745,1881,483,1352,61,190,204,458,265,648
410660,202303,4717,10913,2929,7392,449,1249,1067,2268,1516,3517
410670,202303,1223,2901,751,2018,117,322,273,615,390,937
410680,202303,2943,8195,2015,6015,493,1484,426,1228,919,2712
410685,202303,649,1559,463,1235,98,295,197,461,295,756
410690,202303,180274,408652,128239,317295,19540,55295,57031,121069,76571,176364
410700,202303,3058,7296,2500,6466,579,1555,903,2123,1482,3678
410710,202303,1119,2651,720,1926,183,537,271,604,454,1141
410712,202303,831,2115,695,1875,106,298,373,963,479,1261
410715,202303,1079,2851,680,2026,70,230,291,783,361,1013
410720,202303,4896,11223,4040,9866,557,1687,1512,3373,2069,5060
410725,202303,1468,3348,906,2386,191,550,199,409,390,959
410730,202303,1066,2532,719,1895,98,312,165,410,263,722
410740,202303,1035,2738,793,2298,57,197,421,1185,478,1382
410750,202303,2480,5567,1937,4667,313,786,893,1968,1206,2754
410752,202303,493,1139,261,708,97,249,53,126,150,375
410753,202303,418,1115,297,876,35,117,92,225,127,342
410754,202303,1424,3270,1168,2904,86,218,842,2108,928,2326
410755,202303,685,1633,502,1326,60,176,237,536,297,712
410760,202303,4432,10882,3121,8577,831,2713,773,1895,1604,4608
410765,202303,23595,58458,18840,50104,3747,11103,6374,14215,10121,25318
410770,202303,1255,2810,858,2175,82,182,423,1036,505,1218
410773,202303,1651,3898,1405,3506,220,606,840,1929,1060,2535
410775,202303,2094,4287,1837,3953,44,114,1441,2918,1485,3032
410780,202303,774,1807,528,1377,90,248,162,381,252,629
410785,202303,994,2228,713,1794,109,323,310,721,419,1044
410790,202303,1347,3622,1097,3177,221,710,160,362,381,1072
410800,202303,4315,8508,3458,7338,65,186,2405,4789,2470,4975
410810,202303,557,1384,410,1120,43,153,210,495,253,648
410820,202303,1267,3302,727,2007,154,445,147,303,301,748
410830,202303,58482,126862,42593,101474,6377,17720,21565,45633,27942,63353
410832,202303,1394,3413,1140,2994,98,323,715,1688,813,2011
410840,202303,11448,26849,6791,18230,1292,3936,1862,3724,3154,7660
410845,202303,1506,3198,1193,2775,130,353,752,1596,882,1949
410850,202303,2670,6817,2283,6167,441,1356,1066,2613,1507,3969
410855,202303,860,2030,549,1445,60,184,260,564,320,748
410860,202303,6171,13266,4910,11283,209,663,3502,7313,3711,7976
410865,202303,1796,4648,1523,4181,209,616,834,2340,1043,2956
410870,202303,1465,3611,1160,3094,149,447,639,1602,788,2049
410880,202303,5986,14756,4097,11467,712,1955,682,1932,1394,3887
410890,202303,1466,3650,1177,3133,225,587,544,1353,769,1940
410895,202303,1230,3575,1013,3117,341,1178,239,620,580,1798
410900,202303,1043,2610,689,1987,102,309,139,283,241,592
410910,202303,533,1155,340,817,16,45,196,413,212,458
410920,202303,1160,2541,873,2110,98,276,489,1093,587,1369
410930,202303,2187,5187,1502,4083,370,1127,250,557,620,1684
410940,202303,32007,78998,23674,64782,4602,14180,9528,23363,14130,37543
410950,202303,2493,6267,2216,5848,206,503,1652,4284,1858,4787
410960,202303,11073,24477,7846,19490,2118,6142,2991,6512,5109,12654
410965,202303,1390,3324,868,2363,112,341,372,900,484,1241
410970,202303,5434,13612,3838,10575,929,3033,691,1430,1620,4463
410975,202303,1856,4084,1334,3260,210,561,563,1267,773,1828
410980,202303,9606,22054,6357,16502,662,1978,3174,7202,3836,9180
410990,202303,1903,4130,1317,3280,229,648,629,1466,858,2114
411000,202303,837,2149,590,1708,109,348,175,426,284,774
411005,202303,575,1349,363,948,41,110,143,314,184,424
411007,202303,3178,7763,2348,6371,468,1404,815,1948,1283,3352
411010,202303,5876,15501,4422,12721,1214,3618,823,1972,2037,5590
411020,202303,2934,7506,2402,6661,629,1871,729,1877,1358,3748
411030,202303,857,2025,607,1554,77,204,254,563,331,767
411040,202303,1263,3006,665,1794,124,340,181,412,305,752
411050,202303,2468,7153,1957,6157,407,1432,332,821,739,2253
411060,202303,2859,7006,1867,5072,312,907,621,1356,933,2263
411065,202303,471,1136,287,773,33,103,111,265,144,368
411070,202303,9961,22631,7869,19339,1112,3202,4267,9466,5379,12668
411080,202303,2509,6071,2000,5218,471,1411,618,1415,1089,2826
411090,202303,965,2475,592,1737,84,286,142,333,226,619
411095,202303,2982,6700,1744,4606,249,647,277,592,526,1239
411100,202303,1517,3635,1010,2731,135,449,364,892,499,1341
411110,202303,796,1997,374,1120,38,103,27,43,65,146
411120,202303,2088,5007,1672,4341,270,854,819,1864,1089,2718
411125,202303,6808,17948,5973,16543,1673,4847,2184,5964,3857,10811
411130,202303,920,2257,632,1715,175,465,175,476,350,941
411140,202303,2671,7602,2172,6582,524,1654,587,1784,1111,3438
411150,202303,5051,11936,3347,8674,696,1924,320,630,1016,2554
411155,202303,1373,3115,944,2371,122,370,487,988,609,1358
411160,202303,468,1000,307,754,36,96,88,211,124,307
411170,202303,993,2623,735,2106,143,457,314,838,457,1295
411180,202303,6729,15787,5518,13716,754,2173,3115,6908,3869,9081
411190,202303,2727,6496,2085,5408,274,791,966,2177,1240,2968
411200,202303,6422,15736,4912,13137,941,2977,1682,3598,2623,6575
411210,202303,4506,9480,3215,7386,388,1061,1509,3056,1897,4117
411220,202303,1232,2867,854,2219,160,445,305,697,465,1142
411230,202303,1043,2600,773,2094,160,460,235,562,395,1022
411240,202303,1942,4286,1378,3407,253,682,486,1073,739,1755
411250,202303,2855,6925,2053,5564,440,1340,575,1345,1015,2685
411260,202303,402,977,264,712,45,151,111,251,156,402
411270,202303,2479,6127,1836,4945,277,824,849,1996,1126,2820
411275,202303,2065,4199,1481,3322,147,417,927,1830,1074,2247
411280,202303,1892,4695,1375,3753,294,861,450,1056,744,1917
411290,202303,1046,2494,691,1828,74,244,362,865,436,1109
411295,202303,1581,3796,1169,3069,213,568,493,1171,706,1739
411300,202303,1237,2952,780,2112,87,254,282,590,369,844
411310,202303,1205,2454,934,2106,166,417,497,1013,663,1430
411320,202303,7437,17044,5660,14059,782,2204,2842,6030,3624,8234
411325,202303,1875,4685,1521,4066,273,752,816,2203,1089,2955
411330,202303,4009,9981,3004,8311,722,2222,863,2182,1585,4404
411340,202303,1010,2590,596,1734,86,260,176,435,262,695
411342,202303,1302,2977,702,1815,131,394,264,540,395,934
411345,202303,1520,3492,1103,2788,67,178,737,1781,804,1959
411350,202303,3727,9326,2463,6898,617,1879,340,771,957,2650
411360,202303,945,2093,676,1659,92,268,321,670,413,938
411370,202303,74529,171797,55129,140299,4316,13148,32406,74218,36722,87366
411373,202303,1784,4114,1399,3559,161,420,661,1689,822,2109
411375,202303,1365,3223,929,2435,109,302,359,823,468,1125
411380,202303,1430,3073,966,2236,39,109,636,1326,675,1435
411390,202303,1948,4813,1510,3936,233,703,638,1345,871,2048
411400,202303,2939,6586,2225,5388,245,687,1222,2656,1467,3343
411410,202303,3715,9686,2767,7743,647,2007,686,1609,1333,3616
411420,202303,5257,12172,2873,7913,392,1192,525,997,917,2189
411430,202303,5142,12267,3906,10107,749,2161,1393,3039,2142,5200
411435,202303,548,1375,313,899,44,134,60,132,104,266
411440,202303,3332,8328,2527,6877,549,1594,707,1660,1256,3254
411450,202303,3265,7861,2478,6603,377,992,1338,3530,1715,4522
411460,202303,5704,13813,3711,10193,524,1672,964,2101,1488,3773
411470,202303,1116,2543,870,2146,93,301,494,1059,587,1360
411480,202303,6852,16623,4953,13228,956,2977,1521,3384,2477,6361
411490,202303,2114,4892,1625,4179,207,613,776,1785,983,2398
411500,202303,1716,4242,1223,3262,208,617,283,559,491,1176
411510,202303,2831,6382,2183,5366,350,1021,644,1506,994,2527
411520,202303,45956,105601,27814,71327,3178,9706,12516,27219,15694,36925
411530,202303,1136,2712,634,1786,86,268,120,291,206,559
411535,202303,644,1773,426,1304,45,144,119,322,164,466
411540,202303,3336,7463,2308,5660,136,363,1442,3325,1578,3688
411545,202303,1101,2932,925,2621,76,238,591,1634,667,1872
411550,202303,860,2000,653,1637,100,269,234,498,334,767
411560,202303,2406,6286,1331,3979,200,615,101,200,301,815
411570,202303,9770,20980,6922,16813,1536,4065,2345,5125,3881,9190
411573,202303,982,2410,793,2095,122,387,435,1018,557,1405
411575,202303,2514,6157,1850,4959,324,921,601,1455,925,2376
411580,202303,5405,12431,3269,8938,432,1338,564,1125,996,2463
411585,202303,734,2073,378,1206,57,174,50,134,107,308
411590,202303,586,1451,435,1164,43,136,239,564,282,700
411600,202303,427,994,280,763,44,116,112,262,156,378
411605,202303,1972,4216,1279,3178,159,456,603,1503,762,1959
411610,202303,3670,7430,2657,5756,64,210,2019,3959,2083,4169
411620,202303,3794,8822,3123,7819,578,1524,1456,3554,2034,5078
411630,202303,1060,2505,716,1928,108,362,298,662,406,1024
411640,202303,562,1395,373,1007,45,125,129,286,174,411
411650,202303,245,663,159,491,23,76,47,121,70,197
411660,202303,1056,2523,737,1936,108,302,259,568,367,870
411670,202303,1919,4206,1298,3163,131,344,738,1616,869,1960
411680,202303,1758,4336,1299,3478,247,727,450,1045,697,1772
411690,202303,4993,11695,3687,9524,775,2017,1164,2952,1939,4969
411695,202303,791,2179,545,1585,44,139,242,639,286,778
411700,202303,2000,4883,1375,3735,317,915,322,768,639,1683
411705,202303,3052,7559,2575,6790,406,1149,1605,4168,2011,5317
411710,202303,2657,6259,1854,4849,390,1079,561,1234,951,2313
411720,202303,1294,2995,905,2316,129,333,315,721,444,1054
411721,202303,1214,2860,877,2266,155,410,263,609,418,1019
411722,202303,1194,3152,721,2081,124,375,262,609,386,984
411725,202303,1586,4189,1028,3110,234,793,233,603,467,1396
411727,202303,1733,4501,1146,3321,225,673,142,267,367,940
411729,202303,711,1730,421,1187,72,235,105,219,177,454
411730,202303,6960,16689,5337,13718,1151,3347,2129,5015,3280,8362
411740,202303,606,1510,333,955,79,207,70,159,149,366
411745,202303,949,2544,669,1957,100,313,137,302,237,615
411750,202303,8226,19758,6124,15964,799,2283,3054,7383,3853,9666
411760,202303,9506,22519,7144,18873,2151,5993,1508,3938,3659,9931
411770,202303,4005,10731,3015,8697,654,2010,667,1667,1321,3677
411780,202303,3236,8300,2715,7434,714,2007,838,2352,1552,4359
411790,202303,4002,8922,2536,6428,329,999,1041,2165,1370,3164
411800,202303,1454,3895,1067,3020,193,605,264,586,457,1191
411810,202303,1912,4603,1396,3658,214,599,519,1173,733,1772
411820,202303,21792,51552,18474,46288,4174,10729,9692,23279,13866,34008
411830,202303,593,1447,418,1111,75,175,66,165,141,340
411840,202303,15959,38932,11308,30021,1668,4884,4324,9722,5992,14606
411845,202303,801,2116,509,1496,78,262,134,328,212,590
411850,202303,10306,24240,7255,19180,1944,5538,1358,2890,3302,8428
411860,202303,936,2421,694,1954,125,369,134,340,259,709
411870,202303,744,1983,542,1570,139,457,102,211,241,668
411880,202303,3021,6620,2178,5309,343,916,956,2072,1299,2988
411885,202303,1315,3263,938,2601,133,416,248,557,381,973
411890,202303,1877,4664,1365,3802,230,709,163,414,393,1123
411900,202303,1045,2659,650,1860,177,529,76,192,253,721
411910,202303,1377,3769,988,2996,187,668,320,834,507,1502
411915,202303,21071,47981,14828,37031,2157,6031,6501,14121,8658,20152
411920,202303,1470,3853,1209,3406,283,889,444,1102,727,1991
411925,202303,597,1440,397,1068,80,222,186,447,266,669
411930,202303,6418,17330,5433,15679,2676,8082,576,1815,3252,9897
411940,202303,4157,11018,3286,9328,768,2241,1163,2915,1931,5156
411950,202303,19837,48176,16749,43326,1931,5839,10593,25475,12524,31314
411960,202303,7479,18160,5900,15339,1097,3204,2333,5287,3430,8491
411965,202303,630,1617,453,1254,66,189,207,506,273,695
411970,202303,1453,2952,1123,2522,215,407,521,1351,736,1758
411980,202303,2114,4561,1564,3747,331,786,715,1590,1046,2376
411990,202303,51484,123826,35240,95890,6161,18556,14637,35979,20798,54535
411995,202303,6387,14206,4893,11993,1369,3771,1501,3336,2870,7107
412000,202303,2467,5104,1788,4016,40,118,1374,2835,1414,2953
412010,202303,752,2071,494,1520,58,208,116,252,174,460
412015,202303,633,1653,509,1423,86,255,253,689,339,944
412020,202303,577,1545,358,1101,54,191,105,283,159,474
412030,202303,791,2052,600,1712,76,232,289,744,365,976
412033,202303,1145,2801,807,2194,91,261,340,794,431,1055
412035,202303,859,2186,548,1626,105,315,232,643,337,958
412040,202303,882,2182,568,1582,87,256,158,344,245,600
412050,202303,1764,4152,1225,3237,307,929,228,546,535,1475
412060,202303,9165,24053,7426,20765,1954,6197,2012,5005,3966,11202
412065,202303,776,1937,556,1529,99,295,149,360,248,655
412070,202303,1655,3873,1271,3192,139,409,611,1277,750,1686
412080,202303,3419,8118,2550,6527,309,885,1342,2884,1651,3769
412085,202303,409,974,171,509,17,66,48,107,65,173
412090,202303,8182,18765,6048,15275,1309,3671,2600,6224,3909,9895
412100,202303,2322,5680,1699,4644,508,1524,380,1048,888,2572
412110,202303,1174,2898,725,2016,79,234,224,506,303,740
412120,202303,2908,7382,2258,6282,463,1451,683,1614,1146,3065
412125,202303,981,2561,592,1756,94,261,137,386,231,647
412130,202303,953,2244,632,1665,118,315,134,318,252,633
412135,202303,701,1776,347,1017,42,141,136,336,178,477
412140,202303,2517,5690,1797,4489,304,814,433,1043,737,1857
412150,202303,3467,8150,2881,7158,566,1559,1426,3100,1992,4659
412160,202303,1138,3368,574,1859,38,131,38,77,76,208
412170,202303,5814,14144,4851,12698,899,2573,2340,5450,3239,8023
412175,202303,1635,4319,1343,3805,316,930,446,1214,762,2144
412180,202303,2121,5436,1562,4453,224,729,599,1535,823,2264
412190,202303,3963,9337,2823,7360,342,1030,1200,2791,1542,3821
412200,202303,2406,6331,1592,4565,405,1280,324,793,729,2073
412210,202303,801,1813,501,1335,67,208,233,558,300,766
412215,202303,4155,10218,2972,7962,638,1813,1303,3427,1941,5240
412217,202303,1254,2873,1023,2491,16,55,782,1743,798,1798
412220,202303,7516,20206,6021,17482,1364,4009,1508,4180,2872,8189
412230,202303,3456,9199,2661,7769,388,1307,479,1138,867,2445
412240,202303,10187,24881,6816,18651,1209,3617,2151,4954,3360,8571
412250,202303,2406,5843,1737,4639,415,1203,337,710,752,1913
412260,202303,1690,4035,1283,3283,229,609,438,985,667,1594
412265,202303,1285,3014,1026,2624,133,382,644,1519,777,1901
412270,202303,1350,3486,912,2593,116,366,374,908,490,1274
412280,202303,521,1358,395,1135,81,229,89,220,170,449
412290,202303,1326,3061,976,2479,178,480,372,864,550,1344
412300,202303,2265,5374,1694,4455,306,866,542,1209,848,2075
412310,202303,795,2176,572,1729,95,346,159,398,254,744
412320,202303,881,2139,554,1506,49,181,187,466,236,647
412330,202303,1984,4844,1309,3646,252,756,334,846,586,1602
412340,202303,1475,3731,1039,2904,160,483,142,362,302,845
412350,202303,3960,9795,2600,7221,438,1347,716,1624,1154,2971
412360,202303,360,851,272,693,6,21,197,472,203,493
412370,202303,1432,3578,1001,2787,195,568,230,589,425,1157
412380,202303,1846,4819,1332,3842,321,999,75,228,396,1227
412382,202303,627,1445,419,1112,46,155,216,465,262,620
412385,202303,2929,6967,2322,5893,669,1654,805,2100,1474,3754
412390,202303,3086,6988,2372,5843,434,1136,740,1699,1174,2835
412395,202303,940,2336,663,1780,88,236,327,810,415,1046
412400,202303,1161,2788,814,2160,144,414,259,583,403,997
412402,202303,3023,6916,2103,5469,456,1164,607,1543,1063,2707
412405,202303,3733,9425,2486,7197,682,1940,396,1056,1078,2996
412410,202303,8193,19811,6046,16467,1102,3453,2014,4937,3116,8390
412420,202303,642,1521,411,1079,45,125,161,375,206,500
412430,202303,656,1600,361,1006,56,150,131,348,187,498
412440,202303,3725,8940,2623,7113,585,1624,770,1980,1355,3604
412450,202303,657,1792,433,1285,54,166,45,83,99,249
412460,202303,1451,3284,1112,2752,205,556,489,1135,694,1691
412470,202303,1950,5538,1621,4869,385,1314,450,1180,835,2494
412480,202303,1732,3959,1181,2929,193,525,483,1012,676,1537
412490,202303,1648,3700,1257,3056,78,221,755,1639,833,1860
412500,202303,2553,5903,1882,4760,307,839,619,1339,926,2178
412510,202303,2394,6665,1711,5098,426,1365,275,610,701,1975
412520,202303,1740,4162,1085,2922,206,548,147,341,353,889
412530,202303,861,2170,629,1747,113,319,149,365,262,684
412535,202303,981,2486,592,1712,85,265,74,150,159,415
412540,202303,1277,3130,884,2446,153,530,177,420,330,950
412545,202303,911,2189,601,1608,106,307,201,493,307,800
412550,202303,47987,116347,35603,93578,5003,14631,17017,39250,22020,53881
412555,202303,360,861,242,630,27,91,79,145,106,236
412560,202303,6816,17526,5102,13969,1269,3882,1054,2365,2323,6247
412570,202303,5325,12344,3290,8704,564,1703,664,1355,1228,3058
412575,202303,1409,3177,1117,2713,294,689,483,1065,777,1754
412580,202303,1958,4536,1406,3599,128,368,776,1754,904,2122
412590,202303,545,1356,301,848,55,171,42,84,97,255
412600,202303,2138,4987,1697,4203,97,317,1121,2506,1218,2823
412610,202303,1029,2596,749,2039,102,281,319,749,421,1030
412620,202303,1601,3784,1256,3266,249,701,526,1232,775,1933
412625,202303,11956,29774,8115,22623,1559,4647,1293,2902,2852,7549
412627,202303,1412,3681,1002,2910,252,819,203,523,455,1342
412630,202303,3385,9315,2386,7276,389,1303,545,1414,934,2717
412635,202303,573,1428,353,1023,58,169,97,234,155,403
412640,202303,1210,3031,711,2016,102,290,130,279,232,569
412650,202303,2073,5297,1637,4448,272,829,633,1498,905,2327
412660,202303,3629,8471,2572,6572,302,863,1005,2223,1307,3086
412665,202303,529,1236,401,1026,82,221,155,362,237,583
412667,202303,2066,5181,1507,4121,233,729,593,1495,826,2224
412670,202303,1168,2489,815,1951,135,389,347,685,482,1074
412680,202303,2617,6507,1779,5011,204,664,512,1153,716,1817
412690,202303,1415,3378,987,2591,178,521,355,789,533,1310
412700,202303,2298,5553,1890,4912,402,1148,869,2058,1271,3206
412710,202303,6833,18188,5099,14815,811,2556,1363,3105,2174,5661
412720,202303,1618,4321,1311,3718,195,608,408,887,603,1495
412730,202303,3453,8258,2565,6632,408,1229,1149,2572,1557,3801
412740,202303,2538,6559,1745,5107,314,1020,298,780,612,1800
412750,202303,4910,12027,3931,10529,510,1532,2164,5340,2674,6872
412760,202303,3976,9572,3291,8478,633,1874,1773,4172,2406,6046
412770,202303,15251,37381,8937,25581,1122,3484,2242,5164,3364,8648
412780,202303,1573,3777,1147,3057,282,844,353,799,635,1643
412785,202303,2772,5921,1929,4599,260,663,1251,2805,1511,3468
412788,202303,1731,4524,1390,3947,365,1067,503,1322,868,2389
412790,202303,1719,4154,1107,3049,178,567,442,983,620,1550
412795,202303,1522,3671,904,2525,142,411,226,559,368,970
412796,202303,2767,7367,2322,6637,514,1566,696,1772,1210,3338
412800,202303,5334,11488,3890,9049,374,1100,2228,4419,2602,5519
412810,202303,16990,40082,11589,29957,1288,3825,5081,11203,6369,15028
412820,202303,7989,20382,5689,16002,1427,4267,1471,3858,2898,8125
412830,202303,420,1110,324,930,37,99,92,240,129,339
412840,202303,2488,5328,1807,4120,143,403,1163,2312,1306,2715
412850,202303,3460,8327,2611,7019,289,924,1348,3221,1637,4145
412853,202303,2048,4593,1718,4072,213,588,987,2008,1200,2596
412855,202303,1692,4084,910,2495,122,355,201,420,323,775
412860,202303,950,2272,620,1732,105,320,241,580,346,900
412862,202303,801,1910,542,1485,99,263,223,554,322,817
412863,202303,1581,4254,1383,3899,268,863,694,1744,962,2607
412865,202303,826,2113,605,1681,153,444,135,341,288,785
412870,202303,1214,2886,875,2361,257,785,232,583,489,1368
412880,202303,1193,3028,843,2422,181,552,286,738,467,1290
420005,202303,571,1577,340,1022,38,113,156,444,194,557
420010,202303,4000,9048,2664,6808,184,508,1913,4827,2097,5335
420020,202303,501,1485,380,1192,76,265,121,291,197,556
420030,202303,160,534,118,428,32,120,26,87,58,207
420040,202303,748,2173,465,1541,78,297,35,84,113,381
420050,202303,995,2302,678,1672,115,331,391,822,506,1153
420055,202303,213,601,131,405,18,71,56,146,74,217
420060,202303,256,672,191,528,29,85,94,239,123,324
420070,202303,1116,3046,882,2595,175,574,460,1247,635,1821
420075,202303,96,258,55,159,8,25,21,43,29,68
420080,202303,516,1421,363,1054,74,228,83,200,157,428
420090,202303,570,1650,373,1198,76,267,91,227,167,494
420100,202303,1883,4191,1530,3645,104,254,1133,2667,1237,2921
420110,202303,376,1114,314,977,46,158,171,508,217,666
420120,202303,826,2156,580,1649,76,240,275,689,351,929
420125,202303,466,1355,315,999,58,182,97,269,155,451
420127,202303,412,1078,190,581,24,89,72,208,96,297
420130,202303,6293,16297,4815,13736,965,3160,1947,4652,2912,7812
420140,202303,6084,15146,4726,12840,1281,3901,1219,2856,2500,6757
420150,202303,908,2204,679,1850,62,200,372,958,434,1158
420160,202303,266,631,121,345,18,62,42,106,60,168
420165,202303,229,651,147,456,25,92,42,99,67,191
420170,202303,430,1202,348,1024,40,131,179,460,219,591
420180,202303,190,598,108,400,18,82,27,88,45,170
420190,202303,263,741,163,496,36,107,44,122,80,229
420195,202303,2595,6297,2032,5382,457,1398,976,2307,1433,3705
420200,202303,10325,22998,6904,16863,857,2415,3360,6757,4217,9172
420205,202303,2832,6945,1964,5263,274,811,1017,2508,1291,3319
420207,202303,2894,6938,1937,5177,348,1067,802,1857,1150,2924
420208,202303,449,1224,281,887,85,278,67,165,152,443
420209,202303,228,680,141,438,16,59,70,187,86,246
420210,202303,5742,13767,4184,11081,677,2030,2132,5113,2809,7143
420213,202303,1024,2820,832,2416,158,495,319,869,477,1364
420215,202303,313,862,224,670,50,159,68,188,118,347
420220,202303,449,1272,311,988,51,190,124,330,175,520
420230,202303,8074,19766,6371,16684,783,2361,3605,8556,4388,10917
420240,202303,20688,54007,14034,39151,1725,5601,6423,14824,8148,20425
420243,202303,621,1457,507,1247,80,226,323,750,403,976
420245,202303,2666,6221,2069,5215,183,545,1293,2980,1476,3525
420250,202303,863,1892,756,1748,46,148,605,1310,651,1458
420253,202303,598,1371,431,1125,43,114,254,649,297,763
420257,202303,217,522,151,408,26,83,72,186,98,269
420260,202303,1619,3742,1232,3218,93,294,915,2313,1008,2607
420270,202303,761,1881,392,1035,43,118,175,412,218,530
420280,202303,1950,5211,1554,4388,201,674,746,1885,947,2559
420285,202303,199,546,114,336,18,62,29,59,47,121
420287,202303,606,1303,428,1061,74,203,188,437,262,640
420290,202303,7444,19403,5973,16391,844,2708,3468,8510,4312,11218
420300,202303,10392,27596,6154,17949,1122,3481,1888,4692,3010,8173
420310,202303,1064,2276,631,1566,65,184,309,674,374,858
420315,202303,1165,2976,757,2178,91,284,381,1002,472,1286
420320,202303,8504,21352,6520,18228,1830,5477,1968,5039,3798,10516
420325,202303,431,1173,311,932,44,153,115,286,159,439
420330,202303,1393,3864,899,2770,161,538,274,730,435,1268
420340,202303,1615,3823,1252,3202,283,772,515,1139,798,1911
420350,202303,1805,3970,1400,3292,148,390,959,2146,1107,2536
420360,202303,3864,10099,2162,6538,365,1193,187,496,552,1689
420370,202303,1811,4316,1482,3766,119,393,1065,2498,1184,2891
420380,202303,6026,14785,4244,11524,769,2411,1881,4542,2650,6953
420390,202303,1441,3482,1049,2722,181,512,359,632,540,1144
420395,202303,1658,4315,1194,3460,169,537,233,492,402,1029
420400,202303,1540,3813,1117,3028,141,428,612,1530,753,1958
420410,202303,760,1867,554,1451,77,221,308,771,385,992
420415,202303,465,1232,332,933,65,202,149,393,214,595
420417,202303,799,2235,615,1837,147,414,275,860,422,1274
420419,202303,186,607,135,468,42,156,12,48,54,204
420420,202303,19899,48607,13945,37612,3457,10578,4673,10825,8130,21403
420425,202303,812,2140,575,1645,55,178,290,777,345,955
420430,202303,4420,11128,2917,8032,470,1478,1212,2804,1682,4282
420435,202303,468,1166,284,824,62,186,135,375,197,561
420440,202303,1073,2606,734,1916,249,596,222,552,471,1148
420445,202303,302,706,192,505,29,83,63,126,92,209
420450,202303,1139,3113,868,2539,155,551,346,834,501,1385
420455,202303,2744,6171,2043,5121,522,1299,769,1949,1291,3248
420460,202303,13157,32304,10382,27399,1394,4276,5835,13984,7229,18260
420470,202303,893,2269,504,1388,85,272,148,311,233,583
420475,202303,90,238,42,134,7,27,13,38,20,65
420480,202303,7392,17329,4946,13187,886,2513,2083,5242,2969,7755
420490,202303,516,1371,361,1019,56,183,157,395,213,578
420500,202303,1765,4533,1192,3493,211,737,546,1437,757,2174
420510,202303,165,455,111,332,18,68,34,70,52,138
420515,202303,165,461,123,367,14,50,42,95,56,145
420517,202303,933,2228,783,1962,94,251,462,1113,556,1364
420519,202303,400,995,282,804,35,108,129,356,164,464
420520,202303,364,964,198,640,26,92,7,14,33,106
420530,202303,1005,2904,700,2221,128,469,223,570,351,1039
420535,202303,269,746,108,343,15,51,30,78,45,129
420540,202303,52974,120166,38429,95940,5042,14754,16874,35359,21916,50113
420543,202303,313,856,235,677,36,124,94,229,130,353
420545,202303,2030,5798,1551,4733,309,1019,586,1570,895,2589
420550,202303,5634,13660,3679,10138,596,1792,1503,3803,2099,5595
420555,202303,437,1191,301,910,37,142,156,415,193,557
420560,202303,551,1217,402,1012,54,145,222,546,276,691
420570,202303,4070,9665,3083,7936,487,1447,1678,3921,2165,5368
420580,202303,2321,6139,1643,4959,380,1253,483,1325,863,2578
420590,202303,4109,10561,2716,7623,426,1345,807,1787,1233,3132
420600,202303,1736,4380,1433,3835,111,405,942,2307,1053,2712
420610,202303,776,2014,529,1519,112,315,245,672,357,987
420620,202303,1102,2705,783,2168,134,405,305,791,439,1196
420630,202303,1403,3985,1017,3069,165,560,447,1196,612,1756
420640,202303,615,1641,315,1002,69,224,17,37,86,261
420650,202303,4683,11520,3238,8661,452,1402,1466,3211,1918,4613
420660,202303,571,1398,355,946,60,169,69,145,129,314
420665,202303,936,2267,634,1738,110,339,274,625,384,964
420670,202303,1573,4246,944,2860,95,330,196,424,291,754
420675,202303,267,662,176,511,14,54,106,278,120,332
420680,202303,357,764,202,551,21,81,116,275,137,356
420690,202303,1227,3320,825,2406,120,372,271,644,391,1016
420700,202303,4220,10354,3338,8825,274,837,2248,5592,2522,6429
420710,202303,1420,3848,1183,3346,158,521,672,1644,830,2165
420720,202303,1755,4436,1338,3694,206,635,784,1982,990,2617
420730,202303,4912,11866,3846,10115,675,2045,1924,4538,2599,6583
420740,202303,614,1683,359,1122,77,263,70,181,147,444
420750,202303,2918,7983,2020,5980,315,1128,778,1998,1093,3126
420757,202303,142,364,71,226,10,32,33,103,43,135
420760,202303,504,1376,277,794,46,135,85,198,131,333
420765,202303,733,1993,389,1156,63,213,190,534,253,747
420768,202303,1799,4556,1493,3996,185,491,1049,2759,1234,3250
420770,202303,349,962,152,520,12,50,21,41,33,91
420775,202303,387,1008,239,721,45,150,82,213,127,363
420780,202303,1270,3372,798,2322,151,419,134,353,285,772
420785,202303,290,714,214,566,14,41,100,201,114,242
420790,202303,1437,3806,1126,3165,211,752,644,1550,855,2302
420800,202303,1016,2312,648,1649,166,438,326,775,492,1213
420810,202303,1893,5243,1572,4628,378,1321,731,1829,1109,3150
420820,202303,18859,44640,14225,37327,1977,5726,7412,17804,9389,23530
420830,202303,6691,16334,5085,13554,895,2706,2178,5308,3073,8014
420840,202303,786,2355,434,1488,74,280,43,127,117,407
420845,202303,3953,9529,2798,7563,533,1723,1218,2979,1751,4702
420850,202303,1331,3856,975,2983,173,603,322,785,495,1388
420860,202303,495,1263,308,926,82,250,81,212,163,462
420870,202303,1060,2810,738,2166,157,491,247,654,404,1145
420880,202303,1562,4338,1255,3754,264,880,508,1344,772,2224
420890,202303,10040,26028,6501,18763,942,3032,2171,5231,3113,8263
420895,202303,242,681,155,464,27,85,67,178,94,263
420900,202303,2122,5036,1332,3634,176,590,579,1287,755,1877
420910,202303,47082,116980,33419,92273,5008,15842,15011,35421,20019,51263
420915,202303,581,1965,473,1698,85,325,217,774,302,1099
420917,202303,614,1485,307,777,50,100,166,412,216,512
420920,202303,122,317,51,156,6,23,8,14,14,37
420930,202303,24130,56466,18196,46366,2449,7242,10130,23165,12579,30407
420940,202303,4812,11117,3212,8494,640,1943,944,1901,1584,3844
420945,202303,255,750,144,433,25,87,58,147,83,234
420950,202303,517,1366,346,997,57,191,104,249,161,440
420960,202303,1436,3390,1048,2758,169,506,457,1040,626,1546
420970,202303,2978,7485,2086,5887,410,1209,650,1816,1060,3025
420980,202303,329,1078,271,937,88,322,54,176,142,498
420985,202303,489,1279,281,862,56,190,74,186,130,376
420990,202303,472,1355,300,953,50,171,62,150,112,321
421000,202303,744,2150,506,1611,104,345,94,231,198,576
421003,202303,556,1330,202,581,16,40,15,37,31,77
421005,202303,136,382,98,294,14,43,39,116,53,159
421010,202303,4992,12403,3666,10037,608,1966,1433,3138,2041,5104
421020,202303,524,1527,412,1302,62,239,214,609,276,848
421030,202303,1358,3561,1044,2941,221,692,402,1016,623,1708
421040,202303,886,2048,532,1464,59,186,324,831,383,1017
421050,202303,1605,4164,1071,2945,173,543,388,833,561,1376
421055,202303,212,573,129,393,19,66,56,143,75,209
421060,202303,938,2507,694,1982,121,387,312,749,433,1136
421070,202303,844,2324,526,1552,101,325,232,589,333,914
421080,202303,678,1865,539,1593,85,302,233,618,318,920
421085,202303,423,1154,195,629,19,58,30,78,49,136
421090,202303,394,980,234,634,18,68,103,227,121,295
421100,202303,1121,2390,529,1440,82,231,120,276,202,507
421105,202303,2019,5067,1467,4044,285,836,567,1440,852,2276
421110,202303,1695,3965,1422,3579,133,406,925,2225,1058,2631
421120,202303,1435,4053,1034,3202,139,471,344,894,483,1365
421125,202303,504,1210,366,921,87,239,148,326,235,565
421130,202303,8456,22121,7139,19591,1322,4026,3765,9486,5087,13512
421140,202303,459,1208,315,923,77,220,115,303,192,523
421145,202303,528,1358,361,1024,96,309,99,218,195,527
421150,202303,1003,2659,699,2032,121,401,286,693,407,1094
421160,202303,842,2172,671,1834,89,290,417,1024,506,1314
421165,202303,298,835,186,551,32,95,60,144,92,239
421170,202303,1579,3876,1366,3549,124,337,1003,2557,1127,2894
421175,202303,1366,3435,833,2481,157,533,328,909,485,1442
421180,202303,506,1226,291,811,35,124,144,334,179,458
421185,202303,419,1025,301,797,44,125,142,317,186,442
421187,202303,335,1003,214,705,38,117,71,231,109,348
421189,202303,524,1408,404,1179,66,222,158,396,224,618
421190,202303,18595,46797,14285,38516,2353,7316,6787,16002,9140,23318
421200,202303,1033,2626,796,2168,102,331,445,1134,547,1465
421205,202303,316,796,250,685,56,162,95,247,151,409
421210,202303,1423,3459,815,2379,188,539,252,678,440,1217
421220,202303,1832,4980,1455,4234,370,1153,470,1221,840,2374
421223,202303,552,1343,375,1036,70,215,205,518,275,733
421225,202303,1405,3649,1224,3367,133,457,823,2177,956,2634
421227,202303,913,2413,592,1752,121,383,232,670,353,1053
421230,202303,837,2076,585,1626,104,314,224,576,328,890
421240,202303,345,989,174,582,26,115,43,110,69,225
421250,202303,3447,8191,2602,6822,407,1068,1531,3815,1938,4883
421260,202303,340,1034,98,310,17,56,10,22,27,78
421265,202303,1252,2791,1072,2544,95,211,860,2023,955,2234
421270,202303,459,1204,244,773,62,214,82,244,144,458
421280,202303,3487,8497,2696,7192,412,1274,1401,3415,1813,4689
421290,202303,1436,3708,729,2040,116,332,130,301,246,633
421300,202303,416,1083,206,636,29,97,35,91,64,188
421310,202303,311,824,212,616,73,217,73,183,146,400
421315,202303,389,988,245,695,50,147,80,202,130,349
421320,202303,808,2442,459,1460,40,124,60,94,100,218
421330,202303,788,2171,524,1587,112,351,150,403,262,754
421335,202303,515,1478,414,1286,61,207,202,595,263,802
421340,202303,1814,4789,1280,3839,205,680,519,1428,724,2108
421350,202303,2233,5274,1519,4103,305,866,547,1409,852,2275
421360,202303,2700,6853,1683,4818,425,1433,536,1117,961,2550
421370,202303,970,2933,631,2055,104,382,199,520,303,902
421380,202303,1114,2581,971,2366,83,257,679,1557,762,1814
421390,202303,206,541,91,293,26,89,22,56,48,145
421400,202303,835,2125,578,1627,102,326,263,655,365,981
421410,202303,241,625,135,409,37,105,26,85,63,190
421415,202303,258,676,184,506,20,60,71,176,91,236
421420,202303,785,2062,571,1597,72,222,279,697,351,919
421430,202303,123,361,82,258,12,42,14,30,26,72
421440,202303,882,2273,557,1641,109,324,229,626,338,950
421450,202303,526,1545,369,1179,47,154,36,113,83,267
421460,202303,436,1300,241,851,13,37,20,48,33,85
421470,202303,483,1307,353,1069,47,143,110,330,157,473
421480,202303,4220,10636,3017,8242,394,1299,1383,3322,1777,4621
421490,202303,153,463,100,330,13,52,26,68,39,120
421500,202303,3204,8623,2321,6811,451,1532,728,1724,1179,3256
421505,202303,413,1031,341,923,35,113,208,545,243,658
421507,202303,538,1360,323,912,51,159,131,315,182,474
421510,202303,531,1396,361,1015,46,155,150,326,196,481
421520,202303,574,1504,335,939,56,155,104,241,160,396
421530,202303,432,1263,262,877,30,131,51,117,81,248
421535,202303,578,1454,369,1015,51,150,198,492,249,642
421540,202303,464,1047,281,755,27,91,105,253,132,344
421545,202303,879,2432,674,2053,126,429,302,828,428,1257
421550,202303,2950,7339,2282,6166,375,1108,1165,2933,1540,4041
421555,202303,274,755,82,263,12,39,15,32,27,71
421560,202303,128,398,79,264,11,44,25,67,36,111
421565,202303,1314,3198,964,2620,224,684,400,971,624,1655
421567,202303,641,1862,480,1434,139,446,127,359,266,805
421568,202303,388,1094,211,657,43,159,60,158,103,317
421569,202303,196,538,89,265,13,45,46,114,59,159
421570,202303,2094,5493,1511,4252,281,893,617,1465,898,2358
421575,202303,413,1126,304,843,35,122,156,371,191,493
421580,202303,6497,16603,4282,11929,596,1894,1793,4183,2389,6077
421590,202303,240,645,183,531,41,135,79,210,120,345
421600,202303,780,1924,523,1395,74,219,213,460,287,679
421605,202303,889,2230,654,1851,112,314,260,723,372,1037
421610,202303,1323,3319,932,2609,186,592,375,945,561,1537
421620,202303,5037,12487,3543,9837,666,2124,1464,3526,2130,5650
421625,202303,164,452,89,265,11,30,28,67,39,97
421630,202303,3789,9417,2518,7027,414,1305,822,1935,1236,3240
421635,202303,579,1471,400,1111,31,112,243,581,274,693
421640,202303,935,2312,691,1940,172,494,331,869,503,1363
421650,202303,3569,8896,2474,6992,494,1595,830,2015,1324,3610
421660,202303,16716,42680,12645,34963,1727,5522,6521,15883,8248,21405
421670,202303,1201,3164,834,2280,153,468,346,816,499,1284
421680,202303,2328,4672,1926,4063,127,353,1516,2946,1643,3299
421690,202303,1957,5357,1392,4214,274,872,361,997,635,1869
421700,202303,807,2278,511,1571,73,245,133,322,206,567
421710,202303,274,830,160,504,19,65,66,188,85,253
421715,202303,216,531,161,396,30,94,97,210,127,304
421720,202303,2739,7107,1651,4787,347,1112,454,1057,801,2169
421725,202303,380,901,217,596,29,87,100,227,129,314
421730,202303,700,1961,475,1353,76,220,210,542,286,762
421740,202303,1115,2950,778,2259,135,426,308,736,443,1162
421750,202303,1253,2909,699,1909,167,502,227,543,394,1045
421755,202303,219,591,125,365,19,60,46,113,65,173
421760,202303,1390,3399,905,2524,170,546,338,799,508,1345
421770,202303,3295,8080,2383,6509,430,1222,902,2274,1332,3496
421775,202303,269,700,164,481,19,61,50,107,69,168
421780,202303,1242,3270,855,2487,140,432,371,957,511,1389
421790,202303,1168,2995,637,1937,125,385,191,500,316,885
421795,202303,302,878,189,567,30,97,52,137,82,234
421800,202303,4108,10524,3126,8682,502,1511,1481,3732,1983,5243
421810,202303,760,1970,524,1531,56,179,255,712,311,891
421820,202303,1470,3993,1014,2955,182,617,321,764,503,1381
421825,202303,2091,4674,1759,4171,117,308,1292,2982,1409,3290
421830,202303,2481,6811,1842,5482,388,1239,416,1166,804,2405
421835,202303,334,760,240,603,30,82,145,349,175,431
421840,202303,467,1395,371,1176,75,271,110,304,185,575
421850,202303,505,1412,292,972,57,187,48,122,105,309
421860,202303,309,793,178,535,24,85,56,124,80,209
421870,202303,7138,16670,5375,13339,603,1866,3249,6998,3852,8864
421875,202303,392,1147,174,542,23,74,35,94,58,168
421880,202303,871,2342,582,1701,115,312,140,375,255,687
421885,202303,378,1019,208,619,33,97,59,154,92,251
421890,202303,1330,3420,994,2789,151,534,593,1504,744,2038
421895,202303,548,1324,469,1196,51,108,298,793,349,901
421900,202303,1432,3580,1049,2743,133,417,494,1056,627,1473
421910,202303,425,1233,229,746,31,125,48,121,79,246
421915,202303,506,1359,314,903,73,223,64,140,137,363
421917,202303,825,1818,472,1312,124,368,94,259,218,627
421920,202303,551,1574,381,1198,111,357,111,335,222,692
421930,202303,4266,10186,2549,7032,459,1386,842,1994,1301,3380
421935,202303,548,1506,443,1299,106,300,227,658,333,958
421940,202303,456,1273,227,687,37,123,66,159,103,282
421950,202303,4318,10481,2640,7297,451,1387,763,1708,1214,3095
421960,202303,191,462,110,321,14,38,37,94,51,132
421970,202303,2701,6675,1715,4621,300,930,703,1591,1003,2521
421985,202303,421,1108,292,839,32,100,144,385,176,485
422000,202303,2600,6073,2061,5286,168,507,1409,3512,1577,4019
430003,202303,786,1938,562,1553,87,267,293,766,380,1033
430005,202303,464,1060,353,883,16,50,255,577,271,627
430010,202303,2360,4977,1757,4081,343,777,905,2098,1248,2875
430020,202303,717,1533,534,1280,63,177,334,741,397,918
430030,202303,1346,2899,794,1914,101,267,458,987,559,1254
430040,202303,12595,27516,8207,20479,2125,5711,2265,5024,4390,10735
430045,202303,695,1520,517,1233,28,84,386,877,414,961
430047,202303,301,645,122,316,17,45,43,104,60,149
430050,202303,1046,2460,626,1655,108,296,248,586,356,882
430055,202303,334,760,170,442,14,37,82,184,96,221
430057,202303,123,273,63,166,18,50,13,31,31,81
430060,202303,28499,67051,23060,58930,3819,10695,12589,30544,16408,41239
430063,202303,916,2330,761,2047,152,409,418,1099,570,1508
430064,202303,1459,3602,1063,2888,195,563,548,1419,743,1982
430066,202303,132,281,104,238,8,26,84,183,92,209
430070,202303,780,1957,187,568,34,116,26,55,60,171
430080,202303,1185,2803,684,1807,104,329,343,753,447,1082
430085,202303,1137,2278,704,1631,112,297,314,682,426,979
430087,202303,1160,2605,947,2321,79,238,623,1469,702,1707
430090,202303,557,1391,231,728,45,151,50,131,95,282
430100,202303,1368,3081,824,2089,125,350,322,679,447,1029
430105,202303,1868,4345,1338,3474,181,560,717,1728,898,2288
430107,202303,205,558,108,314,16,45,30,72,46,117
430110,202303,2775,6296,2105,5307,331,935,1030,2415,1361,3350
430120,202303,1624,4196,1140,3079,195,517,502,1243,697,1760
430130,202303,4480,9286,3342,7773,1152,2656,680,1879,1832,4535
430140,202303,1315,3151,939,2509,156,454,447,1102,603,1556
430150,202303,694,1720,390,1123,77,251,106,273,183,524
430155,202303,288,687,135,386,18,53,26,54,44,107
430160,202303,28041,57016,22769,49999,1755,4556,16247,33713,18002,38269
430163,202303,4481,8839,3205,7059,67,222,2611,5479,2678,5701
430165,202303,415,1040,162,506,15,41,22,53,37,94
430170,202303,1136,2811,415,1333,86,326,59,138,145,464
430175,202303,1075,2452,931,2191,161,376,544,1238,705,1614
430180,202303,851,1987,621,1592,140,356,260,649,400,1005
430185,202303,778,1895,406,1132,93,284,80,176,173,460
430187,202303,1074,2065,799,1744,92,191,553,1191,645,1382
430190,202303,1869,4267,1459,3644,271,689,678,1579,949,2268
430192,202303,142,362,67,188,12,35,20,43,32,78
430195,202303,525,1439,90,281,8,24,15,32,23,56
430200,202303,1426,3687,1132,3181,309,906,260,750,569,1656
430205,202303,692,1344,645,1261,15,40,602,1148,617,1188
430210,202303,9165,22226,5597,14754,739,2103,1631,3320,2370,5423
430215,202303,429,972,268,676,39,109,124,285,163,394
430220,202303,720,1707,248,743,36,119,81,194,117,313
430222,202303,300,758,206,581,37,109,76,198,113,307
430223,202303,345,829,264,698,27,78,155,384,182,462
430225,202303,39,83,29,67,2,3,18,36,20,39
430230,202303,2606,6195,2195,5625,124,343,1742,4382,1866,4725
430235,202303,573,1463,385,1094,56,180,101,224,157,404
430237,202303,673,1358,511,1116,24,71,414,863,438,934
430240,202303,1716,3795,987,2544,125,374,461,1023,586,1397
430245,202303,945,2260,764,1945,149,363,432,1131,581,1494
430250,202303,1306,2929,949,2360,295,789,249,538,544,1327
430258,202303,157,390,121,326,10,31,55,142,65,173
430260,202303,903,2055,591,1516,67,200,339,832,406,1032
430265,202303,294,806,207,653,28,94,81,250,109,344
430270,202303,4299,8835,3468,7641,400,1020,2431,4997,2831,6017
430280,202303,6546,13656,4805,10914,726,1742,2509,5325,3235,7067
430290,202303,2760,5676,2246,5058,178,458,1691,3636,1869,4094
430300,202303,13833,30211,10745,25288,1332,3641,6560,14198,7892,17839
430310,202303,17964,40624,13251,32462,1632,4422,7613,17063,9245,21485
430320,202303,1120,2663,652,1783,60,162,350,913,410,1075
430330,202303,800,1836,491,1259,86,227,168,374,254,601
430340,202303,805,1692,560,1321,76,180,362,811,438,991
430350,202303,11048,24516,8605,20598,1102,2872,5185,11598,6287,14470
430355,202303,421,1107,168,516,34,95,18,44,52,139
430360,202303,1117,2537,692,1832,161,475,205,480,366,955
430367,202303,437,889,282,653,35,112,177,357,212,469
430370,202303,583,1554,247,736,49,147,55,124,104,271
430380,202303,771,1803,409,1165,86,259,98,248,184,507
430390,202303,4487,10280,3014,7742,596,1640,369,702,965,2342
430400,202303,1325,2543,984,2097,133,352,592,1135,725,1487
430410,202303,697,1466,518,1204,44,114,382,846,426,960
430420,202303,3755,8539,2958,7057,379,1085,1849,3907,2228,4992
430430,202303,627,1498,281,813,50,156,48,122,98,278
430435,202303,2327,5222,1693,4158,286,747,838,1967,1124,2714
430440,202303,6348,14513,5269,12832,515,1461,3549,8117,4064,9578
430450,202303,9896,20943,8109,18091,1227,3219,4791,9788,6018,13007
430460,202303,51469,115367,38041,94070,5088,14071,21261,48967,26349,63038
430461,202303,256,654,103,302,20,67,36,87,56,154
430462,202303,378,920,197,566,34,105,59,144,93,249
430463,202303,9500,22673,7103,18445,1363,4017,3340,7984,4703,12001
430465,202303,724,1629,494,1227,75,209,273,646,348,855
430466,202303,6246,13938,5051,12220,808,2158,2963,6549,3771,8707
430467,202303,641,1433,477,1192,48,140,281,641,329,781
430468,202303,1874,4092,1531,3611,91,288,1192,2663,1283,2951
430469,202303,728,1950,153,466,15,45,47,99,62,144
430470,202303,7411,17560,5015,13482,1261,3886,1264,2867,2525,6753
430471,202303,969,2293,832,2070,102,309,578,1318,680,1627
430480,202303,772,2017,504,1469,78,256,165,370,243,626
430485,202303,205,505,105,283,22,50,23,60,45,110
430490,202303,559,1325,324,874,38,113,157,351,195,464
430495,202303,488,1258,334,979,54,170,162,451,216,621
430500,202303,1213,2887,862,2333,282,856,229,516,511,1372
430510,202303,35522,85631,26510,69291,4750,13964,11721,26870,16471,40834
430511,202303,398,1060,151,462,27,79,25,53,52,132
430512,202303,1295,2642,1049,2300,226,545,442,914,668,1459
430513,202303,961,2158,496,1244,67,196,277,600,344,796
430515,202303,483,1206,342,946,41,125,152,386,193,511
430517,202303,1739,4356,1336,3539,227,587,734,1906,961,2493
430520,202303,1635,3873,953,2500,144,392,238,542,382,934
430530,202303,1163,2755,497,1396,80,235,135,342,215,577
430535,202303,4612,10699,3366,8597,475,1279,1703,4085,2178,5364
430537,202303,687,1495,609,1358,70,141,446,968,516,1109
430540,202303,705,1617,431,1168,72,196,222,580,294,776
430543,202303,1338,2247,843,1677,206,393,223,490,429,883
430544,202303,840,2210,565,1630,141,438,178,482,319,920
430545,202303,3082,7133,2416,6166,395,1061,1346,3318,1741,4379
430550,202303,484,1242,337,952,93,250,91,247,184,497
430558,202303,186,407,82,205,3,7,44,101,47,108
430560,202303,356,785,187,522,25,80,62,145,87,225
430570,202303,997,2258,726,1783,154,478,329,621,483,1099
430580,202303,992,2335,725,1933,174,459,272,767,446,1226
430583,202303,213,510,49,135,5,18,13,20,18,38
430585,202303,257,589,142,365,29,83,44,96,73,179
430587,202303,247,623,185,526,21,67,80,219,101,286
430590,202303,1675,3750,1320,3190,144,362,872,2041,1016,2403
430593,202303,39,103,34,88,6,20,17,33,23,53
430595,202303,494,1211,141,423,17,47,21,34,38,81
430597,202303,549,1284,291,781,24,61,92,181,116,242
430600,202303,2382,5921,1064,2927,155,453,216,513,371,966
430605,202303,1661,3933,1213,3182,180,488,544,1360,724,1848
430607,202303,839,1761,565,1299,37,96,364,788,401,884
430610,202303,7829,16507,5754,13538,1395,3934,2356,4704,3751,8638
430613,202303,311,694,96,267,10,28,27,59,37,87
430620,202303,1012,2226,768,1815,153,439,401,788,554,1227
430630,202303,529,1380,187,530,32,94,51,120,83,214
430632,202303,527,1317,229,628,36,104,84,201,120,305
430635,202303,707,1454,524,1149,54,106,372,807,426,913
430637,202303,635,1403,475,1163,42,122,306,683,348,805
430640,202303,1394,3592,966,2763,138,413,354,878,492,1291
430642,202303,445,1169,277,781,42,128,107,271,149,399
430645,202303,199,451,103,260,19,56,33,60,52,116
430650,202303,2298,5597,1726,4705,524,1363,633,1900,1157,3263
430655,202303,381,860,232,577,27,84,135,282,162,366
430660,202303,6766,15309,5197,12868,866,2387,2704,6190,3570,8577
430670,202303,740,1656,527,1295,95,232,232,538,327,770
430673,202303,622,1343,296,786,63,162,110,265,173,427
430675,202303,281,788,64,216,10,36,5,17,15,53
430676,202303,7550,16947,6030,14615,951,2415,3615,8373,4566,10788
430680,202303,1503,3564,1007,2640,312,884,334,655,646,1539
430690,202303,4197,9661,3324,8199,1046,2681,1264,3000,2310,5681
430692,202303,246,683,197,603,13,44,153,462,166,506
430693,202303,1174,2913,729,2071,155,485,184,479,339,964
430695,202303,498,1129,309,761,44,128,157,337,201,465
430697,202303,650,1454,506,1254,75,204,328,798,403,1002
430700,202303,10285,23464,6710,17246,1373,3861,1630,3412,3003,7273
430705,202303,450,1001,225,610,24,69,89,207,113,276
430710,202303,2459,4305,1678,3310,70,192,1353,2505,1423,2697
430720,202303,961,2194,518,1420,62,189,270,670,332,859
430730,202303,1175,2957,806,2258,114,335,330,844,444,1179
430740,202303,843,2120,454,1299,72,231,144,373,216,604
430745,202303,615,1344,454,1052,54,184,281,524,335,708
430750,202303,2135,4787,1448,3606,341,897,652,1481,993,2378
430755,202303,575,1329,425,1047,34,100,259,573,293,673
430760,202303,3255,7337,2560,6308,532,1422,1249,2828,1781,4250
430770,202303,9819,21675,7816,18792,862,2386,5089,11580,5951,13966
430780,202303,2746,6306,1885,4902,289,826,976,2359,1265,3185
430781,202303,764,1797,518,1286,162,428,199,405,361,833
430783,202303,435,932,281,700,63,175,138,316,201,491
430786,202303,43,129,29,99,5,15,6,15,11,30
430790,202303,6246,13994,4691,11438,468,1421,2904,6325,3372,7746
430800,202303,1090,2125,827,1770,50,124,646,1314,696,1438
430805,202303,507,1110,359,831,10,33,282,605,292,638
430807,202303,729,1680,439,1154,63,195,183,395,246,590
430810,202303,955,2152,500,1308,71,206,190,416,261,622
430820,202303,1691,4404,1006,2960,163,483,300,768,463,1251
430825,202303,316,720,133,317,20,50,54,111,74,161
430830,202303,2566,5739,2140,5010,126,303,1637,3633,1763,3936
430840,202303,1491,3226,1020,2487,145,353,626,1460,771,1813
430843,202303,224,530,105,288,8,18,38,92,46,110
430845,202303,633,1329,430,1000,58,153,258,526,316,679
430850,202303,2977,7242,2073,5627,575,1676,533,1341,1108,3017
430860,202303,1459,3392,783,2113,117,384,323,730,440,1114
430865,202303,702,1633,437,1167,101,308,149,303,250,611
430870,202303,642,1627,283,841,47,138,51,132,98,270
430880,202303,1917,3887,1378,3057,154,409,924,1899,1078,2308
430885,202303,208,530,131,376,15,36,81,233,96,269
430890,202303,1380,3230,889,2412,174,560,96,196,270,756
430900,202303,4099,7764,2906,6149,139,414,2155,4191,2294,4605
430905,202303,1188,2743,819,2101,140,377,324,751,464,1128
430910,202303,2852,7098,2173,5739,330,1047,1033,2302,1363,3349
430912,202303,633,1665,413,1209,65,183,225,663,290,846
430915,202303,646,1709,416,1234,113,359,104,302,217,661
430920,202303,35582,80071,28735,69416,3329,8967,18591,42438,21920,51405
430925,202303,107,225,54,138,8,22,24,61,32,83
430930,202303,15744,32939,11814,27324,1315,3407,7512,16177,8827,19584
430940,202303,1605,3792,1115,2874,230,633,453,1016,683,1649
430950,202303,1086,2120,728,1565,51,151,535,1032,586,1183
430955,202303,516,1274,152,418,25,69,43,95,68,164
430957,202303,252,713,222,650,41,121,120,355,161,476
430960,202303,1768,3956,1054,2722,264,717,347,797,611,1514
430965,202303,2002,4150,1596,3561,63,146,1258,2790,1321,2936
430970,202303,456,1053,263,708,41,118,121,305,162,423
430975,202303,618,1619,477,1323,78,253,173,413,251,666
430980,202303,532,1161,313,797,39,113,143,313,182,426
430990,202303,763,1898,530,1436,79,238,249,627,328,865
430995,202303,689,1538,504,1252,82,214,276,627,358,841
431000,202303,1727,3884,787,2146,121,333,77,162,198,495
431010,202303,3438,8243,2461,6597,447,1380,919,2048,1366,3428
431020,202303,11054,22739,6737,16102,1039,2949,3227,6565,4266,9514
431030,202303,401,1048,208,649,37,132,29,83,66,215
431033,202303,5322,11569,3672,9022,779,1935,1425,3343,2204,5278
431036,202303,361,778,89,260,6,12,29,70,35,82
431040,202303,1135,2561,741,1936,77,268,432,1010,509,1278
431041,202303,519,1148,359,894,58,151,154,321,212,472
431043,202303,471,1118,329,836,26,90,212,473,238,563
431046,202303,126,313,58,162,7,18,12,29,19,47
431050,202303,1592,3439,1160,2790,192,458,645,1519,837,1977
431053,202303,875,2087,487,1360,98,284,162,356,260,640
431055,202303,758,1692,576,1393,59,149,385,932,444,1081
431057,202303,254,713,164,516,34,117,55,151,89,268
431060,202303,7212,16201,5103,12889,1164,3254,2001,4480,3165,7734
431065,202303,585,1342,386,1016,54,159,200,497,254,656
431070,202303,515,1276,320,877,62,184,88,232,150,416
431075,202303,344,829,194,509,34,113,96,198,130,311
431080,202303,800,2088,570,1626,83,248,181,444,264,692
431085,202303,973,2354,531,1394,58,173,234,587,292,760
431087,202303,506,1253,413,1080,50,134,251,630,301,764
431090,202303,493,1111,201,580,37,109,40,112,77,221
431100,202303,5591,10643,4123,8827,376,929,2868,5746,3244,6675
431110,202303,1851,3923,1321,3022,185,472,691,1395,876,1867
431112,202303,790,1849,654,1615,89,250,413,960,502,1210
431113,202303,648,1510,502,1247,116,301,277,637,393,938
431115,202303,1319,3254,1023,2743,113,390,695,1716,808,2106
431120,202303,3411,7874,2341,5945,524,1506,917,1980,1441,3486
431123,202303,424,1021,273,729,43,116,132,336,175,452
431125,202303,1476,3437,1065,2712,264,682,562,1407,826,2089
431127,202303,272,692,79,237,10,33,16,35,26,68
431130,202303,4223,9438,3301,8053,542,1460,1731,3938,2273,5398
431140,202303,7187,16300,4683,11709,588,1654,2186,4559,2774,6213
431142,202303,808,1745,611,1447,86,235,402,908,488,1143
431150,202303,1281,3091,941,2514,125,373,513,1289,638,1662
431160,202303,827,2034,554,1509,151,437,169,414,320,851
431162,202303,719,1676,507,1296,47,159,298,688,345,847
431164,202303,204,464,58,176,6,16,11,27,17,43
431170,202303,582,1440,436,1160,116,295,95,226,211,521
431171,202303,1175,2285,987,2061,155,326,737,1507,892,1833
431173,202303,570,1359,406,1130,121,394,125,294,246,688
431175,202303,1624,3530,1008,2491,148,358,465,1073,613,1431
431177,202303,1175,2743,887,2309,163,480,493,1215,656,1695
431179,202303,390,846,135,383,27,79,41,112,68,191
431180,202303,3019,7325,1916,5199,424,1149,411,919,835,2068
431190,202303,717,1711,313,867,26,75,74,134,100,209
431198,202303,506,1355,416,1185,93,263,174,496,267,759
431200,202303,388,948,122,332,26,64,17,44,43,108
431205,202303,298,739,166,464,48,135,50,131,98,266
431210,202303,806,1729,647,1494,126,303,338,779,464,1082
431213,202303,339,826,253,663,22,63,125,291,147,354
431215,202303,744,1706,388,1071,47,146,178,444,225,590
431217,202303,212,503,143,371,26,74,61,139,87,213
431220,202303,747,1730,483,1261,107,293,238,549,345,842
431225,202303,1984,4077,1540,3407,160,386,1055,2263,1215,2649
431230,202303,912,2286,685,1793,137,414,340,748,477,1162
431235,202303,202,542,33,106,0,0,8,24,8,24
431237,202303,450,1261,345,1045,51,171,176,510,227,681
431238,202303,47,150,39,132,9,38,18,49,27,87
431240,202303,6929,15189,5662,13242,583,1690,3702,7935,4285,9625
431242,202303,392,873,320,738,45,117,184,390,229,507
431244,202303,479,1093,250,630,49,114,92,198,141,312
431245,202303,1585,3460,1056,2580,106,266,513,1144,619,1410
431247,202303,353,807,234,595,39,117,104,215,143,332
431250,202303,2455,5390,1901,4638,419,1019,962,2351,1381,3370
431260,202303,393,984,239,677,22,87,100,249,122,336
431261,202303,350,948,288,843,28,100,166,441,194,541
431262,202303,330,895,177,557,26,95,89,267,115,362
431265,202303,1905,4294,770,2100,139,424,209,434,348,858
431267,202303,303,707,197,514,25,77,118,279,143,356
431270,202303,3580,7344,1970,4731,464,1206,688,1501,1152,2707
431275,202303,194,497,132,358,22,72,75,176,97,248
431280,202303,324,872,158,487,28,85,38,107,66,192
431290,202303,445,1259,302,929,53,169,47,117,100,286
431295,202303,95,235,39,111,10,31,11,27,21,58
431300,202303,368,952,103,300,15,51,31,67,46,118
431301,202303,313,863,90,289,14,44,10,27,24,71
431303,202303,822,1909,506,1312,34,106,225,481,259,587
431306,202303,2895,6476,1821,4690,239,672,757,1668,996,2340
431308,202303,51,141,42,119,15,44,15,41,30,85
431310,202303,652,1560,435,1130,75,179,201,487,276,666
431320,202303,859,2203,531,1556,84,271,170,424,254,695
431330,202303,2429,5393,1380,3588,175,521,695,1586,870,2107
431333,202303,250,637,145,417,28,80,39,102,67,182
431335,202303,43,117,27,87,8,23,1,4,9,27
431337,202303,5316,10997,4503,9858,221,709,3744,7705,3965,8414
431339,202303,553,1311,383,1024,91,237,140,370,231,607
431340,202303,24599,55385,18051,44763,2455,6934,9569,21605,12024,28539
431342,202303,490,1064,364,866,49,127,242,561,291,688
431344,202303,429,1041,242,681,37,100,132,353,169,453
431346,202303,254,610,96,289,17,54,25,60,42,114
431349,202303,1240,2595,834,1841,138,342,491,997,629,1339
431350,202303,6245,14136,4916,12104,650,1794,3000,6854,3650,8648
431360,202303,703,1583,366,956,101,287,107,230,208,517
431365,202303,3070,5991,2426,5155,127,342,2003,4060,2130,4402
431370,202303,6470,13801,4844,11357,848,2225,2703,5914,3551,8139
431380,202303,1161,2812,929,2447,202,557,507,1306,709,1863
431390,202303,3432,7850,2260,5903,242,769,1229,2768,1471,3537
431395,202303,2292,4613,1795,3921,172,406,1274,2642,1446,3048
431400,202303,383,1017,220,653,41,126,43,107,84,233
431402,202303,1121,2284,833,1868,91,225,560,1179,651,1404
431403,202303,234,629,182,526,45,148,66,164,111,312
431405,202303,7346,17293,5813,14818,981,2852,2894,6658,3875,9510
431406,202303,706,1779,470,1292,120,299,145,428,265,727
431407,202303,662,1649,430,1174,78,204,186,477,264,681
431410,202303,25073,56220,18196,45151,2305,6751,10847,24100,13152,30851
431413,202303,307,835,77,235,5,14,24,57,29,71
431415,202303,915,2112,619,1618,121,371,255,556,376,927
431417,202303,680,1371,427,979,69,185,228,497,297,682
431420,202303,2140,4301,1623,3629,116,296,1118,2345,1234,2641
431430,202303,695,1666,355,1010,54,165,115,290,169,455
431440,202303,49558,102098,38518,86349,5635,14760,22026,43651,27661,58411
431442,202303,195,526,96,301,12,41,12,36,24,77
431445,202303,772,1676,494,987,13,43,383,618,396,661
431446,202303,366,973,291,833,32,103,158,429,190,532
431447,202303,933,2229,521,1430,84,231,171,462,255,693
431449,202303,993,2303,667,1716,95,249,348,810,443,1059
431450,202303,3197,5585,2520,4699,199,311,1970,3547,2169,3858
431454,202303,53,165,44,143,9,33,23,71,32,104
431455,202303,665,1485,351,881,38,85,165,383,203,468
431460,202303,4006,8399,2652,6135,521,1310,1144,2442,1665,3752
431470,202303,1737,4334,1253,3405,241,708,458,1155,699,1863
431475,202303,310,819,64,210,3,12,8,14,11,26
431477,202303,583,1365,334,896,85,208,110,274,195,482
431478,202303,295,785,61,193,9,26,8,17,17,43
431480,202303,4275,10139,3415,8820,779,2082,1371,3388,2150,5470
431490,202303,175692,362091,138227,306694,7565,21398,105826,219434,113391,240832
431500,202303,594,1383,446,1124,66,166,231,549,297,715
431505,202303,309,690,214,551,22,51,146,376,168,427
431507,202303,361,834,147,418,38,116,23,52,61,168
431510,202303,2129,5030,1451,3742,497,1327,359,899,856,2226
431513,202303,263,554,143,358,30,94,45,80,75,174
431514,202303,155,366,127,322,6,17,81,182,87,199
431515,202303,685,1462,522,1188,118,284,275,592,393,876
431517,202303,85,236,69,204,8,30,31,86,39,116
431520,202303,449,1057,191,535,29,103,77,165,106,268
431530,202303,6711,13815,4119,9944,910,2278,1734,3916,2644,6194
431531,202303,270,610,159,411,30,75,56,145,86,220
431532,202303,751,1569,443,1043,75,192,215,475,290,667
431535,202303,359,897,176,500,26,70,38,91,64,161
431540,202303,2254,6113,2033,5816,109,332,1563,4511,1672,4843
431545,202303,423,987,105,255,13,28,47,105,60,133
431550,202303,2793,6400,1991,4960,240,684,1088,2502,1328,3186
431555,202303,852,1774,507,1209,45,117,283,664,328,781
431560,202303,33187,73752,23189,58567,4262,10575,9519,23870,13781,34445
431570,202303,7082,13665,6115,12341,356,913,5094,9681,5450,10594
431575,202303,483,1055,416,951,74,164,252,534,326,698
431580,202303,847,2006,580,1509,66,219,335,768,401,987
431590,202303,1021,2591,680,1865,171,503,233,544,404,1047
431595,202303,450,1116,292,800,58,172,103,246,161,418
431600,202303,2345,5292,1678,4263,294,840,714,1605,1008,2445
431610,202303,1815,3973,1176,2882,202,493,464,1195,666,1688
431620,202303,570,1343,310,794,57,184,170,350,227,534
431630,202303,1605,3728,758,2080,184,547,218,515,402,1062
431640,202303,8976,18095,7486,16173,908,2221,5047,10431,5955,12652
431642,202303,801,1690,501,1173,92,210,238,506,330,716
431643,202303,459,1088,218,592,21,47,81,204,102,251
431645,202303,3138,5453,2497,4660,34,76,2210,3989,2244,4065
431647,202303,374,865,127,364,14,31,20,45,34,76
431650,202303,182,487,135,409,19,64,61,155,80,219
431660,202303,1080,2666,559,1645,91,311,135,329,226,640
431670,202303,1533,3419,922,2338,139,382,453,1016,592,1398
431673,202303,251,634,105,337,12,43,34,92,46,135
431675,202303,429,1053,113,373,13,45,16,35,29,80
431680,202303,12882,28273,9778,23021,1870,5067,5018,10520,6888,15587
431690,202303,35765,78510,26293,62575,4005,11178,14758,31839,18763,43017
431695,202303,282,648,178,461,25,100,101,211,126,311
431697,202303,581,1246,441,1034,81,187,248,575,329,762
431700,202303,1852,4041,1440,3364,234,491,751,1769,985,2260
431710,202303,19609,39676,14703,33149,1708,4380,9528,20324,11236,24704
431720,202303,8991,19975,5508,14039,1381,3774,1147,2347,2528,6121
431725,202303,45,114,32,90,10,34,13,31,23,65
431730,202303,5855,12490,3982,9759,738,1997,1990,4446,2728,6443
431740,202303,6630,14755,4532,11422,996,2822,1393,3037,2389,5859
431750,202303,10995,25432,7975,20637,1932,5286,2761,6760,4693,12046
431755,202303,376,983,101,323,12,43,17,46,29,89
431760,202303,6967,14547,4906,11299,525,1484,3025,6221,3550,7705
431770,202303,2631,5354,1996,4513,370,788,1237,2799,1607,3587
431775,202303,265,636,146,407,31,100,39,86,70,186
431780,202303,2657,5933,1761,4386,323,874,572,1309,895,2183
431790,202303,956,2400,659,1823,143,420,273,716,416,1136
431795,202303,313,752,154,442,22,57,41,105,63,162
431800,202303,10629,23300,6983,17808,1923,5795,838,1737,2761,7532
431805,202303,323,804,73,249,3,5,3,5,6,10
431810,202303,4133,8611,2710,6206,400,1037,1531,3158,1931,4195
431820,202303,2808,6606,2156,5649,486,1427,941,2306,1427,3733
431830,202303,11054,22920,8082,18925,2391,6356,1287,3003,3678,9359
431840,202303,3698,8178,2985,7134,468,1226,1796,4141,2264,5367
431842,202303,594,1397,206,582,40,117,33,77,73,194
431843,202303,371,947,251,692,60,187,105,253,165,440
431844,202303,212,567,81,260,19,62,17,53,36,115
431845,202303,601,1425,395,1032,33,95,233,584,266,679
431846,202303,376,809,327,741,14,37,292,646,306,683
431848,202303,192,476,110,311,11,36,30,64,41,100
431849,202303,417,1008,81,226,11,34,13,23,24,57
431850,202303,5457,13355,4163,10998,1035,2944,1230,2989,2265,5933
431860,202303,842,1848,467,1153,68,192,286,653,354,845
431861,202303,125,320,78,223,17,57,27,61,44,118
431862,202303,623,1827,510,1637,99,378,239,713,338,1091
431870,202303,31154,69363,25115,60454,2404,6755,16628,37356,19032,44111
431880,202303,5166,12022,3823,9787,498,1519,2072,4848,2570,6367
431890,202303,6346,14595,4103,10466,1123,2966,1041,2482,2164,5448
431900,202303,1343,3127,891,2354,151,452,416,951,567,1403
431910,202303,931,2093,371,974,58,162,97,192,155,354
431912,202303,694,1542,571,1350,82,200,363,832,445,1032
431915,202303,1475,3030,1184,2598,70,174,944,1988,1014,2162
431920,202303,1700,3251,1387,2870,36,87,1225,2469,1261,2556
431930,202303,916,2159,631,1663,204,538,205,528,409,1066
431935,202303,101,251,75,208,10,27,14,29,24,56
431936,202303,385,968,216,579,39,112,116,292,155,404
431937,202303,188,455,120,329,28,67,39,101,67,168
431940,202303,3760,8038,2496,5915,167,463,1621,3555,1788,4018
431950,202303,2858,6524,2216,5516,518,1386,921,2133,1439,3519
431960,202303,3782,8419,2855,6857,828,2100,713,1619,1541,3719
431970,202303,534,1291,254,669,43,134,76,147,119,281
431971,202303,93,228,50,146,12,34,14,39,26,73
431973,202303,717,1958,494,1514,47,141,342,1050,389,1191
431975,202303,133,268,43,110,10,29,12,22,22,51
431980,202303,1606,3394,1267,2900,135,407,865,1754,1000,2161
431990,202303,8996,19203,6461,15753,423,1279,4304,9963,4727,11242
432000,202303,20347,42286,15549,35271,1742,4676,10356,21653,12098,26329
432010,202303,3558,7682,2417,5928,550,1383,860,1927,1410,3310
432020,202303,1957,4872,1255,3449,393,1143,219,562,612,1705
432023,202303,669,1478,329,856,38,94,148,333,186,427
432026,202303,1261,3072,980,2557,288,761,346,937,634,1698
432030,202303,564,1253,322,843,28,78,186,437,214,515
432032,202303,410,989,270,715,23,70,137,308,160,378
432035,202303,893,2255,740,1998,181,472,328,892,509,1364
432040,202303,1127,2643,539,1506,57,187,236,554,293,741
432045,202303,237,586,137,395,19,65,59,155,78,220
432050,202303,707,1614,524,1314,69,214,264,627,333,841
432055,202303,861,1986,583,1497,177,442,156,408,333,850
432057,202303,181,445,154,386,12,33,104,233,116,266
432060,202303,528,1221,157,474,17,57,29,74,46,131
432065,202303,285,708,221,582,53,162,107,256,160,418
432067,202303,1021,2546,853,2200,105,278,536,1351,641,1629
432070,202303,2090,4777,1559,3869,225,631,787,1744,1012,2375
432080,202303,6530,13573,4875,11169,856,2366,2365,4800,3221,7166
432085,202303,517,1271,408,1105,82,237,204,501,286,738
432090,202303,3468,8075,2130,5626,449,1128,884,2131,1333,3259
432100,202303,1155,2743,566,1650,96,275,82,185,178,460
432110,202303,2790,6465,2059,5260,455,1291,609,1290,1064,2581
432120,202303,4684,11371,3834,10023,612,1854,1975,4677,2587,6531
432130,202303,3573,7911,2961,7077,533,1288,1465,3504,1998,4792
432132,202303,330,830,179,504,26,89,89,211,115,300
432135,202303,1265,2616,855,1954,96,219,527,1220,623,1439
432140,202303,2489,6033,2021,5229,242,705,1335,3277,1577,3982
432143,202303,1985,4702,1499,3951,137,408,929,2356,1066,2764
432145,202303,2272,5587,1506,4121,243,745,486,1036,729,1781
432146,202303,164,417,133,379,49,155,34,88,83,243
432147,202303,696,1775,380,1102,124,372,61,175,185,547
432149,202303,621,1385,291,736,34,86,125,281,159,367
432150,202303,5353,11969,4097,10013,800,2285,2104,4469,2904,6754
432160,202303,8474,19124,6499,16235,1562,4202,2564,6048,4126,10250
432162,202303,237,511,42,115,7,20,9,11,16,31
432163,202303,211,502,45,125,2,6,9,15,11,21
432166,202303,830,2093,672,1812,126,374,242,555,368,929
432170,202303,1951,4864,1360,3811,242,740,531,1313,773,2053
432180,202303,3642,8040,1948,4994,273,798,901,1973,1174,2771
432183,202303,493,1286,384,1066,72,247,192,478,264,725
432185,202303,1091,2541,669,1763,131,392,324,766,455,1158
432190,202303,2862,6200,2100,5063,171,522,1434,3143,1605,3665
432195,202303,1260,3017,784,2140,147,414,246,651,393,1065
432200,202303,4825,10598,3712,8959,293,759,2628,6043,2921,6802
432210,202303,524,1223,360,937,44,117,189,433,233,550
432215,202303,796,1983,652,1739,77,182,355,981,432,1163
432218,202303,270,619,130,342,17,50,45,87,62,137
432220,202303,4700,9956,3387,7887,562,1383,1880,4073,2442,5456
432225,202303,204,507,141,386,24,59,55,151,79,210
432230,202303,950,2159,462,1249,61,195,170,371,231,566
432232,202303,614,1409,393,1032,71,203,183,428,254,631
432234,202303,355,850,191,532,37,94,47,114,84,208
432235,202303,64,160,36,90,6,18,19,40,25,58
432237,202303,381,903,330,819,12,29,276,668,288,697
432240,202303,22417,47852,16834,40677,1605,3824,11439,27167,13044,30991
432250,202303,9059,22070,6893,17964,1197,3517,3757,9013,4954,12530
432252,202303,600,1349,390,958,51,147,197,430,248,577
432253,202303,1164,3016,822,2219,237,684,205,478,442,1162
432254,202303,754,1702,233,652,27,83,44,90,71,173
432255,202303,130,316,83,225,9,27,41,94,50,121
432260,202303,7638,17194,5761,13955,1071,2938,2974,6385,4045,9323
432270,202303,2927,6957,2383,6031,715,1851,816,2006,1531,3857
432280,202303,1552,3711,839,2370,129,409,254,573,383,982
432285,202303,161,477,34,99,4,10,9,25,13,35
432290,202303,439,1073,285,755,62,193,101,210,163,403
432300,202303,41180,89747,32316,76450,2660,7776,22856,50332,25516,58108
432310,202303,1332,2837,1027,2351,121,252,778,1784,899,2036
432320,202303,247,545,121,319,19,53,42,86,61,139
432330,202303,227,514,95,284,20,56,15,45,35,101
432335,202303,196,560,79,277,9,27,9,23,18,50
432340,202303,391,945,199,588,30,96,75,208,105,304
432345,202303,1086,1988,932,1809,15,40,821,1541,836,1581
432350,202303,378,888,194,553,39,131,62,141,101,272
432360,202303,261,749,55,176,4,13,15,42,19,55
432370,202303,440,990,244,657,25,74,132,337,157,411
432375,202303,644,1467,441,1086,141,367,133,326,274,693
432377,202303,197,574,47,168,4,14,12,33,16,47
432380,202303,2480,6350,1724,4965,278,888,821,2246,1099,3134
500020,202303,4403,9757,3093,7787,332,995,2009,4827,2341,5822
500025,202303,1421,3248,913,2350,116,311,499,1217,615,1528
500060,202303,10557,26414,7618,20603,936,2755,4356,11386,5292,14141
500070,202303,6560,14780,4762,11913,861,2357,2272,5433,3133,7790
500080,202303,1963,4485,1239,3252,198,575,491,1131,689,1706
500085,202303,2573,5928,1807,4624,439,1225,703,1610,1142,2835
500090,202303,2566,6160,1764,4872,279,826,507,1478,786,2304
500100,202303,5021,11605,3731,9605,606,1718,1552,3666,2158,5384
500110,202303,13628,30392,9444,23954,1854,5128,4491,10867,6345,15995
500124,202303,2789,6998,2248,6195,335,910,1380,3803,1715,4713
500150,202303,2000,4120,1413,3351,223,607,780,1667,1003,2274
500190,202303,6419,15273,4262,11317,909,2568,1412,3312,2321,5880
500200,202303,3426,7243,2292,5441,202,511,1417,3137,1619,3648
500210,202303,6549,13711,4712,11400,1270,3248,2330,5375,3600,8623
500215,202303,1793,4494,1331,3734,142,419,715,1956,857,2375
500220,202303,4347,10614,3240,8813,440,1275,1723,4315,2163,5590
500230,202303,2709,5830,2100,5003,293,750,1305,2958,1598,3708
500240,202303,5332,14177,3913,11401,529,1675,1585,4558,2114,6233
500260,202303,4132,8206,2659,6208,269,714,1624,3510,1893,4224
500270,202303,194412,422697,129272,321096,17039,48692,61193,134310,78232,183002
500280,202303,1739,3971,1138,3080,185,488,627,1687,812,2175
500290,202303,4724,10689,2913,7713,452,1402,1081,2484,1533,3886
500295,202303,5348,11809,3636,8978,555,1555,1630,3469,2185,5024
500310,202303,1348,2486,880,1916,121,213,496,1069,617,1282
500315,202303,6237,13246,5164,11846,300,784,4316,9609,4616,10393
500320,202303,26315,63738,18369,51060,4475,12188,7498,21706,11973,33894
500325,202303,7822,15794,5579,12791,667,1700,3522,7621,4189,9321
500330,202303,8767,18390,5830,14219,581,1492,3308,7948,3889,9440
500345,202303,2806,6440,1920,5042,351,982,674,1601,1025,2583
500348,202303,3027,6890,2324,5767,191,544,1604,3849,1795,4393
500350,202303,1487,3829,869,2572,107,353,299,783,406,1136
500370,202303,36110,86694,26894,72214,3585,10965,13159,33353,16744,44318
500375,202303,3271,8039,2051,5653,259,775,747,1761,1006,2536
500380,202303,4551,10547,3158,8283,881,2321,506,1326,1387,3647
500390,202303,899,1728,548,1315,82,223,349,833,431,1056
500400,202303,2040,4884,1386,3676,222,656,511,1181,733,1837
500410,202303,3041,6541,2121,5262,234,561,1157,2975,1391,3536
500430,202303,3596,8210,2473,6589,400,1064,947,2737,1347,3801
500440,202303,2042,4573,1144,3047,201,550,434,1147,635,1697
500450,202303,2489,5763,1576,4278,305,856,403,998,708,1854
500460,202303,4917,11988,3066,8533,534,1655,650,1601,1184,3256
500470,202303,3555,8917,2404,6691,547,1710,686,1563,1233,3273
500480,202303,2397,6903,1963,6221,213,721,1359,4343,1572,5064
500490,202303,1458,3233,886,2372,168,532,216,560,384,1092
500500,202303,5206,12750,3472,10123,1103,3722,349,1015,1452,4737
500510,202303,900,2127,606,1609,54,190,366,845,420,1035
500515,202303,2085,4955,1589,4211,217,617,834,2173,1051,2790
500520,202303,4364,11350,3335,9655,727,2089,1588,4689,2315,6778
500525,202303,1269,3373,1014,2989,148,474,564,1586,712,2060
500540,202303,6634,16239,4049,11761,1077,3498,658,1567,1735,5065
500560,202303,7265,17115,5889,15400,272,821,4834,12537,5106,13358
500568,202303,5914,11989,3759,8830,781,1893,1599,3348,2380,5241
500570,202303,11465,24432,8063,19093,1035,2886,4660,9893,5695,12779
500580,202303,3975,9390,2866,7533,720,1959,1142,2918,1862,4877
500600,202303,4697,10934,3401,8929,779,2165,934,2327,1713,4492
500620,202303,10590,25193,7409,19478,1062,2967,3779,9134,4841,12101
500625,202303,715,1788,498,1382,71,228,220,545,291,773
500627,202303,1003,2578,628,1920,110,360,175,490,285,850
500630,202303,10048,21031,6038,14830,1260,3421,1939,4284,3199,7705
500635,202303,3291,9815,2413,8566,309,998,1525,5949,1834,6947
500640,202303,2236,4484,1514,3564,71,171,1050,2350,1121,2521
500660,202303,27571,62337,18926,49960,5387,14914,6494,16853,11881,31767
500690,202303,3501,8271,2361,6465,818,2459,754,1945,1572,4404
500710,202303,4277,10449,3051,8370,696,2114,854,2166,1550,4280
500720,202303,6407,15356,4317,11978,846,2529,1336,3421,2182,5950
500730,202303,1307,2948,739,1974,145,364,245,638,390,1002
500740,202303,5865,13093,3760,9904,899,2407,1343,3420,2242,5827
500750,202303,1432,3257,1021,2599,134,385,467,1047,601,1432
500755,202303,1444,3487,919,2539,158,490,260,590,418,1080
500769,202303,6629,15416,3692,10133,858,2373,451,1078,1309,3451
500770,202303,1791,4482,1259,3647,234,710,418,1173,652,1883
500780,202303,1621,3802,1053,2830,177,531,256,544,433,1075
500790,202303,9805,24268,7098,19497,1330,4007,2623,6899,3953,10906
500793,202303,2684,6283,1926,5006,361,1014,779,1785,1140,2799
500795,202303,3862,8011,3142,7083,189,447,2603,5856,2792,6303
500797,202303,1053,2443,719,1852,235,667,210,485,445,1152
500800,202303,4485,9521,2854,7137,684,1948,726,1748,1410,3696
500830,202303,27182,62077,18256,46510,3803,10355,6520,15061,10323,25416
500840,202303,1815,4089,1165,2900,121,324,576,1270,697,1594
510010,202303,2258,4561,1627,3781,216,500,1075,2477,1291,2977
510020,202303,5207,12521,2914,8194,488,1387,734,1834,1222,3221
510025,202303,9641,21661,6312,16541,686,1968,3514,8588,4200,10556
510030,202303,3986,8149,2586,6033,211,517,1360,3089,1571,3606
510035,202303,1395,3506,900,2711,229,704,315,1014,544,1718
510040,202303,3086,6292,2300,5314,308,693,1381,3264,1689,3957
510050,202303,2898,5442,2047,4397,217,559,1481,3024,1698,3583
510060,202303,1985,4735,1371,3651,335,961,281,580,616,1541
510080,202303,1945,4650,1263,3548,187,590,479,1113,666,1703
510100,202303,897,1849,645,1483,71,182,391,818,462,1000
510120,202303,335,564,197,406,9,18,154,299,163,317
510125,202303,2612,6224,1983,5244,250,795,914,2135,1164,2930
510130,202303,2093,4784,1500,3890,295,859,737,1757,1032,2616
510140,202303,3817,9437,2614,7844,1009,3301,743,2269,1752,5570
510160,202303,2546,5404,1973,4682,49,137,1776,4178,1825,4315
510170,202303,6441,15161,4926,12817,851,2481,2447,5991,3298,8472
510180,202303,19383,39379,13308,31160,1870,4729,7054,16458,8924,21187
510185,202303,2195,5348,1446,4276,532,1651,410,1383,942,3034
510190,202303,3126,8030,1988,6207,465,1585,459,1413,924,2998
510250,202303,22705,51591,16921,43178,2435,6824,9605,24118,12040,30942
510260,202303,2297,9168,1923,8559,280,1206,1149,5769,1429,6975
510263,202303,4992,12962,3372,9839,577,1835,799,1901,1376,3736
510267,202303,7248,19528,4348,13169,710,2270,829,2100,1539,4370
510268,202303,1543,3819,1074,3039,265,784,229,554,494,1338
510269,202303,1174,2972,776,2256,151,481,325,871,476,1352
510270,202303,3727,9954,2615,8076,398,1370,1065,3173,1463,4543
510279,202303,2274,5502,1312,3788,185,578,394,1004,579,1582
510285,202303,1331,3286,861,2478,209,660,283,710,492,1370
510300,202303,5291,11587,4011,9932,267,712,2980,7287,3247,7999
510305,202303,1905,4862,1297,3808,277,830,421,1208,698,2038
510310,202303,1353,3095,965,2493,260,643,344,924,604,1567
510320,202303,5217,11756,3524,9080,778,2229,1068,2382,1846,4611
510325,202303,5643,15357,3881,12002,890,2945,811,2412,1701,5357
510330,202303,3359,8713,2277,6966,530,1783,932,2767,1462,4550
510335,202303,6278,16318,4777,13951,910,2881,2434,6977,3344,9858
510336,202303,645,1684,469,1419,68,187,250,821,318,1008
510337,202303,1877,4987,1236,3873,423,1462,295,835,718,2297
510340,202303,128606,268086,89390,213816,17662,49125,39890,84927,57552,134052
510343,202303,1597,3546,1079,2738,119,341,603,1415,722,1756
510345,202303,1717,4180,1302,3460,236,676,684,1624,920,2300
510350,202303,4094,9659,2738,7505,753,2133,675,1772,1428,3905
510360,202303,2476,4543,1481,3405,59,116,1077,2565,1136,2681
510370,202303,2266,5897,1742,5108,301,847,1019,3084,1320,3931
510380,202303,678,1541,400,1089,48,156,163,418,211,574
510385,202303,1560,4762,1177,4096,109,435,795,2829,904,3264
510390,202303,1818,3942,1242,3274,218,629,786,2020,1004,2649
510395,202303,868,1737,576,1331,45,92,378,880,423,972
510410,202303,6831,16507,5144,13813,701,1970,3276,8708,3977,10678
510420,202303,3363,6091,2334,4753,65,143,1878,3725,1943,3868
510450,202303,662,1496,396,1070,88,241,140,340,228,581
510452,202303,1196,3070,899,2523,125,371,522,1447,647,1818
510454,202303,1527,3692,1063,2924,191,495,588,1739,779,2234
510455,202303,1158,2902,761,2166,141,444,301,776,442,1220
510460,202303,2500,5852,1759,4759,643,1995,476,889,1119,2884
510480,202303,6153,13965,4055,10245,704,1961,1747,3913,2451,5874
510490,202303,2192,4980,1634,4279,223,562,1057,2830,1280,3392
510500,202303,1861,4277,1130,3161,271,812,274,730,545,1542
510510,202303,5053,12971,3514,10441,1045,3415,1012,2895,2057,6310
510515,202303,6969,16824,4871,13300,896,2641,1893,4720,2789,7361
510517,202303,2051,4870,1430,3982,509,1598,421,1025,930,2623
510520,202303,2851,5544,1526,3818,170,454,667,1719,837,2173
510523,202303,1470,3223,1050,2606,153,419,615,1428,768,1847
510525,202303,10583,27204,7797,21918,1499,4546,2786,7061,4285,11607
510530,202303,717,1679,543,1449,41,124,389,1019,430,1143
510550,202303,3296,8667,2496,7339,486,1511,1246,3545,1732,5056
510558,202303,2820,7108,2063,5970,284,788,1043,3174,1327,3962
510560,202303,2428,6456,1572,4840,383,1251,286,877,669,2128
510562,202303,7714,16723,5773,13601,912,2295,3038,6558,3950,8853
510590,202303,4145,9265,3007,7808,296,825,2129,5480,2425,6305
510600,202303,1552,3083,1075,2429,232,660,509,931,741,1591
510610,202303,3546,7769,2481,6366,341,1047,1483,3608,1824,4655
510615,202303,3615,8406,2543,6763,420,1172,1381,3610,1801,4782
510617,202303,1350,3663,1079,3261,136,434,765,2390,901,2824
510618,202303,1629,3913,1170,3211,224,715,605,1554,829,2269
510619,202303,931,2244,521,1505,115,334,105,229,220,563
510620,202303,1741,3696,842,2288,300,910,72,146,372,1056
510621,202303,1980,4993,1208,3607,277,867,321,829,598,1696
510622,202303,7198,18516,4588,13206,1254,3839,628,1524,1882,5363
510623,202303,3513,8005,2530,6529,516,1443,993,2442,1509,3885
510624,202303,2059,5098,1117,3402,120,410,208,543,328,953
510625,202303,4565,10260,2827,7340,533,1514,950,2388,1483,3902
510626,202303,1741,4119,1179,3261,294,914,280,727,574,1641
510627,202303,795,1924,456,1302,116,351,121,364,237,715
510628,202303,1841,3820,1160,2962,371,1075,412,943,783,2018
510629,202303,2234,5751,1426,4246,315,1043,349,970,664,2013
510630,202303,4298,10945,2760,8303,620,1916,652,2111,1272,4027
510631,202303,743,1595,570,1358,24,47,442,1065,466,1112
510637,202303,4610,10009,3266,8167,844,2364,1173,2747,2017,5111
510642,202303,7441,18636,5765,16278,1018,3311,3319,8986,4337,12297
510645,202303,1275,2371,757,1706,201,446,310,698,511,1144
510650,202303,9618,20805,7510,18515,961,1481,5423,14810,6384,16291
510665,202303,2156,4409,1369,3224,289,640,550,1378,839,2018
510670,202303,523,1071,321,806,37,89,170,429,207,518
510675,202303,8527,21755,5832,16873,1413,4583,1159,2871,2572,7454
510677,202303,2817,6704,2008,5526,348,1042,1093,2943,1441,3985
510680,202303,881,2128,497,1457,90,291,130,314,220,605
510682,202303,2198,5713,1643,4844,510,1667,570,1582,1080,3249
510685,202303,666,1710,487,1390,49,130,285,807,334,937
510700,202303,5502,11935,3795,9554,385,1152,2545,6112,2930,7264
510704,202303,14577,32238,9918,24781,2258,6077,3205,7086,5463,13163
510706,202303,3144,8487,2187,6887,413,1335,879,2947,1292,4282
510710,202303,3749,8618,2356,6130,629,1624,571,1323,1200,2947
510715,202303,804,1603,509,1192,50,135,318,708,368,843
510718,202303,2842,6252,1725,4762,318,893,811,2502,1129,3395
510719,202303,588,1175,335,822,44,132,154,303,198,435
510720,202303,1136,2433,761,1920,165,473,323,729,488,1202
510724,202303,1108,2954,750,2270,100,345,320,878,420,1223
510726,202303,1109,2026,655,1486,67,148,376,834,443,982
510729,202303,733,1610,341,906,31,92,115,291,146,383
510730,202303,3698,8289,2537,6577,370,1122,1346,3139,1716,4261
510735,202303,1650,4203,1336,3758,122,315,1051,2980,1173,3295
510740,202303,1222,2722,843,2096,70,201,534,1184,604,1385
510757,202303,646,1947,504,1712,128,495,212,660,340,1155
510760,202303,58095,120063,36386,88647,7436,20649,13361,28101,20797,48750
510770,202303,5366,10692,3844,8815,226,496,2801,6491,3027,6987
510774,202303,510,1222,354,993,62,172,189,552,251,724
510775,202303,851,2036,534,1541,121,376,140,373,261,749
510776,202303,952,2311,648,1730,114,340,297,756,411,1096
510777,202303,1729,4327,1232,3687,232,793,727,2028,959,2821
510779,202303,1016,2535,749,2105,90,232,459,1352,549,1584
510780,202303,5480,12330,3941,10135,713,1753,1997,5459,2710,7212
510785,202303,2659,6450,1567,4533,342,1056,448,1259,790,2315
510787,202303,4438,11633,3057,9019,997,3041,305,790,1302,3831
510788,202303,667,1456,436,1112,66,152,188,546,254,698
510790,202303,25225,61655,16095,45875,3173,9936,1585,3840,4758,13776
510792,202303,13838,36170,9069,27171,2067,6780,1971,5023,4038,11803
510794,202303,1616,4152,1147,3397,344,1160,206,475,550,1635
510795,202303,14031,33033,9988,26329,2185,6439,3566,8317,5751,14756
510800,202303,1849,4648,1278,3720,349,1110,161,340,510,1450
510805,202303,1895,4891,1214,3660,246,802,445,1219,691,2021
510810,202303,841,1606,542,1220,164,329,263,629,427,958
510820,202303,969,1754,563,1257,26,64,377,800,403,864
510830,202303,1103,2433,840,2098,97,252,550,1404,647,1656
510835,202303,767,1645,492,1264,56,163,303,736,359,899
510840,202303,81086,156963,59152,130585,9212,19902,36137,79923,45349,99825
510850,202303,2229,5372,1409,4079,324,1025,98,177,422,1202
510860,202303,3391,8244,2270,6538,780,2428,446,1264,1226,3692
510880,202303,896,2395,646,1961,189,590,127,366,316,956
510885,202303,754,1770,488,1355,97,253,114,312,211,565
510890,202303,1055,2733,750,2201,214,694,199,536,413,1230
510895,202303,1892,4466,1245,3386,212,691,594,1421,806,2112
520005,202303,4757,11399,3802,10149,1207,2948,1396,4430,2603,7378
520010,202303,3738,9098,2743,7251,576,1676,1104,2488,1680,4164
520013,202303,4542,10617,2952,7792,756,1990,766,2121,1522,4111
520015,202303,642,1510,469,1258,102,265,168,482,270,747
520017,202303,1517,3509,1051,2786,189,570,444,1039,633,1609
520020,202303,706,1259,549,1080,54,99,418,803,472,902
520025,202303,50683,122087,43295,111870,6336,17267,27371,69207,33707,86474
520030,202303,9129,19127,7594,17105,595,1306,5791,12823,6386,14129
520050,202303,500,1150,284,750,52,126,118,310,170,436
520055,202303,2121,4949,1288,3267,207,510,523,1217,730,1727
520060,202303,2424,5717,1650,4425,302,904,420,1074,722,1978
520080,202303,2353,5443,1797,4718,380,961,864,2353,1244,3314
520082,202303,1007,2406,702,1886,141,414,264,717,405,1131
520085,202303,1274,2911,1024,2584,239,591,474,1168,713,1759
520090,202303,1147,2049,841,1723,115,157,644,1390,759,1547
520110,202303,57094,139913,39212,110557,10292,31253,2980,7155,13272,38408
520120,202303,312,698,169,446,25,82,63,146,88,228
520130,202303,4974,10941,3803,9136,723,1838,1578,3581,2301,5419
520140,202303,66091,161149,46382,128698,14993,44659,5671,15440,20664,60099
520145,202303,746,1607,470,1206,104,278,163,373,267,651
520150,202303,874,1950,664,1686,81,205,373,904,454,1109
520160,202303,1106,2494,750,1865,134,306,320,803,454,1109
520170,202303,5959,11734,3957,9312,487,1233,2583,5838,3070,7071
520180,202303,3562,8148,2893,7231,379,1094,1882,4495,2261,5589
520215,202303,2291,5010,1702,4172,196,553,1039,2404,1235,2957
520235,202303,959,1873,638,1443,94,247,401,845,495,1092
520250,202303,2186,5081,1594,4197,608,1733,215,659,823,2392
520260,202303,931,2070,563,1475,110,283,194,500,304,783
520280,202303,1066,2201,835,1870,197,444,396,864,593,1308
520310,202303,1253,2509,831,1907,184,492,385,851,569,1343
520320,202303,2582,6118,1941,5140,279,745,986,2634,1265,3379
520330,202303,6503,15110,5058,12803,700,2127,3006,6959,3706,9086
520340,202303,2832,5763,1671,4125,187,417,801,2103,988,2520
520350,202303,4221,9557,2942,7608,954,2561,853,2184,1807,4745
520355,202303,2410,6061,1759,4886,510,1507,280,677,790,2184
520357,202303,1099,2352,797,1933,33,85,633,1512,666,1597
520360,202303,1014,2332,795,1996,124,360,377,859,501,1219
520380,202303,1712,4057,1018,2812,165,467,292,689,457,1156
520390,202303,1512,3302,955,2537,247,744,189,518,436,1262
520393,202303,886,1891,608,1487,86,228,278,617,364,845
520396,202303,1112,2515,935,2251,59,138,652,1493,711,1631
520400,202303,2028,4405,1569,3813,96,241,1150,2785,1246,3026
520410,202303,2842,5721,1963,4483,277,718,1122,2362,1399,3080
520420,202303,476,984,373,832,21,58,280,594,301,652
520425,202303,1929,4454,1082,2872,294,835,204,441,498,1276
520430,202303,3138,6848,1878,4773,374,947,314,687,688,1634
520440,202303,3773,8628,2196,5845,437,1302,475,1165,912,2467
520450,202303,18214,40747,12603,32029,3170,8402,3455,8501,6625,16903
520455,202303,1023,2436,714,1986,198,567,206,583,404,1150
520460,202303,1332,2900,1015,2474,226,496,555,1430,781,1926
520465,202303,1140,2440,932,2173,53,151,715,1623,768,1774
520470,202303,3003,6691,2339,5870,776,2102,883,2201,1659,4303
520480,202303,1265,3150,940,2621,213,600,395,1049,608,1649
520485,202303,1913,5238,1529,4646,253,838,803,2330,1056,3168
520490,202303,5441,12813,4185,10950,666,1882,2426,6109,3092,7991
520495,202303,2065,3927,1558,3267,120,262,1139,2340,1259,2602
520500,202303,2270,5067,1699,4126,271,751,904,1976,1175,2727
520505,202303,1212,2251,949,1934,110,182,715,1459,825,1641
520510,202303,13047,29235,9897,24582,1634,4744,4908,11122,6542,15866
520520,202303,1477,3430,1139,2942,306,848,456,1137,762,1985
520530,202303,3168,7701,2302,6224,447,1210,1058,3027,1505,4237
520540,202303,3908,9423,2652,7144,459,1326,851,2006,1310,3332
520545,202303,1864,4169,1444,3545,355,887,637,1507,992,2394
520547,202303,1784,4232,1389,3570,286,727,695,1762,981,2489
520549,202303,21927,50373,18173,45080,2222,6152,12083,28525,14305,34677
520551,202303,6585,14786,5472,13225,461,1382,4125,9455,4586,10837
520552,202303,1213,2881,951,2503,229,605,454,1215,683,1820
520570,202303,688,1443,435,1056,73,155,191,457,264,612
520580,202303,2792,5695,2093,4891,422,960,1136,2674,1558,3634
520590,202303,1749,4030,1208,3168,266,720,460,1147,726,1867
520620,202303,12543,29177,10173,25899,1805,4999,5694,14006,7499,19005
520630,202303,1106,2536,777,2026,94,244,342,859,436,1103
520640,202303,2875,6504,2137,5232,521,1297,622,1574,1143,2871
520650,202303,1353,2663,996,2193,216,432,506,1166,722,1598
520660,202303,651,1541,380,1082,77,233,96,272,173,505
520670,202303,1220,2848,999,2522,99,223,675,1669,774,1892
520680,202303,1067,2273,850,1979,129,260,533,1252,662,1512
520690,202303,443,1020,305,804,89,223,87,211,176,434
520710,202303,567,1265,384,971,26,70,235,548,261,618
520725,202303,1762,3913,1182,2977,216,597,532,1270,748,1867
520735,202303,1159,2530,788,1949,228,534,246,604,474,1138
520740,202303,3314,6999,2339,5671,479,1173,1049,2508,1528,3681
520750,202303,944,1952,679,1583,100,245,386,848,486,1093
520753,202303,1653,3936,1249,3260,224,658,598,1425,822,2083
520760,202303,1862,3538,1559,3183,32,64,1430,2919,1462,2983
520780,202303,1930,4299,1416,3576,204,518,709,1720,913,2238
520790,202303,3982,8786,2727,6808,423,968,1425,3718,1848,4686
520800,202303,23968,54551,18818,47074,3300,8445,10533,26293,13833,34738
520810,202303,1510,2989,1117,2537,270,614,536,1326,806,1940
520815,202303,738,2093,537,1671,94,299,160,480,254,779
520830,202303,2207,4367,1590,3638,94,215,1211,2718,1305,2933
520840,202303,3711,9052,2962,8060,818,2460,1005,2664,1823,5124
520850,202303,1188,2387,885,1971,172,452,436,905,608,1357
520860,202303,12077,29356,8893,23940,2162,6127,3104,7900,5266,14027
520870,202303,198064,420471,144386,341314,26639,67180,67219,147318,93858,214498
520880,202303,12412,32229,9954,27919,2083,6000,4138,11158,6221,17158
520890,202303,6236,12675,4384,9949,685,1853,2356,4860,3041,6713
520910,202303,5789,13532,3876,10272,799,2256,1064,2485,1863,4741
520915,202303,1015,2448,683,1812,124,371,286,691,410,1062
520920,202303,5898,11861,4311,9965,842,1803,2321,5530,3163,7333
520929,202303,790,1753,600,1474,108,208,257,679,365,887
520940,202303,1206,2894,942,2502,81,243,690,1767,771,2010
520945,202303,582,1204,424,995,38,76,253,584,291,660
520960,202303,1439,2975,1104,2509,390,839,397,986,787,1825
520970,202303,4699,11103,3525,9291,1189,3206,723,1994,1912,5200
520980,202303,988,2089,718,1742,102,251,354,804,456,1055
520990,202303,3951,8573,3223,7697,526,1114,2186,5348,2712,6462
520993,202303,1550,3531,1020,2587,256,675,343,803,599,1478
520995,202303,3192,7372,2315,6041,562,1574,535,1467,1097,3041
521000,202303,12373,29322,8295,22025,1293,3562,2698,6509,3991,10071
521010,202303,5129,11883,3760,9586,560,1582,1960,4631,2520,6213
521015,202303,988,2252,691,1742,45,117,448,1062,493,1179
521020,202303,5658,12952,3497,9142,759,2119,912,2209,1671,4328
521030,202303,1024,1731,800,1441,26,55,690,1196,716,1251
521040,202303,10894,24800,7972,20336,1961,5051,2462,6548,4423,11599
521056,202303,1320,3186,907,2492,261,696,185,539,446,1235
521060,202303,1245,3010,862,2311,189,555,289,730,478,1285
521080,202303,1281,2610,703,1741,127,326,265,609,392,935
521090,202303,3959,9958,2649,7374,619,1875,283,698,902,2573
521100,202303,2490,5067,1852,4219,245,585,1168,2637,1413,3222
521120,202303,6465,14273,4869,12247,1212,2947,1415,4122,2627,7069
521130,202303,1286,2856,598,1600,64,186,303,800,367,986
521140,202303,2088,4757,1521,3804,193,487,883,2079,1076,2566
521150,202303,18262,38056,11946,28997,2947,7874,4758,10898,7705,18772
521160,202303,1043,1974,660,1394,65,121,433,879,498,1000
521170,202303,1380,2977,992,2395,155,416,454,993,609,1409
521180,202303,11134,26325,8610,22273,1727,4854,3882,9668,5609,14522
521190,202303,14698,34203,9595,25990,2240,6580,2833,7052,5073,13632
521200,202303,904,2049,610,1593,89,257,274,642,363,899
521205,202303,766,1667,588,1398,27,66,460,1046,487,1112
521210,202303,1059,2650,638,1798,151,471,148,300,299,771
521220,202303,4957,10741,3298,8181,817,2312,1274,2760,2091,5072
521225,202303,546,1042,410,895,33,70,315,690,348,760
521230,202303,1853,4242,1530,3816,648,1693,461,1118,1109,2811
521250,202303,48445,109672,39499,97661,8929,23946,21569,50836,30498,74782
521260,202303,675,1412,498,1164,67,190,286,606,353,796
521270,202303,2693,5807,2225,5217,229,491,1593,3804,1822,4295
521280,202303,2324,5718,1729,4778,339,1015,631,1689,970,2704
521290,202303,726,1517,484,1202,49,136,284,654,333,790
521295,202303,1478,3000,1105,2518,171,369,630,1373,801,1742
521300,202303,2322,5232,1743,4387,352,863,890,2250,1242,3113
521305,202303,834,1776,570,1418,55,148,358,858,413,1006
521308,202303,6125,14753,4270,11478,396,1161,2605,6608,3001,7769
521310,202303,14167,32791,9750,25113,1931,5479,3817,8861,5748,14340
521340,202303,514,1078,342,844,30,67,188,445,218,512
521350,202303,2423,5693,1833,4821,126,366,1309,3333,1435,3699
521370,202303,1618,3920,1049,2998,323,993,171,508,494,1501
521375,202303,2059,4969,1380,3799,271,743,331,957,602,1700
521377,202303,1688,3328,1222,2748,149,283,869,2075,1018,2358
521380,202303,8115,20160,5230,14992,819,2490,986,2851,1805,5341
521385,202303,873,1921,651,1634,94,211,348,928,442,1139
521390,202303,858,2080,584,1643,137,448,108,270,245,718
521400,202303,3797,8133,2994,7095,399,1009,1814,4162,2213,5171
521405,202303,1698,4181,1128,3118,131,394,541,1408,672,1802
521410,202303,1184,2591,934,2230,227,482,475,1192,702,1674
521440,202303,1855,4174,1407,3517,419,998,600,1553,1019,2551
521450,202303,5383,14502,4021,11952,994,3018,888,2636,1882,5654
521460,202303,7941,18616,5642,14613,1435,3903,1847,4541,3282,8444
521470,202303,1061,2424,728,1841,133,302,334,805,467,1107
521480,202303,655,1342,448,1014,62,156,245,476,307,632
521483,202303,2965,6601,2136,5386,611,1509,757,1947,1368,3456
521486,202303,2210,4882,1693,4148,153,286,1087,2652,1240,2938
521487,202303,606,1292,443,1078,87,206,268,649,355,855
521490,202303,1074,2583,796,2144,36,122,572,1439,608,1561
521500,202303,2600,6166,1971,5300,192,706,1153,2843,1345,3549
521520,202303,1070,2246,833,1931,123,249,490,1139,613,1388
521523,202303,18662,49337,14393,41394,4284,12871,5513,15071,9797,27942
521525,202303,1340,2937,1013,2471,97,296,657,1502,754,1798
521530,202303,2859,6979,1819,4979,337,936,513,1280,850,2216
521540,202303,992,2338,714,1898,165,499,288,699,453,1198
521550,202303,2164,5143,1136,3110,208,608,263,746,471,1354
521560,202303,7254,16771,5272,14095,1510,4133,2100,5774,3610,9907
521565,202303,854,1959,589,1526,111,289,251,632,362,921
521570,202303,5452,13519,3785,10535,767,2354,505,1373,1272,3727
521580,202303,707,1515,456,1115,77,205,183,398,260,603
521590,202303,1102,2201,791,1778,99,227,475,1002,574,1229
521600,202303,540,1304,329,916,62,194,146,357,208,551
521630,202303,2164,4367,1338,3193,410,1021,343,737,753,1758
521640,202303,2476,5476,1574,4108,351,1051,452,1068,803,2119
521645,202303,653,1588,366,1065,153,428,19,39,172,467
521680,202303,1835,4520,1426,3880,355,1005,559,1468,914,2473
521690,202303,675,1562,562,1412,84,227,316,759,400,986
521710,202303,4497,10138,2985,7658,508,1463,835,1802,1343,3265
521720,202303,3143,6535,2009,4851,257,677,1096,2551,1353,3228
521730,202303,5246,13035,3839,10696,1006,3141,867,1975,1873,5116
521740,202303,5998,13821,4739,12023,1521,4183,1470,3335,2991,7518
521760,202303,24914,56564,20415,50427,3947,11118,11695,27125,15642,38243
521770,202303,4195,9126,2720,6878,516,1336,596,1466,1112,2802
521800,202303,9085,21549,6464,17356,1971,5420,1711,5015,3682,10435
521805,202303,1437,2778,940,2123,198,412,453,1091,651,1503
521810,202303,955,2024,690,1660,124,302,389,945,513,1247
521830,202303,7759,18740,6278,16480,525,1608,4473,11267,4998,12875
521839,202303,1128,2372,862,1965,82,215,605,1270,687,1485
521850,202303,8672,18785,5553,14060,1749,4405,677,1602,2426,6007
521860,202303,2085,5280,1441,4113,248,771,434,1109,682,1880
521870,202303,894,2254,660,1839,116,369,246,569,362,938
521878,202303,1046,2539,683,1822,65,185,354,863,419,1048
521880,202303,31707,71632,22986,58334,4762,12987,10092,23848,14854,36835
521890,202303,4343,10209,2945,7873,765,2048,768,1906,1533,3954
521900,202303,1714,3798,923,2467,237,526,21,49,258,575
521910,202303,1810,3657,1269,2985,305,694,483,1094,788,1788
521920,202303,704,1636,544,1388,65,197,340,800,405,997
521925,202303,1030,2416,760,2017,147,431,338,849,485,1280
521930,202303,6963,15665,4706,12361,1418,3157,1757,5119,3175,8276
521935,202303,1266,2836,874,2187,87,229,514,1205,601,1434
521940,202303,1709,3454,1135,2664,191,490,596,1345,787,1835
521945,202303,824,1908,566,1465,91,236,290,732,381,968
521950,202303,930,2034,646,1600,99,248,306,746,405,994
521960,202303,850,2047,575,1541,57,189,337,817,394,1006
521970,202303,3563,7364,2702,6302,257,518,1991,4769,2248,5287
521971,202303,980,2246,655,1708,154,390,164,398,318,788
521973,202303,2104,5029,1538,4056,189,500,887,2246,1076,2746
521975,202303,17908,41152,14592,36547,2450,6720,8669,20823,11119,27543
521980,202303,2878,6175,2149,5220,148,368,1606,3854,1754,4222
521990,202303,1876,4106,1585,3703,279,731,980,2256,1259,2987
522000,202303,3439,8162,2651,7152,948,2727,902,2461,1850,5188
522005,202303,499,1054,320,800,51,136,114,270,165,406
522010,202303,5962,13711,4200,10841,907,2512,1470,3493,2377,6005
522015,202303,1360,3218,1007,2696,271,758,403,1029,674,1787
522020,202303,6926,14994,4670,11625,982,2537,2022,4973,3004,7510
522026,202303,975,2356,634,1764,103,344,191,440,294,784
522028,202303,651,1456,451,1124,71,211,222,485,293,696
522040,202303,4852,9635,3366,7637,416,1078,2067,4243,2483,5321
522045,202303,26937,67403,20315,56590,4472,13254,5250,13775,9722,27029
522050,202303,1525,3609,1088,2878,200,596,465,1051,665,1647
522060,202303,3952,9605,2870,7907,545,1443,1216,3345,1761,4788
522068,202303,2350,5016,1887,4481,124,246,1516,3644,1640,3890
522070,202303,1070,2070,878,1794,27,55,763,1513,790,1568
522100,202303,1127,2594,734,1933,113,308,326,797,439,1105
522108,202303,1463,2966,1149,2549,59,152,902,1907,961,2059
522119,202303,2535,5331,2026,4719,347,704,1217,2893,1564,3597
522130,202303,679,1492,520,1281,41,86,390,981,431,1067
522140,202303,32025,75505,22606,59125,4803,13419,6764,15908,11567,29327
522145,202303,977,2170,690,1755,146,415,358,871,504,1286
522150,202303,1404,3051,942,2344,211,530,288,689,499,1219
522155,202303,1270,3036,952,2535,142,347,528,1399,670,1746
522157,202303,942,1862,764,1651,46,93,581,1257,627,1350
522160,202303,7992,18737,5185,13973,1315,3829,528,1507,1843,5336
522170,202303,3461,8181,2657,6982,384,1008,1589,4142,1973,5150
522180,202303,946,1998,628,1441,118,283,194,455,312,738
522185,202303,31595,71049,23311,60166,9526,26823,4019,10834,13545,37657
522190,202303,1033,2151,701,1650,137,342,322,672,459,1014
522200,202303,2706,6750,1999,5556,502,1395,703,1921,1205,3316
522205,202303,1989,4523,1452,3716,502,1370,359,840,861,2210
522220,202303,1484,3221,1094,2712,137,326,650,1648,787,1974
522230,202303,1674,3679,1308,3154,177,481,794,1836,971,2317
530010,202303,348064,814921,293366,733488,41429,112942,175731,416179,217160,529121
110001,202302,4945,12779,3312,9772,776,2548,1040,2914,1816,5462
110002,202302,17257,40689,12616,33182,3204,9107,3581,8963,6785,18070
110003,202302,905,2488,656,2007,157,505,143,380,300,885
110004,202302,17594,41286,12182,32310,2646,7481,4253,10662,6899,18143
110005,202302,3164,7704,2258,6290,522,1461,691,1979,1213,3440
110006,202302,1765,4708,1119,3417,198,675,222,615,420,1290
110007,202302,1519,3630,972,2721,275,784,202,627,477,1411
110008,202302,4298,10019,3213,8545,645,1517,1774,5271,2419,6788
110009,202302,5586,14452,3611,10941,798,2648,1292,3693,2090,6341
110010,202302,10199,28013,7841,23978,1887,5252,3556,12455,5443,17707
110011,202302,9506,23119,6621,18168,1823,5220,1443,3764,3266,8984
110012,202302,22006,50977,14715,39107,3714,10040,3518,8727,7232,18767
110013,202302,7139,18690,4944,14532,1808,5693,812,2354,2620,8047
110014,202302,4793,11486,3197,8616,496,1475,1541,3962,2037,5437
110015,202302,7602,17910,4952,13250,1015,3081,1513,3347,2528,6428
110018,202302,5671,13280,3635,9861,753,2172,876,2118,1629,4290
110020,202302,117414,245002,89965,208939,18558,44472,47147,109112,65705,153584
110025,202302,5918,13372,4241,10642,659,1868,2235,5255,2894,7123
110026,202302,707,1776,503,1440,119,359,144,427,263,786
110028,202302,9244,21952,5938,16355,1443,4477,662,1740,2105,6217
110029,202302,1924,4454,1198,3252,219,584,471,1272,690,1856
110030,202302,17603,38654,11207,29251,3189,9006,1538,4056,4727,13062
110032,202302,4608,11795,2805,8260,894,2663,477,1448,1371,4111
110033,202302,5917,16057,4452,13423,1383,4279,1452,4597,2835,8876
110034,202302,3901,8717,2639,6956,924,2700,631,1776,1555,4476
110037,202302,1913,5292,1334,4225,366,1206,392,1212,758,2418
110040,202302,3613,9339,2608,7595,676,2140,654,1735,1330,3875
110045,202302,5581,14781,4105,12197,1166,3743,1348,3923,2514,7666
110050,202302,2117,5347,1398,4122,470,1573,172,399,642,1972
110060,202302,1146,3153,759,2279,188,585,174,506,362,1091
110070,202302,1895,5431,1345,4258,357,1234,315,855,672,2089
110080,202302,8088,17976,6047,15294,1354,3527,2880,7490,4234,11017
110090,202302,739,1882,512,1473,122,413,150,401,272,814
110092,202302,1682,4478,1204,3615,273,858,575,1724,848,2582
110094,202302,3447,9337,2560,7706,938,2991,361,1126,1299,4117
110100,202302,2200,5800,1726,4972,630,1913,514,1471,1144,3384
110110,202302,2205,5510,1567,4524,468,1464,299,912,767,2376
110120,202302,1638,4291,1156,3384,281,864,311,879,592,1743
110130,202302,3368,7789,2072,5559,413,1134,265,680,678,1814
110140,202302,3050,7961,2273,6513,466,1484,1017,2733,1483,4217
110143,202302,1744,4398,1264,3567,354,1122,393,1020,747,2142
110145,202302,1170,2831,718,1997,182,494,273,787,455,1281
110146,202302,642,1581,434,1242,134,363,142,450,276,813
110147,202302,968,2287,651,1730,88,266,327,764,415,1030
110148,202302,1176,3028,617,1846,142,473,67,147,209,620
110149,202302,4245,10074,2919,8056,991,2850,673,1936,1664,4786
110150,202302,3051,7383,1967,5667,612,1940,297,893,909,2833
110155,202302,1046,2801,726,2069,143,464,294,734,437,1198
110160,202302,1781,4900,1284,3887,456,1428,221,665,677,2093
110170,202302,2577,6086,1678,4490,268,798,947,2332,1215,3130
110175,202302,2647,6891,1819,5196,330,1019,783,2105,1113,3124
110180,202302,1615,4018,1138,3143,170,490,527,1425,697,1915
120001,202302,4354,10951,3513,9731,500,1618,2268,6084,2768,7702
120005,202302,2448,8246,2182,7819,257,944,1606,5892,1863,6836
120010,202302,7769,18428,6741,17042,605,1402,5202,13241,5807,14643
120013,202302,3128,8858,2681,8243,848,2527,1141,3945,1989,6472
120017,202302,3804,9104,3215,8302,430,1076,2113,5724,2543,6800
120020,202302,19767,60704,18259,58125,1280,4470,14397,45648,15677,50118
120025,202302,4701,10546,3874,9619,567,1396,2542,6604,3109,8000
120030,202302,7704,27384,7131,26448,515,2190,5351,20360,5866,22550
120032,202302,2117,8330,1989,8084,100,619,1670,6670,1770,7289
120033,202302,5415,16157,5073,15597,129,558,4450,13476,4579,14034
120034,202302,3600,10675,3115,9915,159,653,2596,8110,2755,8763
120035,202302,5160,15900,4787,15288,256,951,4099,12977,4355,13928
120038,202302,4049,10403,3483,9564,539,1570,2109,5908,2648,7478
120039,202302,2490,9354,2321,9040,148,748,1862,7199,2010,7947
120040,202302,77464,186321,67097,171564,8530,23170,44403,111711,52933,134881
120042,202302,4357,13106,4007,12513,201,767,3316,10205,3517,10972
120043,202302,1833,6460,1551,6052,53,335,1287,4937,1340,5272
120045,202302,7486,16967,6275,15513,567,1519,4745,11702,5312,13221
120050,202302,12354,36456,11381,35130,535,1978,9605,29598,10140,31576
120060,202302,12259,40421,11202,38915,496,2301,9582,33089,10078,35390
120070,202302,4310,11829,3697,11000,644,1783,2263,7196,2907,8979
120080,202302,6980,16083,6258,15097,732,1737,4752,11504,5484,13241
130002,202302,4139,13192,3641,12530,434,1144,2899,10564,3333,11708
130006,202302,3183,9905,2648,9083,606,1895,1478,5619,2084,7514
130008,202302,3292,9859,2833,9218,186,597,2253,7548,2439,8145
130010,202302,5477,12743,4720,11885,158,368,4267,10753,4425,11121
130014,202302,4928,12318,3675,10455,719,2074,2027,6061,2746,8135
130020,202302,3413,12002,2985,11409,135,736,2426,9171,2561,9907
130030,202302,20123,40863,18807,39404,199,498,18008,37380,18207,37878
130040,202302,4942,13302,4068,12204,570,1621,2911,9056,3481,10677
130050,202302,9003,29199,7629,27451,427,1439,6506,23980,6933,25419
130060,202302,9026,32123,7698,30440,388,2169,6418,24987,6806,27156
130063,202302,7850,22786,6938,21770,200,869,6303,19702,6503,20571
130068,202302,4688,13407,3941,12447,215,856,3129,9828,3344,10684
130070,202302,9231,23434,7579,21624,719,1710,5822,17307,6541,19017
130080,202302,9508,28013,8178,26502,403,1170,7031,23252,7434,24422
130083,202302,3523,10028,3080,9485,267,818,2451,7779,2718,8597
130090,202302,5161,12536,4590,11892,105,227,4067,10837,4172,11064
130100,202302,9212,25430,7693,23822,160,424,7084,22250,7244,22674
130110,202302,11054,26432,9018,23935,1763,4187,5606,16342,7369,20529
130115,202302,6322,17268,5445,16273,151,434,4704,14276,4855,14710
130120,202302,20540,56347,18301,53534,1521,4847,15208,44339,16729,49186
130130,202302,7347,19309,5704,17237,638,1808,4062,13057,4700,14865
130140,202302,8836,26927,7745,25690,349,1385,6692,22294,7041,23679
130150,202302,4798,14360,4507,14039,72,370,4188,13009,4260,13379
130160,202302,8075,21434,6977,20112,375,926,6081,17841,6456,18767
130165,202302,4119,13411,3871,13127,160,608,3448,11737,3608,12345
130170,202302,17782,39915,14849,36705,445,1376,13328,32647,13773,34023
130180,202302,5388,15182,5148,14924,39,227,4976,14356,5015,14583
130185,202302,25417,53023,21017,48322,1753,2272,17670,43002,19423,45274
130190,202302,26053,72286,21390,65750,1905,5616,16214,50490,18119,56106
130195,202302,3039,9864,2569,9300,115,453,2153,7943,2268,8396
130200,202302,3813,8843,3120,7947,204,635,2490,6182,2694,6817
130210,202302,1983,6468,1781,6226,157,680,1425,4925,1582,5605
130220,202302,3197,8822,2640,8169,91,289,2348,7416,2439,7705
130230,202302,6236,21670,5454,20644,201,1046,4820,18261,5021,19307
130240,202302,18095,40203,15120,36576,148,669,14125,33655,14273,34324
130250,202302,32472,85375,27755,79969,1719,4236,22765,67669,24484,71905
130255,202302,6199,16528,5300,15052,260,674,4308,12228,4568,12902
130260,202302,470652,1028475,402645,941151,72878,183986,263518,599446,336396,783432
130270,202302,12220,37365,10144,34330,1985,6178,6344,22630,8329,28808
130280,202302,4622,15099,4211,14636,145,571,3878,13527,4023,14098
130290,202302,21814,51371,19664,48876,621,1685,18104,44787,18725,46472
130300,202302,6188,17598,5493,16695,143,620,4735,14241,4878,14861
130310,202302,10893,24853,9659,23407,483,1097,8457,20518,8940,21615
130320,202302,4316,12757,3590,11766,468,1438,2536,8637,3004,10075
130330,202302,5660,15650,4553,14357,229,797,3799,12207,4028,13004
130340,202302,31424,79749,27051,74928,1606,3852,22901,65342,24507,69194
130350,202302,4605,15104,4112,14486,162,749,3567,12548,3729,13297
130353,202302,9951,23650,8113,21306,1278,3070,5400,14854,6678,17924
130356,202302,7100,19167,6022,17589,1157,3307,3560,10898,4717,14205
130360,202302,3664,10862,2955,9990,89,374,2616,8863,2705,9237
130370,202302,6184,24435,5192,22996,764,4063,3097,13776,3861,17839
130380,202302,9556,37349,8938,36459,754,3571,7159,29162,7913,32733
130390,202302,8970,30172,7860,28588,398,1830,6937,25088,7335,26918
130395,202302,3103,8576,2572,7762,177,621,2081,6144,2258,6765
130400,202302,3595,9534,3052,8830,98,304,2700,7835,2798,8139
130406,202302,14506,44833,12321,42179,2490,7782,8053,29063,10543,36845
130410,202302,5512,16788,4766,15672,1270,4267,2571,8812,3841,13079
130420,202302,19028,56030,16038,52359,2084,6611,11361,38181,13445,44792
130423,202302,5380,15170,4672,14341,225,934,4087,12326,4312,13260
130426,202302,3928,12131,3524,11689,67,198,3109,10865,3176,11063
130430,202302,6255,13615,5392,12554,201,478,4812,11065,5013,11543
130440,202302,7345,17305,6314,16095,138,426,5914,15028,6052,15454
140002,202302,3070,8029,2643,7526,226,579,2069,6125,2295,6704
140005,202302,4106,10643,3568,10016,1054,2927,2035,6003,3089,8930
140010,202302,65483,167229,52977,149355,12956,38486,21022,60367,33978,98853
140015,202302,6807,14403,5862,13380,340,681,5187,12055,5527,12736
140017,202302,7387,16709,6508,15657,412,937,5427,13240,5839,14177
140020,202302,7188,17413,6163,16173,477,1277,4787,12716,5264,13993
140023,202302,3501,8856,2811,7926,321,972,2126,6034,2447,7006
140028,202302,2566,5923,2155,5424,136,358,1673,4217,1809,4575
140030,202302,8042,16350,7295,15510,346,490,6637,14411,6983,14901
140040,202302,3602,12280,3303,11901,107,536,3009,10804,3116,11340
140045,202302,4609,14494,4017,13719,1084,2954,2188,8638,3272,11592
140047,202302,7697,19711,6454,17941,842,2415,4405,12460,5247,14875
140050,202302,2213,5602,1870,5120,320,778,1217,3498,1537,4276
140060,202302,2783,5897,2492,5523,255,493,2059,4628,2314,5121
140070,202302,2510,11810,2425,11658,155,1041,2066,9741,2221,10782
150010,202302,66071,134066,59444,125924,1379,2653,53657,112419,55036,115072
150013,202302,2780,5688,2349,5224,146,246,1980,4497,2126,4743
150020,202302,19229,47982,17639,45882,1759,3615,14090,37961,15849,41576
150030,202302,11497,35695,10346,34374,790,2073,8344,29820,9134,31893
150034,202302,5495,11649,4439,10367,266,588,3666,8656,3932,9244
150040,202302,20316,46786,17815,44042,1149,1515,15717,40763,16866,42278
150050,202302,9947,26508,8985,25276,244,651,8151,23202,8395,23853
150060,202302,30061,72300,24365,64056,3563,9479,15337,40757,18900,50236
150070,202302,11039,30577,9789,29128,226,832,9088,26987,9314,27819
150080,202302,116153,244864,96000,218707,25898,58716,32923,84746,58821,143462
150085,202302,12285,27251,11179,25979,162,367,10559,24571,10721,24938
150090,202302,15934,40120,14855,38449,600,1571,13089,33481,13689,35052
150095,202302,9240,19495,8108,18150,925,1185,6609,15636,7534,16821
150100,202302,3666,11260,3214,10563,216,686,2620,8728,2836,9414
150110,202302,5764,19455,5353,19010,172,650,4932,17804,5104,18454
150120,202302,10052,26748,9286,25840,363,676,8257,23455,8620,24131
150125,202302,1113,2565,813,2151,101,314,511,1309,612,1623
150130,202302,31080,77492,26617,71002,5221,12334,15968,45358,21189,57692
150140,202302,381033,727967,326525,659975,29894,60930,238847,469324,268741,530254
150145,202302,5141,14703,4208,13247,1570,4865,1377,5132,2947,9997
150150,202302,22882,49448,19403,45168,1596,3495,14646,34053,16242,37548
150157,202302,4516,11044,3556,9744,445,1229,2286,6435,2731,7664
150160,202302,5137,10732,4749,10232,388,947,3863,8070,4251,9017
150170,202302,36447,90811,32516,84780,5474,12366,21039,58417,26513,70783
150172,202302,7282,15996,5922,14218,333,825,4682,11179,5015,12004
150175,202302,2468,6080,2085,5484,175,606,1589,3962,1764,4568
150178,202302,15956,33129,12208,28879,1246,1663,9584,24620,10830,26283
150180,202302,36245,90824,32710,86944,2849,4668,26481,76153,29330,80821
150190,202302,9793,23773,9012,22870,135,434,8431,21241,8566,21675
150195,202302,6492,17544,6013,16898,180,622,5472,15266,5652,15888
150200,202302,7333,18417,6599,17588,55,166,6068,16198,6123,16364
150210,202302,41462,105726,39083,102928,1390,3393,34990,93066,36380,96459
150215,202302,13453,34217,11490,31102,1934,5423,6912,18514,8846,23937
150220,202302,17435,41105,15244,38198,856,2064,11823,29237,12679,31301
150230,202302,17899,41750,15880,39112,1206,2606,12257,30557,13463,33163
150240,202302,45875,110274,38510,98740,8141,21412,17948,43953,26089,65365
150250,202302,5306,17495,4966,17128,429,1512,4302,15031,4731,16543
150260,202302,3611,9602,3158,8952,110,327,2669,7530,2779,7857
150270,202302,11200,28601,7921,22927,2210,6670,2211,6504,4421,13174
150275,202302,9748,24295,8915,23228,193,692,7977,20333,8170,21025
150276,202302,2924,7091,2546,6639,305,713,1791,5051,2096,5764
150277,202302,7119,15312,5648,13638,699,1709,4046,9947,4745,11656
150280,202302,9196,29598,8823,29060,659,1704,7383,25313,8042,27017
150285,202302,4394,12726,3783,11760,239,692,2946,9219,3185,9911
150290,202302,13960,32168,12616,30760,528,782,11389,28463,11917,29245
150293,202302,12298,26740,9628,23331,1042,2591,6704,16155,7746,18746
150295,202302,9257,22333,6496,18513,2145,6033,2172,7077,4317,13110
150300,202302,4277,8656,3938,8255,34,91,3739,7768,3773,7859
150304,202302,5482,14031,4582,12688,682,1695,3096,8930,3778,10625
150307,202302,7132,19950,6405,18808,296,839,5147,15124,5443,15963
150309,202302,8081,20513,6520,18067,904,2429,4030,11399,4934,13828
150310,202302,9011,30902,8449,30206,296,1285,7414,26855,7710,28140
150320,202302,11732,27342,10606,25794,908,2013,7966,19497,8874,21510
150330,202302,19047,50090,17533,48095,2382,5020,12155,36552,14537,41572
150340,202302,2978,7962,2608,7451,320,846,1874,5390,2194,6236
150345,202302,11474,26997,10118,25287,385,1063,8879,22000,9264,23063
150350,202302,12895,26135,11598,24522,904,1442,9785,20981,10689,22423
150360,202302,31745,77172,25505,69508,2535,4866,19197,54863,21732,59729
150370,202302,14403,36825,11801,33401,1534,3637,8373,25293,9907,28930
150375,202302,4895,17509,4418,16860,273,1031,3854,14856,4127,15887
150380,202302,13064,28925,10530,25641,284,840,8990,21554,9274,22394
150390,202302,9540,33748,8396,31904,1825,5857,5005,21005,6830,26862
150400,202302,8182,25386,7726,24682,144,500,6626,21749,6770,22249
150405,202302,11179,25335,9589,23456,786,1320,7565,19267,8351,20587
150410,202302,2414,6499,2038,5923,188,485,1423,4190,1611,4675
150420,202302,59178,141675,46606,123981,10599,29662,22474,60847,33073,90509
150430,202302,10259,25771,9289,24592,665,1273,7859,21218,8524,22491
150440,202302,8428,19880,7623,18866,488,1152,6398,15777,6886,16929
150442,202302,39335,78489,33226,71363,2026,4362,26549,55767,28575,60129
150445,202302,10201,23669,9161,22267,168,445,8425,20303,8593,20748
150450,202302,8054,23852,7507,23160,302,1435,6881,20705,7183,22140
150460,202302,10881,29450,9828,28155,531,1241,8171,24295,8702,25536
150470,202302,25916,61106,23091,57730,439,1514,21026,51877,21465,53391
150475,202302,6933,18734,5857,17093,959,2466,3792,11671,4751,14137
150480,202302,17971,47498,16133,44944,3595,8474,10115,30862,13710,39336
150490,202302,10124,31185,9090,29761,706,1948,7173,24399,7879,26347
150495,202302,6900,18789,6456,18224,168,659,5887,16448,6055,17107
150497,202302,3409,9549,2703,8367,537,1712,1451,4706,1988,6418
150500,202302,3898,9066,3426,8412,203,514,2712,6483,2915,6997
150503,202302,7065,16753,5105,14267,1663,4211,1891,5889,3554,10100
150506,202302,16780,41029,14349,37826,2414,5832,9692,27097,12106,32929
150510,202302,15957,41411,13915,38193,1137,2919,10940,30093,12077,33012
150520,202302,10191,30854,9738,30326,149,832,9204,28401,9353,29233
150530,202302,15344,46046,13243,43101,1220,3347,10221,34204,11441,37551
150540,202302,6619,14747,5680,13389,336,751,4727,11031,5063,11782
150543,202302,9201,22902,7593,20876,670,1855,5687,16004,6357,17859
150548,202302,13158,34846,11646,32753,542,1474,10063,28479,10605,29953
150549,202302,2400,5998,1999,5436,86,269,1612,4349,1698,4618
150550,202302,25620,67445,20818,59958,5641,16704,7861,23321,13502,40025
150553,202302,48488,120568,37310,102372,9545,27018,15710,42791,25255,69809
150555,202302,2525,5966,1960,5137,178,434,1303,3517,1481,3951
150560,202302,2447,6034,2168,5572,233,579,1453,3707,1686,4286
150563,202302,3321,8747,2699,7680,560,1670,1431,4035,1991,5705
150565,202302,5521,15839,4869,14856,147,501,3858,11987,4005,12488
150570,202302,9971,23330,9138,22246,280,847,8180,19650,8460,20497
150580,202302,14270,48161,12166,45835,1632,4765,9295,37520,10927,42285
150590,202302,10488,30241,8977,28476,256,956,8101,25782,8357,26738
150600,202302,13150,34323,12134,33110,403,1011,10961,30176,11364,31187
150610,202302,4067,9094,3623,8460,139,403,3124,7094,3263,7497
150611,202302,4113,9683,3564,8942,83,282,3119,7633,3202,7915
150613,202302,18494,45986,14118,38975,2729,8070,6964,18511,9693,26581
150616,202302,4748,12005,3434,9782,667,2060,1587,4318,2254,6378
150618,202302,9107,22885,7390,20291,1052,3096,4521,12343,5573,15439
150619,202302,8244,20838,6706,18747,860,2054,4661,13591,5521,15645
150620,202302,9430,27071,8258,25157,1744,4897,4547,14666,6291,19563
150630,202302,8922,18693,8148,17771,154,378,7450,15986,7604,16364
150635,202302,6870,16206,5753,14475,698,1595,3761,9567,4459,11162
150640,202302,2570,6818,2316,6503,54,156,2087,5881,2141,6037
150650,202302,15266,36485,13247,33501,3682,8962,5861,15758,9543,24720
150655,202302,6967,17227,6276,16272,101,345,5638,14398,5739,14743
150658,202302,5521,14618,4000,12109,1031,3290,1688,5136,2719,8426
150660,202302,6966,17705,6053,16404,1275,3340,3411,9241,4686,12581
150670,202302,12763,24573,10163,21618,951,1964,7923,17157,8874,19121
150680,202302,99061,244435,79301,215530,17154,43879,41513,120135,58667,164014
150690,202302,3314,7086,2838,6523,138,253,2455,5744,2593,5997
150700,202302,8586,21472,7622,20302,927,1847,5595,15812,6522,17659
150710,202302,4755,13476,4247,12731,570,1624,2901,8928,3471,10552
150715,202302,6871,16201,5623,14468,319,805,4592,11780,4911,12585
150720,202302,10645,26105,9805,25002,346,1077,8700,21884,9046,22961
150730,202302,16636,44275,14138,40692,2032,6109,9654,28201,11686,34310
150740,202302,5002,12260,4312,11250,493,1042,3132,8435,3625,9477
150745,202302,6950,17049,5604,15193,715,2072,3891,10689,4606,12761
150746,202302,2167,5453,1919,5111,57,162,1593,4155,1650,4317
150747,202302,6871,16752,6109,15688,480,1068,4805,12471,5285,13539
150750,202302,4744,12541,3828,11238,430,1275,2659,8132,3089,9407
150760,202302,14672,37467,13161,35416,2526,6191,8215,23356,10741,29547
150770,202302,8864,25954,8117,25112,259,563,7377,23535,7636,24098
150775,202302,1485,3474,1169,3085,144,421,803,2104,947,2525
150780,202302,6203,16234,5489,15408,312,839,4842,13838,5154,14677
150790,202302,7811,18178,6576,16854,591,1149,4333,13255,4924,14404
150795,202302,21001,53347,18140,49346,3335,9043,11252,31335,14587,40378
150796,202302,5312,10527,4555,9676,212,404,3958,8407,4170,8811
150797,202302,5644,14395,4773,13184,547,1411,3694,10271,4241,11682
150800,202302,18331,49033,16323,46438,2818,7418,10563,31552,13381,38970
150803,202302,10941,25122,10064,23990,278,745,9124,21432,9402,22177
150805,202302,4498,12169,3784,11222,379,1064,2797,8497,3176,9561
150808,202302,8230,21897,6083,18428,2066,7016,889,2792,2955,9808
150810,202302,27312,60655,20848,52998,4603,11342,10865,30326,15468,41668
150812,202302,8292,18752,7356,17372,458,1384,5876,13177,6334,14561
150815,202302,11829,31147,9857,28816,1411,4128,7349,21869,8760,25997
150820,202302,19164,38596,16819,35891,1946,2907,13069,29643,15015,32550
150830,202302,16454,45870,15280,44455,638,1564,13609,40360,14247,41924
150835,202302,4474,11672,3822,10694,419,1203,2683,7442,3102,8645
150840,202302,10812,26697,8809,23673,1222,3696,5422,14001,6644,17697
160005,202302,1841,3838,1616,3578,69,184,1421,3104,1490,3288
160010,202302,2744,6669,2532,6447,20,83,2446,6190,2466,6273
160015,202302,5151,10349,4661,9800,85,210,4413,9198,4498,9408
160020,202302,3210,8116,2769,7550,354,820,2006,5783,2360,6603
160021,202302,1562,5055,1373,4827,67,281,998,3652,1065,3933
160023,202302,1756,5233,1553,4909,285,841,941,3141,1226,3982
160025,202302,2454,6154,2284,5971,64,104,2169,5729,2233,5833
160027,202302,14767,29650,13343,27954,788,1687,11572,24060,12360,25747
160030,202302,113215,263832,94404,240136,17521,42469,55889,149160,73410,191629
160040,202302,7737,21806,6804,20575,511,1442,5736,17597,6247,19039
160050,202302,8163,19336,6864,17703,2534,5586,3215,9781,5749,15367
160053,202302,5477,13962,4801,13047,285,689,3982,11050,4267,11739
160055,202302,2138,4027,2057,3939,32,91,1978,3749,2010,3840
160060,202302,39514,82530,33519,75863,3283,5963,26525,62151,29808,68114
160070,202302,3866,11666,3370,10945,441,1167,2399,8410,2840,9577
160080,202302,4060,10549,3538,9982,55,168,3261,9316,3316,9484
170025,202302,763,1899,465,1344,89,242,134,365,223,607
170030,202302,1361,3782,1004,3135,186,569,378,1215,564,1784
170035,202302,1776,4199,1297,3471,117,343,755,1909,872,2252
170040,202302,2273,5520,1750,4807,272,751,924,2647,1196,3398
170070,202302,2331,4934,1650,4085,95,250,967,2420,1062,2670
170100,202302,3020,7433,2435,6544,355,850,1511,4143,1866,4993
170105,202302,787,2085,511,1549,107,325,165,434,272,759
170110,202302,1258,3296,955,2818,74,291,574,1592,648,1883
170130,202302,1782,4393,1326,3662,122,386,848,2256,970,2642
170190,202302,1930,4472,1497,3832,209,665,905,2164,1114,2829
170200,202302,2442,5336,1594,4036,277,732,627,1484,904,2216
170210,202302,34044,84526,25736,71445,7069,21104,4777,13419,11846,34523
170215,202302,1537,3711,1207,3265,62,226,904,2387,966,2613
170220,202302,6945,19532,5638,17328,2279,7083,1325,4705,3604,11788
170230,202302,1516,3934,1134,3264,264,787,387,1060,651,1847
170240,202302,3601,8198,2879,7112,197,567,2129,5089,2326,5656
170255,202302,4567,12062,3364,10081,581,1819,1598,4764,2179,6583
170270,202302,1027,2343,696,1845,87,235,382,962,469,1197
170290,202302,3825,9352,3276,8629,292,550,2486,6851,2778,7401
170300,202302,2641,5945,2135,5224,151,353,1602,3805,1753,4158
170305,202302,799,1978,647,1723,80,205,344,923,424,1128
170307,202302,1311,3625,1086,3244,150,492,679,1925,829,2417
170310,202302,1913,4324,1356,3501,180,491,706,1779,886,2270
170320,202302,1285,3121,947,2589,123,381,555,1488,678,1869
170330,202302,1199,3220,1083,3055,28,123,949,2603,977,2726
170360,202302,698,1617,511,1340,26,82,333,795,359,877
170370,202302,1586,3637,1122,2925,186,499,570,1385,756,1884
170380,202302,2187,5653,1654,4851,136,445,956,2866,1092,3311
170382,202302,604,1601,486,1413,25,93,338,938,363,1031
170384,202302,2083,6318,1733,5713,335,1103,935,3035,1270,4138
170386,202302,1128,2910,694,2089,79,288,256,693,335,981
170388,202302,881,2133,636,1750,98,293,332,856,430,1149
170389,202302,991,2856,782,2494,88,304,475,1548,563,1852
170390,202302,2215,4336,1677,3712,39,105,1459,3230,1498,3335
170410,202302,745,1681,542,1366,29,97,374,873,403,970
170460,202302,488,1238,382,1069,51,151,239,665,290,816
170510,202302,1096,2759,783,2243,36,141,509,1327,545,1468
170550,202302,8268,19876,6268,16875,1671,4920,2039,5185,3710,10105
170555,202302,1649,3970,1296,3445,152,360,625,1711,777,2071
170560,202302,1199,2985,897,2572,106,279,512,1530,618,1809
170600,202302,1675,4081,1307,3553,223,557,737,2055,960,2612
170610,202302,2020,4615,1497,3860,116,356,1001,2456,1117,2812
170625,202302,529,1271,361,981,51,128,134,331,185,459
170650,202302,1805,4421,1471,3923,136,435,983,2495,1119,2930
170700,202302,4342,11539,3301,9618,659,2000,1435,3949,2094,5949
170710,202302,2066,4420,1569,3733,180,441,1050,2406,1230,2847
170720,202302,2218,4871,1649,4007,134,380,1195,2792,1329,3172
170730,202302,1325,3173,1001,2709,116,251,610,1676,726,1927
170740,202302,2412,7087,2054,6475,150,560,1532,4717,1682,5277
170755,202302,1016,2478,717,2014,145,440,315,813,460,1253
170765,202302,1393,3250,987,2629,157,415,484,1260,641,1675
170770,202302,2243,5712,1806,5070,151,451,1308,3592,1459,4043
170820,202302,4759,12348,3643,10515,710,2082,1795,5091,2505,7173
170825,202302,1312,2646,1081,2364,106,234,812,1744,918,1978
170830,202302,1633,3836,1201,3151,289,889,568,1297,857,2186
170900,202302,3646,9778,3128,9080,394,969,2371,7100,2765,8069
170930,202302,4874,12037,3718,10034,837,2398,1237,3093,2074,5491
170950,202302,14143,36420,10074,29517,2965,9392,1347,3896,4312,13288
170980,202302,620,1407,417,1081,46,146,230,548,276,694
171050,202302,2016,5628,1725,5143,136,444,1304,3922,1440,4366
171070,202302,1625,4047,1372,3694,296,702,675,2106,971,2808
171090,202302,1187,2876,915,2476,143,402,475,1266,618,1668
171110,202302,677,1721,465,1336,67,186,215,571,282,757
171150,202302,1177,2705,722,1969,57,188,434,1133,491,1321
171180,202302,864,2230,541,1636,100,288,202,635,302,923
171190,202302,2377,6739,1988,6086,314,999,1158,3539,1472,4538
171195,202302,1003,2803,787,2414,106,409,477,1357,583,1766
171200,202302,739,1908,535,1577,130,446,162,423,292,869
171215,202302,473,1128,367,961,43,127,191,474,234,601
171240,202302,900,2630,698,2295,13,76,481,1521,494,1597
171245,202302,916,2419,703,2015,67,212,387,1011,454,1223
171250,202302,1146,2929,795,2338,126,398,334,958,460,1356
171270,202302,576,1832,443,1553,67,281,212,711,279,992
171280,202302,1058,2823,844,2484,67,207,534,1567,601,1774
171320,202302,4710,12148,3592,10227,714,2059,1400,3959,2114,6018
171330,202302,3471,8641,2635,7249,694,1984,1145,3062,1839,5046
171360,202302,1831,4548,1361,3887,141,380,864,2641,1005,3021
171370,202302,852,1971,645,1687,73,195,394,998,467,1193
171380,202302,1733,4286,1411,3851,182,453,941,2691,1123,3144
171395,202302,1203,2840,809,2202,100,296,485,1281,585,1577
171420,202302,2400,5945,1810,4935,319,935,944,2451,1263,3386
171430,202302,1319,3419,1077,2996,76,243,696,1812,772,2055
171488,202302,3006,7530,2310,6438,406,1139,1188,3267,1594,4406
171500,202302,1049,2458,733,1946,88,268,423,1075,511,1343
171510,202302,1005,2826,854,2570,76,286,576,1662,652,1948
171515,202302,589,1325,410,1051,32,100,269,630,301,730
171525,202302,855,2072,639,1724,82,231,382,976,464,1207
171550,202302,403,1040,299,901,40,161,146,390,186,551
171570,202302,1323,3449,1101,3089,163,483,647,1800,810,2283
171575,202302,1990,4794,1321,3688,128,372,702,1877,830,2249
171610,202302,7311,19031,5430,15970,1327,4325,1119,3429,2446,7754
171620,202302,3652,8072,3122,7365,170,423,2585,6069,2755,6492
171630,202302,1332,3144,994,2666,149,420,617,1654,766,2074
171650,202302,2739,7142,2086,6075,512,1627,515,1466,1027,3093
171660,202302,2799,6408,1984,5161,168,464,1295,3278,1463,3742
171665,202302,1493,3820,1164,3301,258,804,492,1357,750,2161
171670,202302,2247,5452,1660,4497,255,747,768,1969,1023,2716
171700,202302,1388,3472,1031,2856,135,376,575,1539,710,1915
171720,202302,905,2126,683,1789,73,209,458,1185,531,1394
171750,202302,1696,4697,1218,3826,261,831,334,1218,595,2049
171780,202302,1558,3512,1100,2827,106,321,711,1743,817,2064
171790,202302,1665,4944,1326,4274,196,639,681,2148,877,2787
171800,202302,859,2091,654,1804,65,190,375,973,440,1163
171820,202302,14464,37051,10727,31097,2509,7864,2740,8029,5249,15893
171830,202302,1868,5269,1591,4827,351,995,765,2521,1116,3516
171840,202302,847,2034,634,1714,19,67,379,964,398,1031
171845,202302,826,1814,620,1523,56,164,424,976,480,1140
171850,202302,1199,3226,1017,2876,38,164,813,2194,851,2358
171855,202302,1242,3466,1024,3090,109,332,594,1748,703,2080
171865,202302,592,1522,500,1385,65,211,298,756,363,967
171870,202302,951,2387,666,1904,125,378,304,848,429,1226
171875,202302,1764,4192,1450,3735,58,232,1148,2812,1206,3044
171880,202302,1786,4164,1553,3864,53,152,1253,3072,1306,3224
171884,202302,1356,3183,1028,2661,221,545,531,1372,752,1917
171886,202302,1794,4492,1310,3805,329,1052,330,1020,659,2072
171888,202302,678,1811,454,1370,34,124,259,734,293,858
171889,202302,505,1417,333,1066,77,271,107,314,184,585
171890,202302,1474,3870,1087,3245,139,451,656,1889,795,2340
171900,202302,662,2024,513,1737,71,207,234,805,305,1012
172000,202302,673,1858,515,1573,97,303,199,589,296,892
172010,202302,1524,4214,1275,3830,130,360,791,2403,921,2763
172015,202302,431,1367,329,1177,62,225,139,483,201,708
172020,202302,3486,8633,3017,8060,274,753,2160,5892,2434,6645
172025,202302,858,2110,615,1744,44,124,423,1161,467,1285
172030,202302,1449,3906,1166,3450,88,306,832,2395,920,2701
172049,202302,1457,3366,950,2655,122,327,485,1388,607,1715
172065,202302,1778,4010,1396,3533,154,306,938,2641,1092,2947
172080,202302,2838,7488,2276,6543,122,410,1520,4258,1642,4668
172085,202302,526,1334,329,933,56,157,114,290,170,447
172090,202302,5022,10708,3922,9288,150,387,3172,7306,3322,7693
172093,202302,540,1497,385,1221,31,139,225,662,256,801
172097,202302,815,1960,537,1501,84,271,193,500,277,771
172100,202302,62988,142908,46995,119311,8645,24433,20196,49194,28841,73627
172110,202302,2050,6323,1750,5890,111,465,1364,4557,1475,5022
172120,202302,6304,16352,4912,14178,506,1591,2989,8420,3495,10011
172125,202302,493,1205,370,1015,33,113,204,494,237,607
172130,202302,693,1631,521,1352,18,65,336,792,354,857
172208,202302,3064,6660,2362,5763,196,439,1714,4148,1910,4587
172210,202302,3211,7089,2472,6191,254,591,1629,4211,1883,4802
210005,202302,23630,60931,17742,51754,4669,14346,7299,21430,11968,35776
210010,202302,2663,6538,2443,6291,41,186,2256,5717,2297,5903
210015,202302,3788,10210,3254,9511,140,422,2697,7899,2837,8321
210020,202302,9976,19132,8646,17590,560,742,7628,15820,8188,16562
210030,202302,5364,16158,4865,15400,491,1634,3809,12131,4300,13765
210040,202302,2608,5062,2280,4676,56,159,2074,4149,2130,4308
210043,202302,6931,17739,5795,16229,386,1146,4541,12725,4927,13871
210047,202302,8273,21944,6500,19658,156,627,5600,16874,5756,17501
210050,202302,2975,8126,2371,7078,162,649,1788,5113,1950,5762
210055,202302,2511,6471,2192,6033,57,159,1902,5320,1959,5479
210060,202302,8806,29044,7771,27259,839,3088,5212,18683,6051,21771
210070,202302,8137,19037,7519,18272,102,263,7039,17036,7141,17299
210080,202302,5301,14551,4982,14212,40,222,4647,13192,4687,13414
210083,202302,7295,16711,6139,15462,102,333,5783,14485,5885,14818
210087,202302,3185,8187,2684,7534,127,393,2214,6173,2341,6566
210090,202302,10879,29823,10008,28454,374,968,8671,24586,9045,25554
210095,202302,7486,22543,6741,21566,535,1591,5274,17605,5809,19196
210100,202302,7610,21061,6585,19334,920,2621,4270,12726,5190,15347
210110,202302,3679,9306,3354,8907,47,208,3057,8022,3104,8230
210120,202302,35421,75305,30188,68901,1525,2924,24409,55967,25934,58891
210125,202302,5422,12920,4700,12114,867,1675,3236,9068,4103,10743
210130,202302,5001,11410,4061,10266,79,187,3577,9008,3656,9195
210135,202302,2162,4734,1790,4214,54,123,1566,3658,1620,3781
210140,202302,25651,60750,20074,53565,2776,7330,12655,33985,15431,41315
210150,202302,5625,11907,4895,10936,111,302,4231,9226,4342,9528
210160,202302,26591,59465,22695,54645,1839,3848,17776,43508,19615,47356
210170,202302,21422,53360,19481,50832,1917,4086,15134,40871,17051,44957
210173,202302,2695,9005,2540,8767,95,414,2223,7627,2318,8041
210177,202302,3787,9548,3242,8859,461,1136,2381,6732,2842,7868
210180,202302,1854,4115,1625,3843,37,90,1466,3466,1503,3556
210190,202302,6842,15075,5758,13663,99,265,4977,11615,5076,11880
210193,202302,1614,4045,1375,3683,48,136,1074,2856,1122,2992
210197,202302,2316,6519,2079,6193,155,424,1653,5034,1808,5458
210200,202302,9651,26555,8429,24792,545,1711,6644,19485,7189,21196
210203,202302,8425,22097,7035,20323,561,1582,5480,16221,6041,17803
210207,202302,4560,10034,3724,9077,151,336,3099,7634,3250,7970
210210,202302,8752,24932,7826,23672,137,707,6745,20144,6882,20851
210215,202302,2881,8083,2494,7540,145,591,2040,6083,2185,6674
210220,202302,8357,23113,7859,22434,135,812,7142,19843,7277,20655
210230,202302,6779,17088,6210,16232,149,372,5655,14772,5804,15144
210232,202302,14524,39013,11936,35314,1665,4819,7987,24479,9652,29298
210235,202302,4058,10936,3529,10200,164,575,2927,8419,3091,8994
210237,202302,4954,10734,4249,9950,32,125,4042,9351,4074,9476
210240,202302,2985,8157,2672,7688,81,242,2176,6227,2257,6469
210250,202302,7319,17954,6620,17087,114,419,6070,15531,6184,15950
210255,202302,3148,8593,2654,7727,313,994,1645,4605,1958,5599
210260,202302,6380,16842,5506,15600,422,1278,4429,12446,4851,13724
210270,202302,5787,13890,5074,13018,76,348,4593,11618,4669,11966
210275,202302,4009,9080,3388,8348,170,361,2776,6889,2946,7250
210280,202302,7622,17323,6303,15488,148,626,5246,12295,5394,12921
210290,202302,9945,21584,8900,20346,113,319,8413,19104,8526,19423
210300,202302,38850,97818,31481,87538,6423,17160,15160,47016,21583,64176
210310,202302,3594,7975,3126,7348,38,114,2849,6628,2887,6742
210312,202302,3499,7240,3106,6815,25,80,2865,6174,2890,6254
210315,202302,4374,9343,3921,8849,116,254,3635,8195,3751,8449
210317,202302,5183,14287,4686,13705,103,440,4265,12402,4368,12842
210320,202302,33763,71104,31495,68377,241,1106,29820,63564,30061,64670
210325,202302,4116,10632,3402,9683,437,1267,2445,7028,2882,8295
210330,202302,31669,75273,25520,67931,3903,8407,16824,49351,20727,57758
210340,202302,15331,33351,13794,31492,725,1350,11589,26965,12314,28315
210350,202302,11680,27835,10237,26080,135,422,9280,23431,9415,23853
210355,202302,4505,13738,3953,12888,107,494,3303,10719,3410,11213
210360,202302,14650,41975,13100,39567,550,2288,9838,28634,10388,30922
210370,202302,14496,27022,10861,23226,308,475,9993,21666,10301,22141
210375,202302,3866,9718,2804,8132,973,2999,647,1959,1620,4958
210380,202302,6665,15159,5740,14058,250,680,4963,12020,5213,12700
210390,202302,3860,9737,3592,9356,62,260,3295,8457,3357,8717
210400,202302,5508,14003,4834,13231,269,514,4254,11988,4523,12502
210405,202302,9012,20773,7334,18558,1188,2664,4514,11969,5702,14633
210407,202302,2446,6947,2052,6285,147,436,1543,4754,1690,5190
210408,202302,3211,10375,2965,10062,177,742,2374,8100,2551,8842
210409,202302,4475,13662,3995,12997,221,790,3202,10657,3423,11447
210410,202302,4342,11319,3636,10085,79,322,3002,8077,3081,8399
210420,202302,4423,12722,3890,11805,215,627,3183,9676,3398,10303
210430,202302,2668,6992,2311,6513,196,549,1883,5338,2079,5887
210440,202302,5063,12240,4390,11428,180,377,3911,10229,4091,10606
210450,202302,2692,7133,2311,6598,272,653,1684,5009,1956,5662
210455,202302,5909,13511,4562,11844,1054,2889,2197,5710,3251,8599
210460,202302,4156,10965,3464,10047,115,404,2891,8313,3006,8717
210462,202302,1949,5334,1629,4862,64,181,1271,3817,1335,3998
210465,202302,3121,8020,2689,7453,127,476,2264,6145,2391,6621
210467,202302,7379,19312,6332,17976,630,1614,4925,14392,5555,16006
210470,202302,2172,5495,1610,4725,183,491,1115,3347,1298,3838
210480,202302,20154,53549,16570,49177,2207,4722,11480,37685,13687,42407
210490,202302,3896,8803,3077,7711,91,229,2605,6485,2696,6714
210500,202302,7494,24875,6911,23956,350,1496,5808,19958,6158,21454
210510,202302,8065,20834,7209,19931,118,341,6715,18635,6833,18976
210515,202302,4455,11816,3757,10961,196,600,3112,9209,3308,9809
210520,202302,3046,7999,2724,7588,140,440,2272,6251,2412,6691
210530,202302,68162,152784,53499,132223,9999,26442,23425,60616,33424,87058
210535,202302,4407,12109,3994,11546,141,482,3497,10100,3638,10582
210540,202302,18205,46815,15136,42460,2203,5462,9782,29185,11985,34647
210542,202302,7652,16562,5933,14622,516,1216,4623,11484,5139,12700
210545,202302,2514,7135,2298,6787,47,181,1962,5721,2009,5902
210547,202302,4375,13916,3879,13098,227,751,3002,10350,3229,11101
210550,202302,6944,19352,5328,16837,677,2275,3204,10368,3881,12643
210560,202302,4313,12095,3795,11302,90,330,3236,9493,3326,9823
210565,202302,1776,4692,1447,4249,106,360,1083,3216,1189,3576
210570,202302,12851,31991,11351,30160,272,740,10126,27047,10398,27787
210580,202302,3441,8058,2701,7154,192,460,1966,5453,2158,5913
210590,202302,4827,13131,4097,12219,87,425,3621,10725,3708,11150
210592,202302,3365,8191,3122,7832,29,135,2769,6774,2798,6909
210594,202302,2865,7325,2238,6384,207,544,1546,4571,1753,5115
210596,202302,3445,10374,3044,9702,360,1132,2238,7345,2598,8477
210598,202302,2423,5842,2165,5512,83,239,1896,4802,1979,5041
210600,202302,3506,8863,2820,7896,350,907,1829,5163,2179,6070
210610,202302,3686,8423,3124,7752,57,218,2714,6610,2771,6828
210620,202302,3568,7779,2901,6964,140,292,2481,5882,2621,6174
210630,202302,3732,10678,3290,9961,168,607,2606,7817,2774,8424
210632,202302,7258,16392,6472,15392,190,618,5786,13434,5976,14052
210635,202302,1885,6203,1759,5978,193,592,1311,4588,1504,5180
210637,202302,3131,8831,2628,8135,158,555,1996,6273,2154,6828
210640,202302,5949,16999,5519,16523,61,307,5142,15311,5203,15618
210650,202302,8195,20687,7339,19648,111,393,6546,17457,6657,17850
210660,202302,9514,24621,8512,23103,161,699,7374,19424,7535,20123
210663,202302,3606,8160,3186,7673,315,497,2377,6217,2692,6714
210667,202302,2248,6478,1994,6101,54,184,1712,5349,1766,5533
210670,202302,6845,17096,6171,16098,123,474,5562,14230,5685,14704
210675,202302,6489,14446,5424,13132,646,1325,4126,10276,4772,11601
210680,202302,5833,11801,4922,10758,87,152,4608,10060,4695,10212
210690,202302,11338,25273,9589,23310,256,734,8768,21072,9024,21806
210700,202302,3293,8037,2622,7089,177,438,1998,5449,2175,5887
210710,202302,6374,16470,5602,15495,111,423,5019,13768,5130,14191
210720,202302,3588,10101,3120,9542,100,414,2730,8316,2830,8730
210725,202302,1539,4439,1316,4108,52,166,934,3037,986,3203
210730,202302,1717,3530,1425,3146,60,104,1244,2752,1304,2856
210735,202302,5409,13736,4556,12691,322,776,3688,10677,4010,11453
210740,202302,6209,14100,5257,13033,133,280,4479,11028,4612,11308
210745,202302,4954,12123,4466,11531,59,207,4013,10263,4072,10470
210750,202302,31402,73832,27234,68554,4199,9176,17337,46235,21536,55411
210760,202302,7619,15472,6465,14254,123,228,6010,13436,6133,13664
210770,202302,7417,16362,6322,15133,56,229,5903,13958,5959,14187
210780,202302,8788,24274,7560,22314,521,1554,5886,17324,6407,18878
210790,202302,5188,14128,4550,13282,282,754,3711,11123,3993,11877
210800,202302,5775,13670,4943,12577,78,295,4453,11116,4531,11411
210805,202302,4905,15291,4483,14682,209,700,3734,12341,3943,13041
210810,202302,5809,15095,5218,14358,449,1074,4230,11977,4679,13051
210820,202302,8520,21973,7070,19733,1027,2710,4203,12104,5230,14814
210825,202302,10077,23339,9163,22207,224,637,8403,20167,8627,20804
210830,202302,10692,24595,9694,23416,925,1537,7870,19962,8795,21499
210840,202302,5955,10252,5483,9704,28,113,5213,8991,5241,9104
210845,202302,7296,17386,6408,16405,67,182,6092,15647,6159,15829
210850,202302,8379,22059,6968,20070,477,1358,5570,16088,6047,17446
210860,202302,25495,55904,21081,50665,933,2067,17594,43158,18527,45225
210870,202302,8915,19540,7086,17487,168,394,6330,15572,6498,15966
210880,202302,4888,13105,4317,12365,226,678,3418,9729,3644,10407
210890,202302,5972,13014,5471,12450,191,474,4923,11027,5114,11501
210900,202302,5816,15232,4535,13050,1613,4663,927,3023,2540,7686
210905,202302,2712,5668,2312,5184,47,79,2170,4870,2217,4949
210910,202302,8748,24583,7217,22177,1034,3136,4485,13907,5519,17043
210920,202302,3732,10338,3278,9749,61,270,2979,8749,3040,9019
210923,202302,2331,5217,2001,4765,99,235,1640,3812,1739,4047
210927,202302,5423,16228,4693,15346,677,2154,3089,10564,3766,12718
210930,202302,3456,8943,3034,8216,84,346,2635,6879,2719,7225
210940,202302,4198,11015,3773,10496,333,1488,3055,7789,3388,9277
210945,202302,9948,22497,8883,21295,796,1288,7109,17915,7905,19203
210950,202302,6448,15888,4961,13824,609,1289,3332,9984,3941,11273
210955,202302,1790,4945,1490,4480,259,764,888,2706,1147,3470
210960,202302,10907,29287,9301,26830,3190,9096,3507,11170,6697,20266
210970,202302,2069,4759,1711,4207,91,270,1437,3389,1528,3659
210975,202302,2011,5565,1808,5266,210,612,1294,3763,1504,4375
210980,202302,12820,24648,11396,23173,172,270,10785,21935,10957,22205
210990,202302,21234,52096,16502,46143,1725,4171,11605,33811,13330,37982
211000,202302,17381,44081,14265,40256,2880,7150,9168,27722,12048,34872
211003,202302,7520,17558,6288,16137,104,393,5584,14307,5688,14700
211010,202302,8290,23529,7477,22542,76,349,6858,20754,6934,21103
211020,202302,10787,25653,9480,24219,199,609,8450,21872,8649,22481
211023,202302,2466,7043,2256,6783,139,389,1824,5495,1963,5884
211027,202302,4647,11306,4382,10916,102,329,4060,9958,4162,10287
211030,202302,4571,11342,4039,10686,409,1010,3004,8114,3413,9124
211040,202302,5194,16563,4749,15821,122,622,4216,13920,4338,14542
211050,202302,10966,24518,9797,23093,125,383,8935,20925,9060,21308
211060,202302,9146,22330,8283,21212,171,611,7463,18793,7634,19404
211065,202302,2972,6744,2481,6149,123,249,2129,5354,2252,5603
211070,202302,10070,26948,8544,24750,357,1118,7212,20819,7569,21937
211080,202302,1579,3782,1239,3277,30,159,960,2349,990,2508
211085,202302,2595,6413,2149,5856,207,395,1658,4794,1865,5189
211090,202302,3702,9047,3325,8628,30,119,3071,7905,3101,8024
211100,202302,8980,18246,8287,17470,41,107,7828,16403,7869,16510
211102,202302,3965,11132,3581,10594,397,1218,2766,8196,3163,9414
211105,202302,2784,7781,2342,7047,115,355,1807,5343,1922,5698
211107,202302,5551,15706,4706,14490,167,561,3736,11979,3903,12540
211110,202302,7744,17824,6155,15550,267,772,5040,12376,5307,13148
211120,202302,60686,131329,49977,118827,8200,18041,31954,78494,40154,96535
211125,202302,2232,6081,1883,5575,40,180,1591,4674,1631,4854
211130,202302,224893,482475,194321,443094,25686,52548,130328,303083,156014,355631
211140,202302,5493,14729,4737,13769,169,510,3987,11668,4156,12178
211150,202302,11571,27094,9674,24780,579,1124,7766,20497,8345,21621
211153,202302,3532,8539,2433,7165,438,1125,1500,4712,1938,5837
211157,202302,1507,4136,1282,3733,96,286,918,2647,1014,2933
211160,202302,6442,14034,5255,12458,131,451,4378,9813,4509,10264
211163,202302,1737,5027,1565,4791,60,195,1329,4118,1389,4313
211167,202302,2058,5240,1896,5029,32,114,1762,4634,1794,4748
211170,202302,8768,17028,8108,16294,62,164,7703,15294,7765,15458
211172,202302,3011,7567,2531,6867,78,252,2041,5310,2119,5562
211174,202302,3382,8490,3041,8119,29,142,2881,7625,2910,7767
211176,202302,4994,12760,3907,11226,296,921,3033,8659,3329,9580
211178,202302,6422,12151,5559,11246,35,122,5356,10729,5391,10851
211180,202302,4918,14348,4480,13737,173,691,3690,11179,3863,11870
211190,202302,3899,9534,3287,8672,33,171,2987,7743,3020,7914
211195,202302,1924,4410,1670,4053,64,154,1463,3532,1527,3686
211200,202302,2503,6742,1949,5873,198,627,1344,3977,1542,4604
211210,202302,7236,20049,6440,18967,529,1541,5104,15117,5633,16658
211220,202302,52780,111821,44039,101274,4113,8846,33328,76574,37441,85420
211223,202302,6291,15213,5056,13583,658,1799,3226,8678,3884,10477
211227,202302,2001,5636,1716,5233,53,198,1421,4351,1474,4549
211230,202302,10280,24908,8806,22890,321,678,7608,19867,7929,20545
211240,202302,12374,27710,11666,26867,140,547,11125,25198,11265,25745
211245,202302,9356,20192,8250,19037,173,387,7825,17978,7998,18365
211250,202302,18345,46762,16565,44180,1374,3620,12955,34410,14329,38030
211260,202302,9841,26930,8447,25348,173,665,7599,22894,7772,23559
211270,202302,12015,33440,10230,31204,398,1474,8343,25612,8741,27086
211280,202302,19202,40323,17199,37930,360,788,15847,34755,16207,35543
211285,202302,2372,6571,2098,6228,167,543,1579,4696,1746,5239
211290,202302,8536,22858,7604,21603,343,1036,6214,17542,6557,18578
211300,202302,8448,22608,7303,20777,466,1384,5550,15520,6016,16904
211400,202302,14100,34601,11414,30985,1532,3943,7480,21210,9012,25153
220005,202302,2365,5267,2151,4991,54,120,1792,4029,1846,4149
220010,202302,1763,4466,1428,3916,67,157,1089,2985,1156,3142
220020,202302,5540,11603,4800,10651,271,553,4123,9028,4394,9581
220025,202302,2784,5431,2369,4843,63,111,1989,3918,2052,4029
220027,202302,1657,3533,1431,3237,30,90,1237,2719,1267,2809
220030,202302,4699,9689,4325,9225,95,240,3860,8032,3955,8272
220040,202302,9764,25994,8493,23726,1570,4094,4827,13881,6397,17975
220045,202302,1918,4834,1592,4342,20,97,1369,3617,1389,3714
220050,202302,6755,14215,5904,13192,60,200,5545,12170,5605,12370
220060,202302,3547,5956,3060,5408,69,90,2875,5070,2944,5160
220070,202302,2835,6530,2323,5811,66,148,1950,4798,2016,4946
220080,202302,875,2252,751,2075,18,73,631,1703,649,1776
220090,202302,2042,4329,1652,3765,63,96,1380,3148,1443,3244
220095,202302,1195,2110,1138,2051,19,31,1067,1909,1086,1940
220100,202302,1694,4038,1335,3515,33,130,1084,2711,1117,2841
220105,202302,2427,6555,2079,5980,173,524,1515,4334,1688,4858
220110,202302,4263,9944,3671,9006,42,171,3272,7884,3314,8055
220115,202302,3454,8701,3151,8319,157,450,2739,7152,2896,7602
220117,202302,1658,3501,1298,3016,18,60,1084,2419,1102,2479
220120,202302,20959,39589,19428,37770,85,279,18482,35346,18567,35625
220130,202302,1336,3129,1109,2831,26,114,983,2422,1009,2536
220140,202302,2882,5150,2456,4671,88,160,2181,4199,2269,4359
220150,202302,7808,19579,7044,18355,150,541,5907,14939,6057,15480
220155,202302,1397,3637,1112,3144,21,73,792,2153,813,2226
220157,202302,1325,2771,1111,2469,30,66,903,1952,933,2018
220160,202302,3378,8212,2866,7335,53,182,2339,5763,2392,5945
220170,202302,1834,4446,1528,4007,32,111,1303,3373,1335,3484
220173,202302,2491,6270,2008,5457,44,169,1565,4129,1609,4298
220177,202302,2871,6116,2724,5959,8,28,2681,5840,2689,5868
220180,202302,1426,2898,1168,2498,3,17,972,1927,975,1944
220190,202302,10226,20194,8711,18322,665,1166,6670,14392,7335,15558
220191,202302,1962,5159,1777,4868,138,409,1296,3450,1434,3859
220192,202302,2429,5729,1771,4634,43,130,1425,3655,1468,3785
220194,202302,2237,5319,1949,4874,44,163,1633,3879,1677,4042
220196,202302,2593,5808,2351,5465,17,78,2027,4604,2044,4682
220198,202302,1590,3523,1340,3218,14,30,1225,2955,1239,2985
220200,202302,5984,15630,5208,14587,148,542,4353,12049,4501,12591
220202,202302,2586,6256,2188,5647,28,120,1864,4695,1892,4815
220205,202302,3273,7560,2909,6962,85,241,2488,5783,2573,6024
220207,202302,918,2423,779,2202,77,197,493,1432,570,1629
220208,202302,2129,5893,1720,5165,312,996,852,2516,1164,3512
220209,202302,1861,4899,1545,4344,39,134,1161,3180,1200,3314
220210,202302,2315,4636,2017,4218,23,64,1770,3581,1793,3645
220211,202302,2054,4213,1868,3978,18,61,1642,3421,1660,3482
220213,202302,2161,5012,1847,4510,28,89,1484,3429,1512,3518
220217,202302,2892,6890,2670,6640,166,249,2355,6073,2521,6322
220220,202302,16564,32771,14293,29638,461,1026,12112,24438,12573,25464
220225,202302,1223,2698,994,2415,2,12,938,2252,940,2264
220230,202302,7054,15359,6072,14048,434,841,5049,11766,5483,12607
220240,202302,3864,9619,3128,8400,96,377,2542,6606,2638,6983
220245,202302,2515,4363,1942,3699,10,37,1815,3391,1825,3428
220250,202302,3662,8777,3198,8214,26,94,2979,7593,3005,7687
220253,202302,1994,4808,1674,4332,33,111,1424,3596,1457,3707
220255,202302,2375,4896,2005,4391,42,139,1721,3600,1763,3739
220260,202302,6199,15084,5359,13696,274,667,4294,10897,4568,11564
220265,202302,1851,4754,1676,4528,83,277,1409,3706,1492,3983
220270,202302,7296,20901,6843,20142,175,845,5762,16254,5937,17099
220271,202302,1829,4012,1596,3702,53,126,1374,3144,1427,3270
220272,202302,2034,5310,1755,4806,51,174,1342,3508,1393,3682
220273,202302,1511,3916,1233,3419,64,209,918,2497,982,2706
220275,202302,3204,6026,2595,5234,72,98,2322,4661,2394,4759
220277,202302,2868,5922,2422,5325,92,174,2018,4349,2110,4523
220280,202302,2400,4348,2022,3892,26,50,1832,3451,1858,3501
220285,202302,2044,4046,1763,3712,11,47,1686,3489,1697,3536
220290,202302,8447,20544,6722,18224,607,1475,4692,13190,5299,14665
220300,202302,2337,6045,1817,5377,40,188,1467,4300,1507,4488
220310,202302,3898,9014,3068,8066,48,170,2671,6967,2719,7137
220320,202302,3731,9430,2835,7909,67,284,2247,6006,2314,6290
220323,202302,2067,5048,1586,4302,47,164,1336,3499,1383,3663
220325,202302,1437,3932,1189,3507,35,139,950,2746,985,2885
220327,202302,2008,4830,1765,4461,66,220,1467,3584,1533,3804
220330,202302,6559,12693,5653,11643,91,263,5196,10467,5287,10730
220335,202302,2251,5524,2051,5263,132,234,1707,4471,1839,4705
220340,202302,2115,5231,1582,4357,91,309,995,2609,1086,2918
220342,202302,1506,3705,1341,3478,122,214,1002,2701,1124,2915
220345,202302,3719,7397,2826,6202,19,60,2525,5419,2544,5479
220350,202302,3942,9086,3143,7933,227,524,2193,5482,2420,6006
220360,202302,1588,3565,1214,2965,16,56,991,2327,1007,2383
220370,202302,10955,26910,9879,25319,385,993,8346,21138,8731,22131
220375,202302,2074,4814,1838,4535,15,24,1765,4370,1780,4394
220380,202302,1885,3770,1497,3254,25,41,1298,2808,1323,2849
220385,202302,1143,2243,931,1898,4,6,841,1673,845,1679
220390,202302,15698,33140,12593,28817,1976,4641,7123,15916,9099,20557
220400,202302,1807,3863,1378,3216,16,52,1078,2374,1094,2426
220410,202302,1439,3497,1153,3027,29,99,944,2418,973,2517
220415,202302,1006,2331,806,2000,22,40,621,1507,643,1547
220420,202302,2219,5779,1777,4955,82,265,1269,3438,1351,3703
220430,202302,3545,7492,3135,6973,40,95,2844,6217,2884,6312
220435,202302,2495,5271,2154,4761,29,94,1850,3932,1879,4026
220440,202302,3959,8946,3362,8129,56,263,3000,6937,3056,7200
220450,202302,3350,7336,2777,6637,53,181,2453,5737,2506,5918
220455,202302,1718,4200,1619,4076,20,61,1477,3732,1497,3793
220460,202302,1411,2804,1290,2645,26,60,1144,2258,1170,2318
220465,202302,2904,7847,2557,7337,189,553,1996,5723,2185,6276
220470,202302,4689,11082,4132,10237,221,427,3155,7763,3376,8190
220480,202302,3172,7493,2508,6517,238,438,1660,4339,1898,4777
220490,202302,2899,6433,2469,5911,26,123,2158,5038,2184,5161
220500,202302,4002,8565,3352,7618,130,242,2590,5751,2720,5993
220510,202302,3277,7660,2648,6629,118,282,2051,5181,2169,5463
220515,202302,2167,4404,1974,4145,70,92,1697,3544,1767,3636
220520,202302,6221,13806,5629,13003,105,227,4834,11074,4939,11301
220525,202302,1688,3611,1400,3268,37,77,1241,2911,1278,2988
220527,202302,1982,4196,1643,3703,64,138,1442,3249,1506,3387
220530,202302,2020,4057,1674,3627,170,353,1257,2818,1427,3171
220535,202302,1019,2453,934,2326,27,95,759,1809,786,1904
220540,202302,3857,10716,3520,10073,226,611,2798,7967,3024,8578
220545,202302,1801,4657,1605,4369,88,308,1345,3592,1433,3900
220550,202302,10528,29631,9213,27249,546,1761,6661,19130,7207,20891
220551,202302,1767,4158,1524,3775,25,77,1272,3076,1297,3153
220552,202302,1929,5017,1552,4387,23,112,1250,3378,1273,3490
220553,202302,2565,5017,2160,4503,25,43,1964,4046,1989,4089
220554,202302,1166,2552,900,2169,79,151,639,1516,718,1667
220555,202302,4755,8467,4228,7859,29,72,3821,7029,3850,7101
220556,202302,1578,3939,1331,3527,41,179,969,2390,1010,2569
220557,202302,2040,5538,1649,4733,96,363,1207,3287,1303,3650
220558,202302,1764,4035,1415,3566,26,102,1210,2937,1236,3039
220559,202302,2244,4741,1901,4232,131,189,1453,3312,1584,3501
220560,202302,2398,4463,2019,4014,19,34,1899,3739,1918,3773
220570,202302,9893,25075,8843,23574,699,1682,6868,18301,7567,19983
220580,202302,8144,19458,7342,18299,101,285,6511,16121,6612,16406
220585,202302,2485,6853,2041,6038,60,142,1641,4849,1701,4991
220590,202302,2020,4224,1678,3763,102,202,1369,3013,1471,3215
220595,202302,3353,7885,2999,7421,84,275,2559,6164,2643,6439
220600,202302,2257,3783,1951,3443,24,41,1842,3212,1866,3253
220605,202302,1735,4644,1458,4152,22,110,1155,3169,1177,3279
220610,202302,3609,8504,3360,8169,15,84,3180,7639,3195,7723
220620,202302,10911,26009,9940,24736,130,610,9132,22231,9262,22841
220630,202302,418,1111,318,940,27,77,197,556,224,633
220635,202302,2148,5628,1877,5115,62,177,1510,4004,1572,4181
220640,202302,2858,7062,2433,6473,87,292,1942,5070,2029,5362
220650,202302,2943,6519,2506,5885,68,148,2097,4890,2165,5038
220660,202302,3108,8590,2583,7755,77,345,2117,6165,2194,6510
220665,202302,1659,4107,1423,3745,31,138,1232,3134,1263,3272
220667,202302,1937,5073,1751,4770,78,252,1419,3802,1497,4054
220669,202302,1984,5118,1883,4978,35,146,1687,4339,1722,4485
220670,202302,2861,5982,2301,5227,29,77,2028,4517,2057,4594
220672,202302,4177,9014,3449,8153,98,325,3059,7052,3157,7377
220675,202302,1540,3774,1365,3476,84,246,1034,2572,1118,2818
220680,202302,3751,7852,3555,7615,207,319,3138,6801,3345,7120
220690,202302,1882,4427,1606,4021,102,285,1219,2973,1321,3258
220695,202302,1121,2774,1009,2588,18,55,844,2127,862,2182
220700,202302,15203,29247,12446,25723,454,977,10273,20489,10727,21466
220710,202302,1046,2512,759,2044,27,81,571,1477,598,1558
220720,202302,2752,5439,2454,5074,27,75,2195,4423,2222,4498
220730,202302,1677,3886,1440,3529,16,60,1255,2983,1271,3043
220735,202302,1238,2468,958,2058,41,75,726,1518,767,1593
220740,202302,1656,3786,1310,3337,56,126,1061,2724,1117,2850
220750,202302,5330,10944,4697,10124,270,428,4143,9016,4413,9444
220755,202302,1826,3662,1525,3255,34,74,1276,2657,1310,2731
220760,202302,4283,9043,3731,8338,47,157,3500,7749,3547,7906
220770,202302,34253,85352,29519,77929,7701,21755,12695,32850,20396,54605
220775,202302,1715,3452,1535,3237,3,15,1500,3134,1503,3149
220777,202302,1900,4294,1497,3710,50,93,1035,2693,1085,2786
220779,202302,1471,3531,1258,3213,40,116,1038,2596,1078,2712
220780,202302,7181,15361,6409,14290,396,884,5017,11133,5413,12017
220785,202302,1749,3404,1534,3141,18,37,1443,2922,1461,2959
220790,202302,12664,30572,11280,28704,228,763,9698,24247,9926,25010
220793,202302,1186,2623,961,2259,15,33,818,1886,833,1919
220795,202302,1677,3824,1475,3555,29,81,1286,3085,1315,3166
220800,202302,26740,49673,23036,44985,964,1785,19002,36074,19966,37859
220810,202302,3737,8984,3141,8042,71,151,2558,6605,2629,6756
220820,202302,7409,15279,6519,14066,296,483,5489,11826,5785,12309
220830,202302,9409,20817,8329,19325,439,998,6773,15360,7212,16358
220840,202302,16426,41198,13991,36977,1891,4895,8964,23077,10855,27972
220850,202302,3610,9836,3180,9310,55,262,2823,8246,2878,8508
220855,202302,1053,1967,921,1804,23,56,842,1630,865,1686
220860,202302,1452,2818,1246,2538,25,68,1154,2299,1179,2367
220865,202302,2702,6739,2059,5642,50,200,1525,3998,1575,4198
220870,202302,4030,8855,3309,7949,39,156,3019,7124,3058,7280
220880,202302,8241,14516,7120,13192,140,291,6553,12001,6693,12292
220885,202302,1833,4388,1522,3943,92,261,1212,3101,1304,3362
220887,202302,1989,3627,1682,3231,31,41,1561,2974,1592,3015
220890,202302,1707,4543,1453,4180,57,201,1161,3317,1218,3518
220900,202302,2649,5211,2235,4679,24,61,2013,4118,2037,4179
220910,202302,2203,4682,1873,4216,285,456,1333,3168,1618,3624
220915,202302,1089,2699,867,2330,10,33,638,1615,648,1648
220920,202302,1945,4927,1672,4586,115,302,1367,3777,1482,4079
220930,202302,2428,5064,2043,4565,20,55,1850,4191,1870,4246
220935,202302,1255,3310,980,2748,19,79,661,1736,680,1815
220937,202302,1763,4115,1484,3685,37,120,1177,2823,1214,2943
220940,202302,2288,4797,1877,4139,41,109,1606,3398,1647,3507
220945,202302,587,1790,462,1567,23,120,316,1041,339,1161
220950,202302,1652,3414,1128,2644,7,17,913,2030,920,2047
220955,202302,2048,4356,1692,3790,16,29,1487,3274,1503,3303
220960,202302,888,2100,643,1698,36,120,440,1073,476,1193
220965,202302,2259,5103,1959,4676,20,89,1730,4003,1750,4092
220970,202302,2633,5066,1968,4155,7,25,1740,3544,1747,3569
220975,202302,925,2116,786,1945,15,56,688,1640,703,1696
220980,202302,1567,3578,1388,3346,34,90,1215,2862,1249,2952
220985,202302,1778,3764,1536,3412,90,157,1197,2611,1287,2768
220987,202302,1827,4616,1617,4291,52,175,1345,3510,1397,3685
220990,202302,1971,4883,1726,4530,26,97,1440,3720,1466,3817
220995,202302,1723,3822,1417,3331,13,44,1225,2825,1238,2869
220997,202302,2933,7458,2658,7026,47,174,2345,6030,2392,6204
221000,202302,5926,13516,5132,12441,189,527,4283,10205,4472,10732
221005,202302,2022,4339,1837,4058,25,98,1594,3339,1619,3437
221010,202302,1572,2971,1244,2583,38,54,1094,2249,1132,2303
221020,202302,1804,4972,1617,4671,24,99,1267,3613,1291,3712
221030,202302,2094,4174,1789,3808,25,65,1606,3420,1631,3485
221035,202302,1930,4182,1624,3782,46,69,1408,3299,1454,3368
221037,202302,840,2028,700,1802,10,39,523,1257,533,1296
221038,202302,618,1550,484,1338,25,76,338,906,363,982
221039,202302,1005,2448,821,2163,28,97,656,1673,684,1770
221040,202302,5353,13615,4574,12366,241,627,3609,9741,3850,10368
221050,202302,5689,11041,5104,10331,70,188,4682,9356,4752,9544
221060,202302,11869,28067,9763,24728,503,1132,7727,19342,8230,20474
221062,202302,1635,4063,1400,3720,121,255,1075,2905,1196,3160
221063,202302,1500,3418,1306,3146,58,162,1085,2533,1143,2695
221065,202302,3539,7421,3052,6651,14,48,2758,5887,2772,5935
221070,202302,3990,11028,3191,9455,478,1393,1883,5653,2361,7046
221080,202302,4420,9437,3612,8269,51,173,3040,6658,3091,6831
221090,202302,1716,3693,1426,3277,14,34,1243,2779,1257,2813
221093,202302,2051,4543,1848,4220,182,349,1368,3043,1550,3392
221095,202302,1092,2510,898,2240,32,85,725,1786,757,1871
221097,202302,993,2258,739,1844,23,60,567,1339,590,1399
221100,202302,182484,402214,155409,361004,10373,27631,114806,251856,125179,279487
221110,202302,14014,32989,12724,31392,390,856,11209,27547,11599,28403
221120,202302,5996,15204,5326,14244,210,626,4543,12045,4753,12671
221130,202302,7376,15628,5835,13035,1051,2075,3609,7838,4660,9913
221135,202302,2441,5012,2106,4589,91,167,1809,4003,1900,4170
221140,202302,1952,3535,1608,3126,48,77,1423,2732,1471,2809
221150,202302,1365,3005,1031,2473,25,96,809,1824,834,1920
221160,202302,886,1956,783,1829,38,49,613,1442,651,1491
221170,202302,1284,2932,1189,2783,8,19,1095,2510,1103,2529
230010,202302,3654,8619,2941,7440,73,208,2382,5808,2455,6016
230015,202302,4411,11522,3830,10406,226,655,2729,7276,2955,7931
230020,202302,18745,47344,17336,45246,957,2440,14238,37140,15195,39580
230030,202302,15830,34590,13195,31093,563,1165,10571,25198,11134,26363
230040,202302,5671,12139,4713,10713,50,192,3832,8820,3882,9012
230050,202302,3108,8841,2391,7279,308,1025,1190,3278,1498,4303
230060,202302,2994,7023,2309,5897,38,143,1867,4609,1905,4752
230070,202302,5431,12011,4287,10091,567,1288,2750,6429,3317,7717
230075,202302,12087,31914,10936,30051,525,1756,8866,23677,9391,25433
230080,202302,3773,6870,2900,5818,12,26,2692,5338,2704,5364
230090,202302,5690,11725,4755,10330,154,324,3970,8340,4124,8664
230100,202302,27773,58651,24105,53991,2196,5015,17089,37621,19285,42636
230110,202302,16955,44588,14320,39837,2247,6596,7880,20928,10127,27524
230120,202302,9975,22999,8550,20869,834,2032,5890,14280,6724,16312
230125,202302,3751,8714,3119,7732,65,250,2577,6105,2642,6355
230130,202302,6870,18532,5535,15838,354,969,3824,10728,4178,11697
230140,202302,4340,11249,3606,9901,106,406,2813,7371,2919,7777
230150,202302,1968,5165,1623,4501,211,564,946,2618,1157,3182
230160,202302,9036,18074,7769,16304,242,452,6671,13675,6913,14127
230170,202302,7483,19331,6044,16573,463,1193,4104,11013,4567,12206
230180,202302,2026,4887,1633,4198,15,62,1328,3259,1343,3321
230185,202302,5697,13340,4689,11789,446,1127,3336,8390,3782,9517
230190,202302,17797,48174,14501,42055,1979,5861,7973,22399,9952,28260
230195,202302,7082,17875,6344,16693,340,881,4852,12678,5192,13559
230200,202302,5910,14756,4860,12911,323,843,3507,9067,3830,9910
230205,202302,5751,13298,5018,12296,478,962,3775,9300,4253,10262
230210,202302,13341,26911,11369,24373,471,994,9207,19199,9678,20193
230220,202302,19154,40823,16777,37609,978,2200,13623,29888,14601,32088
230230,202302,8842,21962,7950,20354,592,1386,5988,15158,6580,16544
230240,202302,17053,37856,14400,33716,884,1764,11118,25747,12002,27511
230250,202302,11598,27911,10750,26697,577,1450,7983,19212,8560,20662
230260,202302,18753,47032,16053,42581,2242,5719,9773,25555,12015,31274
230270,202302,8824,21119,6718,17502,863,2069,3867,10340,4730,12409
230280,202302,24878,56248,20614,49633,419,1609,16838,38154,17257,39763
230290,202302,6451,14503,5447,12784,230,514,4373,9905,4603,10419
230300,202302,6193,13838,5536,12972,80,210,4867,11346,4947,11556
230310,202302,5688,14504,4666,12676,154,541,3388,8834,3542,9375
230320,202302,9279,23839,7657,21138,242,901,5931,15792,6173,16693
230330,202302,5904,14010,4569,11629,160,495,3442,8381,3602,8876
230340,202302,4706,13034,4034,11746,283,873,2786,7842,3069,8715
230350,202302,23779,54396,20665,50113,1042,2979,15224,35606,16266,38585
230360,202302,3797,8591,2944,7213,166,390,2161,5259,2327,5649
230365,202302,3754,7953,3105,7054,75,210,2733,6113,2808,6323
230370,202302,101750,214218,89666,198251,4892,12744,71735,150898,76627,163642
230380,202302,7540,18582,5916,15721,129,441,4463,11304,4592,11745
230390,202302,4124,10450,3511,9517,77,319,2795,7314,2872,7633
230393,202302,4165,10275,3322,8697,84,410,2673,6589,2757,6999
230395,202302,6849,16865,5791,15131,532,1396,3826,9735,4358,11131
230400,202302,6951,16422,6100,15157,86,372,4948,11658,5034,12030
230410,202302,16220,43254,13391,38431,1070,3145,9097,25823,10167,28968
230420,202302,37653,89423,30893,78610,3071,8244,19435,47056,22506,55300
230423,202302,5515,14612,4820,13396,306,911,3462,9304,3768,10215
230425,202302,7562,19845,6947,18739,725,1875,4822,12861,5547,14736
230426,202302,3272,7552,2349,5889,44,161,1787,4261,1831,4422
230427,202302,2131,5468,1548,4350,142,456,839,2125,981,2581
230428,202302,12314,29909,10563,27476,1525,4007,6194,15529,7719,19536
230430,202302,5921,15127,4630,12923,191,533,3442,9387,3633,9920
230435,202302,7853,17596,6403,15268,901,2072,3724,8716,4625,10788
230440,202302,618429,1256368,529932,1138143,34762,83231,396230,810676,430992,893907
230445,202302,4991,12368,4073,10873,238,652,2753,6992,2991,7644
230450,202302,4644,11292,4026,10428,197,692,3051,7466,3248,8158
230460,202302,2758,6387,2351,5765,67,234,1984,4719,2051,4953
230465,202302,5119,12381,4255,10836,145,426,3296,8046,3441,8472
230470,202302,14267,39937,12779,37323,813,2757,9451,26527,10264,29284
230480,202302,1886,4595,1539,4014,56,216,1179,2879,1235,3095
230490,202302,3337,8232,2760,7160,207,626,1850,4427,2057,5053
230495,202302,7526,18318,6531,16708,838,2272,4091,10071,4929,12343
230500,202302,11296,32243,9892,29838,440,1368,7790,23474,8230,24842
230510,202302,2180,5232,1720,4391,160,434,1099,2642,1259,3076
230520,202302,5894,13985,5054,12623,400,968,3697,8965,4097,9933
230523,202302,20440,53936,16000,45348,3587,9849,4194,12204,7781,22053
230526,202302,4857,11554,4088,10382,329,644,2862,7511,3191,8155
230530,202302,6694,18909,5598,16925,1209,3771,3040,9128,4249,12899
230533,202302,6111,11555,4881,9796,65,184,4219,8052,4284,8236
230535,202302,6024,15516,5074,14032,357,1092,3351,9076,3708,10168
230540,202302,18545,45755,15878,41907,268,929,13071,33833,13339,34762
230550,202302,28362,63773,23349,55989,1944,4747,16151,37253,18095,42000
230560,202302,9375,19546,7432,16703,165,326,6290,14038,6455,14364
230565,202302,3773,9144,3126,8027,89,290,2491,6174,2580,6464
230570,202302,4094,9340,3418,8412,71,213,2820,6761,2891,6974
230580,202302,15023,32331,12890,29384,519,1134,10852,24350,11371,25484
230590,202302,11672,28667,9711,25463,729,1817,7014,18063,7743,19880
230600,202302,4574,10151,3601,8586,150,365,2509,5931,2659,6296
230610,202302,8230,19643,7238,18078,471,1200,5704,14035,6175,15235
230620,202302,2527,6017,1969,5027,85,264,1333,3144,1418,3408
230625,202302,12563,29745,10818,26963,2125,5579,5166,12180,7291,17759
230630,202302,14396,35455,12632,32467,1537,3621,8124,20950,9661,24571
230640,202302,32569,88749,29435,83863,1453,4894,23353,64941,24806,69835
230650,202302,6321,14974,5281,13299,186,670,4312,10348,4498,11018
230655,202302,11968,33508,11249,32404,889,2329,8961,26170,9850,28499
230660,202302,7295,19012,5832,16515,173,702,4686,12903,4859,13605
230670,202302,7236,15288,5199,12210,151,400,4151,9386,4302,9786
230680,202302,3407,8159,2747,7074,158,320,1913,4878,2071,5198
230690,202302,8432,22340,7091,19867,547,1584,4419,12284,4966,13868
230700,202302,12970,28018,10342,23493,407,980,8051,17558,8458,18538
230710,202302,8027,22788,6998,20775,647,1970,4645,13383,5292,15353
230720,202302,2303,6083,1910,5412,139,386,1261,3460,1400,3846
230725,202302,5817,14868,5237,13945,369,1147,3625,9177,3994,10324
230730,202302,74994,175414,59092,153440,12503,32903,24333,64051,36836,96954
230740,202302,7275,18187,6071,16320,172,480,4790,12743,4962,13223
230750,202302,10195,24062,8308,21126,141,488,6686,16342,6827,16830
230760,202302,14313,33084,12346,30251,487,1508,9501,22198,9988,23706
230763,202302,5826,13926,4755,12210,92,351,3789,9291,3881,9642
230765,202302,57557,134015,49246,121847,4884,13085,31939,74641,36823,87726
230770,202302,36377,71755,30971,65090,1994,4328,24179,49083,26173,53411
230780,202302,8091,24457,7268,22679,975,2827,4372,13766,5347,16593
230790,202302,3870,9343,3446,8703,132,428,2728,6544,2860,6972
230800,202302,10778,29291,9341,26630,1115,3370,5656,15274,6771,18644
230810,202302,12970,35198,11468,32819,551,1679,8793,24614,9344,26293
230820,202302,4265,12352,3536,10910,347,1263,2180,6338,2527,7601
230830,202302,9390,22029,7958,19808,328,706,6287,15310,6615,16016
230835,202302,5048,10617,3966,9054,119,281,3234,7137,3353,7418
230837,202302,4801,10765,4337,10051,76,291,3798,8409,3874,8700
230840,202302,11517,30198,9808,27353,798,2238,7144,19717,7942,21955
230850,202302,12493,30257,10549,26918,607,1451,7800,19613,8407,21064
230860,202302,7990,14910,6741,13266,202,321,5969,11545,6171,11866
230870,202302,22704,44666,19442,39714,744,1446,16042,31744,16786,33190
230880,202302,2424,6523,2193,6147,74,307,1704,4581,1778,4888
230890,202302,5556,15423,5007,14525,229,789,3707,10502,3936,11291
230900,202302,4000,9945,3323,8688,131,459,2429,5993,2560,6452
230910,202302,4255,9268,3308,7884,62,235,2783,6454,2845,6689
230920,202302,5715,14150,4564,12294,131,407,3493,9079,3624,9486
230930,202302,8334,20747,6790,18149,363,1060,4706,12186,5069,13246
230940,202302,10109,22148,8735,20242,199,440,7482,17070,7681,17510
230945,202302,7912,19807,6724,17742,322,944,4876,12352,5198,13296
230950,202302,7720,16732,6806,15531,149,350,5798,13158,5947,13508
230960,202302,15833,40768,13663,36961,2160,5968,6944,17938,9104,23906
230970,202302,19358,44683,16409,40416,1623,4197,10756,25464,12379,29661
230980,202302,4318,9170,3735,8261,324,690,2787,6024,3111,6714
230990,202302,2073,5116,1715,4470,68,253,1263,3080,1331,3333
231000,202302,3378,7717,2641,6393,72,221,2033,4633,2105,4854
231010,202302,4592,8962,3529,7313,34,126,3145,6251,3179,6377
231020,202302,11028,28032,9767,25869,1590,3861,5935,15933,7525,19794
231025,202302,10519,23728,9326,21979,628,1381,7308,16966,7936,18347
231030,202302,8704,23492,6621,19423,838,2448,3819,11045,4657,13493
231040,202302,3826,8882,3253,7933,86,239,2722,6372,2808,6611
231050,202302,15020,32723,12199,28195,485,1226,9619,21342,10104,22568
231060,202302,3540,8557,3136,7970,103,316,2512,6313,2615,6629
231070,202302,9926,25203,8569,22951,749,1969,5834,15307,6583,17276
231080,202302,4636,11701,3816,10392,230,647,2646,7107,2876,7754
231085,202302,9109,19053,7235,16833,271,661,5682,12885,5953,13546
231090,202302,5200,12235,3831,9726,121,429,2706,6420,2827,6849
231095,202302,2641,7250,2074,6084,189,550,1365,3946,1554,4496
231100,202302,3536,9196,2901,8077,146,463,2187,5891,2333,6354
231110,202302,4452,11747,4062,11068,358,1139,2856,7381,3214,8520
231120,202302,2952,7329,2479,6575,106,277,1860,4814,1966,5091
231123,202302,2346,5447,1831,4579,107,256,1290,3172,1397,3428
231126,202302,6721,16336,5432,14062,305,718,3981,10152,4286,10870
231130,202302,30977,62692,25902,56443,1186,3309,20561,42397,21747,45706
231135,202302,5075,12702,4174,11082,161,459,3041,7878,3202,8337
231140,202302,21831,51837,17780,45494,829,2590,13237,32148,14066,34738
231150,202302,7111,17421,5049,13520,833,2294,1902,4904,2735,7198
231160,202302,8618,21844,7662,20199,755,1986,5113,13193,5868,15179
231170,202302,5639,14254,4669,12546,291,840,3351,8571,3642,9411
231180,202302,19235,47067,15714,40493,2355,6052,8385,20831,10740,26883
231190,202302,5026,12269,3941,10422,96,314,3021,7704,3117,8018
231195,202302,5968,16184,4880,14157,304,975,3446,9911,3750,10886
231200,202302,10318,25209,9025,22934,143,640,7597,18353,7740,18993
231210,202302,5870,15074,4905,13521,146,587,3924,10408,4070,10995
231220,202302,16368,35298,12938,29495,613,1311,9640,20938,10253,22249
231230,202302,12161,33959,10680,31336,788,2443,7842,22687,8630,25130
231240,202302,14610,38532,12821,35434,1720,4657,7872,21396,9592,26053
231250,202302,2537,5488,1687,3820,61,145,1183,2476,1244,2621
231260,202302,4097,9666,3447,8695,355,776,2344,5961,2699,6737
231270,202302,7888,17730,6390,15392,155,542,4906,11130,5061,11672
231280,202302,2168,5964,1867,5448,160,464,1290,3755,1450,4219
231290,202302,44663,119821,37618,107583,5057,14481,19736,54131,24793,68612
231300,202302,5061,12329,3911,10170,190,594,2693,6624,2883,7218
231310,202302,10361,21801,8246,18298,562,1434,6131,12806,6693,14240
231320,202302,8316,21058,6448,17775,175,462,5019,13650,5194,14112
231325,202302,2905,6775,2269,5782,140,264,1631,4119,1771,4383
231330,202302,13591,33852,11252,29723,1396,3580,7232,18919,8628,22499
231335,202302,6777,15821,5630,14102,152,467,4793,11795,4945,12262
231340,202302,22850,61648,20374,57762,1591,4388,15115,43199,16706,47587
231350,202302,19674,46878,17877,44438,305,933,15941,39066,16246,39999
231355,202302,5342,13841,4724,12771,228,653,3690,9767,3918,10420
231360,202302,9709,25790,8351,23628,438,1333,6520,18125,6958,19458
231370,202302,2462,6157,1948,5277,42,125,1489,3955,1531,4080
231375,202302,4941,13436,4393,12556,204,547,3457,9941,3661,10488
231380,202302,7440,16789,6529,15606,202,412,5434,12902,5636,13314
231390,202302,4081,10675,3609,9933,120,464,2720,7172,2840,7636
231395,202302,5351,13379,4482,12042,321,809,3121,8235,3442,9044
231400,202302,11992,29732,9993,26296,297,1149,7740,19396,8037,20545
231410,202302,20211,49794,18306,47072,865,2104,15178,38783,16043,40887
240010,202302,3086,7253,2397,6105,361,931,1196,2906,1557,3837
240020,202302,17511,40665,14529,35777,853,2514,10351,24162,11204,26676
240030,202302,4784,8796,4309,8149,80,233,3936,7150,4016,7383
240040,202302,932,2469,769,2185,23,73,505,1366,528,1439
240050,202302,4204,9920,3279,8330,63,161,2534,6243,2597,6404
240060,202302,1800,4170,1403,3495,49,125,1097,2665,1146,2790
240070,202302,3233,7890,2855,7142,220,613,2037,4756,2257,5369
240080,202302,3544,8570,2771,7285,128,374,1937,4928,2065,5302
240090,202302,2821,5870,2316,5107,44,90,1998,4307,2042,4397
240100,202302,13739,28310,11025,23992,229,675,8972,18349,9201,19024
240110,202302,6009,14860,5006,13109,178,599,3803,9455,3981,10054
240120,202302,4073,10301,3397,9389,256,839,2416,6457,2672,7296
240130,202302,4884,8452,3986,7331,29,69,3642,6566,3671,6635
240140,202302,2175,5974,1822,5354,205,700,1134,3178,1339,3878
240145,202302,8401,21154,6729,18373,737,2076,4311,11531,5048,13607
240150,202302,1285,3008,1065,2607,55,174,837,1948,892,2122
240160,202302,1771,4569,1448,4001,43,185,1069,2812,1112,2997
240165,202302,1176,2818,971,2464,24,90,805,1966,829,2056
240170,202302,3471,7968,2909,7055,289,701,1928,4562,2217,5263
240180,202302,3692,9818,2981,8432,626,1759,1346,3901,1972,5660
240185,202302,1667,4489,1483,4180,45,168,1174,3170,1219,3338
240190,202302,1392,3313,1142,2929,28,100,927,2313,955,2413
240200,202302,16191,34261,13098,29442,1447,3391,8114,17265,9561,20656
240210,202302,4279,8618,3533,7462,29,121,3101,6229,3130,6350
240220,202302,8636,23397,7738,22036,519,1744,5911,16474,6430,18218
240230,202302,7096,15902,5541,13456,313,617,4038,9914,4351,10531
240240,202302,2107,5601,1469,4267,193,611,515,1251,708,1862
240250,202302,3806,8360,3261,7579,59,189,2752,6146,2811,6335
240260,202302,19788,50223,17190,46148,4943,12805,7198,21416,12141,34221
240270,202302,3010,7622,2473,6793,110,319,1697,4746,1807,5065
240280,202302,1957,4547,1614,4006,66,155,1258,3069,1324,3224
240290,202302,1389,3593,1139,3115,31,125,772,1901,803,2026
240300,202302,2679,6235,1960,5064,98,258,1208,2984,1306,3242
240310,202302,10459,25100,8259,21407,1148,2922,4160,10453,5308,13375
240320,202302,2266,5689,1591,4403,100,305,1063,2777,1163,3082
240325,202302,46820,105682,38703,93045,4434,12066,23815,53230,28249,65296
240330,202302,2158,5300,1680,4473,75,255,1148,2863,1223,3118
240340,202302,2540,4914,2040,4202,61,149,1693,3313,1754,3462
240350,202302,3053,6237,2707,5842,61,151,2464,5264,2525,5415
240360,202302,15654,36563,13970,34088,2148,5053,8902,21627,11050,26680
240370,202302,2678,5737,2058,4673,93,258,1526,3227,1619,3485
240375,202302,1165,2504,941,2158,38,123,690,1409,728,1532
240380,202302,2770,6953,2145,5728,216,554,1242,3197,1458,3751
240390,202302,1159,2579,798,1937,25,51,513,1150,538,1201
240400,202302,1715,3864,1264,3130,36,120,898,2080,934,2200
240410,202302,706,1911,579,1681,60,215,321,857,381,1072
240420,202302,6285,18284,5623,17053,443,1699,3893,11207,4336,12906
240430,202302,4285,9675,3584,8555,111,356,2798,6324,2909,6680
240440,202302,3407,6773,2901,6090,275,527,2205,4548,2480,5075
240450,202302,5346,13093,4210,11109,320,1015,2651,6393,2971,7408
240460,202302,4245,9741,3806,9082,303,659,3025,7236,3328,7895
240470,202302,4054,11308,3083,9363,640,1722,1384,4426,2024,6148
240480,202302,687,1708,416,1145,29,59,199,534,228,593
240485,202302,2533,6446,2002,5536,155,460,1272,3495,1427,3955
240490,202302,1967,4341,1492,3550,90,168,1078,2502,1168,2670
240500,202302,2630,6287,2266,5710,117,284,1808,4487,1925,4771
240510,202302,2019,4851,1729,4422,68,201,1398,3462,1466,3663
240520,202302,1955,3933,1502,3355,104,217,1172,2604,1276,2821
240530,202302,2877,6775,2547,6271,157,294,2038,4985,2195,5279
240540,202302,2828,6079,2520,5631,46,114,2263,5002,2309,5116
240550,202302,1077,2311,956,2123,15,54,852,1821,867,1875
240560,202302,4829,9985,4164,9149,151,266,3512,7657,3663,7923
240570,202302,3332,8131,2235,5872,305,830,865,1993,1170,2823
240580,202302,10611,26543,9368,24487,522,1479,7588,19467,8110,20946
240590,202302,1136,2175,990,1979,23,37,817,1565,840,1602
240600,202302,2113,5110,1538,4031,61,167,1060,2615,1121,2782
240610,202302,5548,12631,4722,11250,255,638,3411,7722,3666,8360
240615,202302,1569,3528,1254,3030,90,244,933,2114,1023,2358
240620,202302,2372,5648,2022,5083,65,199,1674,4074,1739,4273
240630,202302,2818,6207,2532,5776,212,344,1917,4453,2129,4797
240640,202302,1108,2611,866,2221,34,106,647,1594,681,1700
240650,202302,4838,12824,3998,11197,324,849,2664,7407,2988,8256
240660,202302,5311,9363,4865,8806,79,140,4552,8144,4631,8284
240670,202302,3110,7546,2459,6318,216,589,1594,3893,1810,4482
240680,202302,1942,4478,1548,3842,54,166,1201,2829,1255,2995
240690,202302,1472,3058,1149,2545,20,71,967,2001,987,2072
240700,202302,2840,7531,2281,6561,109,328,1665,4712,1774,5040
240710,202302,24795,51087,21278,45865,1725,3867,16016,33073,17741,36940
240720,202302,6322,14280,5281,12828,638,1602,3441,8143,4079,9745
240725,202302,1303,3383,987,2828,40,116,626,1718,666,1834
240730,202302,2726,6756,2121,5672,70,231,1609,4144,1679,4375
240740,202302,2273,5673,1816,4796,89,286,1275,3160,1364,3446
240750,202302,2612,7602,2258,6885,259,851,1353,3942,1612,4793
240760,202302,2083,4180,1523,3391,116,169,1114,2589,1230,2758
240770,202302,4060,9613,3404,8733,135,442,2827,7046,2962,7488
240780,202302,6531,15565,5458,13851,746,1889,3520,8722,4266,10611
240790,202302,1062,2645,868,2321,25,113,632,1586,657,1699
240800,202302,73087,147306,59057,127461,5435,12470,39181,78653,44616,91123
240810,202302,136331,291510,119701,266961,11141,25612,86027,184782,97168,210394
240820,202302,7754,20394,6779,18689,1020,2869,4030,11025,5050,13894
240830,202302,10472,26348,9044,24309,349,1161,7198,18960,7547,20121
240840,202302,1310,2960,1037,2540,46,93,728,1727,774,1820
240850,202302,1663,4149,1136,3079,82,212,672,1715,754,1927
240860,202302,1783,3865,1348,3153,34,109,1110,2471,1144,2580
240870,202302,1252,2863,962,2409,165,398,477,1210,642,1608
240880,202302,1547,4420,1330,4012,106,404,949,2761,1055,3165
240890,202302,6626,14663,5238,12366,460,1269,3497,7456,3957,8725
240895,202302,3592,9554,3244,9018,391,1050,2366,6640,2757,7690
240910,202302,4175,10123,3425,8854,62,208,2766,6902,2828,7110
240920,202302,1294,2816,1042,2470,117,197,672,1642,789,1839
240930,202302,4404,8950,3553,7922,275,421,2322,5673,2597,6094
240933,202302,1924,4328,1615,3894,42,171,1353,3112,1395,3283
240940,202302,8982,18567,7178,15785,682,1466,4863,10154,5545,11620
240950,202302,1328,3553,1127,3161,30,125,877,2335,907,2460
240960,202302,863,2164,770,1979,16,53,600,1469,616,1522
240970,202302,2422,5145,1961,4444,59,171,1633,3551,1692,3722
240980,202302,4840,10996,4333,10230,69,282,3831,8687,3900,8969
240990,202302,3606,8237,3171,7506,230,677,2355,5174,2585,5851
241000,202302,1251,2725,974,2266,14,49,789,1721,803,1770
241010,202302,3843,9899,3478,9226,139,460,2831,7221,2970,7681
241020,202302,2537,6044,1911,4888,97,292,1362,3256,1459,3548
241025,202302,1921,5033,1542,4386,39,154,1096,2993,1135,3147
241030,202302,2999,8396,2423,7286,251,749,1598,4691,1849,5440
241040,202302,2591,7208,2207,6583,105,420,1669,4904,1774,5324
241050,202302,1725,4285,1357,3639,41,129,1021,2657,1062,2786
241060,202302,994,2422,831,2099,40,101,590,1401,630,1502
241070,202302,850,2008,704,1784,17,43,546,1313,563,1356
241080,202302,1326,3373,1043,2830,35,119,733,1898,768,2017
241090,202302,2505,6274,1987,5437,76,292,1480,3856,1556,4148
241100,202302,1396,3507,1064,2877,55,123,698,1836,753,1959
241105,202302,1299,3395,1057,2972,203,597,495,1323,698,1920
241110,202302,1076,2781,803,2235,47,137,502,1324,549,1461
241120,202302,9147,23319,7770,21100,798,2194,5076,13649,5874,15843
241140,202302,3990,9601,3026,7767,134,388,2163,5351,2297,5739
241142,202302,899,2213,685,1836,57,132,404,1006,461,1138
241150,202302,7104,16347,6186,14987,258,612,4857,11579,5115,12191
241160,202302,1392,3561,1064,2966,163,503,552,1425,715,1928
241170,202302,1590,3627,1337,3198,31,91,1102,2535,1133,2626
241180,202302,1240,2841,918,2296,87,229,513,1208,600,1437
241190,202302,1443,3240,1184,2795,22,70,881,1960,903,2030
241200,202302,32260,68104,28528,62630,3040,7050,19867,41167,22907,48217
241210,202302,2005,4505,1446,3533,111,286,915,2151,1026,2437
241220,202302,12396,30578,10905,28249,2476,6413,5318,13847,7794,20260
241230,202302,3529,8249,3032,7546,109,255,2481,6104,2590,6359
241240,202302,1435,3707,881,2547,99,308,305,820,404,1128
241250,202302,7599,17900,6101,15366,139,582,4834,11467,4973,12049
241255,202302,3259,8557,2754,7656,163,521,2013,5390,2176,5911
241260,202302,5984,13799,4796,11931,167,498,3653,8668,3820,9166
241270,202302,1913,5041,1582,4435,110,340,1109,3016,1219,3356
241280,202302,3143,6204,2741,5550,96,183,2367,4664,2463,4847
241290,202302,3882,8502,2838,6919,100,305,2245,5243,2345,5548
241300,202302,1905,4439,1551,3893,44,153,1102,2602,1146,2755
241310,202302,2873,5812,2474,5284,60,113,2146,4508,2206,4621
241320,202302,1135,3348,964,3034,106,358,567,1728,673,2086
241330,202302,2093,4713,1671,4166,26,73,1478,3646,1504,3719
241335,202302,4472,10883,3915,9954,127,423,3181,7774,3308,8197
241340,202302,2134,5021,1680,4200,207,615,949,2156,1156,2771
241350,202302,2622,6242,2266,5643,107,266,1749,4251,1856,4517
241355,202302,1658,3954,1317,3324,52,110,978,2424,1030,2534
241360,202302,2479,5675,1798,4402,58,171,1330,3070,1388,3241
241370,202302,1628,3886,1252,3202,59,175,910,2147,969,2322
241380,202302,856,2009,679,1720,65,165,412,1021,477,1186
241390,202302,3280,8428,2873,7832,154,483,2212,5946,2366,6429
241400,202302,4381,10853,3841,10053,214,662,2959,7505,3173,8167
241410,202302,2989,8009,2400,6848,238,736,1531,4272,1769,5008
241415,202302,2312,5455,1946,4836,41,160,1580,3710,1621,3870
241420,202302,3838,9774,3439,9156,594,1667,2069,5484,2663,7151
241430,202302,852,1913,562,1390,18,47,383,862,401,909
241440,202302,10461,27172,9407,25507,262,873,7716,20423,7978,21296
241445,202302,1665,3381,1433,3079,28,60,1282,2726,1310,2786
241450,202302,3704,7569,2993,6520,215,423,2335,5011,2550,5434
241460,202302,4747,11429,3736,9494,327,901,2453,5864,2780,6765
241470,202302,1742,4079,1386,3569,40,143,1168,2936,1208,3079
241475,202302,1451,3513,1134,2956,23,84,847,2064,870,2148
241480,202302,3757,10298,3102,8994,845,2446,1099,3398,1944,5844
241490,202302,905,1823,644,1442,14,39,532,1149,546,1188
241500,202302,966,2316,855,2186,11,27,757,1929,768,1956
250010,202302,3294,8426,2653,7194,73,245,2007,5220,2080,5465
250020,202302,1924,4519,1420,3639,83,140,1062,2709,1145,2849
250030,202302,8648,20660,7510,19010,958,2527,5120,12792,6078,15319
250040,202302,5780,14644,5007,13362,798,2056,2979,7857,3777,9913
250050,202302,4506,10407,3987,9764,181,452,3268,8100,3449,8552
250053,202302,1561,3930,1400,3696,144,308,925,2432,1069,2740
250057,202302,919,2488,833,2369,12,44,757,2141,769,2185
250060,202302,7594,16761,6662,15467,499,1154,5069,11677,5568,12831
250070,202302,4872,11895,4038,10525,41,176,3245,8094,3286,8270
250073,202302,977,2264,770,1942,8,24,624,1532,632,1556
250077,202302,3257,6852,2522,5756,33,100,2147,4715,2180,4815
250080,202302,7416,14165,6142,12667,68,181,5635,11395,5703,11576
250090,202302,4775,8934,4204,8235,66,138,3740,7110,3806,7248
250100,202302,4132,11207,3712,10485,270,680,2752,7649,3022,8329
250110,202302,6098,14852,5514,14066,367,1055,4219,10506,4586,11561
250115,202302,937,1922,709,1600,10,35,572,1229,582,1264
250120,202302,2163,5687,1904,5276,23,111,1546,4128,1569,4239
250130,202302,7646,15947,6524,14477,47,199,5815,12497,5862,12696
250135,202302,1661,3866,1432,3487,95,245,1140,2713,1235,2958
250140,202302,2736,7071,2492,6781,171,515,1980,5459,2151,5974
250150,202302,5735,15934,5142,15003,200,701,4066,11533,4266,12234
250153,202302,1681,3991,1383,3568,74,149,1069,2727,1143,2876
250157,202302,2676,6097,2358,5615,49,152,1981,4556,2030,4708
250160,202302,4715,10156,3767,8895,84,210,3222,7504,3306,7714
250170,202302,2266,5273,2018,4929,38,124,1710,4056,1748,4180
250180,202302,31080,60266,26898,55142,1344,3340,21724,42373,23068,45713
250190,202302,5222,11942,4388,10790,439,1009,3062,7297,3501,8306
250200,202302,3237,6016,2772,5448,36,78,2499,4758,2535,4836
250205,202302,982,2795,814,2519,21,89,630,1929,651,2018
250210,202302,1718,4674,1511,4344,77,264,1143,3200,1220,3464
250215,202302,1947,4809,1638,4394,99,270,943,2547,1042,2817
250220,202302,829,2037,649,1763,30,106,461,1176,491,1282
250230,202302,2007,4064,1418,3242,22,55,1115,2455,1137,2510
250240,202302,3787,8208,3354,7542,36,141,2996,6521,3032,6662
250250,202302,5926,13820,5217,12871,432,709,4026,10486,4458,11195
250260,202302,1896,4893,1570,4314,71,184,1183,3256,1254,3440
250270,202302,1432,3872,1306,3723,93,282,923,2757,1016,3039
250280,202302,4932,10494,4370,9787,271,465,3411,7763,3682,8228
250290,202302,2288,4739,1916,4223,28,61,1607,3403,1635,3464
250300,202302,7497,15947,6711,15034,219,682,5637,12199,5856,12881
250310,202302,1477,3764,1200,3301,59,141,867,2352,926,2493
250320,202302,18405,33718,16148,31222,193,528,14909,28099,15102,28627
250330,202302,3265,7290,2763,6620,67,230,2401,5519,2468,5749
250340,202302,1530,3171,1314,2889,18,44,1181,2566,1199,2610
250350,202302,4617,11932,3981,10843,331,695,2959,8318,3290,9013
250355,202302,2737,6438,2420,6063,15,61,2245,5591,2260,5652
250360,202302,2189,5065,1942,4744,78,235,1610,3770,1688,4005
250370,202302,20510,41233,17512,36998,244,757,15542,31586,15786,32343
250375,202302,1578,3326,1266,2968,6,14,1148,2734,1154,2748
250380,202302,2217,4608,2038,4401,45,138,1825,3791,1870,3929
250390,202302,2392,5183,2026,4645,138,310,1559,3553,1697,3863
250400,202302,92082,207129,70709,175797,20514,54159,21473,52209,41987,106368
250403,202302,2967,5983,2631,5618,54,249,2280,4544,2334,4793
250407,202302,1898,3744,1351,2977,143,246,877,2046,1020,2292
250410,202302,860,1997,744,1814,21,56,610,1430,631,1486
250415,202302,2425,5675,2118,5230,28,97,1862,4487,1890,4584
250420,202302,1746,3596,1574,3370,12,27,1468,3093,1480,3120
250430,202302,9504,18552,8181,16879,271,552,6996,13934,7267,14486
250435,202302,1938,4911,1507,4204,32,113,1135,3045,1167,3158
250440,202302,5344,12883,4613,11937,107,258,3981,10186,4088,10444
250450,202302,2225,5079,1823,4547,90,173,1426,3631,1516,3804
250460,202302,9686,23107,8451,21392,590,1604,6478,16114,7068,17718
250470,202302,2197,4621,1812,4043,65,142,1485,3187,1550,3329
250480,202302,4683,11374,3921,10438,98,220,3298,8809,3396,9029
250485,202302,844,1747,629,1451,71,104,423,961,494,1065
250490,202302,7080,13627,6271,12724,110,319,5655,11128,5765,11447
250500,202302,2466,6068,2147,5541,51,150,1757,4429,1808,4579
250510,202302,7188,14793,6170,13454,266,364,5130,11349,5396,11713
250520,202302,2214,5392,1882,4954,79,238,1480,3787,1559,4025
250523,202302,2798,5798,2453,5346,194,464,1904,4002,2098,4466
250527,202302,2097,4501,1895,4280,19,55,1716,3832,1735,3887
250530,202302,804,1842,686,1675,19,50,553,1305,572,1355
250535,202302,1636,4226,1456,3929,26,115,1170,3026,1196,3141
250540,202302,4154,7544,3514,6864,406,454,2832,5836,3238,6290
250550,202302,912,2690,798,2485,52,172,545,1663,597,1835
250560,202302,2075,5055,1774,4635,51,188,1470,3704,1521,3892
250570,202302,3322,8616,2850,7815,171,500,2129,5757,2300,6257
250580,202302,1260,2956,1109,2760,65,214,890,2136,955,2350
250590,202302,1283,2641,1162,2484,27,71,1040,2147,1067,2218
250600,202302,9225,22391,7612,20173,282,796,5865,15181,6147,15977
250610,202302,3463,8828,3065,8250,128,392,2454,6554,2582,6946
250620,202302,1137,2389,945,2100,39,113,761,1604,800,1717
250625,202302,2779,7297,2464,6806,47,221,2092,5635,2139,5856
250630,202302,15460,34048,13078,30399,1160,2949,9363,20622,10523,23571
250640,202302,4587,10469,4076,9820,88,314,3526,8274,3614,8588
250650,202302,1303,2736,1021,2370,11,43,872,1972,883,2015
250660,202302,1874,4121,1484,3574,35,90,1222,2812,1257,2902
250670,202302,2950,7763,2670,7288,44,181,2318,6139,2362,6320
250680,202302,7547,14530,6783,13678,34,135,6373,12518,6407,12653
250690,202302,8835,17177,7417,15510,156,307,6422,13185,6578,13492
250700,202302,5632,14133,4903,13010,707,1936,3195,8278,3902,10214
250710,202302,5205,13573,4500,12609,392,1145,3213,8970,3605,10115
250720,202302,3433,8215,3024,7644,67,252,2609,6450,2676,6702
250730,202302,5479,12276,4801,11397,213,592,4069,9347,4282,9939
250740,202302,2517,5482,2070,4906,132,285,1566,3712,1698,3997
250750,202302,162881,339232,141089,310081,9014,22482,108875,228262,117889,250744
250760,202302,3677,6857,3298,6333,145,235,2932,5533,3077,5768
250770,202302,4951,13283,4389,12543,665,1640,2848,8511,3513,10151
250780,202302,2315,5208,1958,4624,60,175,1607,3649,1667,3824
250790,202302,3170,8058,2758,7469,103,394,2215,5756,2318,6150
250800,202302,2988,6926,2586,6308,104,206,2105,5061,2209,5267
250810,202302,1785,3851,1479,3444,164,235,1087,2693,1251,2928
250820,202302,2592,5866,2377,5623,47,163,2142,4978,2189,5141
250830,202302,7465,19846,6148,17344,225,815,4419,11806,4644,12621
250840,202302,886,2592,773,2391,38,138,559,1731,597,1869
250850,202302,2214,5636,1926,5162,27,119,1567,4074,1594,4193
250855,202302,1383,3292,1231,3082,41,118,1019,2473,1060,2591
250860,202302,4251,10978,3536,9874,483,1388,2015,5478,2498,6866
250870,202302,1269,2999,1059,2681,64,144,803,2033,867,2177
250880,202302,1958,4452,1595,3927,129,314,1182,2863,1311,3177
250890,202302,14837,29987,13043,27753,249,1016,11461,23012,11710,24028
250900,202302,4016,9081,3502,8261,78,224,2992,6820,3070,7044
250905,202302,3054,7457,2800,7140,42,158,2536,6409,2578,6567
250910,202302,9264,17517,7947,16082,82,250,7241,14383,7323,14633
250915,202302,2650,5321,1931,4546,29,52,1700,4015,1729,4067
250920,202302,4790,10075,4302,9403,266,525,3559,7609,3825,8134
250930,202302,2847,6762,2518,6357,110,330,2037,4997,2147,5327
250933,202302,1505,3891,1306,3564,51,190,1011,2664,1062,2854
250937,202302,988,2306,821,2058,25,80,674,1671,699,1751
250939,202302,2511,5483,2182,5059,45,112,1829,4140,1874,4252
250940,202302,4782,11053,4136,10204,58,162,3634,8853,3692,9015
250950,202302,2027,4791,1626,4258,47,148,1281,3270,1328,3418
250960,202302,1374,3484,1203,3215,29,127,989,2528,1018,2655
250970,202302,11314,24697,9701,22165,381,792,7854,17549,8235,18341
250980,202302,2902,6749,2606,6351,21,89,2270,5349,2291,5438
250990,202302,2601,6873,2206,6211,114,380,1656,4510,1770,4890
251000,202302,2380,6056,1914,5291,49,166,1533,4188,1582,4354
251010,202302,3029,7398,2654,6854,33,146,2311,5826,2344,5972
251020,202302,1910,4686,1707,4380,32,145,1485,3689,1517,3834
251030,202302,1238,2972,1013,2595,70,155,682,1716,752,1871
251040,202302,2225,5451,1891,4926,25,107,1611,4122,1636,4229
251050,202302,1182,3079,983,2711,44,158,691,1789,735,1947
251060,202302,1366,2685,1004,2215,35,76,748,1638,783,1714
251065,202302,561,1418,414,1146,12,37,290,767,302,804
251070,202302,926,2042,770,1830,15,50,640,1452,655,1502
251080,202302,26738,57255,22036,50595,3626,8385,12690,29215,16316,37600
251090,202302,3439,8800,2875,7880,71,200,2346,6286,2417,6486
251100,202302,953,2751,816,2488,31,99,598,1726,629,1825
251110,202302,2254,5165,1866,4486,139,316,1377,3225,1516,3541
251120,202302,9877,22641,8328,20741,529,1484,6283,15165,6812,16649
251130,202302,6029,10170,5334,9406,51,109,5028,8720,5079,8829
251140,202302,4841,12448,4242,11609,128,419,3339,9052,3467,9471
251150,202302,3409,8576,3098,8113,59,276,2650,6733,2709,7009
251160,202302,2969,6902,2567,6325,25,129,2317,5557,2342,5686
251170,202302,2284,4891,2012,4561,32,93,1820,4014,1852,4107
251180,202302,3400,7657,2813,6876,292,569,1904,4815,2196,5384
251190,202302,6833,13445,6180,12722,60,248,5596,11006,5656,11254
251200,202302,5524,13448,4892,12642,158,343,4116,10717,4274,11060
251203,202302,1220,3494,1068,3156,50,153,712,2015,762,2168
251207,202302,1352,3259,1009,2716,22,95,687,1776,709,1871
251210,202302,9993,21953,8130,19418,660,1270,5683,14009,6343,15279
251220,202302,1654,3356,1206,2772,95,203,915,2100,1010,2303
251230,202302,5722,14346,4887,12917,105,366,3884,9867,3989,10233
251240,202302,4479,11493,3742,10256,308,754,2452,6765,2760,7519
251250,202302,15073,33856,13177,30813,811,2017,10141,22703,10952,24720
251260,202302,663,1533,585,1407,15,63,472,1068,487,1131
251270,202302,5558,14406,4937,13567,273,679,3865,10880,4138,11559
251272,202302,1754,3920,1609,3746,47,173,1420,3175,1467,3348
251274,202302,1015,2604,810,2254,79,220,483,1303,562,1523
251275,202302,1942,4035,1649,3593,79,188,1358,2832,1437,3020
251276,202302,1627,3944,1393,3628,34,137,1121,2803,1155,2940
251278,202302,814,1875,716,1726,30,84,575,1341,605,1425
251280,202302,3450,7034,3146,6638,50,161,2835,5773,2885,5934
251290,202302,10272,17884,9400,16902,292,579,8391,14717,8683,15296
251300,202302,1053,2690,920,2489,17,64,768,2048,785,2112
251310,202302,3442,8542,2947,7781,46,209,2466,6309,2512,6518
251315,202302,2239,6145,2006,5728,108,279,1554,4382,1662,4661
251320,202302,2027,4733,1540,3924,39,138,1171,2849,1210,2987
251330,202302,2637,5250,2108,4630,35,78,1831,3984,1866,4062
251335,202302,1353,3333,1209,3126,19,85,1079,2715,1098,2800
251340,202302,4750,9783,3777,8562,136,326,3007,6638,3143,6964
251350,202302,1330,3320,1195,3113,31,84,987,2531,1018,2615
251360,202302,2229,5378,1734,4662,25,73,1364,3581,1389,3654
251365,202302,953,2258,694,1778,21,55,537,1353,558,1408
251370,202302,35175,79698,30285,73176,4730,11103,17890,43652,22620,54755
251380,202302,1893,4032,1628,3643,53,124,1391,3041,1444,3165
251385,202302,948,2203,713,1801,27,78,503,1198,530,1276
251390,202302,9715,22295,8615,20717,733,1794,6289,14784,7022,16578
251392,202302,1276,3064,1055,2727,40,107,814,2076,854,2183
251394,202302,819,2081,669,1828,69,186,440,1156,509,1342
251396,202302,866,2123,722,1881,25,72,502,1237,527,1309
251398,202302,1221,2882,850,2231,22,81,606,1513,628,1594
251400,202302,1813,3458,1453,2994,60,111,1182,2323,1242,2434
251410,202302,1950,3892,1527,3286,15,52,1304,2649,1319,2701
251420,202302,2591,5735,2092,5160,52,171,1694,4037,1746,4208
251430,202302,1808,4836,1627,4534,57,192,1349,3691,1406,3883
251440,202302,1316,3189,1072,2780,72,152,779,2046,851,2198
251445,202302,2108,4860,1920,4619,27,87,1661,3863,1688,3950
251450,202302,5698,14099,5068,13171,57,221,4396,11176,4453,11397
251455,202302,1052,2766,938,2576,32,101,745,1985,777,2086
251460,202302,1176,2905,936,2516,82,213,654,1749,736,1962
251465,202302,615,1521,509,1342,10,45,393,972,403,1017
251470,202302,1387,3553,1045,2886,127,405,544,1354,671,1759
251480,202302,1244,2896,951,2410,22,67,707,1684,729,1751
251490,202302,2497,5655,2027,5040,141,263,1515,3753,1656,4016
251500,202302,2704,6036,2443,5692,85,207,2091,4720,2176,4927
251510,202302,3155,8648,2618,7641,126,406,1774,4981,1900,5387
251520,202302,1219,2867,913,2351,75,156,583,1451,658,1607
251530,202302,19392,38927,15952,34768,164,702,14251,30099,14415,30801
251540,202302,3630,9272,3207,8563,85,322,2636,6784,2721,7106
251550,202302,5464,10190,4472,9012,126,210,3807,7549,3933,7759
251560,202302,661,1827,587,1723,39,156,434,1195,473,1351
251570,202302,1123,2864,920,2475,20,98,719,1859,739,1957
251580,202302,2820,5425,2487,4962,25,97,2179,4096,2204,4193
251590,202302,2025,4250,1713,3882,62,144,1463,3212,1525,3356
251593,202302,1158,3093,1029,2880,88,302,700,1885,788,2187
251597,202302,2767,6276,2489,5925,15,68,2295,5357,2310,5425
251600,202302,7744,18873,6721,17359,274,783,5472,13833,5746,14616
251610,202302,4214,10202,3631,9170,293,703,2648,6545,2941,7248
251615,202302,1677,3522,1330,3026,21,49,1126,2462,1147,2511
251620,202302,24879,48166,19430,41663,243,472,16922,36149,17165,36621
251630,202302,6532,12802,5282,11110,292,648,4161,8304,4453,8952
251640,202302,2681,6341,2378,5910,22,89,2134,5193,2156,5282
251650,202302,5171,11446,4444,10521,128,304,3792,8793,3920,9097
251660,202302,4452,11319,3902,10407,56,242,3278,8439,3334,8681
251670,202302,5855,12595,5209,11757,53,210,4795,10535,4848,10745
251675,202302,1088,2274,980,2137,44,118,857,1823,901,1941
251680,202302,3223,7290,2708,6634,112,200,2187,5393,2299,5593
251690,202302,3956,9946,3351,8972,136,378,2508,6635,2644,7013
251700,202302,2787,6741,2313,6105,43,171,1932,4885,1975,5056
251710,202302,965,2230,700,1738,41,114,445,1007,486,1121
251720,202302,1571,3973,1246,3442,21,97,960,2525,981,2622
251740,202302,820,1991,652,1714,32,100,488,1230,520,1330
260005,202302,39208,73314,32851,65507,1851,3797,26445,50919,28296,54716
260010,202302,12803,29737,10523,26210,626,1717,6762,16084,7388,17801
260020,202302,8572,16860,7009,14746,76,272,6031,12259,6107,12531
260030,202302,10070,19712,8557,17642,75,277,7611,15104,7686,15381
260040,202302,9005,20282,7582,18397,443,1146,5630,13548,6073,14694
260050,202302,18210,38147,15683,35320,255,677,14623,32667,14878,33344
260060,202302,5266,11067,4504,9949,397,667,3315,7573,3712,8240
260070,202302,14763,29499,12789,26830,201,689,11126,22347,11327,23036
260080,202302,8658,16188,7548,14820,134,305,6561,12478,6695,12783
260090,202302,6871,14546,6103,13575,442,879,4832,10763,5274,11642
260100,202302,4072,8671,3501,7901,34,152,3128,6834,3162,6986
260105,202302,6198,14516,5548,13670,104,378,4724,11269,4828,11647
260110,202302,26659,67036,23530,62609,1143,3448,18910,49222,20053,52670
260120,202302,20009,43574,17060,39539,1900,4031,11860,27368,13760,31399
260130,202302,4094,8769,3518,7987,89,202,2891,6318,2980,6520
260140,202302,17369,32216,15074,29545,415,899,13135,25057,13550,25956
260150,202302,4767,8974,4180,8276,110,215,3757,7365,3867,7580
260160,202302,9417,17964,8191,16529,140,273,7521,15067,7661,15340
260170,202302,27976,55717,24005,50560,1145,2555,19551,39973,20696,42528
260180,202302,4421,9964,3740,9019,75,273,3177,7487,3252,7760
260190,202302,27194,44208,23280,39758,184,361,21484,35746,21668,36107
260200,202302,13752,29007,11875,26634,481,924,10361,23165,10842,24089
260210,202302,13806,34342,11587,30912,401,1217,9226,24280,9627,25497
260220,202302,15441,28657,14264,27237,344,585,12769,23944,13113,24529
260230,202302,16508,30688,14406,28108,333,639,12501,23805,12834,24444
260240,202302,3425,8826,2938,7962,67,275,2354,6168,2421,6443
260250,202302,2961,6423,2517,5768,94,225,2019,4467,2113,4692
260260,202302,17808,39030,15754,36225,1184,2456,12020,27976,13204,30432
260270,202302,6415,11715,5721,10954,78,223,5201,9688,5279,9911
260280,202302,16655,39556,15122,37422,336,1227,13491,32329,13827,33556
260290,202302,55059,121925,47723,112019,4111,10177,34448,78338,38559,88515
260300,202302,13396,28507,11543,25969,278,817,9933,21724,10211,22541
260310,202302,8242,16360,7411,15359,395,662,6259,12996,6654,13658
260320,202302,8985,23549,7479,21142,147,533,6179,17184,6326,17717
260330,202302,2932,8105,2475,7204,63,223,1967,5548,2030,5771
260340,202302,2767,6148,2413,5649,38,138,2130,4790,2168,4928
260345,202302,38092,82284,32550,74828,3030,7533,22255,48233,25285,55766
260350,202302,7973,14296,6953,13169,27,93,6479,11985,6506,12078
260360,202302,2961,6863,2582,6198,100,278,1844,4252,1944,4530
260370,202302,6951,16612,5904,14938,157,551,4773,11474,4930,12025
260380,202302,6154,15732,5226,14263,236,566,3975,10788,4211,11354
260390,202302,5682,15176,4542,13026,235,650,3017,8427,3252,9077
260392,202302,4978,12079,4513,11510,53,302,3996,10019,4049,10321
260400,202302,28201,52295,24687,47861,345,1002,21317,38951,21662,39953
260410,202302,104305,220676,84089,193474,14605,36185,42907,96775,57512,132960
260415,202302,5866,12593,5058,11458,33,134,4456,9779,4489,9913
260420,202302,17209,28700,14809,26107,74,237,14162,24547,14236,24784
260430,202302,3245,9250,2731,8291,161,524,1844,5490,2005,6014
260440,202302,5352,10745,4752,9993,30,113,4379,9014,4409,9127
260450,202302,6956,15512,6199,14542,378,682,5125,12189,5503,12871
260460,202302,7019,17076,6022,15479,435,1315,4218,10235,4653,11550
260470,202302,6332,13156,5335,12040,148,301,4666,10811,4814,11112
260480,202302,4694,10704,3933,9673,323,847,2820,6856,3143,7703
260490,202302,7116,13310,6242,12175,35,121,5794,11030,5829,11151
260500,202302,7544,16485,6459,15021,496,1110,4571,10558,5067,11668
260510,202302,14440,27872,12369,25072,141,446,11176,21982,11317,22428
260515,202302,5754,13004,4527,10871,97,282,3417,7600,3514,7882
260520,202302,20462,41439,17902,38276,1024,2215,14674,30613,15698,32828
260530,202302,12788,29604,10964,27014,95,433,9836,23598,9931,24031
260540,202302,9953,17523,8920,16297,124,253,8292,14907,8416,15160
260545,202302,161,414,106,305,18,60,38,85,56,145
260550,202302,3845,9335,3064,8058,187,635,2061,5022,2248,5657
260560,202302,6973,15815,5757,14035,149,446,4857,11505,5006,11951
260570,202302,11731,23438,10288,21661,201,546,9174,18755,9375,19301
260580,202302,6497,11975,5898,11221,22,49,5522,10336,5544,10385
260590,202302,10107,17331,8714,15818,100,236,8013,14249,8113,14485
260600,202302,44391,95205,37241,85010,1226,3437,30227,65617,31453,69054
260610,202302,9701,22072,8460,20482,381,1016,6543,15487,6924,16503
260620,202302,27985,55342,25033,51577,1158,3159,20709,40208,21867,43367
260630,202302,2893,6865,2370,6059,58,151,1950,4864,2008,5015
260640,202302,32869,59951,28326,54861,960,1886,24390,46332,25350,48218
260650,202302,7823,17281,6297,15420,491,878,5168,12755,5659,13633
260660,202302,9626,19917,8460,18507,276,747,7611,16315,7887,17062
260670,202302,2834,6403,2312,5581,81,230,1796,4117,1877,4347
260680,202302,40131,81324,34116,73391,2095,4806,26059,53464,28154,58270
260690,202302,4193,9549,3445,8443,84,285,2741,6500,2825,6785
260700,202302,9340,18906,8742,18268,63,198,8487,17665,8550,17863
260710,202302,1656,3844,1377,3426,57,188,1103,2668,1160,2856
260720,202302,39195,76165,34136,70201,1801,4108,28125,56140,29926,60248
260730,202302,10324,25074,8941,23202,200,718,7782,19688,7982,20406
260740,202302,1659,3977,1336,3458,25,105,1104,2806,1129,2911
260750,202302,9768,21135,7693,18640,216,380,6745,16754,6961,17134
260760,202302,8658,16472,7600,15263,121,344,6873,13472,6994,13816
260765,202302,10725,25912,9409,24162,649,1893,6833,16992,7482,18885
260770,202302,4770,10563,3892,9200,90,274,3160,7224,3250,7498
260775,202302,7604,16671,6701,15356,156,528,5522,11888,5678,12416
260780,202302,4702,11859,4150,11002,368,1175,2702,6580,3070,7755
260790,202302,193627,360292,165190,325069,19618,39951,117373,221804,136991,261755
260795,202302,4687,8801,4039,8003,149,318,3476,6751,3625,7069
260800,202302,8049,14381,7280,13403,254,402,6436,11598,6690,12000
260805,202302,4742,10918,4103,9928,138,443,3338,7708,3476,8151
260810,202302,8388,19224,7336,17388,299,788,5866,13269,6165,14057
260820,202302,6163,11445,5496,10708,71,211,4894,9399,4965,9610
260825,202302,3579,9390,3128,8670,125,396,2419,6572,2544,6968
260830,202302,5359,13476,4482,12046,534,1177,2992,8224,3526,9401
260840,202302,5876,11995,5240,11180,234,452,4565,9617,4799,10069
260845,202302,5731,12913,5066,11874,204,593,4045,9013,4249,9606
260850,202302,6223,14532,5195,12775,379,1000,3560,8206,3939,9206
260860,202302,4129,10520,3527,9480,154,459,2792,7291,2946,7750
260870,202302,5816,11274,5021,10330,141,261,4427,9034,4568,9295
260875,202302,10705,20874,8852,18374,687,1358,6443,13253,7130,14611
260880,202302,14403,31718,12679,29112,288,785,10945,24336,11233,25121
260890,202302,17020,36764,14657,33395,1208,2820,9982,22237,11190,25057
260900,202302,7004,17291,5789,15623,566,1532,3643,9747,4209,11279
260910,202302,4347,9623,3796,8850,143,329,3027,6916,3170,7245
260915,202302,7358,15297,6687,14532,28,111,6321,13553,6349,13664
260920,202302,4449,8392,3820,7731,114,193,3398,6818,3512,7011
260930,202302,5024,12795,4287,11607,165,568,3392,8856,3557,9424
260940,202302,19933,39757,17330,36285,1157,2577,13492,27217,14649,29794
260950,202302,9720,21516,7912,18716,365,1035,5608,12215,5973,13250
260960,202302,119246,213875,101387,192372,7394,14910,77927,140529,85321,155439
260970,202302,6997,15874,6055,14681,386,699,4559,11211,4945,11910
260980,202302,5975,14247,5217,13325,77,200,4739,12100,4816,12300
260990,202302,21057,51257,17701,46757,729,2227,14021,36141,14750,38368
261000,202302,21868,42147,18417,37914,540,1346,15526,30741,16066,32087
261010,202302,2772,6097,2375,5576,95,245,2032,4715,2127,4960
261020,202302,8590,18807,7565,17247,326,779,6178,13502,6504,14281
261030,202302,5101,12732,4465,11694,101,378,3637,9088,3738,9466
261040,202302,6771,16513,5538,14417,172,572,4378,10850,4550,11422
261050,202302,9963,21841,8988,20494,201,431,7623,17099,7824,17530
261060,202302,18943,39971,16523,37142,398,977,14009,30712,14407,31689
261070,202302,95381,181784,80514,162972,7479,15212,58955,115450,66434,130662
261080,202302,8955,17911,8084,16884,90,187,7619,15776,7709,15963
261090,202302,26511,50329,23614,46710,765,1428,20598,40052,21363,41480
261100,202302,11148,25659,9693,23635,597,1434,7439,17716,8036,19150
261110,202302,98416,230954,83662,206065,9976,26771,52735,123855,62711,150626
261120,202302,5015,10005,4394,9188,103,241,3844,7780,3947,8021
261130,202302,9865,19676,8705,18190,186,362,7611,15641,7797,16003
261140,202302,5010,9602,4408,8836,299,533,3435,6835,3734,7368
261150,202302,7207,15029,6344,13856,233,450,5396,11619,5629,12069
261153,202302,2322,6210,1891,5417,79,242,1333,3744,1412,3986
261160,202302,318896,634871,265876,566888,64853,140638,117152,251628,182005,392266
261170,202302,9869,18674,8610,17065,242,481,7560,14513,7802,14994
261180,202302,11951,25529,10473,23718,474,1025,8233,18363,8707,19388
261190,202302,6654,14917,5973,13925,144,574,5063,11253,5207,11827
261200,202302,4456,8528,3853,7760,137,283,3252,6375,3389,6658
261210,202302,2311,4965,1983,4525,140,220,1606,3679,1746,3899
261220,202302,19035,43815,16286,39496,1416,3625,11421,26150,12837,29775
261230,202302,4779,11773,3937,10696,43,154,3321,8983,3364,9137
261240,202302,8084,15385,7199,14185,203,414,6362,12212,6565,12626
261245,202302,4769,11189,3880,9740,63,273,3201,7615,3264,7888
261247,202302,3785,9895,3130,8773,343,931,2001,5645,2344,6576
261250,202302,38594,70523,34273,65644,3206,6464,27544,51922,30750,58386
261255,202302,4911,12700,3962,10967,169,569,2989,8014,3158,8583
261260,202302,20482,39746,18203,36974,220,806,17070,33705,17290,34511
261270,202302,6716,12383,5950,11502,216,403,5317,10070,5533,10473
261280,202302,3262,7736,2818,7043,104,338,2256,5368,2360,5706
261290,202302,3722,7987,3122,7332,84,252,2570,6029,2654,6281
261300,202302,17300,38444,14916,34880,378,1209,12211,27052,12589,28261
261310,202302,12708,26454,10973,24202,887,2019,8254,17613,9141,19632
261320,202302,7601,18290,6568,16716,99,302,5601,13926,5700,14228
261330,202302,8165,15805,7391,14847,186,457,6639,13003,6825,13460
261340,202302,7668,15153,6899,14253,96,302,6364,12792,6460,13094
261350,202302,10291,27287,8944,25080,297,810,6938,19267,7235,20077
261360,202302,11266,21979,9587,19717,387,813,7848,15562,8235,16375
261370,202302,32123,68798,27361,62726,2256,5442,19883,44080,22139,49522
261380,202302,5586,13295,4813,12077,490,1219,3367,8374,3857,9593
261390,202302,21419,53439,17921,48175,1221,3692,12396,32107,13617,35799
261400,202302,6305,15293,5500,13853,215,698,4402,10487,4617,11185
261410,202302,12630,26279,10462,23172,296,842,8868,18757,9164,19599
261420,202302,10815,25642,9777,24453,589,1772,7832,19158,8421,20930
261430,202302,5551,11136,4806,10080,34,129,4367,8828,4401,8957
261440,202302,1672,4513,1363,3953,53,231,987,2716,1040,2947
261450,202302,19109,42550,16825,39319,620,1455,13616,31390,14236,32845
261460,202302,9716,22547,8221,20327,279,703,6675,16320,6954,17023
261470,202302,4728,10454,4061,9547,53,197,3433,7857,3486,8054
261480,202302,6885,17524,5855,15888,237,851,4603,11974,4840,12825
261485,202302,7097,16884,6212,15612,422,1240,4711,11385,5133,12625
261500,202302,8667,18503,7497,16956,623,1147,5295,12362,5918,13509
261510,202302,2196,5827,1898,5366,68,242,1460,4078,1528,4320
261520,202302,2944,7585,2618,6990,129,368,1928,4975,2057,5343
261530,202302,15512,38325,12717,33857,701,2504,8126,19744,8827,22248
261540,202302,12294,29895,11236,28477,2834,6514,5546,15620,8380,22134
261550,202302,4704,10744,4094,9839,222,609,3093,7083,3315,7692
261560,202302,12008,26819,10596,24897,343,938,8923,20387,9266,21325
261570,202302,4474,10684,3482,9083,281,774,2376,5962,2657,6736
261580,202302,9179,19464,8074,18043,62,280,7537,16527,7599,16807
261590,202302,3515,7462,2841,6517,70,224,2334,5116,2404,5340
261600,202302,7842,14849,6753,13396,168,337,5766,10970,5934,11307
261610,202302,2739,7031,2193,6078,230,651,1277,3554,1507,4205
261618,202302,3645,6835,3225,6292,70,210,2848,5310,2918,5520
261620,202302,6034,14008,5541,13334,585,1252,4097,10218,4682,11470
261630,202302,7427,18849,6326,16840,487,1426,4094,10265,4581,11691
261640,202302,50215,94747,42939,86255,2235,3582,34141,68903,36376,72485
261650,202302,5562,11018,4720,10026,224,445,3889,8165,4113,8610
270010,202302,5143,15292,4410,14116,151,733,3501,10858,3652,11591
270020,202302,5192,10573,4535,9782,112,429,4021,8214,4133,8643
270030,202302,44166,106661,37525,96705,2495,6874,28787,72361,31282,79235
270040,202302,12560,29373,10604,27063,655,1795,8452,21386,9107,23181
270050,202302,6740,13577,5763,12494,148,358,5308,11407,5456,11765
270060,202302,2743,6312,2332,5817,154,408,1866,4573,2020,4981
270070,202302,6524,14354,5699,13261,88,342,5088,11392,5176,11734
270080,202302,1697,4106,1414,3678,86,216,1064,2707,1150,2923
270090,202302,2224,5751,2016,5402,31,139,1778,4652,1809,4791
270100,202302,8857,16465,7762,15065,163,377,6965,13130,7128,13507
270110,202302,4074,8562,3323,7704,214,344,2635,6383,2849,6727
270120,202302,3072,7601,2692,7098,88,270,2207,5721,2295,5991
270130,202302,6174,13947,5289,12917,151,471,4565,10969,4716,11440
270135,202302,2409,5073,2045,4678,26,116,1886,4249,1912,4365
270140,202302,10622,23454,8483,20617,323,1013,6626,15238,6949,16251
270150,202302,3889,8633,3594,8246,21,73,3450,7865,3471,7938
270160,202302,6338,15952,5440,14861,172,606,4869,13135,5041,13741
270170,202302,3855,10212,3218,9322,206,841,2303,6305,2509,7146
270180,202302,2818,7500,2532,7145,38,195,2253,6215,2291,6410
270190,202302,3084,6064,2826,5771,31,83,2671,5360,2702,5443
270200,202302,3188,8363,2748,7745,377,927,1804,5232,2181,6159
270210,202302,7279,14561,6259,13408,83,259,5836,12289,5919,12548
270220,202302,2097,4535,1713,4028,110,313,1312,2907,1422,3220
270230,202302,12359,29525,10467,26797,955,2663,7790,19378,8745,22041
270235,202302,7302,20008,6395,18625,259,788,5185,14922,5444,15710
270240,202302,14289,33720,11837,30437,979,2686,8835,22274,9814,24960
270250,202302,4178,8250,3778,7727,151,299,3366,6780,3517,7079
270255,202302,5265,13501,4160,11651,138,480,3259,8845,3397,9325
270260,202302,6442,17769,5830,16790,95,441,5051,14253,5146,14694
270270,202302,1205,2846,1000,2604,118,285,734,1901,852,2186
270280,202302,4564,9684,3611,8544,286,584,2689,6542,2975,7126
270290,202302,9638,26805,8697,25387,171,741,7740,22297,7911,23038
270300,202302,4954,11563,3864,10372,176,396,3119,8506,3295,8902
270310,202302,8181,20508,6985,18790,158,541,5849,15509,6007,16050
270320,202302,6560,17476,5596,15755,232,816,4226,11299,4458,12115
270330,202302,5237,14314,4593,13409,184,790,3855,11016,4039,11806
270340,202302,1982,4643,1684,4239,81,165,1414,3552,1495,3717
270350,202302,2319,4648,1868,4135,151,284,1365,3085,1516,3369
270360,202302,4260,8013,3869,7585,45,118,3711,7205,3756,7323
270370,202302,1609,4497,1453,4221,35,159,1227,3511,1262,3670
270375,202302,4833,8648,4217,7990,16,48,4069,7649,4085,7697
270380,202302,6853,15869,5796,14624,620,1409,4300,11082,4920,12491
270390,202302,1511,3278,1202,2920,10,59,1029,2469,1039,2528
270400,202302,7867,18356,6541,16423,264,717,5094,12439,5358,13156
270410,202302,5963,14840,5193,13742,144,489,4448,11588,4592,12077
270420,202302,8341,19347,7602,18339,165,598,6844,16029,7009,16627
270430,202302,207943,423360,167186,372867,19979,46617,105915,227389,125894,274006
270440,202302,5718,13656,4939,12685,134,418,4310,11021,4444,11439
270450,202302,11201,23309,9968,21873,489,878,8414,18716,8903,19594
270460,202302,4719,9224,4021,8388,230,366,3551,7477,3781,7843
270470,202302,14615,35133,12725,32598,669,2000,10238,25631,10907,27631
270480,202302,3733,8511,3118,7681,170,504,2579,6138,2749,6642
270490,202302,1080,2679,935,2506,36,118,776,2029,812,2147
270500,202302,5987,15731,5318,14668,273,828,4284,11671,4557,12499
270510,202302,7893,17067,6649,15539,318,920,5366,12010,5684,12930
270520,202302,4991,12305,3986,10802,753,2156,1941,5207,2694,7363
270530,202302,1605,4179,1363,3807,98,249,943,2665,1041,2914
270540,202302,2752,6531,2301,5961,67,207,2001,5098,2068,5305
270550,202302,7972,18357,6248,16460,620,1487,4537,12231,5157,13718
270560,202302,3619,8114,3012,7331,162,483,2419,5700,2581,6183
270570,202302,6933,14319,6075,13170,588,1356,4918,10282,5506,11638
270580,202302,2925,6998,2638,6622,104,290,2305,5702,2409,5992
270590,202302,1742,4786,1601,4592,16,69,1501,4292,1517,4361
270600,202302,3315,8899,3013,8459,58,212,2665,7387,2723,7599
270610,202302,4428,10325,3864,9607,128,255,3423,8483,3551,8738
270620,202302,1449,3934,1321,3723,27,102,1135,3105,1162,3207
270630,202302,23968,48834,20929,44852,698,1889,18226,37748,18924,39637
270640,202302,6673,16583,5503,14750,140,531,4481,11750,4621,12281
270642,202302,3093,8704,2708,8093,201,658,2015,5864,2216,6522
270644,202302,4867,10590,4053,9579,271,638,3237,7564,3508,8202
270650,202302,4575,10539,4031,9871,266,800,3382,8087,3648,8887
270660,202302,2416,5313,2079,4868,90,213,1628,3721,1718,3934
270670,202302,23661,45158,20154,40950,676,1414,17549,34666,18225,36080
270680,202302,8011,14555,7282,13774,311,408,6695,12824,7006,13232
270690,202302,12688,27070,10602,24416,259,771,8950,19982,9209,20753
270700,202302,685,1797,592,1655,59,185,406,1088,465,1273
270710,202302,6956,18248,6094,16973,384,1096,4756,13077,5140,14173
270720,202302,4550,11157,4046,10363,94,304,3580,8957,3674,9261
270730,202302,9672,19196,8342,17808,1016,1298,6230,14602,7246,15900
270740,202302,2780,6734,2430,6324,78,247,2035,5219,2113,5466
270750,202302,6894,15627,6077,14608,99,394,5476,12851,5575,13245
270760,202302,4048,9797,3348,8863,52,234,2841,7348,2893,7582
270770,202302,29292,64108,23951,57469,3341,8163,15521,36677,18862,44840
270780,202302,2504,5361,2308,5111,44,143,2121,4602,2165,4745
270790,202302,2148,4959,1832,4566,134,326,1467,3607,1601,3933
270800,202302,14732,32708,13243,30712,568,1386,11097,25358,11665,26744
270810,202302,4097,9824,3247,8600,180,561,2458,6308,2638,6869
270820,202302,1933,5179,1645,4747,56,232,1328,3751,1384,3983
270830,202302,6324,13622,5150,12213,202,573,4211,9754,4413,10327
270840,202302,9839,26473,8545,24547,341,1459,6927,19125,7268,20584
270850,202302,11054,22242,9706,20714,666,1569,8227,17345,8893,18914
270860,202302,17932,35491,14325,31483,560,1329,11961,25694,12521,27023
270870,202302,2768,7103,2222,6207,209,590,1452,4003,1661,4593
270880,202302,9339,25420,8341,23953,206,825,6948,19480,7154,20305
270890,202302,4275,10356,3621,9437,467,1195,2154,5540,2621,6735
270895,202302,4688,10943,4189,10334,136,393,3695,8954,3831,9347
270900,202302,1888,4430,1455,3773,20,74,1208,3048,1228,3122
270910,202302,5281,13130,4591,12165,239,502,3794,9997,4033,10499
270915,202302,11558,28964,9397,25675,860,2766,6382,16549,7242,19315
270920,202302,7318,18256,6378,16940,125,483,5496,14211,5621,14694
270930,202302,22392,45069,17634,39681,2027,4075,12777,29455,14804,33530
270940,202302,7278,17357,6065,15959,174,723,4978,12619,5152,13342
280010,202302,699,1835,541,1523,20,80,376,954,396,1034
280020,202302,6599,13912,5587,12423,400,917,4283,9137,4683,10054
280030,202302,125590,243668,104910,216120,16016,34176,63634,126279,79650,160455
280040,202302,3785,8651,3282,7957,162,490,2549,5898,2711,6388
280050,202302,5146,13127,4301,11782,941,2554,2143,5808,3084,8362
280060,202302,9562,20440,7790,17925,991,2565,4923,10882,5914,13447
280067,202302,9047,18471,7691,16513,627,1017,5672,12123,6299,13140
280070,202302,2092,5715,1919,5457,121,412,1503,4131,1624,4543
280100,202302,5391,12018,4545,10775,547,1147,2925,7160,3472,8307
280110,202302,1984,4146,1705,3768,22,59,1557,3359,1579,3418
280120,202302,9870,23623,8729,21911,1172,2576,6103,15662,7275,18238
280130,202302,10686,22329,9303,20471,636,1433,7326,15823,7962,17256
280140,202302,7761,14896,6857,13679,695,1135,5158,10488,5853,11623
280150,202302,4884,11089,4201,10134,489,1062,2972,7082,3461,8144
280160,202302,1630,3894,1393,3534,134,377,973,2319,1107,2696
280170,202302,7369,15133,6614,14208,210,485,5710,11970,5920,12455
280190,202302,2109,3433,1918,3194,36,100,1798,2906,1834,3006
280200,202302,1513,3586,1245,3198,77,241,905,2203,982,2444
280210,202302,22352,46742,19410,42789,2163,4778,13141,28094,15304,32872
280220,202302,2120,4785,1807,4385,113,258,1443,3516,1556,3774
280230,202302,5049,11471,4084,10038,268,520,2808,6895,3076,7415
280240,202302,3930,9227,3435,8524,30,154,2996,7203,3026,7357
280250,202302,1239,2372,1052,2116,59,131,830,1582,889,1713
280260,202302,3090,5966,2731,5531,41,97,2524,5050,2565,5147
280270,202302,3018,7018,2657,6525,117,350,2280,5441,2397,5791
280280,202302,4742,12423,4187,11654,584,1373,2857,8199,3441,9572
280290,202302,27884,59210,23867,53776,2362,5546,15164,34386,17526,39932
280300,202302,16771,31732,14549,29344,1158,1580,11514,24279,12672,25859
280310,202302,1682,3823,1394,3384,46,121,1104,2579,1150,2700
280320,202302,11497,25977,9985,23825,962,2400,7343,16695,8305,19095
280330,202302,5615,12386,4655,11067,345,784,3409,7899,3754,8683
280340,202302,6472,11980,5411,10818,197,298,4771,9551,4968,9849
280350,202302,40666,73743,36065,67902,1041,2375,31214,56443,32255,58818
280360,202302,6994,17288,6031,15799,656,1867,3839,9796,4495,11663
280370,202302,2916,5974,2357,5099,143,260,1766,3733,1909,3993
280380,202302,1288,2964,1090,2702,102,224,764,1894,866,2118
280390,202302,5218,10253,4407,9080,277,455,3585,7322,3862,7777
280400,202302,5152,10625,4480,9778,427,855,3384,7328,3811,8183
280410,202302,3483,8129,2924,7265,295,778,1879,4408,2174,5186
280420,202302,5533,12316,4964,11634,119,288,4483,10483,4602,10771
280430,202302,2939,5853,2609,5436,60,164,2298,4622,2358,4786
280440,202302,5590,12268,4934,11349,193,506,4219,9348,4412,9854
280445,202302,2663,6316,2401,5897,50,153,1929,4558,1979,4711
280450,202302,12177,26796,10517,24581,2269,5407,5337,12698,7606,18105
280460,202302,8877,18066,8030,16956,430,1025,6819,13974,7249,14999
280470,202302,2012,5017,1661,4385,132,370,1204,3053,1336,3423
280480,202302,64459,129696,56102,118663,5410,12259,40080,81475,45490,93734
280490,202302,4233,11099,3532,9922,134,542,2639,7021,2773,7563
280500,202302,1298,2628,1071,2349,27,78,889,1944,916,2022
280510,202302,4475,7541,3969,6914,59,163,3661,6126,3720,6289
280520,202302,2342,4764,2046,4372,163,284,1564,3337,1727,3621
280530,202302,2851,6441,2468,5933,118,280,1959,4622,2077,4902
280540,202302,10273,24604,9216,23152,410,1014,7843,19581,8253,20595
280550,202302,8389,16792,7002,14923,117,436,5982,12110,6099,12546
280560,202302,9222,21522,8579,20630,127,398,7728,18244,7855,18642
280570,202302,8866,17789,7367,16006,306,715,5898,12377,6204,13092
280580,202302,7761,16266,6857,15046,451,882,5554,11985,6005,12867
280590,202302,3396,7101,2859,6464,166,427,2156,4633,2322,5060
280600,202302,5307,11243,4672,10358,154,363,3712,8007,3866,8370
280610,202302,3509,6901,3125,6430,133,306,2691,5333,2824,5639
280620,202302,7832,15792,6707,14406,568,836,4928,10981,5496,11817
280630,202302,5144,11461,4716,10936,432,856,3628,8559,4060,9415
280640,202302,3039,6670,2640,6231,102,224,2341,5524,2443,5748
280650,202302,1470,3438,1217,3081,121,292,841,2050,962,2342
280660,202302,4883,8985,4279,8295,133,236,3815,7278,3948,7514
280670,202302,25866,52725,22293,48199,3291,6964,14540,31186,17831,38150
280680,202302,3590,7542,3077,6829,295,540,2114,4842,2409,5382
280690,202302,1285,2594,1089,2356,50,131,911,1888,961,2019
280700,202302,1461,3037,1247,2740,32,76,1035,2206,1067,2282
280710,202302,19162,36667,16345,33534,1020,1512,13959,28898,14979,30410
280720,202302,3261,6370,2680,5696,52,117,2231,4718,2283,4835
280730,202302,1240,2851,1049,2567,84,221,752,1756,836,1977
280740,202302,21592,40354,18692,36415,986,2155,15294,28486,16280,30641
280750,202302,4132,10375,3539,9397,233,682,2533,6553,2766,7235
280760,202302,9202,19377,7845,17594,766,1546,5677,12675,6443,14221
290010,202302,3910,7085,2591,5166,25,56,2264,4313,2289,4369
290020,202302,7614,15286,6942,14501,531,824,5795,12317,6326,13141
290030,202302,5700,11236,4676,10081,341,629,3662,8064,4003,8693
290035,202302,6610,12162,5359,10583,262,431,4356,8496,4618,8927
290040,202302,7246,12187,6258,11058,308,418,5448,9605,5756,10023
290050,202302,2527,7237,2136,6466,148,474,1446,4251,1594,4725
290060,202302,1907,3652,1395,2967,169,383,1001,2044,1170,2427
290070,202302,53541,100160,46081,90923,2924,5564,36128,69309,39052,74873
290080,202302,8385,19210,7277,17683,720,1783,5257,12692,5977,14475
290090,202302,2841,4490,2083,3685,32,63,1932,3361,1964,3424
290100,202302,12179,27772,9802,24407,1700,4017,5068,12971,6768,16988
290110,202302,6965,15754,5974,14232,800,1788,3614,8587,4414,10375
290115,202302,4896,12900,4156,11669,374,1075,3187,8860,3561,9935
290120,202302,8397,17598,7028,15749,204,548,6024,13124,6228,13672
290130,202302,5614,11718,4355,10093,294,572,3087,7384,3381,7956
290135,202302,5721,11486,4669,9827,167,416,3808,7541,3975,7957
290140,202302,5468,12431,4224,10823,217,510,3417,8810,3634,9320
290150,202302,4206,7761,3678,7174,156,395,3140,5907,3296,6302
290160,202302,4398,8448,3896,7785,193,338,3291,6480,3484,6818
290170,202302,4686,9294,4150,8725,136,274,3695,7768,3831,8042
290180,202302,3697,8671,3097,7760,66,228,2638,6411,2704,6639
290190,202302,6279,13172,5608,12323,113,319,4929,10575,5042,10894
290195,202302,3408,6767,2700,5885,170,318,2208,4809,2378,5127
290200,202302,4993,12422,3881,10544,259,571,2702,7369,2961,7940
290205,202302,4584,9770,4030,8986,168,412,3294,7160,3462,7572
290210,202302,18110,39861,15936,36709,1587,3048,12096,28261,13683,31309
290220,202302,4205,7750,3721,7186,91,221,3304,6189,3395,6410
290225,202302,4012,6906,3103,5977,44,120,2876,5392,2920,5512
290230,202302,3919,7496,3579,7122,174,245,2969,6055,3143,6300
290240,202302,5327,10415,4366,9286,75,233,3868,8025,3943,8258
290250,202302,5015,12110,4088,10811,152,353,3390,9097,3542,9450
290260,202302,6668,14121,5657,12709,263,664,4751,10299,5014,10963
290265,202302,3969,10607,3182,9191,301,905,2065,5803,2366,6708
290270,202302,13160,39537,11987,37602,864,2789,9142,28699,10006,31488
290280,202302,7425,20302,6349,18270,561,1828,4292,11851,4853,13679
290290,202302,11873,31281,9444,27022,1044,3231,5844,16232,6888,19463
290300,202302,5111,12317,3729,9844,200,581,2633,6679,2833,7260
290310,202302,2864,4956,2353,4374,22,73,2205,4001,2227,4074
290320,202302,37220,82445,30334,72701,5032,12513,17880,41725,22912,54238
290323,202302,4709,11339,3978,10200,100,270,3128,7946,3228,8216
290327,202302,5154,12933,4325,11436,413,992,2875,7487,3288,8479
290330,202302,3106,5068,2513,4439,23,29,2344,4132,2367,4161
290340,202302,8023,16258,6271,14211,474,1013,5012,11302,5486,12315
290350,202302,5720,14466,4728,12823,258,778,3437,9084,3695,9862
290360,202302,6795,13916,5944,12828,100,256,5263,11141,5363,11397
290370,202302,5794,12640,4184,10533,169,415,2974,7390,3143,7805
290380,202302,7320,15503,6082,13873,179,292,5169,11835,5348,12127
290390,202302,19031,47265,15669,42010,1451,3898,10845,28708,12296,32606
290395,202302,3589,8779,2834,7543,70,259,2231,5765,2301,6024
290400,202302,4577,11113,3645,9641,182,559,2727,6961,2909,7520
290405,202302,5464,14093,4580,12601,476,1263,3010,8441,3486,9704
290410,202302,6755,16106,5143,13673,178,642,3903,9995,4081,10637
290420,202302,3781,9119,3036,8000,109,290,2345,6134,2454,6424
290430,202302,4581,9722,3797,8627,170,482,3060,6594,3230,7076
290440,202302,3450,7652,2497,6185,175,392,1772,4400,1947,4792
290450,202302,5399,10067,4357,8659,89,216,3885,7408,3974,7624
290460,202302,15528,39813,12799,34923,2726,7647,5086,13559,7812,21206
290470,202302,6187,12063,4715,10160,417,937,3226,6685,3643,7622
290475,202302,8054,20017,6648,17736,89,408,5602,14558,5691,14966
290480,202302,2315,4949,1882,4342,68,218,1442,3104,1510,3322
290485,202302,5706,14278,4949,13228,223,655,3983,10610,4206,11265
290490,202302,12131,23562,11009,22136,447,905,9213,18316,9660,19221
290500,202302,5082,13707,3935,11477,713,2222,1549,4295,2262,6517
290510,202302,4530,9274,3792,8352,104,231,3324,7341,3428,7572
290515,202302,4239,10435,3660,9639,28,87,3314,8758,3342,8845
290520,202302,15248,37642,11728,31124,507,1647,7990,19566,8497,21213
290530,202302,5901,15129,4925,13603,97,384,4160,11321,4257,11705
290540,202302,4725,10595,4316,10149,174,461,3821,8951,3995,9412
290550,202302,5242,11577,4555,10775,48,100,4179,9956,4227,10056
290560,202302,7832,17770,6018,15222,556,1576,3855,9163,4411,10739
290570,202302,73014,152694,65535,143378,4562,10825,52716,111964,57278,122789
290580,202302,11448,26005,9981,24065,957,2010,7337,18079,8294,20089
290590,202302,8327,23120,6948,20797,159,542,5703,17069,5862,17611
290600,202302,23075,57183,19894,52242,1099,3047,15702,40493,16801,43540
290610,202302,2935,8293,2295,7080,95,312,1601,4854,1696,5166
290620,202302,7308,18972,6302,17388,433,1111,5006,13821,5439,14932
290630,202302,13302,25265,10997,22435,789,1590,8807,17808,9596,19398
290640,202302,3403,7378,2653,6371,269,511,1808,4543,2077,5054
290650,202302,23610,44305,21622,42121,922,2112,19458,37099,20380,39211
290660,202302,4600,10693,3603,9091,196,539,2528,6340,2724,6879
290670,202302,10805,21249,9463,19435,218,565,8350,16695,8568,17260
290680,202302,13709,32158,11287,28747,223,871,9473,23478,9696,24349
290682,202302,6848,13772,5942,12625,497,679,4407,10131,4904,10810
290685,202302,4351,8784,3155,7115,488,1003,1778,4169,2266,5172
290687,202302,10332,21805,8618,19267,1200,2508,5505,12444,6705,14952
290689,202302,3405,8347,2578,6958,335,908,1627,4371,1962,5279
290690,202302,7139,16172,5834,14367,388,959,4281,10309,4669,11268
290700,202302,3953,7844,3506,7316,65,170,3149,6435,3214,6605
290710,202302,11390,25513,9634,23200,215,690,8468,19989,8683,20679
290720,202302,26000,58097,23230,54066,1647,3405,18252,41814,19899,45219
290730,202302,8678,18309,7299,16704,506,937,5228,12323,5734,13260
290740,202302,1324,3016,1004,2526,23,54,872,2160,895,2214
290750,202302,17608,34318,15083,30696,337,891,12658,24152,12995,25043
290755,202302,2389,6169,1909,5346,107,270,1327,3728,1434,3998
290760,202302,4607,11883,3815,10535,224,511,2685,7526,2909,8037
290770,202302,3799,8728,3512,8400,77,197,3137,7460,3214,7657
290780,202302,9491,21297,7999,19305,327,630,6138,14866,6465,15496
290790,202302,6329,14898,5416,13625,282,708,4453,11175,4735,11883
290800,202302,8632,15160,6232,12440,393,632,4633,9378,5026,10010
290810,202302,7092,15058,5705,13134,226,519,4446,10148,4672,10667
290820,202302,6558,14639,5657,13317,315,668,4039,9281,4354,9949
290830,202302,5276,11612,4608,10571,109,358,3706,7914,3815,8272
290840,202302,22672,52568,19093,47194,2095,4358,12395,32195,14490,36553
290850,202302,11396,20402,9874,18775,476,707,8318,15644,8794,16351
290860,202302,8030,18808,6988,17606,385,851,5885,15083,6270,15934
290870,202302,5867,14351,4463,11795,350,843,2954,7699,3304,8542
290880,202302,1709,3713,1346,3262,198,424,765,2007,963,2431
290890,202302,12172,21102,10710,19487,356,600,9631,17415,9987,18015
290900,202302,2767,6698,2107,5583,198,494,1276,3310,1474,3804
290910,202302,6313,12997,4814,10827,49,122,4185,9261,4234,9383
290920,202302,6441,13760,5554,12709,158,235,4722,11367,4880,11602
290930,202302,8807,22399,6975,19294,293,1004,5182,13876,5475,14880
290940,202302,4119,10542,3382,9451,162,531,2628,7200,2790,7731
290950,202302,1730,3872,1385,3372,121,281,899,2205,1020,2486
290960,202302,7498,15988,6636,14954,306,567,5542,12437,5848,13004
290970,202302,3695,10250,3001,8985,130,464,2263,6687,2393,7151
290980,202302,18138,36747,15765,33372,841,1997,11456,22845,12297,24842
290990,202302,12128,27844,10766,25821,335,1084,9073,20925,9408,22009
291000,202302,4030,9072,3098,7942,163,412,2467,6379,2630,6791
291005,202302,21871,46047,19291,42871,1081,2346,15867,34672,16948,37018
291010,202302,3549,10056,2783,8445,149,500,1785,5224,1934,5724
291020,202302,1564,3496,1263,3017,32,94,914,2017,946,2111
291030,202302,3104,6550,2286,5272,216,443,1429,3194,1645,3637
291040,202302,6417,15520,5194,13830,261,753,3987,10632,4248,11385
291050,202302,14634,28347,12958,26145,1506,2948,9543,18901,11049,21849
291060,202302,10938,23869,9579,22158,954,2036,7197,16593,8151,18629
291070,202302,22684,48666,19275,43615,349,1119,16759,36607,17108,37726
291072,202302,36307,77216,27892,64554,4055,9448,15932,35338,19987,44786
291075,202302,6469,14332,5791,13318,94,257,4825,10629,4919,10886
291077,202302,2021,4780,1558,4006,92,175,1090,2803,1182,2978
291080,202302,170990,354883,139079,313199,28205,64358,68969,151393,97174,215751
291085,202302,6812,15229,5500,13272,242,659,4466,10476,4708,11135
291090,202302,2649,4375,1959,3619,48,85,1692,3039,1740,3124
291100,202302,4103,7512,2913,6121,127,249,2299,4762,2426,5011
291110,202302,7037,19236,5877,17351,374,1308,4403,12603,4777,13911
291120,202302,10653,21071,9154,19267,571,1162,7233,15053,7804,16215
291125,202302,2903,4419,2213,3657,96,130,1923,3149,2019,3279
291130,202302,3804,9679,2837,7910,85,302,2183,5825,2268,6127
291140,202302,5804,13770,4178,10961,702,1652,2346,6148,3048,7800
291150,202302,3507,5959,2772,5160,62,94,2584,4784,2646,4878
291160,202302,6154,15126,5057,13576,569,1563,3190,8317,3759,9880
291165,202302,2472,6271,1771,4951,27,122,1209,3222,1236,3344
291170,202302,27458,61998,22861,54676,1668,4061,15064,34124,16732,38185
291180,202302,9970,17004,7847,14363,257,504,6915,12288,7172,12792
291185,202302,4374,9245,3879,8547,217,448,3110,6786,3327,7234
291190,202302,9504,20244,7865,18228,319,699,6117,14378,6436,15077
291200,202302,3287,8226,2410,6628,87,314,1616,4135,1703,4449
291210,202302,9556,17060,7101,14311,382,662,5499,11028,5881,11690
291220,202302,6178,14242,5492,13260,541,1233,3747,8953,4288,10186
291230,202302,6194,10470,4938,9119,67,100,4602,8446,4669,8546
291240,202302,5037,11649,4257,10394,81,230,3678,8803,3759,9033
291250,202302,3874,10430,2981,8868,180,518,1800,5430,1980,5948
291260,202302,1790,3619,1453,3189,37,69,1189,2638,1226,2707
291270,202302,6881,15049,5390,13055,536,1172,3826,9454,4362,10626
291280,202302,3485,7491,2591,6215,176,440,1803,4108,1979,4548
291290,202302,6874,16199,5240,13754,495,1360,3480,8883,3975,10243
291300,202302,4803,11302,3816,9732,209,513,2810,7035,3019,7548
291310,202302,6453,14854,5555,13393,137,394,4774,11220,4911,11614
291320,202302,8068,19262,6312,16431,1320,3318,3266,8647,4586,11965
291330,202302,2254,5168,1838,4498,68,188,1388,3278,1456,3466
291340,202302,5129,11793,4060,10106,217,417,2747,6772,2964,7189
291345,202302,3639,9001,3244,8434,201,549,2578,6668,2779,7217
291350,202302,8852,18263,6976,15990,196,486,5854,13163,6050,13649
291360,202302,55813,105359,44918,92905,5448,11046,29828,62118,35276,73164
291370,202302,10184,24097,8966,22293,689,1962,6701,15870,7390,17832
291380,202302,5885,11519,5264,10726,115,309,4712,9352,4827,9661
291390,202302,17159,31104,13270,26819,649,1136,11276,22510,11925,23646
291400,202302,20841,41947,17423,37095,1649,3304,12189,25881,13838,29185
291410,202302,3608,8444,2809,7131,61,197,2089,5094,2150,5291
291420,202302,2310,4946,1815,4350,23,73,1566,3705,1589,3778
291430,202302,3160,7846,2681,7081,104,372,2103,5333,2207,5705
291440,202302,8119,20033,6920,18229,533,1322,5006,13429,5539,14751
291450,202302,13823,25121,11480,22473,316,455,10274,20274,10590,20729
291460,202302,22795,48765,19927,44707,1854,3880,14542,31975,16396,35855
291465,202302,10900,23338,8632,20751,269,908,7364,17184,7633,18092
291470,202302,26164,47153,22343,42844,1177,2086,17897,33933,19074,36019
291480,202302,54779,106501,44174,92212,4937,10403,27230,54381,32167,64784
291490,202302,9297,17747,8287,16642,264,584,7529,14944,7793,15528
291500,202302,6898,13010,5816,11673,167,383,5339,10616,5506,10999
291510,202302,5951,11414,4562,9683,75,216,4019,8326,4094,8542
291520,202302,5628,11341,4312,9713,274,623,3457,7680,3731,8303
291530,202302,2896,5808,2119,4832,236,529,1433,3300,1669,3829
291535,202302,4708,11354,3939,10081,217,486,3127,8045,3344,8531
291540,202302,2726,5174,1921,4224,57,138,1646,3583,1703,3721
291550,202302,8405,15163,6643,13072,540,937,4915,9519,5455,10456
291560,202302,22544,48137,16838,40861,3753,8815,7833,19654,11586,28469
291570,202302,2977,5827,2300,5059,79,174,2018,4435,2097,4609
291580,202302,7880,17499,6198,15369,315,901,4734,11299,5049,12200
291590,202302,3506,6336,3120,5900,70,178,2883,5303,2953,5481
291600,202302,6928,14009,5350,11756,497,1204,3590,7612,4087,8816
291610,202302,8774,16758,7812,15697,723,988,6159,12880,6882,13868
291620,202302,3705,7237,2807,6260,220,403,2073,4737,2293,5140
291630,202302,4384,8037,3358,6808,580,857,2357,5049,2937,5906
291640,202302,22984,46149,17874,39334,1502,3464,11456,23813,12958,27277
291650,202302,12930,25632,11443,23924,917,1292,9356,20231,10273,21523
291660,202302,2445,5301,1802,4370,111,344,1248,2780,1359,3124
291670,202302,2425,5784,1991,5162,201,459,1336,3562,1537,4021
291680,202302,5053,10862,4101,9614,574,1325,2510,5936,3084,7261
291685,202302,5716,12741,4553,11152,200,423,3469,8429,3669,8852
291690,202302,5628,9917,4069,7888,139,290,3546,6659,3685,6949
291700,202302,11911,27618,10492,25423,326,1015,9019,21161,9345,22176
291710,202302,6954,13614,5328,11488,348,769,4039,8355,4387,9124
291720,202302,5362,14500,4405,12731,872,2628,2334,6576,3206,9204
291730,202302,10019,18478,8647,16771,411,814,7373,14123,7784,14937
291733,202302,3605,8032,2957,7174,121,224,2178,5487,2299,5711
291735,202302,3164,7966,2395,6615,81,193,1675,4627,1756,4820
291740,202302,4708,11126,3237,8453,115,247,2278,5844,2393,6091
291750,202302,27777,56339,23131,49776,3047,5864,15309,33020,18356,38884
291760,202302,13986,34726,10919,30196,3361,10799,2740,6899,6101,17698
291770,202302,9390,21961,7777,19253,387,1208,5948,13870,6335,15078
291780,202302,6522,14649,5863,13786,170,430,5040,11605,5210,12035
291790,202302,3815,8208,3477,7809,399,603,2564,6056,2963,6659
291800,202302,45281,93609,36296,81487,4293,10356,23023,48765,27316,59121
291810,202302,13622,27851,11658,25567,483,889,9720,21453,10203,22342
291820,202302,4910,11087,4248,10250,138,345,3475,8280,3613,8625
291830,202302,6081,11514,4974,10114,364,495,3873,7976,4237,8471
291835,202302,7837,21163,6233,18343,703,2107,4007,11811,4710,13918
291840,202302,66085,152960,57683,140729,6092,15881,40995,97621,47087,113502
291845,202302,4277,8198,3567,7365,272,428,2855,6064,3127,6492
291850,202302,5554,13004,4680,11704,138,349,3972,9897,4110,10246
291855,202302,2985,4766,2414,4158,35,63,2276,3887,2311,3950
291860,202302,2529,6251,1722,4733,44,113,1161,3082,1205,3195
291870,202302,1501,3489,998,2624,56,166,662,1680,718,1846
291875,202302,3459,9554,2935,8507,68,276,2163,6006,2231,6282
291880,202302,6730,16395,5647,14710,340,813,4264,11223,4604,12036
291890,202302,2145,3859,1402,2999,214,444,889,1863,1103,2307
291900,202302,1665,3443,1268,2858,37,85,1018,2197,1055,2282
291905,202302,2728,6457,2213,5678,105,332,1659,4068,1764,4400
291910,202302,4543,8426,3923,7709,84,171,3507,6838,3591,7009
291915,202302,8961,22477,7205,19648,273,697,5269,14698,5542,15395
291920,202302,45414,96351,40030,89538,1978,5451,32381,69213,34359,74664
291930,202302,3432,7501,2911,6803,300,656,2097,4976,2397,5632
291940,202302,4545,10439,3056,8070,279,703,1836,4742,2115,5445
291950,202302,11018,30721,9169,27440,517,1584,6065,18019,6582,19603
291955,202302,25557,53943,22893,50627,1484,3533,18374,39920,19858,43453
291960,202302,4759,9449,3991,8500,310,484,3162,6951,3472,7435
291970,202302,6226,12645,5266,11520,197,468,4265,9152,4462,9620
291980,202302,12432,31077,10048,27285,932,2394,6725,18394,7657,20788
291990,202302,2752,6232,2291,5679,33,120,2109,5158,2142,5278
291992,202302,6050,11834,5136,10690,209,457,4317,8672,4526,9129
291995,202302,2858,6268,2360,5540,80,252,1960,4424,2040,4676
292000,202302,3461,6792,2879,6118,86,220,2456,5118,2542,5338
292010,202302,7236,14335,5899,12459,106,357,5081,10326,5187,10683
292020,202302,5903,14089,5012,12688,137,498,4137,10018,4274,10516
292030,202302,2572,6606,2219,6014,152,443,1471,3837,1623,4280
292040,202302,5829,12266,4649,10639,167,399,3857,8687,4024,9086
292045,202302,5754,11151,4587,9532,28,71,4306,8890,4334,8961
292050,202302,7906,19470,6343,16904,270,835,4341,11136,4611,11971
292060,202302,16517,30928,15281,29487,503,874,13645,25804,14148,26678
292070,202302,8799,17329,7750,16119,553,1093,6551,13549,7104,14642
292080,202302,4739,8807,3942,7832,48,150,3666,7154,3714,7304
292090,202302,5291,10186,3756,8327,220,526,2974,6538,3194,7064
292100,202302,16291,34217,13965,31367,2064,4638,8605,19361,10669,23999
292105,202302,4020,9240,3459,8475,49,167,2914,7052,2963,7219
292110,202302,8470,16576,6157,13517,733,1760,4101,8666,4834,10426
292120,202302,8927,19827,7318,17253,788,1603,5027,11766,5815,13369
292130,202302,4164,8769,3376,7811,212,535,2497,5621,2709,6156
292140,202302,7242,13881,6128,12363,179,373,5442,10771,5621,11144
292145,202302,3243,7686,2700,6844,154,286,2030,5255,2184,5541
292150,202302,19833,43058,17104,38864,384,996,14685,32308,15069,33304
292160,202302,3578,7543,2701,6464,33,99,2119,5332,2152,5431
292170,202302,10826,25537,8957,22636,540,1585,6688,16333,7228,17918
292180,202302,3498,8745,2615,7180,199,562,1633,4299,1832,4861
292190,202302,3781,8488,3173,7630,276,707,2234,5311,2510,6018
292200,202302,11773,25640,8898,21697,1880,4731,4209,10333,6089,15064
292205,202302,4723,11293,4115,10437,114,314,3505,8864,3619,9178
292210,202302,8378,15861,6970,14155,80,265,6495,12918,6575,13183
292220,202302,2785,5587,2383,5016,197,395,1727,3483,1924,3878
292225,202302,3833,9869,3322,9137,66,261,2860,7729,2926,7990
292230,202302,10889,22544,9518,20795,318,824,7989,16998,8307,17822
292240,202302,6143,15491,5244,13908,319,787,3729,9813,4048,10600
292250,202302,7801,16943,6944,15779,322,814,5581,12263,5903,13077
292260,202302,4134,9562,3628,8943,57,169,3229,7901,3286,8070
292265,202302,4522,10362,3732,9160,66,253,3173,7528,3239,7781
292270,202302,6263,11309,5133,9991,195,311,4330,8314,4525,8625
292273,202302,3477,6623,2759,5761,158,260,1980,4351,2138,4611
292275,202302,2381,5126,1948,4575,51,159,1630,3738,1681,3897
292280,202302,3413,6848,2712,6048,117,204,2294,5196,2411,5400
292285,202302,3206,6562,2512,5663,112,203,2036,4644,2148,4847
292290,202302,9314,20602,7457,18053,200,491,6262,14909,6462,15400
292300,202302,13145,29093,10350,25315,1517,3722,6252,15366,7769,19088
292303,202302,4204,9286,3656,8485,57,136,3267,7451,3324,7587
292305,202302,2799,6685,2540,6340,54,173,2267,5578,2321,5751
292310,202302,8687,18348,7510,16935,146,443,6594,14495,6740,14938
292320,202302,7072,16858,5629,14485,172,509,4385,10951,4557,11460
292330,202302,4045,6735,3394,6022,156,228,2866,5128,3022,5356
292335,202302,6282,14305,5503,13175,277,632,4536,10870,4813,11502
292340,202302,6199,16005,5062,13843,372,935,3530,9600,3902,10535
292350,202302,3404,7770,2853,7058,145,398,2358,5760,2503,6158
292360,202302,6100,14315,5067,12695,273,732,3697,9051,3970,9783
292370,202302,13803,27271,11869,24797,86,328,11241,23063,11327,23391
292380,202302,8417,20572,7454,18972,449,1202,5806,14401,6255,15603
292390,202302,6185,9691,4768,8102,111,191,4342,7314,4453,7505
292400,202302,29290,70410,25150,64333,2431,6074,17576,44450,20007,50524
292405,202302,5607,11888,4645,10439,147,325,3639,8288,3786,8613
292410,202302,3106,5706,2687,5226,89,152,2389,4630,2478,4782
292420,202302,6261,11981,5609,11119,138,265,5067,9821,5205,10086
292430,202302,6004,16031,4503,13356,341,1099,3011,8734,3352,9833
292440,202302,11512,29372,10541,28004,126,596,9565,25002,9691,25598
292450,202302,4960,12499,3740,10263,104,308,2893,7796,2997,8104
292460,202302,8016,16213,6797,14458,161,449,5948,12216,6109,12665
292465,202302,3178,7074,2653,6410,128,263,1785,4578,1913,4841
292467,202302,2697,6182,2389,5791,325,652,1664,4264,1989,4916
292470,202302,3406,8021,2554,6720,152,354,1791,4744,1943,5098
292480,202302,8501,15504,7020,13771,169,335,6353,12326,6522,12661
292490,202302,3487,6625,2877,5860,81,171,2332,4731,2413,4902
292500,202302,9083,20048,7233,17248,415,887,5355,12485,5770,13372
292510,202302,17708,39535,13942,33925,1065,2516,9851,23722,10916,26238
292520,202302,9354,20583,8248,19034,416,1123,6638,14867,7054,15990
292525,202302,8253,16246,6825,14637,138,324,6148,13108,6286,13432
292530,202302,45850,102783,36925,89385,7134,18449,18969,44099,26103,62548
292540,202302,5446,8808,4364,7672,141,221,3941,6940,4082,7161
292550,202302,10468,24820,8130,22012,666,1660,5546,15795,6212,17455
292560,202302,5644,12368,4659,11022,172,500,3587,8103,3759,8603
292570,202302,4609,10444,3833,9156,58,217,3263,7474,3321,7691
292575,202302,8246,21296,7463,20244,931,2430,5330,14710,6261,17140
292580,202302,9989,20361,8285,18007,525,737,6816,14904,7341,15641
292590,202302,8873,21018,7450,18562,311,1016,6143,14745,6454,15761
292593,202302,3573,7857,2816,6618,81,200,2325,5345,2406,5545
292595,202302,7084,15901,6131,14747,324,655,5022,12294,5346,12949
292600,202302,13989,32606,12005,29783,677,1536,9457,23455,10134,24991
292610,202302,5668,12195,4774,10804,156,346,3888,8576,4044,8922
292620,202302,8531,18829,7053,17062,118,279,6467,15626,6585,15905
292630,202302,11690,24177,9409,20737,987,2402,6468,13522,7455,15924
292640,202302,9755,25043,8124,22395,486,1343,5555,15294,6041,16637
292650,202302,5154,11505,4545,10713,65,199,4158,9663,4223,9862
292660,202302,13150,32761,11203,29952,644,1563,8402,22665,9046,24228
292665,202302,2455,6428,2062,5911,121,282,1593,4704,1714,4986
292670,202302,4135,10514,3211,8860,256,832,2066,5415,2322,6247
292680,202302,4805,11255,3816,9618,102,262,2951,7183,3053,7445
292690,202302,2993,7160,2050,5674,217,552,1252,3546,1469,4098
292700,202302,13124,29878,11238,27155,647,1389,8446,20154,9093,21543
292710,202302,4249,8965,3979,8647,76,148,3781,8197,3857,8345
292720,202302,10888,22208,9110,20167,477,902,6976,15911,7453,16813
292730,202302,6976,13165,6280,12228,355,578,5307,10235,5662,10813
292740,202302,522058,1030981,466727,958267,49266,104367,335908,664884,385174,769251
292750,202302,8885,18501,7738,17040,301,621,6572,14328,6873,14949
292760,202302,4803,11984,4119,10849,192,560,3130,8048,3322,8608
292770,202302,9715,20783,8023,18531,991,2321,5565,12902,6556,15223
292780,202302,2641,4464,1962,3681,45,110,1688,2984,1733,3094
292790,202302,4698,8672,3577,7472,307,563,2806,5934,3113,6497
292800,202302,15007,31604,12868,28517,935,1868,9966,22099,10901,23967
292805,202302,4728,9350,3782,8210,140,329,3181,6736,3321,7065
292810,202302,17108,32849,14101,28569,467,1241,11975,22903,12442,24144
292820,202302,8270,21147,6026,17432,503,1619,4089,11512,4592,13131
292830,202302,3662,7440,3129,6821,151,306,2565,5675,2716,5981
292840,202302,12832,25669,11054,23415,151,463,10072,20754,10223,21217
292850,202302,3234,7386,2726,6698,243,552,1898,4597,2141,5149
292860,202302,23269,43021,20839,40144,407,998,18464,34493,18871,35491
292870,202302,29244,59658,25306,54351,1735,3652,18137,37310,19872,40962
292880,202302,13636,33977,11347,30446,437,1519,8176,20789,8613,22308
292890,202302,10921,23382,9689,21718,214,653,8495,18464,8709,19117
292895,202302,4257,7629,3318,6306,247,388,2654,5032,2901,5420
292900,202302,3759,8109,3376,7603,56,200,2857,6145,2913,6345
292905,202302,5497,12284,4371,10653,162,437,3380,7916,3542,8353
292910,202302,7015,15256,6169,14182,179,373,5036,11280,5215,11653
292920,202302,12419,28941,11392,27580,343,1037,9803,23142,10146,24179
292925,202302,6311,16355,5152,14243,450,1022,3476,9632,3926,10654
292930,202302,8684,22063,7485,19949,1015,2752,4258,11003,5273,13755
292935,202302,3496,6332,2827,5599,22,68,2602,5102,2624,5170
292937,202302,3362,7718,2772,6938,418,794,1538,4279,1956,5073
292940,202302,3731,8196,2986,7107,491,1069,1804,4389,2295,5458
292950,202302,11312,26307,9820,24230,588,1389,7351,17739,7939,19128
292960,202302,6800,14148,5723,12704,209,382,4621,10104,4830,10486
292970,202302,4920,11975,4327,11163,117,316,3581,9293,3698,9609
292975,202302,5412,10376,4815,9712,103,230,4412,8814,4515,9044
292980,202302,4890,9147,4099,8082,60,175,3687,7064,3747,7239
292990,202302,13989,34431,11611,30493,411,1292,9086,23002,9497,24294
293000,202302,3318,7133,2778,6311,170,331,2082,4753,2252,5084
293010,202302,23755,51823,19235,45345,2464,6053,12237,28253,14701,34306
293015,202302,10535,28341,8280,24250,712,2124,5550,16200,6262,18324
293020,202302,12897,30326,11675,28655,165,579,10617,25776,10782,26355
293030,202302,6260,14795,4831,12637,410,750,3162,8672,3572,9422
293040,202302,5289,11970,4264,10585,131,354,3568,8761,3699,9115
293050,202302,32290,62679,28399,57313,1950,3855,21977,42959,23927,46814
293060,202302,4687,10978,3762,9354,234,601,2725,6491,2959,7092
293070,202302,42707,80724,38208,75271,2259,4709,30985,58937,33244,63646
293075,202302,4391,11784,3796,10863,66,338,3251,9234,3317,9572
293076,202302,4246,9055,3838,8590,111,204,3388,7650,3499,7854
293077,202302,8130,19142,6580,16834,957,2196,3788,10267,4745,12463
293080,202302,5496,14373,4608,12873,90,364,3778,10299,3868,10663
293090,202302,3720,10019,2864,8577,192,591,1965,5793,2157,6384
293100,202302,7159,16821,5747,14463,332,712,4372,10965,4704,11677
293105,202302,4632,13146,3911,11747,246,769,2697,8050,2943,8819
293110,202302,3183,6459,2685,5783,133,274,2144,4535,2277,4809
293120,202302,6611,13535,6035,12759,515,715,4859,10655,5374,11370
293130,202302,4518,10605,3895,9825,124,394,3367,8317,3491,8711
293135,202302,40168,85827,29728,71899,5574,14847,12013,27934,17587,42781
293140,202302,3660,6080,3217,5578,101,138,2868,4897,2969,5035
293150,202302,6265,16542,5136,14532,412,1255,3479,9508,3891,10763
293160,202302,5243,10503,4623,9808,569,765,3552,8188,4121,8953
293170,202302,6940,11135,5938,10015,111,238,5279,8664,5390,8902
293180,202302,5687,13607,4684,11902,100,337,3829,9402,3929,9739
293190,202302,21136,42456,18674,39149,127,499,17186,35051,17313,35550
293200,202302,11857,23163,9752,20078,597,926,7974,16372,8571,17298
293210,202302,6773,14798,5715,13314,585,1210,4120,9711,4705,10921
293220,202302,7644,15283,5779,12441,777,1631,3824,7869,4601,9500
293230,202302,6044,11694,4614,9949,392,724,3447,7498,3839,8222
293240,202302,5591,12531,4467,10836,211,381,3313,8378,3524,8759
293245,202302,4980,11508,4492,10840,281,649,3666,8708,3947,9357
293250,202302,7172,15161,5763,13271,428,1035,4317,9739,4745,10774
293260,202302,6035,13353,4902,11704,176,335,3580,8564,3756,8899
293270,202302,9576,17761,7640,15721,619,755,6134,13386,6753,14141
293280,202302,5713,12640,4960,11634,309,659,3943,9200,4252,9859
293290,202302,21714,51761,19188,48018,1783,4620,13744,33684,15527,38304
293300,202302,8496,16854,7295,15163,555,1129,5589,11217,6144,12346
293305,202302,5450,10945,4611,9915,41,105,4191,8942,4232,9047
293310,202302,2763,6081,2324,5432,32,115,1925,4342,1957,4457
293315,202302,5876,11147,4885,9807,486,683,3850,7880,4336,8563
293317,202302,3521,7160,3117,6601,313,478,2265,4890,2578,5368
293320,202302,17896,34001,15974,31923,211,509,14661,28698,14872,29207
293325,202302,2298,4914,1788,4286,203,481,1180,2803,1383,3284
293330,202302,98761,224265,81925,197726,9626,26239,49872,111209,59498,137448
293340,202302,2652,6595,2154,5756,179,484,1455,3830,1634,4314
293345,202302,4776,10848,3828,9483,502,917,2431,6681,2933,7598
293350,202302,7202,17707,6134,16387,174,462,5315,14242,5489,14704
293360,202302,19565,40667,16794,37125,565,1179,14585,32411,15150,33590
310010,202302,1243,2564,865,2078,112,303,377,779,489,1082
310020,202302,4021,9511,3031,7840,515,1441,1275,2988,1790,4429
310030,202302,2459,6177,1947,5315,262,765,1257,3288,1519,4053
310040,202302,1030,2398,797,2015,72,234,460,1005,532,1239
310050,202302,2059,5092,1733,4614,148,471,1161,2951,1309,3422
310060,202302,3898,9379,3263,8547,147,482,2408,6344,2555,6826
310070,202302,445,967,338,823,11,36,256,600,267,636
310080,202302,946,2375,699,1959,99,306,336,886,435,1192
310090,202302,6678,14017,5542,12356,200,567,4496,9574,4696,10141
310100,202302,4667,10470,3879,9303,103,362,3308,7647,3411,8009
310110,202302,6010,14066,4715,11947,607,1792,2865,6772,3472,8564
310120,202302,845,1888,561,1479,90,304,282,626,372,930
310130,202302,542,1216,465,1106,30,99,357,790,387,889
310140,202302,449,1145,347,1003,78,255,164,407,242,662
310150,202302,8092,17855,6176,14697,516,1508,3720,7885,4236,9393
310160,202302,13242,28955,10262,24469,1635,4559,5143,11079,6778,15638
310163,202302,1466,3997,1130,3354,263,876,313,767,576,1643
310170,202302,12435,26853,10166,23552,934,2220,7264,16386,8198,18606
310180,202302,2564,5478,1868,4429,200,540,1212,2719,1412,3259
310190,202302,3314,8672,2644,7539,584,1801,549,1410,1133,3211
310200,202302,2483,6370,1881,5348,385,1288,815,2017,1200,3305
310205,202302,1447,3564,1173,3167,148,415,754,2039,902,2454
310210,202302,2975,7254,2395,6239,131,322,1683,4227,1814,4549
310220,202302,1413,3540,1043,2866,86,281,645,1654,731,1935
310230,202302,2926,6838,2417,5986,286,846,1506,3429,1792,4275
310240,202302,1276,3252,1070,2928,58,204,724,1867,782,2071
310250,202302,1537,3245,1282,2883,36,102,1038,2237,1074,2339
310260,202302,4746,11346,3245,8640,753,2343,1099,2323,1852,4666
310270,202302,3683,7025,2998,6165,109,255,2496,5074,2605,5329
310280,202302,3636,7008,2842,5976,140,381,2150,4158,2290,4539
310285,202302,2259,6345,1858,5643,196,654,1112,3345,1308,3999
310290,202302,2007,4747,1700,4213,206,601,1057,2348,1263,2949
310300,202302,2098,5236,1611,4399,166,551,865,2082,1031,2633
310310,202302,420,893,285,679,51,130,144,309,195,439
310320,202302,589,1368,401,1059,25,75,221,552,246,627
310330,202302,613,1355,358,901,62,156,143,328,205,484
310340,202302,10319,23487,8006,19699,952,2382,4257,10130,5209,12512
310350,202302,17414,38795,12586,31260,1818,5086,6649,15096,8467,20182
310360,202302,778,1517,644,1353,26,68,448,889,474,957
310370,202302,1505,4320,1288,3959,255,870,423,1331,678,2201
310375,202302,1095,2480,772,2025,234,597,236,605,470,1202
310380,202302,460,1005,271,726,24,67,145,361,169,428
310390,202302,734,2002,593,1732,105,341,252,653,357,994
310400,202302,16046,35693,12167,30004,913,2690,8105,18638,9018,21328
310410,202302,1323,3488,818,2452,91,311,338,858,429,1169
310420,202302,6049,14557,4658,12169,563,1647,2469,5849,3032,7496
310430,202302,2158,5401,1545,4327,256,746,671,1592,927,2338
310440,202302,811,1900,539,1429,87,220,247,611,334,831
310445,202302,1662,4191,1269,3458,92,228,888,2349,980,2577
310450,202302,6072,12708,4643,10579,271,801,3563,7591,3834,8392
310460,202302,2170,5370,1602,4361,219,644,461,1041,680,1685
310470,202302,4182,8701,3217,7450,470,996,1994,4696,2464,5692
310480,202302,1262,2937,953,2443,107,351,560,1281,667,1632
310490,202302,3791,9109,2987,7829,391,1198,1626,3831,2017,5029
310500,202302,1950,4517,1547,3894,212,557,969,2323,1181,2880
310510,202302,3041,7017,2263,5672,389,1048,1000,2348,1389,3396
310520,202302,1395,3291,976,2543,145,414,452,1119,597,1533
310530,202302,1064,2527,784,2075,112,349,318,689,430,1038
310540,202302,3635,9600,2965,8357,536,1665,1310,3338,1846,5003
310550,202302,1586,3473,1145,2760,85,263,736,1577,821,1840
310560,202302,21640,51006,16062,41304,1772,5372,8382,18420,10154,23792
310570,202302,1562,3284,1224,2850,56,172,1018,2278,1074,2450
310590,202302,5416,12566,4317,10634,274,804,2650,5899,2924,6703
310600,202302,1757,4520,1432,3900,165,485,777,1933,942,2418
310610,202302,598,1532,372,1146,93,304,75,212,168,516
310620,202302,299170,667298,231522,551469,22620,65102,138814,291811,161434,356913
310630,202302,5851,14460,4448,11827,536,1482,2593,6512,3129,7994
310640,202302,1949,4408,1592,3842,114,369,1143,2476,1257,2845
310650,202302,2920,7118,2143,5734,138,435,1271,3187,1409,3622
310660,202302,1786,4100,1458,3666,24,66,1257,3119,1281,3185
310665,202302,1755,3771,1472,3410,44,141,1186,2698,1230,2839
310670,202302,86349,191849,72493,169944,6439,17498,50327,109582,56766,127080
310680,202302,995,2066,826,1831,18,69,684,1440,702,1509
310690,202302,3245,6734,2418,5575,245,587,1648,3547,1893,4134
310700,202302,672,1239,521,1053,11,28,437,848,448,876
310710,202302,7864,20068,5622,16616,1273,4228,930,2402,2203,6630
310720,202302,1475,2964,1176,2586,42,116,893,1886,935,2002
310730,202302,13000,29669,11033,26767,532,1616,8247,18857,8779,20473
310740,202302,8824,21443,6767,17732,775,2412,3497,8021,4272,10433
310750,202302,1740,3675,1325,3092,149,394,776,1604,925,1998
310760,202302,894,2008,644,1629,65,130,399,1020,464,1150
310770,202302,1337,3311,937,2689,123,412,460,1143,583,1555
310780,202302,5190,10776,4176,9387,300,726,2974,6532,3274,7258
310790,202302,2326,6672,1987,6001,414,1427,485,1184,899,2611
310800,202302,2853,7976,2061,6398,456,1563,124,307,580,1870
310810,202302,1903,4000,1560,3485,78,218,1174,2463,1252,2681
310820,202302,1499,3452,896,2463,154,429,279,703,433,1132
310825,202302,3296,8113,2620,7082,44,213,2181,5620,2225,5833
310830,202302,2715,6585,2094,5543,386,1139,1037,2437,1423,3576
310840,202302,2830,7012,2165,5933,449,1374,700,1631,1149,3005
310850,202302,1627,4019,1328,3592,59,218,938,2390,997,2608
310855,202302,4132,9530,3254,8201,229,622,2383,5777,2612,6399
310860,202302,8474,21715,6894,18958,824,2065,4057,11267,4881,13332
310870,202302,1146,2515,911,2198,55,141,655,1501,710,1642
310880,202302,1071,2928,808,2385,95,294,440,1251,535,1545
310890,202302,2772,7379,1846,5595,349,1113,274,717,623,1830
310900,202302,5419,13817,4066,11176,737,2290,1738,4151,2475,6441
310910,202302,2720,6135,1869,4817,273,785,512,1138,785,1923
310920,202302,2327,5404,1767,4606,220,664,1108,2725,1328,3389
310925,202302,1358,3025,1067,2601,52,155,796,1827,848,1982
310930,202302,6742,15764,4665,12581,882,2493,2173,5969,3055,8462
310940,202302,8686,17727,7027,15459,266,720,5550,11633,5816,12353
310945,202302,1683,3855,1310,3274,160,448,750,1719,910,2167
310950,202302,2283,6297,1462,4499,245,864,383,911,628,1775
310960,202302,883,2234,518,1512,77,236,140,378,217,614
310970,202302,1434,4016,1043,3229,253,807,186,544,439,1351
310980,202302,415,906,245,622,20,59,121,279,141,338
310990,202302,1884,4407,1534,3863,177,522,927,2102,1104,2624
311000,202302,5452,13250,4166,11193,717,2168,2269,5547,2986,7715
311010,202302,1234,2936,1008,2569,226,595,513,1279,739,1874
311020,202302,1446,3343,943,2494,73,226,518,1278,591,1504
311030,202302,2348,5334,1717,4336,421,1218,694,1574,1115,2792
311040,202302,359,1033,275,855,78,274,66,177,144,451
311050,202302,3941,8900,3015,7553,452,1330,1547,3500,1999,4830
311060,202302,4583,10530,3426,8564,430,1248,1584,3460,2014,4708
311070,202302,3187,6962,2287,5636,331,1000,1191,2622,1522,3622
311080,202302,1434,2830,1128,2397,38,113,889,1758,927,1871
311090,202302,2879,8082,2358,7181,537,1715,716,2120,1253,3835
311100,202302,3079,7929,2047,6016,383,1267,567,1377,950,2644
311110,202302,4627,9173,2464,6007,574,1399,436,1003,1010,2402
311115,202302,1803,3361,1497,2979,43,101,1296,2497,1339,2598
311120,202302,9125,21649,7023,18052,1018,2976,3090,6697,4108,9673
311130,202302,2343,5646,1793,4883,170,576,1043,2640,1213,3216
311140,202302,1988,4496,1516,3856,206,559,919,2261,1125,2820
311150,202302,1782,5130,1430,4483,196,683,749,2187,945,2870
311160,202302,5196,13322,3839,10962,656,2144,1601,4141,2257,6285
311170,202302,1173,2732,964,2467,62,174,602,1617,664,1791
311180,202302,1903,3898,1290,3040,192,446,692,1544,884,1990
311190,202302,1062,2788,795,2265,116,368,336,805,452,1173
311200,202302,2854,6908,2142,5651,377,1117,912,1995,1289,3112
311205,202302,1137,2963,901,2533,37,121,587,1538,624,1659
311210,202302,1263,3332,1116,3135,140,351,769,2254,909,2605
311220,202302,1110,2461,975,2234,28,89,767,1605,795,1694
311230,202302,9735,26516,7238,21541,1428,4432,2525,7373,3953,11805
311240,202302,1456,3263,1155,2847,159,466,679,1512,838,1978
311250,202302,1685,4198,1315,3587,236,699,537,1283,773,1982
311260,202302,3307,7478,2159,5584,286,852,1051,2333,1337,3185
311265,202302,1725,3690,1253,2978,50,150,951,2135,1001,2285
311270,202302,3768,9869,3223,9042,209,793,2206,5811,2415,6604
311280,202302,1522,3717,932,2624,211,646,237,556,448,1202
311290,202302,2176,6083,1955,5665,116,351,1276,3607,1392,3958
311300,202302,5492,13376,4540,11865,188,610,3664,9276,3852,9886
311310,202302,674,1694,566,1512,46,123,348,884,394,1007
311320,202302,3877,10550,3251,9208,322,1038,1700,4213,2022,5251
311330,202302,7869,16944,6120,14388,701,1768,3139,7328,3840,9096
311340,202302,13586,34048,10838,29415,2327,6748,3541,8839,5868,15587
311350,202302,2850,6418,2064,5078,263,717,973,2038,1236,2755
311360,202302,1408,3113,1016,2591,265,730,447,1110,712,1840
311370,202302,5765,12747,4200,10345,490,1403,2319,5227,2809,6630
311380,202302,487,1373,371,1145,55,178,185,548,240,726
311390,202302,2150,5942,1720,5362,667,2269,429,1130,1096,3399
311400,202302,2046,5038,1487,4047,242,719,487,1036,729,1755
311410,202302,2377,6371,1909,5612,279,928,901,2433,1180,3361
311420,202302,2034,5347,1541,4477,311,979,484,1142,795,2121
311430,202302,5716,13712,3860,10261,547,1542,1580,3873,2127,5415
311440,202302,3852,9707,2930,8162,892,2851,557,1231,1449,4082
311450,202302,3023,8098,1920,5797,464,1619,436,986,900,2605
311455,202302,1355,2832,968,2292,100,245,584,1326,684,1571
311460,202302,729,2013,477,1491,91,324,105,254,196,578
311470,202302,596,1689,409,1305,96,366,64,164,160,530
311480,202302,1467,2971,1202,2597,87,196,966,2036,1053,2232
311490,202302,339,928,258,765,45,164,113,279,158,443
311500,202302,632,1427,498,1231,57,166,302,696,359,862
311510,202302,4475,9827,3246,7911,307,911,1851,3963,2158,4874
311520,202302,822,2001,714,1811,58,174,451,1106,509,1280
311530,202302,11689,24680,8218,19524,1763,4873,2924,6126,4687,10999
311535,202302,1127,2737,828,2184,121,361,409,984,530,1345
311540,202302,663,1744,580,1610,78,239,403,1091,481,1330
311545,202302,2388,6157,2064,5670,98,301,1583,4256,1681,4557
311547,202302,2216,4284,1930,3906,48,97,1668,3269,1716,3366
311550,202302,3689,8974,2992,7831,426,1302,1389,3197,1815,4499
311560,202302,374,745,232,524,35,88,81,155,116,243
311570,202302,1741,3741,1209,3014,66,176,847,2155,913,2331
311580,202302,2812,4920,1979,3944,177,337,1376,2637,1553,2974
311590,202302,762,1751,631,1573,61,188,416,978,477,1166
311600,202302,1838,4106,1494,3658,172,510,1033,2411,1205,2921
311610,202302,2804,7480,2230,6472,149,508,1427,3906,1576,4414
311615,202302,4520,10248,3660,8921,133,420,2966,6930,3099,7350
311620,202302,715,1764,540,1478,65,197,304,776,369,973
311630,202302,1575,4015,1235,3316,101,307,739,1897,840,2204
311640,202302,974,2338,771,2024,111,320,432,1040,543,1360
311650,202302,2309,5138,1859,4493,231,613,1110,2513,1341,3126
311660,202302,3907,10174,2909,8304,393,1296,840,1789,1233,3085
311670,202302,2058,4596,1528,3722,172,479,799,1826,971,2305
311680,202302,2877,6756,2208,5682,142,355,1561,3997,1703,4352
311690,202302,786,1477,577,1219,44,103,385,809,429,912
311700,202302,2474,5324,1888,4502,25,99,1576,3589,1601,3688
311710,202302,1984,5301,1459,4378,390,1293,429,1173,819,2466
311720,202302,518,1422,421,1248,48,169,239,683,287,852
311730,202302,5798,12996,4171,10164,838,2311,2035,4388,2873,6699
311740,202302,1178,2839,961,2534,79,157,731,1971,810,2128
311750,202302,4924,12977,3961,11317,326,1131,2554,6710,2880,7841
311760,202302,922,2316,721,1947,112,393,299,592,411,985
311770,202302,2748,7007,2152,6022,454,1357,783,1968,1237,3325
311780,202302,1890,4817,1430,4006,284,845,511,1240,795,2085
311783,202302,2878,6552,2349,5736,48,189,1933,4485,1981,4674
311787,202302,959,2557,742,2113,116,384,290,671,406,1055
311790,202302,1901,4874,1301,3774,258,851,329,812,587,1663
311800,202302,6345,17276,5010,14590,1059,3197,936,2118,1995,5315
311810,202302,1268,3085,1059,2759,58,179,798,1954,856,2133
311820,202302,1253,2636,955,2207,74,188,663,1437,737,1625
311830,202302,11387,29222,8423,23329,2264,6582,1635,4181,3899,10763
311840,202302,4909,10813,3927,9479,293,755,2826,6770,3119,7525
311850,202302,429,977,336,825,15,59,236,532,251,591
311860,202302,98151,215041,78231,182755,7983,21627,50365,107766,58348,129393
311870,202302,2276,5550,1603,4453,249,816,689,1651,938,2467
311880,202302,7683,17887,6396,16124,464,1112,4645,11792,5109,12904
311890,202302,2368,4712,1898,4093,48,165,1539,3080,1587,3245
311900,202302,795,1849,593,1584,101,254,316,848,417,1102
311910,202302,5425,12171,4248,10640,693,1902,2382,5615,3075,7517
311920,202302,2763,6109,2243,5389,137,337,1578,3700,1715,4037
311930,202302,6181,12308,4724,10410,767,1995,2757,5393,3524,7388
311940,202302,19546,46460,14285,37135,1969,5570,6260,14718,8229,20288
311950,202302,2925,6774,2195,5563,181,505,1345,3336,1526,3841
311960,202302,592,1379,452,1163,54,159,211,472,265,631
311970,202302,476,1451,360,1170,69,259,84,217,153,476
311980,202302,567,1401,314,928,36,108,121,323,157,431
311990,202302,657,1477,429,1135,68,225,182,396,250,621
311995,202302,1166,3119,585,1801,40,144,97,187,137,331
312000,202302,977,2041,747,1724,36,86,560,1252,596,1338
312010,202302,1399,3146,1129,2767,70,179,769,1808,839,1987
312015,202302,1629,4065,1406,3723,65,253,1121,2854,1186,3107
312020,202302,2266,6266,1568,4700,262,847,365,930,627,1777
312030,202302,2705,5279,2278,4794,77,207,2047,4218,2124,4425
312040,202302,1025,2790,746,2250,114,349,328,909,442,1258
312050,202302,1491,4159,1228,3695,232,857,430,1124,662,1981
312060,202302,1242,2753,792,2147,194,556,288,739,482,1295
312070,202302,1110,2897,753,2142,33,125,475,1233,508,1358
312080,202302,3706,8079,2903,6928,143,412,2037,4412,2180,4824
312083,202302,1387,2849,1092,2428,56,169,882,1856,938,2025
312087,202302,3096,6826,2504,5962,87,227,2026,4737,2113,4964
312090,202302,14837,34151,11762,29466,1194,3624,7084,16082,8278,19706
312100,202302,2069,5052,1609,4296,114,372,1002,2421,1116,2793
312110,202302,1216,3452,1000,3009,170,630,479,1255,649,1885
312120,202302,1306,3309,901,2613,229,774,275,639,504,1413
312125,202302,2504,5463,2138,4974,97,262,1747,3917,1844,4179
312130,202302,1485,3133,1100,2534,74,226,656,1285,730,1511
312140,202302,914,2426,744,2095,188,557,306,769,494,1326
312150,202302,646,1538,543,1351,33,91,378,868,411,959
312160,202302,12144,28296,9472,23894,1013,3059,5096,11403,6109,14462
312170,202302,1082,2513,835,2079,57,158,547,1293,604,1451
312180,202302,1718,4048,1394,3509,148,421,823,1921,971,2342
312190,202302,1031,2461,797,2079,73,227,424,1007,497,1234
312200,202302,5814,14081,4526,12104,545,1519,2712,6923,3257,8442
312210,202302,1815,3376,1391,2812,68,146,1132,2198,1200,2344
312220,202302,2049,5575,1745,5058,180,549,1121,3231,1301,3780
312230,202302,26088,59338,19226,47772,3635,10333,7074,14307,10709,24640
312235,202302,2752,5660,2251,4999,130,340,1765,3703,1895,4043
312240,202302,992,2881,769,2448,159,534,225,659,384,1193
312245,202302,4105,7563,3526,6784,46,109,3252,6116,3298,6225
312247,202302,1282,2659,885,2079,114,280,536,1176,650,1456
312250,202302,1124,2765,719,2012,92,283,259,670,351,953
312260,202302,1275,2932,1032,2553,71,190,795,1871,866,2061
312270,202302,899,2239,681,1807,31,114,417,974,448,1088
312280,202302,542,1489,443,1321,104,349,172,453,276,802
312290,202302,1188,3071,1001,2781,161,529,394,968,555,1497
312300,202302,1482,3985,1080,3093,235,727,266,598,501,1325
312310,202302,1268,3404,979,2833,125,434,496,1311,621,1745
312320,202302,2626,6057,1863,4760,348,896,575,1303,923,2199
312330,202302,1150,2940,938,2560,135,428,535,1352,670,1780
312340,202302,297,688,206,547,29,103,114,259,143,362
312350,202302,310,598,229,507,14,39,157,308,171,347
312352,202302,1822,5231,1605,4845,286,922,746,2418,1032,3340
312360,202302,4467,11341,3361,9339,669,2040,1390,3383,2059,5423
312370,202302,2623,5873,2091,5087,253,717,1289,2905,1542,3622
312380,202302,2665,5324,2180,4697,23,61,1869,3872,1892,3933
312385,202302,1531,3722,1198,3172,394,1065,292,800,686,1865
312390,202302,2338,6025,1753,4942,265,832,504,1185,769,2017
312400,202302,3823,9914,3247,9030,1089,3321,665,1781,1754,5102
312410,202302,19569,44939,16186,39774,1861,4965,10532,24412,12393,29377
312420,202302,5034,12153,4066,10630,790,2389,1944,4687,2734,7076
312430,202302,11262,24261,9296,21080,274,818,7295,15555,7569,16373
312440,202302,1297,3709,1091,3324,526,1705,212,586,738,2291
312450,202302,1701,4505,1298,3794,342,1083,485,1395,827,2478
312460,202302,618,1326,449,1092,23,64,306,708,329,772
312470,202302,571,1314,365,970,54,150,113,241,167,391
312480,202302,1331,3042,971,2523,90,269,532,1280,622,1549
312490,202302,3292,6522,2584,5544,201,479,1621,3252,1822,3731
312500,202302,1354,2835,1150,2575,52,152,903,1956,955,2108
312510,202302,6347,15379,4294,11521,803,2119,1216,2922,2019,5041
312520,202302,458,1039,357,885,64,195,218,499,282,694
312530,202302,898,1829,753,1659,45,104,578,1258,623,1362
312540,202302,1903,4664,1294,3547,158,433,698,1792,856,2225
312550,202302,1002,2312,720,1810,36,106,458,1032,494,1138
312560,202302,2190,5194,1663,4385,104,298,1176,3025,1280,3323
312570,202302,3398,7092,2539,6029,404,977,1331,3095,1735,4072
312580,202302,793,1959,542,1468,48,154,278,666,326,820
312590,202302,1850,4813,1421,3989,173,560,765,1931,938,2491
312595,202302,2628,6659,2161,5962,308,794,1192,3524,1500,4318
312600,202302,1735,3931,1166,2762,174,497,392,880,566,1377
312610,202302,8691,20532,5951,15632,986,2915,1962,4304,2948,7219
312620,202302,3094,6852,2362,5861,61,250,1940,4695,2001,4945
312630,202302,407,1040,298,853,51,170,125,318,176,488
312640,202302,668,1682,503,1426,65,213,253,649,318,862
312650,202302,2565,5658,1782,4309,51,171,1327,2938,1378,3109
312660,202302,1650,3533,1288,2969,96,231,909,1956,1005,2187
312670,202302,7600,15751,6377,13929,128,525,5271,10682,5399,11207
312675,202302,1465,3352,1199,2983,64,184,942,2267,1006,2451
312680,202302,1973,4252,1787,4007,37,137,1613,3482,1650,3619
312690,202302,3693,6873,2779,5755,111,236,2256,4555,2367,4791
312695,202302,1264,2889,1065,2593,52,89,885,2135,937,2224
312700,202302,2520,6222,1821,5012,202,656,955,2398,1157,3054
312705,202302,2085,3813,1822,3477,14,48,1726,3247,1740,3295
312707,202302,1638,4194,1159,3374,51,211,757,2009,808,2220
312710,202302,9391,20149,6200,15387,1586,3969,1858,4639,3444,8608
312720,202302,1337,3173,1051,2735,99,298,691,1671,790,1969
312730,202302,1944,4226,1396,3498,120,313,894,2164,1014,2477
312733,202302,1574,3841,1177,3133,48,161,780,1897,828,2058
312735,202302,976,2267,749,1865,50,140,486,1105,536,1245
312737,202302,1025,2067,744,1678,73,183,515,1110,588,1293
312738,202302,1002,2247,721,1779,61,179,471,1033,532,1212
312740,202302,538,1314,341,982,75,231,86,177,161,408
312750,202302,1750,4519,1281,3668,145,482,590,1531,735,2013
312760,202302,2255,6042,1647,4887,242,747,623,1706,865,2453
312770,202302,57464,127406,37946,95108,6221,17548,15507,35005,21728,52553
312780,202302,3247,8182,2716,7317,351,938,1623,4276,1974,5214
312790,202302,290,652,146,415,5,15,33,54,38,69
312800,202302,7346,17522,5912,15035,524,1669,3733,8638,4257,10307
312810,202302,2004,5074,1339,3956,374,1200,400,1039,774,2239
312820,202302,2148,5097,1728,4422,112,291,1199,3013,1311,3304
312825,202302,1915,3624,1604,3238,38,77,1385,2734,1423,2811
312830,202302,3418,8679,2302,6607,539,1650,718,1759,1257,3409
312840,202302,1827,4252,1426,3630,154,452,746,1719,900,2171
312850,202302,1434,2740,1084,2273,20,68,825,1549,845,1617
312860,202302,1300,3114,894,2483,238,696,257,614,495,1310
312870,202302,7349,18281,4773,13542,801,2437,1397,3492,2198,5929
312880,202302,1898,4181,1481,3534,242,535,741,1763,983,2298
312890,202302,2907,6330,2149,5166,133,319,1312,2958,1445,3277
312900,202302,1616,3731,1300,3307,358,948,573,1436,931,2384
312910,202302,1800,3178,1094,2283,149,296,599,1215,748,1511
312920,202302,1142,2833,811,2308,125,418,285,671,410,1089
312930,202302,3008,6569,2174,5336,351,922,1130,2724,1481,3646
312940,202302,1217,2987,964,2644,92,296,513,1292,605,1588
312950,202302,4265,9242,3120,7562,443,1261,1779,3887,2222,5148
312960,202302,2113,5024,1745,4481,111,270,1259,3315,1370,3585
312965,202302,2000,4819,1611,4213,165,415,1023,2681,1188,3096
312970,202302,2030,5034,1630,4431,175,605,957,2357,1132,2962
312980,202302,32932,81397,26646,70602,5016,14055,11781,28946,16797,43001
312990,202302,642,1458,434,1127,80,236,192,451,272,687
313000,202302,594,1517,452,1279,29,120,286,722,315,842
313005,202302,2944,7653,2431,6828,117,352,1757,4757,1874,5109
313010,202302,7555,18231,6130,16018,948,2817,3579,8791,4527,11608
313020,202302,1230,3430,967,2929,191,628,194,477,385,1105
313030,202302,1523,3101,1068,2478,79,212,772,1685,851,1897
313040,202302,1101,3019,925,2696,38,156,576,1567,614,1723
313050,202302,2277,5750,1605,4738,249,829,416,1049,665,1878
313055,202302,2293,5567,1947,5040,671,1968,910,2154,1581,4122
313060,202302,1341,3004,982,2413,195,579,244,521,439,1100
313065,202302,2125,5121,1881,4737,27,117,1609,3883,1636,4000
313070,202302,1073,2654,845,2292,95,286,424,1080,519,1366
313080,202302,493,1240,375,1042,66,221,150,338,216,559
313090,202302,6878,15557,5678,13740,250,694,4113,9614,4363,10308
313100,202302,1650,3854,1316,3387,58,200,952,2320,1010,2520
313110,202302,1861,4508,1320,3553,133,400,666,1610,799,2010
313115,202302,3546,8843,2855,7605,266,844,1660,3923,1926,4767
313120,202302,4576,10071,3324,8421,246,624,2194,5566,2440,6190
313130,202302,41148,95036,31460,78459,3170,9063,18439,41935,21609,50998
313140,202302,986,1878,665,1477,44,108,502,1084,546,1192
313150,202302,1726,4520,1242,3636,349,1157,197,459,546,1616
313160,202302,1770,3922,1327,3282,31,90,1013,2378,1044,2468
313170,202302,14591,37489,10985,30810,1740,5345,4276,10430,6016,15775
313180,202302,3215,7480,2447,5975,174,455,1663,3848,1837,4303
313190,202302,5803,14831,4370,12157,740,2259,1795,4363,2535,6622
313200,202302,1386,3205,1178,2862,32,95,955,2228,987,2323
313210,202302,5282,12220,4362,10849,428,1207,2944,6867,3372,8074
313220,202302,2450,5863,1662,4383,221,657,785,1751,1006,2408
313230,202302,3440,8426,2773,7581,59,204,2270,6190,2329,6394
313240,202302,14570,32111,10572,26027,1054,3233,6061,13408,7115,16641
313250,202302,7725,20386,5942,16759,1103,3306,2693,7010,3796,10316
313260,202302,1002,2256,708,1808,65,236,398,859,463,1095
313270,202302,8654,16670,7280,14931,471,952,5992,12124,6463,13076
313280,202302,562,1382,377,1041,47,149,177,452,224,601
313290,202302,1281,3799,1006,3291,260,965,348,1050,608,2015
313300,202302,2306,5714,1771,4817,364,1071,618,1499,982,2570
313310,202302,1862,4998,1514,4290,263,838,491,1093,754,1931
313320,202302,2509,6085,1836,5058,411,1223,616,1680,1027,2903
313330,202302,5196,11872,3873,9952,281,820,2545,6339,2826,7159
313340,202302,2142,4330,1657,3691,107,274,1238,2615,1345,2889
313350,202302,3710,9301,2548,6899,293,936,1173,2629,1466,3565
313360,202302,2146,4756,1495,3728,251,738,785,1720,1036,2458
313370,202302,2082,5102,1589,4205,324,931,602,1365,926,2296
313375,202302,2344,5687,1510,4197,273,866,421,963,694,1829
313380,202302,8808,20121,6555,16202,973,2830,3224,6834,4197,9664
313390,202302,963,2686,828,2449,47,197,569,1595,616,1792
313400,202302,4629,10106,3469,8409,153,430,2587,6049,2740,6479
313410,202302,1775,4078,1332,3371,334,849,713,1722,1047,2571
313420,202302,19684,41177,11428,28095,2597,7196,3052,6489,5649,13685
313430,202302,1575,3523,1322,3087,65,247,1032,2192,1097,2439
313440,202302,9255,17033,6857,14161,185,478,5513,10883,5698,11361
313450,202302,896,2211,636,1736,107,336,226,478,333,814
313460,202302,2989,7607,2408,6706,425,1334,1117,2951,1542,4285
313470,202302,3429,7712,2760,6765,155,430,2125,5081,2280,5511
313480,202302,1433,3751,900,2658,88,290,389,1009,477,1299
313490,202302,3776,9130,2153,6121,383,1180,546,1336,929,2516
313500,202302,691,1636,473,1233,67,165,215,508,282,673
313505,202302,13183,29829,11216,27172,497,1263,8984,21363,9481,22626
313507,202302,1682,3817,1329,3285,48,156,1027,2428,1075,2584
313510,202302,19514,46109,15258,38273,1401,3859,8911,20243,10312,24102
313520,202302,19829,45386,16153,39609,697,2104,12618,29464,13315,31568
313530,202302,711,1958,525,1575,72,263,219,552,291,815
313535,202302,2788,7118,2211,6034,251,662,1316,3494,1567,4156
313540,202302,1105,2848,861,2326,116,357,399,926,515,1283
313545,202302,1377,4083,1153,3678,170,567,533,1619,703,2186
313550,202302,2620,6726,2178,5793,234,666,1437,3710,1671,4376
313560,202302,3809,6042,2904,4998,38,58,2602,4396,2640,4454
313570,202302,1233,3190,974,2750,199,588,431,1111,630,1699
313580,202302,7819,16221,6224,13768,344,930,4581,9476,4925,10406
313590,202302,1443,3409,1154,3012,236,647,602,1592,838,2239
313600,202302,5591,11621,4770,10445,91,305,4281,9056,4372,9361
313610,202302,1228,2791,1001,2410,78,222,655,1441,733,1663
313620,202302,7206,17319,5945,15182,566,1740,3837,9196,4403,10936
313630,202302,11278,24918,8235,20498,832,2479,5017,11685,5849,14164
313640,202302,1665,3067,1164,2439,96,236,862,1751,958,1987
313650,202302,2010,5524,1562,4766,138,458,938,2875,1076,3333
313652,202302,1106,2777,971,2539,65,212,708,1727,773,1939
313655,202302,1480,3144,1162,2756,69,174,878,2035,947,2209
313657,202302,1361,3221,1053,2741,40,157,757,1798,797,1955
313660,202302,1476,3379,1225,2978,74,267,919,2055,993,2322
313665,202302,7304,16848,5871,14465,495,1501,3877,8728,4372,10229
313670,202302,72422,161462,51012,127109,6508,17890,25832,58927,32340,76817
313680,202302,1333,3065,1073,2660,42,109,719,1672,761,1781
313690,202302,1241,3425,920,2808,170,586,199,520,369,1106
313695,202302,2169,5188,1614,4304,124,310,1047,2831,1171,3141
313700,202302,3487,9620,2991,8986,234,744,2375,7150,2609,7894
313710,202302,1798,3733,1277,3059,120,364,818,1854,938,2218
313720,202302,8154,20266,6045,16113,779,2304,2897,6794,3676,9098
313730,202302,1729,3324,1291,2766,76,142,864,1812,940,1954
313740,202302,2049,6774,1730,6038,366,1442,450,1340,816,2782
313750,202302,2968,6834,2397,5950,336,1006,1461,3265,1797,4271
313753,202302,2582,5892,1724,4538,340,975,623,1550,963,2525
313760,202302,7798,19510,6257,16759,955,2934,3073,7318,4028,10252
313770,202302,5031,12911,3962,11241,221,583,2961,8529,3182,9112
313780,202302,5062,11956,3734,9977,644,1719,1236,3193,1880,4912
313790,202302,750,1910,628,1678,65,204,393,979,458,1183
313800,202302,1683,3468,1218,2839,113,313,709,1502,822,1815
313810,202302,2283,4762,1830,4113,66,212,1480,3163,1546,3375
313820,202302,21761,51276,14712,37235,2319,6214,4614,10303,6933,16517
313830,202302,490,1335,366,1086,70,242,140,363,210,605
313835,202302,1165,2887,863,2404,79,264,457,1152,536,1416
313840,202302,10355,24270,8149,20919,1859,5017,2356,5712,4215,10729
313850,202302,1244,2659,992,2317,167,424,528,1106,695,1530
313860,202302,3579,8410,2731,6990,369,1014,1365,3136,1734,4150
313862,202302,1475,3040,781,2034,52,155,383,949,435,1104
313865,202302,3242,7390,2680,6551,74,225,2079,4819,2153,5044
313867,202302,1672,4787,1341,4147,292,925,594,1873,886,2798
313868,202302,2070,5591,1642,4831,59,231,1234,3441,1293,3672
313870,202302,1320,3072,892,2328,124,343,393,905,517,1248
313880,202302,2806,6500,2148,5439,299,903,1120,2415,1419,3318
313890,202302,2996,5270,2217,4291,64,139,1775,3295,1839,3434
313900,202302,6861,17379,4864,13510,1233,3622,1442,3371,2675,6993
313910,202302,965,2586,730,2147,144,438,186,519,330,957
313920,202302,3503,9307,2895,8171,527,1525,1438,4021,1965,5546
313925,202302,2059,4615,1604,3864,202,434,972,2269,1174,2703
313930,202302,6341,15377,5060,13341,418,1061,3331,8686,3749,9747
313940,202302,12643,33537,9764,28899,2086,6710,2276,7124,4362,13834
313950,202302,7098,13592,5508,11630,277,661,4068,8271,4345,8932
313960,202302,7279,15848,4971,12161,703,2020,2231,4704,2934,6724
313970,202302,2037,4668,1704,4135,53,143,1197,2715,1250,2858
313980,202302,1868,4434,1332,3642,231,698,557,1400,788,2098
313990,202302,2768,7221,2170,6093,337,1168,1236,2994,1573,4162
314000,202302,13458,30023,10760,25597,712,2111,6970,15811,7682,17922
314010,202302,1660,3591,1295,3098,81,230,943,2134,1024,2364
314015,202302,3092,7423,2462,6365,255,800,1501,3481,1756,4281
314020,202302,633,1557,419,1216,141,501,35,90,176,591
314030,202302,1051,2703,769,2166,106,300,315,839,421,1139
314040,202302,785,1980,663,1769,87,288,376,941,463,1229
314050,202302,2538,5864,1913,4816,113,350,1231,2783,1344,3133
314053,202302,2571,6540,2052,5590,317,810,1196,3342,1513,4152
314055,202302,2893,6323,2436,5697,75,218,2020,4704,2095,4922
314060,202302,1592,3766,1150,3051,38,115,823,2114,861,2229
314070,202302,6337,15022,5185,13107,735,1975,2899,6832,3634,8807
314080,202302,2371,5772,1788,4778,158,501,885,2084,1043,2585
314085,202302,2900,6956,2296,6093,234,668,1478,3877,1712,4545
314090,202302,6235,14544,5319,13284,532,1423,3400,8553,3932,9976
314100,202302,3665,8088,2782,6880,83,211,2057,5043,2140,5254
314110,202302,6261,15841,5137,13839,657,1958,2680,6493,3337,8451
314120,202302,835,1835,410,1094,73,221,152,359,225,580
314130,202302,878,2064,637,1635,23,82,446,1065,469,1147
314140,202302,5715,13764,4520,11702,488,1377,2539,6189,3027,7566
314150,202302,1752,4017,1251,3185,132,378,767,1870,899,2248
314160,202302,2969,6714,2040,5184,216,537,840,2034,1056,2571
314170,202302,1167,2866,916,2402,53,184,619,1448,672,1632
314180,202302,6786,16590,5274,14225,649,1760,2665,7075,3314,8835
314190,202302,787,1764,596,1491,70,233,347,763,417,996
314200,202302,3700,9237,3035,8201,295,788,1932,5102,2227,5890
314210,202302,2427,5768,1869,4805,299,806,643,1511,942,2317
314220,202302,2139,5235,1688,4547,259,823,773,1845,1032,2668
314225,202302,1263,3331,994,2842,108,342,604,1627,712,1969
314230,202302,1094,2592,862,2266,130,374,480,1195,610,1569
314240,202302,1342,3373,1052,2945,225,649,437,1222,662,1871
314250,202302,506,1361,328,989,43,147,126,322,169,469
314260,202302,1365,3213,1077,2844,374,1041,325,752,699,1793
314270,202302,4055,9927,3316,8771,86,263,2538,6520,2624,6783
314280,202302,4489,9583,3124,7641,328,927,1868,4220,2196,5147
314290,202302,5695,12809,4826,11393,250,660,3588,8059,3838,8719
314300,202302,2436,6334,1581,4560,347,1082,446,1071,793,2153
314310,202302,4803,11766,3378,9448,886,2841,480,1099,1366,3940
314315,202302,1211,3327,954,2804,61,231,652,1791,713,2022
314320,202302,4209,10140,2934,7861,441,1391,1237,2900,1678,4291
314330,202302,70526,181710,54392,154258,12668,36826,15099,40935,27767,77761
314340,202302,3411,7909,2370,6150,431,1359,962,2019,1393,3378
314345,202302,2027,4877,1642,4233,121,316,1178,2910,1299,3226
314350,202302,1166,2996,768,2252,122,373,162,346,284,719
314360,202302,669,1773,441,1307,67,189,126,329,193,518
314370,202302,937,2120,751,1865,78,208,505,1189,583,1397
314380,202302,1535,3840,1097,3098,251,784,343,899,594,1683
314390,202302,19817,44304,14050,34879,1948,5574,6334,13401,8282,18975
314400,202302,4925,13560,3785,11407,1213,3883,1079,3321,2292,7204
314410,202302,3731,9774,2568,7494,615,2097,494,1208,1109,3305
314420,202302,936,2107,679,1725,25,90,444,1054,469,1144
314430,202302,9964,21373,7162,17074,1012,2538,3500,7807,4512,10345
314435,202302,2277,5523,1769,4746,311,869,901,2280,1212,3149
314437,202302,1106,2488,820,2054,65,179,539,1279,604,1458
314440,202302,736,1970,536,1591,129,444,150,348,279,792
314450,202302,1833,4314,1492,3758,185,525,826,1868,1011,2393
314460,202302,4365,11770,3370,9846,747,2432,1309,3302,2056,5734
314465,202302,2845,7065,2295,6082,47,173,1771,4441,1818,4614
314467,202302,1208,2805,981,2447,103,300,647,1547,750,1847
314470,202302,2897,7383,2401,6503,438,1297,1149,2801,1587,4098
314480,202302,11251,27804,8629,22707,1216,3586,4024,9201,5240,12787
314490,202302,1305,3048,939,2400,86,249,584,1395,670,1644
314500,202302,2365,5213,1714,4369,512,1297,435,1102,947,2399
314505,202302,2899,5684,2373,4994,156,267,1842,3788,1998,4055
314510,202302,2653,6483,1951,5486,583,1909,612,1572,1195,3481
314520,202302,9655,26138,7799,22702,1622,5020,1840,4804,3462,9824
314530,202302,6746,18093,5960,16728,348,1204,4421,11856,4769,13060
314535,202302,3597,7577,2907,6624,160,397,2322,5194,2482,5591
314537,202302,1489,3709,1135,3149,76,198,748,2005,824,2203
314540,202302,522,1188,379,970,18,54,217,500,235,554
314545,202302,2353,4887,2085,4579,67,188,1669,3661,1736,3849
314550,202302,926,2033,600,1498,47,151,314,672,361,823
314560,202302,6151,15951,4711,13113,599,1991,2225,5246,2824,7237
314570,202302,403,1044,298,869,36,118,146,409,182,527
314580,202302,595,1596,471,1354,101,299,155,425,256,724
314585,202302,928,2510,701,2060,61,221,333,886,394,1107
314587,202302,2812,6725,2202,5795,630,1651,1061,2703,1691,4354
314590,202302,5592,13469,4297,11245,502,1489,2152,5095,2654,6584
314600,202302,2217,5678,1444,4258,315,1036,172,443,487,1479
314610,202302,12249,27872,9649,23919,1098,3289,4777,11611,5875,14900
314620,202302,3127,6111,2524,5384,167,278,1985,4307,2152,4585
314625,202302,1992,4410,1689,4003,43,186,1458,3317,1501,3503
314630,202302,6173,13911,4936,12245,190,566,3903,9469,4093,10035
314640,202302,1057,2048,817,1691,28,82,637,1209,665,1291
314650,202302,1053,2310,716,1798,74,218,405,898,479,1116
314655,202302,1812,4507,1286,3628,150,409,695,1933,845,2342
314660,202302,449,851,341,691,12,26,262,491,274,517
314670,202302,1960,3989,1355,3158,33,95,954,2096,987,2191
314675,202302,2062,4709,1745,4222,105,246,1338,3171,1443,3417
314690,202302,2587,6441,1974,5538,515,1490,725,1964,1240,3454
314700,202302,14824,36564,10376,28744,1591,4873,4656,11819,6247,16692
314710,202302,9896,25471,7559,20696,1118,3349,2976,7024,4094,10373
314720,202302,2963,8073,2119,6395,414,1377,423,1012,837,2389
314730,202302,3159,7620,2202,5905,392,1182,776,1748,1168,2930
314740,202302,4083,10263,3227,8832,563,1694,1601,3991,2164,5685
314750,202302,379,903,298,744,26,82,179,382,205,464
314760,202302,2263,6123,1491,4444,229,811,430,915,659,1726
314770,202302,1262,3430,733,2205,115,339,174,474,289,813
314780,202302,447,1028,315,823,31,96,185,446,216,542
314790,202302,15084,36593,11048,29626,1896,5689,4642,11413,6538,17102
314795,202302,1839,4211,1549,3747,69,198,1197,2761,1266,2959
314800,202302,14975,35453,10315,27397,1685,4951,3864,8794,5549,13745
314810,202302,13445,32006,10266,26865,2480,6913,4002,9643,6482,16556
314820,202302,1555,3427,1212,2932,79,243,781,1776,860,2019
314830,202302,2178,5424,1787,4784,160,453,1126,2819,1286,3272
314840,202302,1099,2975,866,2568,83,321,575,1585,658,1906
314850,202302,3419,5728,2846,5048,37,78,2638,4607,2675,4685
314860,202302,4151,10221,3451,9065,141,503,2567,6429,2708,6932
314870,202302,8669,16845,6686,14503,299,624,5099,11144,5398,11768
314875,202302,2228,6035,1950,5643,186,502,1419,4118,1605,4620
314880,202302,959,2163,728,1806,45,132,453,1061,498,1193
314890,202302,637,1774,466,1398,63,218,234,614,297,832
314900,202302,1147,2484,886,2081,103,279,502,1085,605,1364
314910,202302,2058,5397,1534,4555,279,1000,680,1805,959,2805
314915,202302,2557,6734,2061,5901,186,546,1263,3571,1449,4117
314920,202302,711,1587,517,1324,24,70,375,949,399,1019
314930,202302,8150,20430,6408,17315,1013,3118,2928,6933,3941,10051
314940,202302,522,1107,423,963,45,112,270,576,315,688
314950,202302,838,1900,570,1489,54,196,313,735,367,931
314960,202302,1185,2530,926,2122,76,170,631,1407,707,1577
314970,202302,1416,3868,1106,3276,201,662,460,1193,661,1855
314980,202302,2690,6122,2208,5450,206,555,1538,3677,1744,4232
314990,202302,3436,9141,2451,7012,402,1190,671,1619,1073,2809
314995,202302,2094,5165,1615,4327,73,253,1031,2538,1104,2791
315000,202302,1340,3093,952,2504,86,256,618,1558,704,1814
315010,202302,506,1238,403,1085,38,130,253,630,291,760
315015,202302,3122,7556,2726,6942,261,822,1920,4638,2181,5460
315020,202302,957,2541,689,2038,58,210,333,878,391,1088
315030,202302,846,2000,590,1565,184,454,141,342,325,796
315040,202302,1237,2888,1040,2591,163,463,665,1536,828,1999
315050,202302,1434,3358,1057,2801,90,279,504,1230,594,1509
315053,202302,1522,3449,1119,2786,133,341,640,1503,773,1844
315057,202302,2227,5639,1755,4873,156,364,1113,3291,1269,3655
315060,202302,882,2381,642,1900,119,384,184,499,303,883
315070,202302,1113,2162,859,1807,74,205,640,1204,714,1409
315080,202302,4113,9684,3104,7908,155,454,2216,5323,2371,5777
315090,202302,1009,2708,764,2284,106,351,352,939,458,1290
315100,202302,1777,4777,1202,3546,150,525,511,1289,661,1814
315110,202302,2814,5957,2062,4888,168,395,1184,2717,1352,3112
315120,202302,16052,33694,11785,27486,1202,2845,6987,15824,8189,18669
315130,202302,2253,5485,1923,4952,200,610,1043,2367,1243,2977
315140,202302,4153,10275,3360,8958,571,1661,1831,4512,2402,6173
315150,202302,5625,13255,4064,10756,686,2023,1842,4562,2528,6585
315160,202302,2478,5389,1750,4289,247,650,997,2311,1244,2961
315170,202302,1777,5194,1251,3990,239,808,345,1027,584,1835
315180,202302,22583,51624,13673,35947,1830,5456,5017,11114,6847,16570
315190,202302,2771,5582,2111,4723,203,446,1566,3505,1769,3951
315200,202302,5923,14486,4479,12189,1283,3795,1542,3709,2825,7504
315210,202302,10838,26012,7746,20099,812,2352,3732,8302,4544,10654
315213,202302,1269,3078,1093,2831,23,88,900,2251,923,2339
315217,202302,3286,8398,2432,6982,89,374,1711,4648,1800,5022
315220,202302,10514,25927,8120,21976,629,1488,4558,12385,5187,13873
315230,202302,3687,7229,3033,6393,167,294,2216,4624,2383,4918
315240,202302,3117,7966,2535,7001,613,1803,1127,2973,1740,4776
315250,202302,19242,46862,14591,38625,2212,6568,6682,15664,8894,22232
315260,202302,1195,2972,741,2105,141,405,144,324,285,729
315270,202302,1238,3156,968,2700,125,421,456,1043,581,1464
315280,202302,4068,9410,2761,7179,707,1949,778,1844,1485,3793
315290,202302,1519,3425,983,2611,204,609,396,948,600,1557
315300,202302,806,1792,599,1506,33,95,421,1018,454,1113
315310,202302,1599,3597,1202,2943,78,252,825,1795,903,2047
315320,202302,782,2089,553,1643,78,242,209,570,287,812
315330,202302,901,2651,548,1791,62,225,219,614,281,839
315340,202302,3467,7905,2386,6269,576,1563,887,2205,1463,3768
315350,202302,2419,5356,2035,4794,148,414,1576,3532,1724,3946
315360,202302,2115,5545,1665,4717,217,653,786,2018,1003,2671
315370,202302,762,1870,604,1610,87,253,276,658,363,911
315380,202302,295,767,205,587,38,108,27,53,65,161
315390,202302,1584,4018,1299,3553,130,436,752,1821,882,2257
315400,202302,5196,12390,4156,10684,506,1435,2418,5804,2924,7239
315410,202302,2923,6036,2082,4828,387,1065,601,1231,988,2296
315415,202302,1847,4671,1491,4104,429,1401,294,666,723,2067
315420,202302,1897,4858,1375,3958,330,1015,348,822,678,1837
315430,202302,4420,9973,3067,8005,511,1488,1429,3498,1940,4986
315440,202302,1281,2984,1005,2574,103,297,616,1446,719,1743
315445,202302,2850,5499,2109,4517,120,255,1650,3474,1770,3729
315450,202302,2697,6604,2183,5791,211,600,1443,3635,1654,4235
315460,202302,60002,141961,50966,127254,4880,14761,33631,76749,38511,91510
315470,202302,826,2119,594,1610,52,157,292,698,344,855
315480,202302,1897,4738,1369,3678,189,547,645,1539,834,2086
315490,202302,3538,8110,2478,6485,378,1083,947,2246,1325,3329
315500,202302,641,1576,403,1099,25,75,233,566,258,641
315510,202302,1716,3706,1405,3275,17,73,1201,2644,1218,2717
315520,202302,1369,3073,1150,2761,42,110,962,2226,1004,2336
315530,202302,1006,2225,854,1987,63,196,660,1404,723,1600
315540,202302,2083,4977,1385,3730,115,378,614,1478,729,1856
315550,202302,2273,5728,1589,4517,282,941,494,1344,776,2285
315560,202302,8179,21237,7044,19334,462,1187,5098,13812,5560,14999
315570,202302,3101,7110,2211,5573,304,941,1176,2487,1480,3428
315580,202302,4104,8519,3225,7237,412,1053,1500,3023,1912,4076
315590,202302,1613,3024,1354,2663,41,160,1122,1978,1163,2138
315600,202302,3021,8257,2115,6579,519,1567,823,2698,1342,4265
315610,202302,1202,2755,905,2262,116,376,464,960,580,1336
315620,202302,649,1569,486,1324,33,102,264,711,297,813
315630,202302,1497,3627,1147,2985,173,474,543,1270,716,1744
315640,202302,501,1107,393,974,32,84,256,592,288,676
315645,202302,1198,2884,845,2343,137,400,245,624,382,1024
315650,202302,2246,4492,1828,3919,87,181,1459,3053,1546,3234
315660,202302,2486,5942,1878,4883,201,519,1074,2692,1275,3211
315670,202302,20992,49964,16522,42281,2787,7635,8300,19555,11087,27190
315680,202302,3915,9793,2920,8081,393,1196,1514,3932,1907,5128
315690,202302,4795,10954,2969,7924,599,1566,823,2281,1422,3847
315700,202302,10851,26166,8336,21489,750,2197,4825,11287,5575,13484
315710,202302,2191,4765,1557,3865,78,227,1038,2408,1116,2635
315720,202302,5533,13419,4543,11779,215,779,3242,7825,3457,8604
315725,202302,2831,6443,2233,5573,218,517,1471,3803,1689,4320
315727,202302,770,1780,572,1471,65,208,296,686,361,894
315730,202302,736,2020,621,1806,130,397,228,585,358,982
315733,202302,1892,4284,1475,3668,225,598,688,1552,913,2150
315737,202302,1430,3500,1046,2781,32,114,739,1847,771,1961
315740,202302,1055,2661,869,2304,74,237,583,1412,657,1649
315750,202302,1625,3694,1232,3138,93,234,795,2037,888,2271
315760,202302,1516,3061,1245,2712,26,88,1049,2184,1075,2272
315765,202302,2577,5392,2117,4822,24,85,1916,4341,1940,4426
315770,202302,1519,3870,1233,3490,412,1251,313,879,725,2130
315780,202302,39892,97128,33459,86091,2170,6764,22227,53055,24397,59819
315790,202302,4280,12020,3605,10810,320,953,2119,6647,2439,7600
315800,202302,1659,4830,1286,4016,154,576,568,1505,722,2081
315810,202302,1729,3660,1435,3212,58,165,1150,2453,1208,2618
315820,202302,3665,7921,2976,7030,276,623,2103,4907,2379,5530
315830,202302,1539,4190,1045,3122,114,381,300,700,414,1081
315840,202302,1067,2364,768,1890,67,176,405,880,472,1056
315850,202302,1461,3801,1157,3304,171,534,599,1613,770,2147
315860,202302,701,1770,531,1487,99,308,188,425,287,733
315870,202302,551,1388,442,1224,22,71,310,816,332,887
315880,202302,1408,3152,1035,2551,116,342,509,1043,625,1385
315890,202302,2237,5655,1838,5128,561,1743,688,1856,1249,3599
315895,202302,7963,19768,5968,16122,677,2085,2791,6715,3468,8800
315900,202302,1065,2579,894,2354,125,369,511,1250,636,1619
315910,202302,781,1761,677,1619,46,137,541,1260,587,1397
315920,202302,1749,4097,1022,2790,156,543,376,844,532,1387
315930,202302,1436,2885,1010,2317,75,190,594,1277,669,1467
315935,202302,1408,3722,1122,3209,207,611,505,1401,712,2012
315940,202302,748,1808,589,1579,81,244,312,769,393,1013
315950,202302,1573,3777,1332,3412,130,374,997,2526,1127,2900
315960,202302,6638,17231,4605,13212,1051,3244,959,1964,2010,5208
315970,202302,694,1719,563,1548,74,228,363,983,437,1211
315980,202302,5399,10948,3220,7492,562,1402,1584,3270,2146,4672
315990,202302,4299,10124,3371,8579,456,1236,1761,4141,2217,5377
316000,202302,967,2041,762,1756,66,189,485,1021,551,1210
316010,202302,811,2180,635,1846,84,260,269,640,353,900
316020,202302,1133,2850,917,2475,88,289,565,1418,653,1707
316030,202302,3367,8199,2560,6841,375,1044,1496,4015,1871,5059
316040,202302,3274,8807,2293,7004,379,1320,603,1516,982,2836
316045,202302,2816,5713,2587,5432,159,237,2244,4803,2403,5040
316050,202302,510,1227,388,1040,27,80,243,573,270,653
316060,202302,899,1893,655,1576,30,87,475,1075,505,1162
316070,202302,7515,18226,6156,15790,979,2512,3048,7333,4027,9845
316080,202302,1002,2768,794,2365,171,564,289,739,460,1303
316090,202302,659,1594,548,1393,47,148,343,774,390,922
316095,202302,1535,4358,1154,3452,249,812,407,1098,656,1910
316100,202302,3040,7847,2223,6212,328,1075,973,2392,1301,3467
316105,202302,861,2062,671,1763,51,129,428,1147,479,1276
316110,202302,18514,42901,15370,37971,913,2813,11512,26801,12425,29614
316120,202302,1511,3790,992,2748,152,484,344,755,496,1239
316130,202302,1600,3282,1070,2456,97,262,630,1304,727,1566
316140,202302,1295,3239,801,2323,138,403,277,753,415,1156
316150,202302,2742,5695,2153,4829,155,437,1270,2601,1425,3038
316160,202302,1223,2907,984,2516,41,144,712,1740,753,1884
316165,202302,1100,2363,871,2054,80,208,574,1273,654,1481
316170,202302,1783,3564,1402,3051,68,210,1055,2087,1123,2297
316180,202302,1991,5101,1393,3980,271,835,427,1031,698,1866
316190,202302,3305,8692,1924,5556,222,695,839,2023,1061,2718
316200,202302,4736,11589,3805,10108,586,1796,1930,4622,2516,6418
316210,202302,7036,18816,5105,14589,1538,4749,524,1265,2062,6014
316220,202302,882,2459,619,1963,124,422,129,389,253,811
316225,202302,2000,4042,1520,3330,52,185,1185,2348,1237,2533
316230,202302,626,1475,488,1256,109,307,244,588,353,895
316240,202302,7027,17788,6094,16163,436,1280,4470,11436,4906,12716
316245,202302,3884,10739,3457,10065,200,866,2541,6907,2741,7773
316250,202302,14405,31591,11053,26281,1949,5039,4722,10610,6671,15649
316255,202302,3610,9357,3103,8543,182,517,2237,6153,2419,6670
316257,202302,1941,3959,1465,3248,139,299,1026,2178,1165,2477
316260,202302,3373,6648,2644,5591,266,510,1745,3622,2011,4132
316265,202302,1327,3259,1041,2784,27,77,744,1899,771,1976
316270,202302,4685,12731,3972,11294,494,1524,2217,5814,2711,7338
316280,202302,3763,9064,3121,7968,374,1025,1748,4251,2122,5276
316290,202302,5080,12208,3924,10123,477,1303,1642,3800,2119,5103
316292,202302,7692,18371,6260,16169,677,1985,4131,10037,4808,12022
316294,202302,1178,3217,901,2757,189,673,273,716,462,1389
316295,202302,4582,11396,3774,10096,295,950,2464,6092,2759,7042
316300,202302,1380,3226,1108,2851,54,162,819,1996,873,2158
316310,202302,988,2470,694,1966,146,478,215,542,361,1020
316320,202302,822,2128,632,1844,115,377,134,335,249,712
316330,202302,1280,2949,992,2495,55,159,753,1830,808,1989
316340,202302,1308,3071,1020,2591,79,266,669,1534,748,1800
316350,202302,1781,4145,1519,3729,167,426,1079,2530,1246,2956
316360,202302,793,1905,667,1717,70,172,495,1306,565,1478
316370,202302,7550,17217,5842,14443,620,1923,3226,6803,3846,8726
316380,202302,2173,4538,1748,3971,97,199,1291,2872,1388,3071
316390,202302,927,2319,690,1929,248,797,150,345,398,1142
316400,202302,1540,3998,979,2925,109,351,341,866,450,1217
316410,202302,1537,3454,1287,3081,36,113,1081,2476,1117,2589
316420,202302,2333,5648,1954,5112,33,130,1578,3959,1611,4089
316430,202302,1132,2716,794,2153,124,394,324,772,448,1166
316440,202302,1049,3003,853,2681,150,542,238,671,388,1213
316443,202302,695,1765,489,1381,98,332,166,418,264,750
316447,202302,2752,5996,2348,5412,34,99,2079,4666,2113,4765
316450,202302,2586,6787,1943,5563,235,708,1133,3108,1368,3816
316460,202302,1700,4066,1407,3617,128,364,898,2141,1026,2505
316470,202302,9361,24109,7108,19847,963,3080,3185,7730,4148,10810
316480,202302,272,636,229,582,33,96,135,312,168,408
316490,202302,423,1088,297,862,53,184,94,223,147,407
316500,202302,1637,4558,1150,3472,198,629,336,881,534,1510
316510,202302,975,2849,800,2529,134,431,380,1174,514,1605
316520,202302,1713,3812,1286,3094,201,534,518,1059,719,1593
316530,202302,1432,3257,1084,2674,89,319,665,1413,754,1732
316540,202302,1343,3015,1070,2647,183,529,495,1091,678,1620
316550,202302,1829,4426,1545,3959,58,193,1283,3192,1341,3385
316553,202302,6135,16035,4562,12631,582,1817,2140,5043,2722,6860
316555,202302,3346,8661,2895,8091,88,332,2436,6683,2524,7015
316556,202302,692,1480,521,1203,41,106,297,577,338,683
316557,202302,1527,4121,1315,3792,431,1366,527,1406,958,2772
316560,202302,502,1403,358,1126,60,218,99,254,159,472
316570,202302,1780,4531,1474,4014,369,917,471,1402,840,2319
316580,202302,482,984,327,751,35,85,158,330,193,415
316590,202302,1605,3639,1104,2738,140,319,640,1479,780,1798
316600,202302,1224,3134,1068,2853,148,447,665,1630,813,2077
316610,202302,768,2011,613,1762,62,202,375,1013,437,1215
316620,202302,2848,6326,2462,5774,169,370,1938,4475,2107,4845
316630,202302,1918,5198,1613,4656,453,1279,610,1998,1063,3277
316640,202302,210,524,165,447,31,97,68,158,99,255
316650,202302,1411,3518,1144,3121,85,236,770,2012,855,2248
316660,202302,221,504,109,284,11,31,40,85,51,116
316670,202302,1989,4595,1492,3856,392,1060,466,1061,858,2121
316680,202302,2905,6820,2185,5522,179,506,1464,3555,1643,4061
316690,202302,1657,4410,1207,3580,206,655,220,481,426,1136
316695,202302,1153,3085,932,2710,20,68,630,1759,650,1827
316700,202302,641,1095,549,995,13,28,494,862,507,890
316710,202302,4416,11940,3569,10342,396,1388,2083,5436,2479,6824
316720,202302,29064,70793,22915,59925,3302,9568,11872,28140,15174,37708
316730,202302,685,1480,549,1273,58,144,316,651,374,795
316740,202302,1095,2677,968,2504,157,450,646,1634,803,2084
316750,202302,500,1265,375,1059,72,227,163,418,235,645
316760,202302,5011,13842,4262,12522,1396,4649,1622,4564,3018,9213
316770,202302,1930,3885,1445,3257,49,130,1135,2553,1184,2683
316780,202302,757,2025,617,1786,202,666,124,258,326,924
316790,202302,890,2196,659,1772,102,297,186,468,288,765
316800,202302,8316,20752,6641,17993,881,2579,3370,8585,4251,11164
316805,202302,1517,2719,1241,2406,30,80,1071,2007,1101,2087
316810,202302,942,2283,727,1917,81,234,510,1310,591,1544
316820,202302,484,947,293,651,16,55,197,382,213,437
316830,202302,1134,2586,871,2171,98,252,536,1280,634,1532
316840,202302,3710,8210,3016,7171,163,487,2337,5273,2500,5760
316850,202302,2874,6289,2197,5221,183,530,1440,3090,1623,3620
316860,202302,29754,65581,22985,55778,2938,8552,12520,27949,15458,36501
316870,202302,11291,26907,8633,22214,962,2900,4735,10764,5697,13664
316880,202302,1454,3338,1230,3045,150,436,771,1747,921,2183
316890,202302,1432,3039,913,2379,111,365,569,1355,680,1720
316900,202302,3317,7836,2668,6720,409,1139,1288,2841,1697,3980
316905,202302,599,1637,485,1429,224,668,109,341,333,1009
316910,202302,1297,3109,902,2477,220,653,223,554,443,1207
316920,202302,2510,5107,1913,4275,185,549,1356,2703,1541,3252
316930,202302,12159,30533,9697,26502,1888,5710,4031,9809,5919,15519
316935,202302,5546,13175,4177,10787,685,1989,1959,4491,2644,6480
316940,202302,7699,20468,6170,17621,1041,3236,2760,6970,3801,10206
316950,202302,2526,5008,1964,4276,82,168,1658,3532,1740,3700
316960,202302,6905,13481,5096,11169,393,965,3684,7784,4077,8749
316970,202302,5290,12729,4461,11396,583,1672,2345,5367,2928,7039
316980,202302,1105,2821,853,2429,235,755,343,887,578,1642
316990,202302,16566,39957,12555,32515,2962,8214,2979,6504,5941,14718
317000,202302,3295,8014,2895,7509,175,390,2321,6025,2496,6415
317005,202302,3254,8243,2551,6910,401,1219,1318,3295,1719,4514
317010,202302,37751,82160,27143,66418,4006,10990,14883,34120,18889,45110
317020,202302,95643,211730,62504,156668,11561,31769,22977,50796,34538,82565
317030,202302,831,2016,665,1781,16,58,495,1282,511,1340
317040,202302,14580,33985,10110,26722,2408,6868,2738,7215,5146,14083
317043,202302,1185,2277,882,1892,41,91,701,1476,742,1567
317047,202302,1400,2957,984,2316,45,128,703,1558,748,1686
317050,202302,1514,4390,1088,3420,175,603,382,957,557,1560
317052,202302,3093,7206,2466,6280,212,606,1686,4060,1898,4666
317057,202302,2813,5218,2182,4331,35,106,1810,3353,1845,3459
317060,202302,602,1522,372,1062,58,185,142,354,200,539
317065,202302,1360,3562,1126,3127,74,256,723,1803,797,2059
317070,202302,10427,26800,8399,23132,1237,4014,4088,10005,5325,14019
317075,202302,1407,3165,1106,2704,150,390,662,1485,812,1875
317080,202302,8416,17866,6422,14789,1175,2875,3154,6926,4329,9801
317090,202302,5854,14752,5095,13591,383,938,3717,9866,4100,10804
317100,202302,3217,7133,2209,5566,426,1147,962,2231,1388,3378
317103,202302,3115,6466,2650,5843,149,428,2166,4522,2315,4950
317107,202302,1851,4242,1384,3425,53,169,932,1975,985,2144
317110,202302,839,1826,486,1286,76,230,193,478,269,708
317115,202302,1385,3542,1137,3121,137,404,664,1788,801,2192
317120,202302,24920,57778,20529,51050,1429,4390,13748,31442,15177,35832
317130,202302,14520,31212,10332,24532,1406,3691,4163,9470,5569,13161
317140,202302,1186,2573,901,2140,74,179,621,1437,695,1616
317150,202302,1317,2669,1013,2278,29,100,871,1871,900,1971
317160,202302,4195,9377,2715,7030,286,686,1334,3649,1620,4335
317170,202302,2578,5838,2011,4861,88,271,1366,2916,1454,3187
317180,202302,2298,6525,1682,5176,318,1027,354,1009,672,2036
317190,202302,1328,3332,987,2779,181,554,457,1195,638,1749
317200,202302,8160,19898,6070,16007,1315,3636,1474,3378,2789,7014
317210,202302,1527,3220,1184,2778,40,138,850,1944,890,2082
317220,202302,413,1045,363,965,65,200,212,503,277,703
320010,202302,5958,16181,4539,13368,731,2380,2097,5893,2828,8273
320013,202302,2612,6484,1856,5083,316,933,838,2274,1154,3207
320016,202302,3583,8457,2762,7215,224,614,1808,4605,2032,5219
320020,202302,6228,14087,4823,11765,652,1905,2656,5995,3308,7900
320030,202302,2221,5561,1467,4079,202,639,676,1650,878,2289
320035,202302,2423,5813,2016,5170,336,1007,1183,2884,1519,3891
320040,202302,5719,14465,4780,12894,656,1883,2606,6548,3262,8431
320050,202302,2364,4809,2042,4368,209,593,1379,2663,1588,3256
320060,202302,18772,46529,14041,37631,2434,6989,6209,15075,8643,22064
320070,202302,2474,5852,1890,4817,207,684,1041,2291,1248,2975
320080,202302,7105,16554,5065,12778,855,2320,2168,4878,3023,7198
320090,202302,10467,25957,7146,19576,1457,4408,2551,6108,4008,10516
320100,202302,4352,10018,3594,8790,441,1241,2258,5179,2699,6420
320110,202302,3021,6162,2233,5027,251,677,1407,2822,1658,3499
320115,202302,2761,7890,2356,7238,762,2425,880,2799,1642,5224
320120,202302,34053,77833,25116,62942,3282,9091,12780,28932,16062,38023
320130,202302,76450,180049,63209,158200,7696,21235,38624,90540,46320,111775
320140,202302,5250,12814,3894,10277,545,1690,1930,4573,2475,6263
320150,202302,18190,43111,13214,34535,3067,9067,2221,4473,5288,13540
320160,202302,8273,20436,6185,16815,798,2408,3152,8059,3950,10467
320170,202302,2305,5918,1648,4702,424,1243,530,1568,954,2811
320180,202302,920,2685,717,2285,217,777,155,427,372,1204
320190,202302,4001,11424,2990,9331,610,2156,608,1600,1218,3756
320200,202302,1669,4215,1140,3256,233,722,308,864,541,1586
320210,202302,5900,13517,4600,11414,704,1915,2521,5747,3225,7662
320220,202302,4685,10702,3540,8901,704,1846,1541,3585,2245,5431
320225,202302,1936,5430,1320,4086,358,1243,286,829,644,2072
320230,202302,7173,17214,5433,14441,1304,3666,1484,4027,2788,7693
320240,202302,22804,52902,17292,44580,4326,12257,5183,12449,9509,24706
320245,202302,4130,11246,3017,8906,796,2515,378,995,1174,3510
320250,202302,3667,8667,2550,6376,375,1035,1268,2718,1643,3753
320255,202302,2764,7378,2371,6706,369,1145,1565,4369,1934,5514
320260,202302,1808,4717,1184,3477,274,831,303,751,577,1582
320265,202302,2857,8138,2104,6617,765,2619,252,711,1017,3330
320270,202302,2870,7274,2165,5991,556,1744,662,1701,1218,3445
320280,202302,11151,25325,9228,22326,1021,2964,6234,13967,7255,16931
320290,202302,1654,4588,1090,3330,278,940,284,789,562,1729
320300,202302,5667,14997,4564,12988,1216,3865,1513,4043,2729,7908
320305,202302,6888,17343,5252,14394,924,2851,2465,6249,3389,9100
320310,202302,2638,6536,1917,5095,338,994,853,1982,1191,2976
320313,202302,3213,7220,2195,5431,414,1157,818,1665,1232,2822
320316,202302,1970,5131,1494,4345,218,637,803,2342,1021,2979
320320,202302,28217,68732,20900,56875,4993,14430,6939,18212,11932,32642
320330,202302,3720,8996,2920,7699,453,1225,1638,4285,2091,5510
320332,202302,11048,26089,8958,22664,1620,4502,4805,11399,6425,15901
320334,202302,2457,6340,1716,4944,293,1016,414,899,707,1915
320335,202302,2358,6218,1589,4582,314,1044,474,1205,788,2249
320340,202302,7338,15247,6128,13569,443,1130,4322,9230,4765,10360
320350,202302,6800,14872,4806,11550,506,1381,2682,5805,3188,7186
320360,202302,1725,4066,1230,3172,134,372,600,1415,734,1787
320370,202302,3684,9990,2877,8360,779,2580,1028,2692,1807,5272
320380,202302,3954,8645,3326,7651,242,755,2437,5123,2679,5878
320390,202302,10321,24602,7716,19739,1528,4138,3140,7327,4668,11465
320400,202302,4136,10799,3095,8706,827,2582,1119,2875,1946,5457
320405,202302,6825,15802,5191,13149,725,1974,2796,6678,3521,8652
320410,202302,6023,14418,4570,12195,784,2118,2205,5851,2989,7969
320420,202302,5386,12014,4177,10201,897,2362,1709,3904,2606,6266
320425,202302,2756,5832,2118,4856,146,368,1462,3105,1608,3473
320430,202302,3960,9194,3158,7879,428,1115,1925,4570,2353,5685
320435,202302,3082,8696,2487,7519,792,2635,801,2432,1593,5067
320440,202302,1941,4875,1455,3974,249,753,635,1510,884,2263
320450,202302,2787,6702,2255,5800,318,1042,1317,2972,1635,4014
320455,202302,5699,16047,3967,12220,883,3069,949,2415,1832,5484
320460,202302,2728,7471,2021,6084,559,1903,554,1461,1113,3364
320465,202302,2027,5201,1463,4161,352,1096,571,1583,923,2679
320470,202302,5524,13314,4157,10812,740,2168,1452,3264,2192,5432
320480,202302,3181,6803,2581,5865,277,661,1788,3855,2065,4516
320490,202302,34105,77293,25559,63407,4599,11589,11315,27390,15914,38979
320495,202302,1749,4381,1279,3508,290,923,215,420,505,1343
320500,202302,89504,208179,72817,181173,8378,23688,45141,103769,53519,127457
320501,202302,6346,16509,4646,13488,1262,3998,1141,3087,2403,7085
320503,202302,3289,8644,2280,6667,630,2036,607,1569,1237,3605
320506,202302,3520,9554,2668,7807,737,2396,611,1459,1348,3855
320510,202302,16062,38024,12723,32586,1873,4932,6792,16660,8665,21592
320515,202302,2316,5864,1716,4676,483,1416,521,1310,1004,2726
320517,202302,2844,7596,2308,6569,639,1980,886,2406,1525,4386
320520,202302,62401,142082,49472,121572,7087,19392,24942,56560,32029,75952
320530,202302,47275,107640,38245,93175,2698,8189,25706,56893,28404,65082
330010,202302,37451,82115,31582,73233,2363,6354,23489,51590,25852,57944
330015,202302,2304,4797,1806,4048,223,634,1148,2331,1371,2965
330020,202302,30996,66263,26407,59815,2695,7024,19341,41977,22036,49001
330022,202302,2583,6373,1988,5422,390,1126,832,2182,1222,3308
330023,202302,9653,20265,7790,17536,1031,2610,5014,10525,6045,13135
330025,202302,10228,20733,7149,15986,1117,2774,3408,6816,4525,9590
330030,202302,15847,35297,12615,30405,918,2792,8829,19511,9747,22303
330040,202302,25199,56075,21245,49941,909,2820,16376,35852,17285,38672
330045,202302,148261,278594,127413,253414,5354,12090,109222,210789,114576,222879
330050,202302,4780,10586,3881,9227,590,1740,2437,5096,3027,6836
330060,202302,8084,18090,6200,15061,1113,3128,2591,5586,3704,8714
330070,202302,44096,92077,37309,82977,4382,10566,25407,54755,29789,65321
330080,202302,14738,30122,12601,27288,1536,3402,8751,18555,10287,21957
330090,202302,4588,8472,3392,6923,303,526,2298,4741,2601,5267
330093,202302,4104,8418,3168,7180,185,489,2557,5574,2742,6063
330095,202302,1976,4792,1561,4089,160,485,928,2212,1088,2697
330100,202302,108690,235363,95707,217773,4253,11965,77681,170261,81934,182226
330110,202302,3314,7685,2746,6798,281,827,1890,4328,2171,5155
330115,202302,3787,8056,2734,6470,424,1165,1581,3363,2005,4528
330120,202302,4880,9231,3817,7955,170,450,3049,5984,3219,6434
330130,202302,7679,17741,6430,15946,836,2180,4135,9869,4971,12049
330140,202302,6149,12124,5162,10861,183,563,4404,8788,4587,9351
330150,202302,3561,8105,2866,7054,463,1261,1594,3687,2057,4948
330160,202302,2212,5100,1755,4353,293,859,1030,2255,1323,3114
330170,202302,228516,438695,197229,398844,20810,45236,148658,291431,169468,336667
330180,202302,3121,6053,2579,5339,98,285,2098,4082,2196,4367
330185,202302,17424,33900,14979,30806,483,1374,13042,25739,13525,27113
330187,202302,8234,17129,6533,14571,765,2016,4359,8910,5124,10926
330190,202302,67394,130051,58975,119060,2467,6098,49502,96050,51969,102148
330200,202302,28054,58227,23478,52651,2824,6629,16975,37276,19799,43905
330205,202302,3007,6653,2310,5565,151,440,1579,3484,1730,3924
330210,202302,4453,9652,3313,7879,422,1115,1930,4174,2352,5289
330220,202302,20425,43499,15581,36037,2292,6112,8118,16606,10410,22718
330225,202302,6166,13514,4869,11657,349,962,3378,7670,3727,8632
330227,202302,29499,58114,25968,53917,538,1525,23494,47326,24032,48851
330230,202302,2482,5238,1682,4159,152,409,778,1884,930,2293
330240,202302,40703,87845,34890,79325,2891,7660,25802,55664,28693,63324
330245,202302,2208,5001,1387,3608,271,772,593,1343,864,2115
330250,202302,68713,139532,59201,126622,6173,14383,43696,90258,49869,104641
330260,202302,9456,18777,7677,16480,422,1082,6132,12634,6554,13716
330270,202302,47666,100831,31525,75416,3853,10329,16608,36267,20461,46596
330280,202302,3972,8384,3190,7197,192,567,2276,4675,2468,5242
330285,202302,45386,86415,38224,76832,1422,3801,32269,61452,33691,65253
330290,202302,6902,13135,5694,11614,300,879,4699,8938,4999,9817
330300,202302,8370,16663,6295,13868,432,1084,4697,9825,5129,10909
330310,202302,3853,7903,2954,6574,131,344,2243,4716,2374,5060
330320,202302,27355,53764,22180,47448,2408,4883,16654,34909,19062,39792
330330,202302,75745,143215,62961,126914,4348,9781,49685,96009,54033,105790
330340,202302,28189,58557,21879,49404,2768,7563,13052,26371,15820,33934
330350,202302,250639,465542,216166,425056,8131,17882,190801,366120,198932,384002
330360,202302,11192,22163,9825,20551,348,708,8682,17849,9030,18557
330370,202302,8103,19121,6522,16626,1143,3287,3370,7964,4513,11251
330380,202302,10445,22348,8566,19320,588,1714,6381,13325,6969,15039
330385,202302,6216,14549,5104,12973,800,2327,2780,6644,3580,8971
330390,202302,52150,113344,41444,96263,3735,10778,28523,60276,32258,71054
330395,202302,5048,10386,4224,9379,142,435,3410,7171,3552,7606
330400,202302,5104,11456,4304,10240,202,668,3324,7290,3526,7958
330410,202302,4803,10336,3680,8582,418,1259,2549,5363,2967,6622
330411,202302,3951,9494,3215,8282,186,617,2231,5294,2417,5911
330412,202302,2426,5648,2026,5050,152,468,1434,3299,1586,3767
330414,202302,36132,77351,30315,69657,1941,5090,23657,52395,25598,57485
330415,202302,6365,15151,4765,12515,442,1279,2829,6962,3271,8241
330420,202302,18303,40433,13970,33765,1391,3958,8424,18436,9815,22394
330430,202302,16236,30540,13965,27608,494,1214,11842,22404,12336,23618
330440,202302,4239,9524,3253,7878,314,931,2245,4970,2559,5901
330450,202302,2045,4895,1645,4271,125,365,1040,2512,1165,2877
330452,202302,30179,64599,25153,57395,2024,5745,18816,40190,20840,45935
330455,202302,1072750,2055316,908777,1837918,86075,190164,677927,1317455,764002,1507619
330460,202302,1730,4035,1354,3502,216,603,729,1825,945,2428
330470,202302,8454,17879,6250,14718,1344,3580,2575,5569,3919,9149
330475,202302,13606,29511,11132,26375,1407,3831,7503,17023,8910,20854
330480,202302,8047,18006,6876,16356,574,1479,4793,10766,5367,12245
330490,202302,174124,343258,146641,307971,11978,26939,111743,227098,123721,254037
330500,202302,11980,25143,10164,22793,589,1516,7969,17240,8558,18756
330510,202302,72349,150045,58982,132384,5183,13229,44382,95095,49565,108324
330513,202302,1823,4017,1481,3568,214,574,864,2014,1078,2588
330515,202302,4048,9255,3296,8226,455,1332,1807,4092,2262,5424
330520,202302,21215,45798,18081,41362,1560,4271,12984,28011,14544,32282
330530,202302,2276,4929,1649,4010,299,799,789,1854,1088,2653
330540,202302,4367,9988,3433,8486,700,1846,1663,3838,2363,5684
330550,202302,25233,49519,19082,40998,2375,5874,12475,24957,14850,30831
330555,202302,31527,54244,26987,48991,970,2051,23240,41413,24210,43464
330560,202302,5598,12423,4592,10905,631,1549,2975,6747,3606,8296
330570,202302,4445,9855,3923,9160,527,1447,2749,6187,3276,7634
330575,202302,9295,19380,8190,17596,308,869,6948,14056,7256,14925
330580,202302,33666,73505,28466,65138,3791,9363,17994,37986,21785,47349
330590,202302,2248,4904,1891,4468,237,544,1242,2950,1479,3494
330600,202302,19106,41716,16003,37055,853,2514,11814,25434,12667,27948
330610,202302,14368,31303,11939,27668,1023,2783,8434,18299,9457,21082
330615,202302,3019,6898,2504,6233,434,972,1607,4120,2041,5092
330620,202302,6379,15095,5226,13295,756,2228,3067,7173,3823,9401
330630,202302,44710,93893,35353,79660,1438,4403,27227,57131,28665,61534
350010,202302,3060,7364,1931,5148,343,988,507,1048,850,2036
350020,202302,865,2098,536,1490,76,229,184,440,260,669
350030,202302,4921,12143,3904,10484,796,2426,1926,4675,2722,7101
350040,202302,980,2598,612,1842,87,316,189,425,276,741
350050,202302,1967,4475,1374,3520,209,631,488,972,697,1603
350055,202302,1250,2782,1001,2419,137,381,589,1265,726,1646
350060,202302,413,910,226,548,42,106,91,198,133,304
350070,202302,4368,10445,3141,8298,447,1326,1427,3259,1874,4585
350075,202302,877,2288,662,1904,209,601,119,350,328,951
350080,202302,855,2089,576,1567,48,155,302,705,350,860
350090,202302,804,1602,538,1222,71,195,332,668,403,863
350100,202302,3480,7999,2553,6527,149,512,1706,3924,1855,4436
350110,202302,645,1391,487,1132,16,46,356,780,372,826
350115,202302,1458,3976,1206,3495,195,641,570,1470,765,2111
350120,202302,824,1813,491,1256,44,134,265,614,309,748
350130,202302,4473,10616,3593,9097,418,1212,2089,4631,2507,5843
350140,202302,886,2247,642,1815,47,171,370,927,417,1098
350150,202302,584,1645,474,1442,92,309,157,402,249,711
350160,202302,16603,38839,12146,30845,1601,4535,7101,16552,8702,21087
350170,202302,3802,9362,3228,8195,506,1377,1790,4087,2296,5464
350180,202302,1295,2859,819,2057,94,261,446,1006,540,1267
350190,202302,4965,12667,3748,10002,444,1482,2161,4830,2605,6312
350200,202302,710,1657,545,1377,39,111,346,794,385,905
350210,202302,8807,18318,6372,14581,448,1313,4541,9514,4989,10827
350220,202302,4117,10292,2992,8239,508,1516,1301,3121,1809,4637
350230,202302,1466,3302,1159,2892,151,457,685,1597,836,2054
350240,202302,751,1970,466,1330,75,216,126,295,201,511
350250,202302,4656,11516,3593,9859,924,2639,1107,2891,2031,5530
350260,202302,1102,2345,712,1728,84,234,414,896,498,1130
350270,202302,5786,13700,4684,11769,578,1643,2745,6253,3323,7896
350275,202302,3938,9148,3282,8226,221,723,2486,5832,2707,6555
350280,202302,25230,53656,17130,41023,2326,6104,8906,19322,11232,25426
350290,202302,4637,11622,3383,9225,567,1749,1503,3542,2070,5291
350300,202302,922,2092,726,1763,87,238,475,1045,562,1283
350310,202302,1260,3195,979,2693,142,454,468,1137,610,1591
350315,202302,783,1755,564,1431,27,100,340,738,367,838
350320,202302,22882,53887,17873,45383,2873,8311,9025,20363,11898,28674
350330,202302,18510,41449,14037,33572,1199,3326,9602,21080,10801,24406
350335,202302,463,1203,338,964,34,102,149,409,183,511
350340,202302,1722,4164,1105,2996,155,482,522,1237,677,1719
350350,202302,926,2102,733,1893,119,299,431,1115,550,1414
350360,202302,1555,4022,1287,3514,219,643,569,1444,788,2087
350370,202302,927,2081,682,1655,188,444,257,568,445,1012
350380,202302,6277,16077,4684,12859,1031,2985,1653,4114,2684,7099
350390,202302,15330,35804,12093,30618,1503,4228,7380,17166,8883,21394
350395,202302,528,1237,273,770,28,80,93,225,121,305
350400,202302,11493,26294,8296,21026,2051,5643,2598,6043,4649,11686
350410,202302,14538,36902,11177,30890,2082,6348,4594,11614,6676,17962
350420,202302,1503,3559,1079,2809,189,497,380,820,569,1317
350430,202302,847,2019,674,1764,99,312,364,830,463,1142
350440,202302,2803,6181,2234,5325,140,436,1536,3322,1676,3758
350450,202302,9619,23980,7660,20719,1493,4645,3659,8799,5152,13444
350460,202302,2994,7049,1971,5202,294,856,913,2126,1207,2982
350470,202302,329,735,256,627,7,18,192,448,199,466
350480,202302,1210,2869,810,2180,182,564,181,396,363,960
350490,202302,2615,5944,1941,4939,293,864,967,2104,1260,2968
350500,202302,785,1957,560,1566,76,226,223,573,299,799
350510,202302,1576,3586,1222,3001,115,307,759,1713,874,2020
350520,202302,3136,8378,2502,7268,351,1117,1184,3095,1535,4212
350530,202302,4192,9650,3226,7888,251,738,2032,4463,2283,5201
350535,202302,1939,4647,1622,4212,227,654,1022,2519,1249,3173
350540,202302,2631,5248,2031,4426,210,575,1471,2890,1681,3465
350550,202302,12795,28721,9244,22958,876,2623,5591,12398,6467,15021
350560,202302,6140,13838,5196,12424,233,749,4066,9091,4299,9840
350570,202302,41785,102670,34548,90226,5336,15399,18798,45346,24134,60745
350580,202302,2877,6999,1907,5203,537,1642,538,1103,1075,2745
350590,202302,6903,16800,5290,13459,637,1885,3269,7476,3906,9361
350600,202302,44638,97879,29499,72811,4337,12366,14097,30591,18434,42957
350610,202302,9442,23291,7177,19013,805,2468,4189,10022,4994,12490
350620,202302,514,1244,346,982,40,121,194,511,234,632
350630,202302,2342,4927,1723,3931,105,313,1246,2569,1351,2882
350635,202302,15196,32308,11889,27424,1227,3153,8300,17993,9527,21146
350640,202302,1163,2921,652,1860,103,299,190,455,293,754
350650,202302,11383,28012,8516,22700,1435,4243,3741,8830,5176,13073
350660,202302,6619,15042,5222,12906,593,1458,3320,7940,3913,9398
350670,202302,2379,5868,1796,4878,299,862,908,2365,1207,3227
350680,202302,1492,3654,1029,2838,149,440,454,1103,603,1543
350690,202302,1897,4505,1420,3701,245,694,727,1767,972,2461
350700,202302,6887,15610,5414,13401,1044,3052,2976,6626,4020,9678
350710,202302,4113,9632,3472,8627,585,1710,1921,4293,2506,6003
350715,202302,922,2450,777,2199,164,541,367,882,531,1423
350720,202302,208,483,151,397,19,58,44,93,63,151
350730,202302,811,2155,625,1807,47,155,352,902,399,1057
350740,202302,2103,5128,1454,3857,232,672,494,1157,726,1829
350745,202302,793,1920,488,1357,41,139,237,589,278,728
350750,202302,15553,36741,12632,32069,2051,6055,6362,14409,8413,20464
350760,202302,24627,53450,18965,44282,2378,6785,11482,23554,13860,30339
350770,202302,1358,3021,900,2265,91,254,556,1288,647,1542
350775,202302,925,1948,626,1507,84,205,341,765,425,970
350780,202302,3035,6786,2258,5763,574,1364,863,2391,1437,3755
350790,202302,2747,6828,1778,5092,384,1101,434,1002,818,2103
350800,202302,4540,11491,3889,10439,378,1206,2563,6380,2941,7586
350810,202302,3795,8272,2845,6893,640,1617,1288,2885,1928,4502
350820,202302,1185,2554,752,1788,52,147,473,1012,525,1159
350830,202302,1085,2696,650,1810,108,337,228,492,336,829
350840,202302,4503,11997,3496,10209,630,2069,1555,4025,2185,6094
350850,202302,11195,27538,8915,23642,1410,4131,4895,11992,6305,16123
350860,202302,5255,11991,4563,11068,445,1190,3176,7493,3621,8683
350870,202302,3579,8827,2628,7361,415,1217,1334,3546,1749,4763
350880,202302,2098,5164,1756,4546,428,1188,726,1622,1154,2810
350890,202302,653,1583,436,1161,74,204,137,309,211,513
350900,202302,12976,30819,9620,24410,1365,3922,5377,12130,6742,16052
350910,202302,1236,2614,1037,2335,96,228,777,1700,873,1928
350920,202302,17179,38702,14506,34544,671,1937,11445,25818,12116,27755
350925,202302,5798,13809,4332,11425,686,2064,2346,5412,3032,7476
350930,202302,1856,4508,1290,3458,96,279,693,1767,789,2046
350940,202302,3648,8198,2967,7154,241,702,2183,4856,2424,5558
350945,202302,1250,3148,924,2534,172,481,382,937,554,1418
350950,202302,133254,306563,105028,256877,12655,34404,64682,146353,77337,180757
350960,202302,9622,23118,7574,19380,1121,3283,3938,9002,5059,12285
350970,202302,5190,13157,3896,10856,984,3125,1272,2748,2256,5873
350980,202302,1019,2327,848,2047,126,358,535,1169,661,1527
350990,202302,2818,6604,2230,5709,491,1484,1085,2475,1576,3959
350995,202302,1117,3039,1020,2866,69,260,708,1849,777,2109
351000,202302,3972,10005,2573,7254,531,1591,757,1998,1288,3589
351010,202302,514,1205,322,850,48,153,159,381,207,534
351015,202302,1292,3468,1070,3043,196,610,455,1101,651,1711
351020,202302,10930,26308,8422,22048,1545,4422,4315,10191,5860,14613
351030,202302,4096,10807,3285,9262,548,1768,1628,4206,2176,5974
351040,202302,7754,16368,6492,14526,242,679,5336,11341,5578,12020
351050,202302,23832,53641,18539,45912,3008,8167,10253,23769,13261,31936
351060,202302,67600,152653,52762,128618,4504,12695,36609,84066,41113,96761
351070,202302,1923,4427,1146,3135,288,861,232,531,520,1392
351080,202302,3740,8105,2856,7043,349,1005,1827,4185,2176,5190
351090,202302,429,1075,329,906,60,163,126,330,186,493
351100,202302,3791,9244,2504,6731,468,1399,884,2178,1352,3577
351110,202302,7576,18370,5582,14846,871,2656,2922,7078,3793,9734
351120,202302,956,2278,654,1716,116,332,231,513,347,845
351130,202302,1475,3855,689,2053,116,373,158,380,274,753
351140,202302,2967,7460,2290,6287,472,1455,950,2256,1422,3711
351150,202302,3818,9815,2750,7751,423,1363,1052,2603,1475,3966
351160,202302,1797,5056,1285,3943,240,795,266,668,506,1463
351170,202302,2160,5119,1872,4641,143,449,1337,3024,1480,3473
351190,202302,1272,3301,898,2589,209,630,253,663,462,1293
351200,202302,2014,4614,1493,3854,159,459,930,2207,1089,2666
351210,202302,1976,4419,1328,3344,85,267,830,1886,915,2153
351220,202302,5038,11801,4342,10741,485,1148,2863,6854,3348,8002
351230,202302,2937,6839,2287,5789,424,1192,1044,2265,1468,3457
351240,202302,2995,7356,1916,5209,467,1272,429,978,896,2250
351250,202302,1309,3327,777,2229,100,288,269,715,369,1003
351260,202302,1059,2441,737,1885,149,375,282,674,431,1049
351270,202302,680,1702,491,1343,51,148,244,543,295,691
351280,202302,5080,12409,3852,10179,874,2426,1518,3625,2392,6051
351290,202302,1945,4238,1334,3232,115,326,950,2164,1065,2490
351300,202302,30068,72838,22621,59671,3981,11504,11110,26862,15091,38366
351310,202302,5068,11092,3965,9346,193,576,2956,6514,3149,7090
351320,202302,1015,2754,719,2190,122,385,190,501,312,886
351330,202302,393,956,263,714,19,62,129,286,148,348
351340,202302,10969,24570,9302,21772,1544,4366,5913,12140,7457,16506
351350,202302,18105,40441,15097,35598,1069,3049,11596,25586,12665,28635
351360,202302,5264,12152,4345,10856,759,2222,2288,5103,3047,7325
351370,202302,2581,6702,1719,4974,397,1245,381,881,778,2126
351380,202302,63332,138000,46595,110990,4687,12465,30055,66890,34742,79355
351385,202302,470,1171,211,622,30,83,90,249,120,332
351390,202302,1850,4093,1313,3360,66,205,1059,2615,1125,2820
351400,202302,1525,3789,1239,3264,205,520,636,1596,841,2116
351410,202302,3488,8705,2651,7187,466,1354,1177,2922,1643,4276
351420,202302,627,1405,395,1031,46,123,237,561,283,684
351430,202302,1351,3099,1123,2751,70,195,840,1941,910,2136
351440,202302,4734,11349,3289,8603,553,1542,1055,2267,1608,3809
351450,202302,2192,5343,1522,4176,296,986,442,928,738,1914
351460,202302,1337,3131,1108,2791,168,454,675,1608,843,2062
351470,202302,1587,3695,1249,3152,82,243,809,1897,891,2140
351480,202302,3210,8188,2565,7212,431,1402,1264,3196,1695,4598
351490,202302,2963,7354,2573,6686,81,309,2051,5101,2132,5410
351492,202302,470,1090,402,965,8,26,319,725,327,751
351495,202302,293,722,238,624,25,55,135,339,160,394
351500,202302,59695,127660,47201,108512,5664,14624,31703,67698,37367,82322
351510,202302,18353,39526,13913,32477,1490,3917,9132,20022,10622,23939
351512,202302,595,1485,422,1128,83,230,134,325,217,555
351515,202302,4248,9241,2741,6715,530,1359,654,1623,1184,2982
351518,202302,2558,6222,1769,4843,301,929,714,1647,1015,2576
351519,202302,771,1973,474,1408,108,350,103,251,211,601
351520,202302,1511,3544,751,2111,83,285,345,839,428,1124
351530,202302,450,1095,284,774,45,116,123,274,168,390
351535,202302,2172,4977,1543,3920,238,646,677,1578,915,2224
351540,202302,3432,7613,2363,5831,240,710,1250,2669,1490,3379
351550,202302,9848,22388,6965,17465,819,2277,3863,8701,4682,10978
351560,202302,674,1793,529,1512,98,310,190,492,288,802
351565,202302,353,880,268,741,38,130,113,264,151,394
351570,202302,31218,73496,25003,62306,1965,5752,17155,39832,19120,45584
351580,202302,275,681,165,485,25,67,58,182,83,249
351590,202302,554,1221,297,781,22,66,157,363,179,429
351600,202302,1712,4246,1318,3508,216,631,603,1414,819,2045
351610,202302,850,1862,543,1350,53,149,298,670,351,819
351620,202302,32208,78651,24311,66094,3528,11082,11473,28067,15001,39149
351630,202302,39173,89914,32192,79106,2650,7637,23043,53080,25693,60717
351640,202302,27169,61116,22168,53095,1410,4132,16336,36564,17746,40696
351650,202302,476,1242,223,672,38,120,47,118,85,238
351660,202302,792,2093,550,1587,90,283,144,345,234,628
351670,202302,8070,20129,5401,14493,1113,2949,2277,5456,3390,8405
351680,202302,517,1340,351,1015,69,193,100,251,169,444
351685,202302,598,1536,474,1349,87,243,193,479,280,722
351690,202302,1513,3580,891,2419,99,333,373,884,472,1217
351700,202302,1759,3973,1316,3253,230,643,704,1559,934,2202
351710,202302,991,2339,748,1922,62,195,424,950,486,1145
351720,202302,2009,4794,1444,3843,250,676,673,1648,923,2324
351730,202302,1317,2989,1074,2636,74,204,677,1522,751,1726
351740,202302,4388,10129,3586,8777,466,1289,2140,4736,2606,6025
351750,202302,2398,5824,1528,4211,200,585,754,1902,954,2487
351760,202302,4285,10684,3309,8928,568,1805,1584,3743,2152,5548
351770,202302,2660,6407,2181,5581,565,1409,1136,2763,1701,4172
351780,202302,1376,3242,819,2185,105,316,334,809,439,1125
351790,202302,2011,4319,1547,3668,249,586,934,2131,1183,2717
351800,202302,553,1217,286,743,36,100,108,231,144,331
351810,202302,1461,3466,1196,3092,301,881,537,1240,838,2121
351820,202302,4107,9970,3126,8224,618,1804,1224,2761,1842,4565
351830,202302,6646,15175,5143,12788,402,1219,3488,7936,3890,9155
351840,202302,12691,31209,10087,26713,980,2946,6416,15518,7396,18464
351850,202302,1916,5001,1268,3748,209,692,387,886,596,1578
351860,202302,3522,9167,2777,7909,659,2098,1331,3460,1990,5558
351870,202302,37130,85415,29308,73032,5891,15443,14073,33780,19964,49223
351880,202302,228798,500614,183000,428210,25257,70919,117069,248448,142326,319367
351885,202302,1356,3059,1119,2716,51,160,834,1893,885,2053
351890,202302,1045,2528,674,1925,121,389,163,389,284,778
351900,202302,1612,3928,1230,3362,107,297,798,2120,905,2417
351905,202302,802,2104,607,1719,74,230,265,640,339,870
351907,202302,30774,73000,24368,62205,2601,7612,15602,36956,18203,44568
351910,202302,2230,5143,1651,4085,153,443,982,2083,1135,2526
351920,202302,1149,2771,891,2316,137,394,368,846,505,1240
351925,202302,1286,3107,1025,2679,99,316,593,1413,692,1729
351930,202302,5846,12868,5334,12054,528,1430,4237,9116,4765,10546
351940,202302,1425,3396,1055,2764,190,536,424,1082,614,1618
351950,202302,2129,4153,1636,3487,80,214,1206,2397,1286,2611
351960,202302,7283,16751,5584,13976,1298,3481,2350,5229,3648,8710
351970,202302,14280,33625,12016,30076,1366,4293,8207,18792,9573,23085
351980,202302,1390,3102,906,2311,130,371,428,978,558,1349
351990,202302,1839,3997,1362,3336,61,207,756,1615,817,1822
352000,202302,3579,8798,3085,7857,258,792,2136,5009,2394,5801
352010,202302,3043,7276,2435,6339,694,1835,663,1722,1357,3557
352020,202302,2257,5276,1773,4478,243,730,1005,2276,1248,3006
352030,202302,8261,18498,6727,16154,783,2285,4456,9891,5239,12176
352040,202302,5748,13396,4233,10709,683,1922,1692,3705,2375,5627
352042,202302,4929,10507,3497,8378,382,1038,2299,5258,2681,6296
352044,202302,2608,6455,1586,4574,233,761,368,824,601,1585
352050,202302,17417,42693,12176,32901,3393,9875,2752,5901,6145,15776
352060,202302,1003,2398,760,1992,149,425,354,826,503,1251
352070,202302,1220,2392,827,1878,64,158,483,998,547,1156
352080,202302,572,1375,363,992,44,116,119,268,163,384
352090,202302,2011,5294,1663,4672,196,642,858,2119,1054,2761
352100,202302,4981,12672,3900,10727,641,2059,1777,4456,2418,6515
352110,202302,958,2430,719,1977,149,419,304,726,453,1145
352115,202302,620,1567,510,1418,140,445,245,593,385,1038
352120,202302,1082,2811,851,2369,77,220,532,1355,609,1575
352130,202302,2504,6565,1608,4404,208,599,749,1816,957,2415
352140,202302,1765,4357,1305,3469,262,698,532,1330,794,2028
352150,202302,1094,2620,811,2157,101,295,498,1245,599,1540
352160,202302,1217,2773,877,2223,93,259,432,1029,525,1288
352170,202302,3808,9475,2961,7792,469,1436,1405,3216,1874,4652
352180,202302,3594,8994,2805,7665,571,1670,1117,2785,1688,4455
352190,202302,2174,4923,1750,4292,309,810,942,2244,1251,3054
352200,202302,428,1262,315,1025,46,160,114,333,160,493
352210,202302,31833,63499,25723,55455,1355,3394,20797,42988,22152,46382
352215,202302,790,1932,608,1618,99,294,315,792,414,1086
352220,202302,37705,80250,29239,66845,3650,9733,18738,38445,22388,48178
352230,202302,20791,53406,16486,45928,4120,12700,6348,15291,10468,27991
352240,202302,14285,33333,11232,28546,2034,5798,5898,13362,7932,19160
352250,202302,32963,84346,27438,75399,3538,10699,17867,46836,21405,57535
352260,202302,6722,15568,4823,11964,776,2185,2564,5482,3340,7667
352265,202302,1122,2944,996,2767,169,512,563,1474,732,1986
352270,202302,2616,6774,2101,5772,386,1161,908,2234,1294,3395
352280,202302,3131,6930,2409,5882,339,945,1355,2952,1694,3897
352290,202302,2039,5089,1663,4404,192,570,968,2288,1160,2858
352300,202302,1231,2930,791,2046,84,228,418,976,502,1204
352310,202302,53257,128407,41821,110517,6350,17942,25288,64133,31638,82075
352320,202302,9045,20512,7240,17473,866,2508,4503,9497,5369,12005
352330,202302,3504,7734,2795,6771,268,850,1891,4163,2159,5013
352340,202302,10238,24665,7876,20433,1219,3549,4157,9609,5376,13158
352350,202302,3342,8080,2741,6910,135,407,2006,4796,2141,5203
352360,202302,2025,4714,1634,4061,154,402,1109,2561,1263,2963
352370,202302,1344,3398,1138,3061,50,154,856,2224,906,2378
352380,202302,1254,2936,955,2453,197,531,330,767,527,1298
352390,202302,18499,42498,13587,33889,2028,5822,7958,17907,9986,23729
352400,202302,4832,12594,3778,10643,899,2750,1271,3114,2170,5864
352410,202302,5030,11281,3954,9587,443,1151,2449,5553,2892,6704
352420,202302,1086,2523,754,1994,133,372,282,666,415,1038
352430,202302,11900,25442,9102,20990,1161,3085,5321,11225,6482,14310
352440,202302,25889,64108,20097,53690,4473,12608,7282,18238,11755,30846
352450,202302,1001,2357,576,1637,84,272,231,565,315,837
352460,202302,3467,8686,2590,7189,472,1457,1147,2879,1619,4336
352470,202302,3940,9627,3145,8370,267,854,2018,4903,2285,5757
352480,202302,5919,12936,4092,9831,524,1517,2145,4426,2669,5943
352490,202302,1084,2718,865,2353,178,527,352,894,530,1421
352500,202302,14737,34985,10395,27446,3636,11200,2223,3672,5859,14872
352510,202302,6013,14311,4855,12361,509,1472,3289,7815,3798,9287
352520,202302,3851,9409,2989,7999,522,1597,1606,3820,2128,5417
352530,202302,15690,36515,11267,28719,2203,6398,4206,8733,6409,15131
352540,202302,719,1844,535,1484,67,187,277,693,344,880
352550,202302,1302,3223,886,2509,175,595,335,781,510,1376
352560,202302,851,2031,713,1794,45,156,513,1186,558,1342
352570,202302,2695,6958,1813,5290,419,1423,288,471,707,1894
352580,202302,991,2213,835,1964,105,296,560,1194,665,1490
352585,202302,480,1232,357,1020,37,138,186,457,223,595
352590,202302,16934,41712,12731,34323,2335,7177,6880,16716,9215,23893
352600,202302,2536,6020,2078,5262,219,625,1387,3215,1606,3840
352610,202302,3842,9207,2963,7811,456,1419,1468,3495,1924,4914
352620,202302,7827,17308,6033,14830,1343,3486,2858,6744,4201,10230
352630,202302,1085,2445,825,2096,143,407,402,943,545,1350
352640,202302,4378,10053,3280,8151,293,835,2067,4638,2360,5473
352650,202302,704,1843,468,1361,77,234,176,464,253,698
352660,202302,1442,3708,1183,3243,99,340,785,1956,884,2296
352670,202302,14215,33824,10566,27072,1817,5162,5009,11311,6826,16473
352680,202302,4261,11358,3198,9087,622,2154,1540,3497,2162,5651
352690,202302,35097,81228,28048,70057,1241,3892,20729,48790,21970,52682
352700,202302,1043,2452,795,2047,110,300,394,933,504,1233
352710,202302,7206,17057,5374,13923,1356,4022,2234,5015,3590,9037
352720,202302,13495,30609,11090,26553,1632,4458,6427,14002,8059,18460
352725,202302,663,1459,381,988,16,48,230,535,246,583
352730,202302,5597,15727,5083,14627,637,2077,2470,5919,3107,7996
352740,202302,3066,6865,2329,5808,307,874,1193,2716,1500,3590
352750,202302,517,1207,341,927,36,110,155,365,191,475
352760,202302,2018,5056,1598,4324,204,563,859,2188,1063,2751
352770,202302,1202,2898,852,2282,115,323,440,1084,555,1407
352780,202302,826,2183,579,1673,135,367,163,450,298,817
352790,202302,508,1248,383,1010,52,136,159,360,211,496
352800,202302,1689,4622,1191,3563,225,716,228,471,453,1187
352810,202302,1498,3383,1018,2545,184,459,526,1250,710,1709
352820,202302,560,1480,416,1236,89,272,97,249,186,521
352830,202302,689,1648,350,983,32,87,115,281,147,368
352840,202302,5028,13019,4105,11435,927,2822,1807,4735,2734,7557
352850,202302,17651,37580,13246,30984,2339,6255,7381,15370,9720,21625
352860,202302,1498,3803,1132,3158,207,616,417,1064,624,1680
352870,202302,1060,2544,742,1917,80,235,442,1059,522,1294
352880,202302,2151,4782,1537,3744,244,631,629,1329,873,1960
352885,202302,469,1138,364,957,46,142,229,558,275,700
352890,202302,889,1930,613,1411,59,141,398,816,457,957
352900,202302,25442,60602,17804,46490,2856,7852,7243,17315,10099,25167
352910,202302,456,1135,256,745,18,56,102,256,120,312
352920,202302,3614,8371,2797,7033,143,447,2047,4824,2190,5271
352930,202302,7610,18290,5982,15136,893,2664,3015,6551,3908,9215
352940,202302,36092,86876,29334,74004,4225,11849,17676,41258,21901,53107
352950,202302,670,1702,438,1282,85,278,130,313,215,591
352960,202302,931,2312,562,1561,67,201,183,389,250,590
352965,202302,278,737,194,577,41,118,57,158,98,276
352970,202302,5080,9487,4217,8256,111,290,3663,6805,3774,7095
352980,202302,1908,4285,1496,3715,353,929,810,1909,1163,2838
352990,202302,5812,13523,4457,11396,759,2124,2421,5856,3180,7980
353000,202302,561,1412,315,894,41,129,111,266,152,395
353010,202302,3409,7744,2425,6015,427,1177,1152,2545,1579,3722
353020,202302,4163,9992,2621,7039,389,1193,1023,2445,1412,3638
353030,202302,6140,14545,4333,11527,1009,2888,1272,3071,2281,5959
353040,202302,965,2027,723,1667,79,210,487,1021,566,1231
353050,202302,6852,17662,4991,14010,843,2624,2534,6566,3377,9190
353060,202302,67222,152150,56052,135314,3335,10175,42728,96906,46063,107081
353070,202302,14724,37251,11165,30116,1811,5451,5322,12669,7133,18120
353080,202302,6378,15421,4589,12116,927,2748,1916,4233,2843,6981
353090,202302,746,2024,602,1760,58,184,343,957,401,1141
353100,202302,373,907,166,484,30,97,49,108,79,205
353110,202302,10849,24880,8774,22072,1967,4957,4353,11318,6320,16275
353120,202302,620,1463,479,1234,60,205,253,547,313,752
353130,202302,3940,8581,2721,6510,607,1635,1243,2541,1850,4176
353140,202302,4032,8761,3086,7307,320,972,2007,4327,2327,5299
353150,202302,2184,5015,1620,4125,330,911,676,1578,1006,2489
353160,202302,800,1921,555,1501,71,220,249,568,320,788
353170,202302,837,1969,647,1698,77,230,354,870,431,1100
353180,202302,12390,28672,9831,24476,2298,6296,4375,9834,6673,16130
353190,202302,4533,10983,3558,9138,419,1226,2044,4734,2463,5960
353200,202302,2223,5558,1460,4121,197,650,571,1392,768,2042
353205,202302,601,1561,505,1361,41,133,291,679,332,812
353210,202302,1215,2384,798,1730,27,75,611,1220,638,1295
353215,202302,502,1235,398,1059,51,157,178,411,229,568
353220,202302,957,2472,675,1923,112,309,208,517,320,826
353230,202302,1080,2759,842,2381,205,664,206,520,411,1184
353240,202302,3273,7760,2747,6979,377,1094,1641,3874,2018,4968
353250,202302,1765,3601,1247,2816,161,400,754,1612,915,2012
353260,202302,1382,2992,786,2046,167,486,315,715,482,1201
353270,202302,1068,2442,870,2108,97,287,543,1166,640,1453
353280,202302,925,2271,684,1898,140,405,242,641,382,1046
353282,202302,2154,5521,1779,4854,151,481,1087,2734,1238,3215
353284,202302,454,1035,259,681,19,57,107,227,126,284
353286,202302,204,494,121,352,21,61,32,64,53,125
353290,202302,1562,3863,936,2622,173,454,257,660,430,1114
353300,202302,2830,6878,2097,5547,332,1001,970,2147,1302,3148
353310,202302,515,1149,390,954,29,94,256,553,285,647
353320,202302,838,2042,688,1812,43,150,434,1035,477,1185
353325,202302,1011,2602,738,2068,120,349,339,862,459,1211
353330,202302,822,1869,535,1375,76,210,262,579,338,789
353340,202302,4456,11130,3540,9451,554,1737,1923,4570,2477,6307
353350,202302,5716,12838,4258,10348,1016,2656,1333,2785,2349,5441
353360,202302,889,2262,737,1996,73,257,465,1153,538,1410
353370,202302,749,1962,621,1762,50,160,393,1073,443,1233
353380,202302,380,965,303,833,39,131,166,400,205,531
353390,202302,8429,19377,6358,16085,542,1605,3884,9014,4426,10619
353400,202302,718,1748,556,1474,96,302,240,475,336,777
353410,202302,678,1623,505,1309,132,374,229,510,361,884
353420,202302,603,1442,423,1111,63,170,105,227,168,397
353430,202302,3010,7580,2425,6566,470,1351,1113,2790,1583,4141
353440,202302,102571,245085,78939,200564,10012,29129,48361,111217,58373,140346
353450,202302,491,1125,351,906,49,153,172,390,221,543
353460,202302,4234,10571,3052,8365,615,1936,723,1585,1338,3521
353470,202302,12104,28812,9047,23420,1470,4311,4218,9557,5688,13868
353475,202302,2051,4719,1411,3589,150,437,734,1622,884,2059
353480,202302,2078,4783,1734,4290,109,341,1235,2844,1344,3185
353490,202302,1362,3272,1026,2703,127,352,515,1228,642,1580
353500,202302,1577,3525,1160,2868,243,657,589,1324,832,1981
353510,202302,1285,3351,963,2665,171,494,366,839,537,1333
353520,202302,1377,3318,904,2500,131,404,383,888,514,1292
353530,202302,3335,7685,2716,6664,310,893,1676,3699,1986,4592
353540,202302,2786,6728,2292,6007,393,1111,1292,3188,1685,4299
353550,202302,8185,18329,6598,15831,984,2540,3991,8837,4975,11377
353560,202302,2996,7307,2380,6427,663,1935,845,1973,1508,3908
353570,202302,812,2037,534,1516,89,281,203,490,292,771
353580,202302,3180,7568,2541,6450,452,1133,1394,3379,1846,4512
353590,202302,950,2221,709,1841,96,251,394,964,490,1215
353600,202302,1975,4686,1451,3799,188,536,710,1755,898,2291
353610,202302,1033,2722,799,2269,113,351,367,934,480,1285
353620,202302,3830,9052,2795,7416,605,1725,894,2016,1499,3741
353625,202302,785,1808,461,1236,52,173,249,604,301,777
353630,202302,2032,5393,1748,4864,248,759,975,2447,1223,3206
353640,202302,1812,4264,1399,3565,179,464,891,2138,1070,2602
353650,202302,9353,23406,7393,20051,986,2954,4089,10163,5075,13117
353657,202302,460,1149,354,985,33,109,155,394,188,503
353660,202302,1747,3322,1251,2687,170,413,852,1718,1022,2131
353670,202302,5738,14284,4508,12033,824,2553,2136,4977,2960,7530
353680,202302,942,2202,704,1871,103,299,404,990,507,1289
353690,202302,568,1453,274,809,28,78,71,176,99,254
353700,202302,2855,6576,2348,5809,220,588,1573,3701,1793,4289
353710,202302,5381,11648,4045,9463,654,1534,2210,4503,2864,6037
353715,202302,523,1318,311,890,26,86,131,325,157,411
353720,202302,2544,6060,1971,5196,377,1107,901,2238,1278,3345
353730,202302,6641,15600,5266,13298,684,2053,3170,7272,3854,9325
353740,202302,2806,6682,2080,5446,376,1084,939,2185,1315,3269
353750,202302,1167,3231,878,2706,209,653,214,618,423,1271
353760,202302,19778,39251,15536,33899,2756,6624,8936,18584,11692,25208
353770,202302,795,2131,457,1429,60,225,61,149,121,374
353780,202302,9117,21326,7557,18668,1228,3410,4363,9959,5591,13369
353790,202302,3726,10152,2839,8431,636,2092,629,1503,1265,3595
353800,202302,24499,57961,20088,51333,2868,7723,11890,28829,14758,36552
353810,202302,1551,3744,1108,2886,185,510,457,1098,642,1608
353820,202302,2337,5720,1662,4490,434,1191,455,1054,889,2245
353830,202302,779,1804,590,1523,83,247,313,729,396,976
353850,202302,2065,5074,1608,4284,285,787,713,1727,998,2514
353860,202302,3609,8726,2786,7391,630,1973,1328,2969,1958,4942
353870,202302,39241,94057,29070,75604,4017,11502,14477,33425,18494,44927
353880,202302,3917,9657,3191,8358,226,740,2087,4975,2313,5715
353890,202302,4191,8006,2968,6232,192,509,2099,3916,2291,4425
353900,202302,948,2430,709,1984,86,278,295,730,381,1008
353910,202302,4153,9662,3573,8817,250,726,2640,6277,2890,7003
353920,202302,2544,6343,1877,5168,540,1648,444,914,984,2562
353930,202302,7162,16979,5229,13420,935,2699,2327,5182,3262,7881
353940,202302,1691,4466,1229,3582,194,624,474,1200,668,1824
353950,202302,4558,11003,3545,9257,907,2610,1160,2626,2067,5236
353960,202302,966,2366,679,1864,168,439,153,398,321,837
353970,202302,868,1809,681,1546,62,173,503,1071,565,1244
353980,202302,22870,50715,18009,43006,772,2401,13851,30835,14623,33236
353990,202302,1269,2770,905,2190,171,446,506,1110,677,1556
354000,202302,3304,7502,1988,5116,329,893,730,1638,1059,2531
354010,202302,422,1019,320,860,52,171,183,455,235,626
354020,202302,5302,12499,4269,10638,808,2227,2033,4415,2841,6642
354025,202302,932,2375,625,1796,96,313,179,433,275,746
354030,202302,669,1408,368,913,58,150,173,387,231,537
354040,202302,1011,2118,695,1660,41,125,489,1065,530,1190
354050,202302,1352,3510,962,2857,183,636,373,1004,556,1640
354060,202302,5442,13563,4087,10810,630,1899,2103,4804,2733,6703
354070,202302,5347,12420,3790,9533,594,1670,1779,3856,2373,5526
354075,202302,3757,9351,3072,8232,484,1449,1814,4429,2298,5878
354080,202302,1895,4864,1337,3826,193,588,598,1511,791,2099
354085,202302,526,979,409,836,1,4,304,566,305,570
354090,202302,2244,5562,1932,4948,107,309,1488,3614,1595,3923
354100,202302,32044,78613,23755,65157,4482,13512,11415,28975,15897,42487
354105,202302,1608,3742,1185,3045,165,512,585,1308,750,1820
354110,202302,599,1543,471,1322,84,267,200,517,284,784
354120,202302,1864,4649,1268,3424,236,689,452,1011,688,1700
354130,202302,7760,18510,5420,14182,1492,4054,1186,2526,2678,6580
354140,202302,24481,56967,18418,46100,2533,7173,9791,21622,12324,28795
354150,202302,3694,8187,2941,7068,738,1831,936,2178,1674,4009
354160,202302,3679,9514,3009,8346,703,2109,1276,3239,1979,5348
354165,202302,934,2460,746,2108,85,324,449,1111,534,1435
354170,202302,2564,6395,2095,5575,271,843,1084,2497,1355,3340
354180,202302,576,1473,455,1240,40,124,261,642,301,766
354190,202302,1972,5066,1427,4003,101,341,781,2001,882,2342
354200,202302,1175,2636,891,2193,90,262,563,1251,653,1513
354210,202302,1364,3237,1087,2789,94,290,695,1605,789,1895
354220,202302,4036,9709,3060,7957,551,1553,1413,3364,1964,4917
354230,202302,1034,2318,841,2082,41,126,629,1497,670,1623
354240,202302,2397,6118,1679,4679,296,859,629,1490,925,2349
354250,202302,811,1887,561,1486,129,341,201,483,330,824
354260,202302,11779,26834,9269,22831,1350,3638,4737,10868,6087,14506
354270,202302,1290,3421,1065,3021,162,494,514,1291,676,1785
354280,202302,1043,2290,863,2021,41,126,644,1354,685,1480
354290,202302,1224,3463,1016,3052,149,482,555,1591,704,2073
354300,202302,4333,11460,3645,10255,922,2607,1673,4520,2595,7127
354310,202302,1032,2624,885,2386,140,422,524,1302,664,1724
354320,202302,1224,2730,815,2090,126,340,386,827,512,1167
354323,202302,595,1320,384,959,44,118,190,417,234,535
354325,202302,1684,4753,1064,3315,187,587,165,448,352,1035
354330,202302,13076,29822,9568,23319,1075,3009,5886,12976,6961,15985
354340,202302,54081,123865,40640,101884,5607,15638,23385,54807,28992,70445
354350,202302,1513,3419,1218,2959,139,448,804,1719,943,2167
354360,202302,806,1786,511,1341,112,305,177,408,289,713
354370,202302,1277,3257,1057,2926,158,473,623,1617,781,2090
354380,202302,674,1653,502,1387,67,237,198,458,265,695
354390,202302,20243,44660,14393,34977,2041,5504,7850,17210,9891,22714
354400,202302,2107,6132,1648,5150,282,949,543,1572,825,2521
354410,202302,9326,21235,7379,17927,1066,2976,4309,9462,5375,12438
354420,202302,1842,4431,1327,3486,174,506,690,1602,864,2108
354425,202302,3731,8218,2753,6624,491,1232,1458,3319,1949,4551
354430,202302,2240,5192,1751,4451,142,426,1138,2662,1280,3088
354440,202302,757,1796,508,1325,57,165,263,598,320,763
354450,202302,606,1521,335,1006,51,164,101,237,152,401
354460,202302,1026,2470,690,1901,163,498,211,501,374,999
354470,202302,515,1269,347,949,30,106,126,262,156,368
354480,202302,1732,3644,1189,2782,91,257,769,1642,860,1899
354490,202302,1038,2790,791,2281,158,456,354,931,512,1387
354500,202302,2978,7421,2386,6476,626,1838,821,2008,1447,3846
354510,202302,969,2459,770,2115,81,253,423,1025,504,1278
354515,202302,566,1487,388,1127,65,198,134,347,199,545
354520,202302,10818,26548,8100,21216,1005,3047,4642,10868,5647,13915
354530,202302,6781,16669,5467,14337,1379,3614,2099,5168,3478,8782
354540,202302,1641,3949,1204,3211,206,603,536,1314,742,1917
354550,202302,728,1852,583,1596,80,242,301,741,381,983
354560,202302,2714,6073,1522,3941,161,438,884,2056,1045,2494
354570,202302,1167,2791,543,1538,100,281,85,227,185,508
354580,202302,10757,26927,7665,21161,1094,3401,4139,10471,5233,13872
354600,202302,2659,6487,2083,5447,321,845,1167,2893,1488,3738
354610,202302,567,1420,313,904,31,94,148,395,179,489
354620,202302,621,1629,392,1191,35,125,179,496,214,621
354625,202302,377,1001,224,708,28,98,67,186,95,284
354630,202302,3162,8125,2688,7303,784,2187,772,1892,1556,4079
354640,202302,5115,12767,4047,10779,477,1531,2208,5210,2685,6741
354650,202302,1110,2646,902,2318,196,469,443,1094,639,1563
354660,202302,4555,9982,2710,7105,342,1060,1185,2757,1527,3817
354670,202302,1497,3785,1078,2970,221,677,356,804,577,1481
354680,202302,8389,18914,6739,16386,1045,2797,4020,9238,5065,12035
354690,202302,679,1912,493,1521,77,245,194,539,271,784
354700,202302,1154,2789,841,2208,106,316,462,1091,568,1407
354710,202302,607,1480,405,1098,41,118,191,444,232,562
354720,202302,392,873,196,515,61,151,58,142,119,293
354730,202302,14880,38670,11875,33240,1648,5074,6961,18240,8609,23314
354740,202302,403,1040,184,550,34,106,28,63,62,169
354750,202302,3054,7370,2137,5648,330,982,921,2068,1251,3050
354760,202302,2885,6970,2144,5704,432,1259,789,1805,1221,3064
354765,202302,438,1103,204,604,18,68,70,164,88,232
354770,202302,3228,7344,2405,5902,463,1236,1094,2400,1557,3636
354780,202302,85335,188451,67459,156010,4470,12725,48538,102209,53008,114934
354790,202302,1168,2958,917,2568,78,241,569,1513,647,1754
354800,202302,3575,8439,2655,6919,572,1624,1042,2369,1614,3993
354805,202302,1827,3906,1367,3264,104,279,932,1993,1036,2272
354810,202302,708,1964,438,1411,78,297,127,342,205,639
354820,202302,1223,3247,883,2629,170,548,269,649,439,1197
354830,202302,691,1556,396,1030,78,221,146,308,224,529
354840,202302,1083,2633,656,1738,54,167,362,845,416,1012
354850,202302,30216,68323,22508,55707,1948,5899,15242,34474,17190,40373
354860,202302,1898,4762,1321,3676,185,562,543,1333,728,1895
354870,202302,91305,205339,72613,173117,5548,15680,50061,109290,55609,124970
354880,202302,8181,19004,4731,12041,568,1661,2207,4435,2775,6096
354890,202302,24500,55022,19793,47204,2442,6818,11681,25806,14123,32624
354900,202302,467,1110,316,860,75,222,111,250,186,472
354910,202302,7928,19296,5078,14343,1082,3263,1453,3528,2535,6791
354920,202302,612,1543,327,976,40,127,86,199,126,326
354925,202302,354,957,205,646,24,77,40,108,64,185
354930,202302,451,1049,312,805,36,97,162,368,198,465
354940,202302,3407,9105,2650,7551,741,2278,984,2373,1725,4651
354950,202302,2047,4569,1692,4120,101,333,1236,2789,1337,3122
354960,202302,1057,2580,755,2100,88,308,346,834,434,1142
354970,202302,5722,14162,4600,12380,364,1247,3192,8041,3556,9288
354980,202302,47353,103817,34077,81957,3562,10367,22181,48255,25743,58622
354990,202302,105317,234941,78247,188650,5076,15249,54252,119064,59328,134313
354995,202302,4469,8371,3530,7199,154,385,2879,5606,3033,5991
355000,202302,1978,4485,1513,3820,236,714,776,1724,1012,2438
355010,202302,5285,13120,3623,9763,1159,3037,807,2070,1966,5107
355020,202302,4140,10986,3296,9589,754,2440,1327,3457,2081,5897
355030,202302,1818752,4111123,1388357,3340189,184771,496091,779721,1696448,964492,2192539
355040,202302,4710,10129,3739,8865,370,964,2771,6329,3141,7293
355050,202302,1424,3004,1056,2512,260,638,408,901,668,1539
355060,202302,9003,21967,6897,18303,1063,3217,3780,9075,4843,12292
355070,202302,14278,32319,11961,28818,1322,3743,7930,17602,9252,21345
355080,202302,1263,3321,827,2554,187,620,138,354,325,974
355090,202302,1789,4411,1451,3863,254,741,761,1823,1015,2564
355100,202302,40751,92143,34248,82784,3523,9763,24536,56033,28059,65796
355110,202302,1269,3200,916,2694,172,538,69,150,241,688
355120,202302,938,2265,664,1868,81,265,329,847,410,1112
355130,202302,1082,2185,643,1425,27,73,464,920,491,993
355140,202302,3003,5492,2598,4971,72,181,2296,4237,2368,4418
355150,202302,6511,15055,5359,13194,590,1609,3489,8096,4079,9705
355160,202302,3096,7676,2248,6276,507,1534,647,1574,1154,3108
355170,202302,16138,36686,12898,31509,2046,5627,7379,16750,9425,22377
355180,202302,3708,8519,2796,7177,524,1565,1428,3284,1952,4849
355190,202302,2409,5873,1912,5104,734,2025,536,1520,1270,3545
355200,202302,1132,3129,963,2871,275,941,324,879,599,1820
355210,202302,4239,10428,3278,8538,800,2123,1316,3181,2116,5304
355220,202302,71724,168153,59165,145771,7678,21765,34947,77409,42625,99174
355230,202302,1548,3685,866,2356,152,444,326,728,478,1172
355240,202302,32690,79580,24177,63911,2520,7502,14707,35883,17227,43385
355250,202302,54618,130255,42746,108774,8710,24014,21313,49347,30023,73361
355255,202302,810,1906,436,1235,48,128,147,380,195,508
355260,202302,2059,4343,1536,3572,116,342,1082,2301,1198,2643
355270,202302,1608,4264,1296,3684,310,882,522,1372,832,2254
355280,202302,43901,100226,33103,81700,3892,10629,19273,43697,23165,54326
355290,202302,1215,2942,961,2550,186,488,477,1169,663,1657
355300,202302,1833,4806,1516,4240,250,756,701,1731,951,2487
355310,202302,1182,2930,888,2432,121,358,483,1251,604,1609
355320,202302,725,1786,543,1452,116,360,208,448,324,808
355330,202302,3959,9103,3142,7741,141,447,2385,5481,2526,5928
355340,202302,5323,11020,4096,9457,776,1838,1935,4580,2711,6418
355350,202302,1828,4620,1414,3879,253,804,632,1523,885,2327
355360,202302,1668,3855,1301,3302,163,451,730,1660,893,2111
355365,202302,456,1064,252,725,41,120,80,198,121,318
355370,202302,7417,17102,5874,14768,1265,2877,2782,7201,4047,10078
355380,202302,3868,9373,2968,7799,574,1654,1138,2541,1712,4195
355385,202302,1795,4212,1465,3734,112,350,952,2192,1064,2542
355390,202302,1026,2609,766,2106,108,334,363,856,471,1190
355395,202302,2274,6058,1659,4855,266,881,669,1680,935,2561
355400,202302,12575,32655,10322,28519,2187,6882,4380,10584,6567,17466
355410,202302,32538,81715,22529,62178,4229,12921,8749,21835,12978,34756
355420,202302,771,2255,639,2017,131,467,206,597,337,1064
355430,202302,4816,11124,3794,9393,611,1667,2076,4824,2687,6491
355440,202302,927,2308,595,1670,97,280,137,318,234,598
355450,202302,4741,11208,3361,8685,448,1302,1662,3711,2110,5013
355460,202302,618,1445,425,1129,42,126,190,463,232,589
355465,202302,547,1295,442,1135,62,157,276,691,338,848
355470,202302,1506,3532,896,2383,234,687,313,731,547,1418
355475,202302,431,932,351,827,17,45,260,576,277,621
355480,202302,5534,13963,4410,12255,624,1989,2729,7215,3353,9204
355490,202302,1129,2847,653,1914,74,229,290,761,364,990
355495,202302,1212,2955,899,2453,121,407,415,962,536,1369
355500,202302,9273,21630,6330,16307,819,2443,2972,6615,3791,9058
355510,202302,1745,4053,1194,3122,200,543,519,1206,719,1749
355520,202302,380,860,190,532,37,112,41,104,78,216
355530,202302,379,818,170,433,9,28,94,211,103,239
355535,202302,671,1694,539,1484,111,362,261,607,372,969
355540,202302,17652,38266,14977,34703,1523,3928,10843,24014,12366,27942
355550,202302,844,2268,726,2070,84,277,419,1069,503,1346
355560,202302,1401,3437,807,2313,160,500,36,113,196,613
355570,202302,362,884,207,571,45,132,67,161,112,293
355580,202302,1526,3481,904,2374,164,466,209,484,373,950
355590,202302,212,516,157,427,16,45,85,220,101,265
355600,202302,1682,3968,1109,2943,172,507,302,690,474,1197
355610,202302,2589,5892,1787,4535,282,778,966,2195,1248,2973
355620,202302,6666,16201,5210,13567,546,1731,3081,7142,3627,8873
355630,202302,3387,8208,2460,6529,274,797,1487,3579,1761,4376
355635,202302,1260,3338,919,2681,136,416,330,861,466,1277
355640,202302,4496,11460,3039,8759,741,2131,510,1461,1251,3592
355645,202302,4852,12486,3577,10272,516,1628,1903,5110,2419,6738
355650,202302,10385,25042,8509,21892,1637,4463,4330,10177,5967,14640
355660,202302,1716,4196,1138,3195,193,493,204,497,397,990
355670,202302,5774,14016,4252,10949,527,1659,2196,4768,2723,6427
355680,202302,3448,8942,1804,5365,468,1508,136,356,604,1864
355690,202302,903,2471,628,1965,191,618,12,21,203,639
355695,202302,335,860,212,610,17,55,46,87,63,142
355700,202302,11294,28326,9624,25076,1146,3411,5934,14217,7080,17628
355710,202302,13392,29372,9466,22430,1263,3562,5063,10156,6326,13718
355715,202302,580,1497,335,960,90,259,64,165,154,424
355720,202302,1898,4706,1508,4068,247,739,812,1985,1059,2724
355730,202302,1378,3365,1110,2932,100,319,656,1580,756,1899
410010,202302,1525,3972,1152,3216,245,720,273,674,518,1394
410020,202302,1393,3652,1031,2924,302,838,250,643,552,1481
410030,202302,2156,5193,1804,4677,260,704,933,2370,1193,3074
410040,202302,18969,47504,14229,39110,2945,8661,4607,11358,7552,20019
410045,202302,894,2284,668,1833,134,393,185,433,319,826
410050,202302,2727,6609,1963,5361,319,988,676,1643,995,2631
410060,202302,2575,6711,2079,5855,525,1627,586,1463,1111,3090
410070,202302,2450,5748,1794,4614,329,943,700,1563,1029,2506
410080,202302,1681,4197,1227,3447,271,772,268,679,539,1451
410090,202302,1422,3130,1149,2753,151,325,532,1392,683,1717
410100,202302,2626,6924,1828,5233,311,975,152,388,463,1363
410105,202302,695,1571,465,1164,26,82,264,566,290,648
410110,202302,3845,8781,2866,7157,359,1032,1552,3474,1911,4506
410115,202302,676,1654,489,1334,61,188,184,429,245,617
410120,202302,4131,9636,3612,8870,594,1412,2327,5612,2921,7024
410130,202302,1650,3938,1453,3614,197,522,877,2096,1074,2618
410140,202302,22070,50217,15028,38267,2717,7605,4945,11138,7662,18743
410150,202302,20583,46229,11665,29816,1859,5249,3885,8270,5744,13519
410160,202302,3688,9680,3014,8549,653,2122,1087,2794,1740,4916
410165,202302,759,1926,594,1594,79,242,299,735,378,977
410170,202302,3649,8810,2245,5957,395,1131,390,839,785,1970
410180,202302,22279,56620,17551,47629,2861,8611,8547,20485,11408,29096
410185,202302,564,1518,427,1202,79,237,154,367,233,604
410190,202302,2768,6491,1986,5166,398,1071,505,1099,903,2170
410200,202302,7209,15398,4109,10372,813,2197,811,1752,1624,3949
410210,202302,3866,9204,2431,6726,368,1143,809,1863,1177,3006
410220,202302,660,1608,458,1251,94,268,154,372,248,640
410230,202302,2488,6173,1889,5031,289,867,790,1761,1079,2628
410240,202302,6270,15591,4411,12230,867,2791,717,1652,1584,4443
410250,202302,2811,6390,2069,5238,278,698,912,2201,1190,2899
410260,202302,2504,5662,1612,4088,312,830,801,1802,1113,2632
410270,202302,610,1509,441,1213,56,184,183,423,239,607
410275,202302,730,1888,508,1434,78,257,206,504,284,761
410280,202302,2900,7106,1996,5445,260,806,885,2103,1145,2909
410290,202302,3980,10261,2801,7964,928,2594,673,1852,1601,4446
410300,202302,853,1953,679,1697,65,197,362,778,427,975
410302,202302,418,999,260,725,30,98,113,287,143,385
410304,202302,1840,3988,1562,3564,167,408,941,2121,1108,2529
410305,202302,2131,4706,1520,3845,176,491,961,2274,1137,2765
410310,202302,3959,9138,3276,8023,255,809,2220,5001,2475,5810
410315,202302,919,1933,593,1445,164,410,184,422,348,832
410320,202302,1164,3099,783,2372,95,312,124,319,219,631
410322,202302,781,2007,395,1141,54,164,125,294,179,458
410330,202302,1834,4194,1291,3250,216,549,431,965,647,1514
410335,202302,1029,2558,776,2117,138,392,268,655,406,1047
410337,202302,965,2289,674,1748,90,252,238,525,328,777
410340,202302,559,1484,382,1075,27,92,161,354,188,446
410345,202302,3388,8281,2154,5827,484,1323,785,1876,1269,3199
410347,202302,933,2257,694,1862,95,255,187,474,282,729
410350,202302,2056,4688,1480,3801,141,429,836,1874,977,2303
410360,202302,4898,11675,3629,9517,647,1773,1116,2715,1763,4488
410370,202302,18050,45190,12090,31976,1381,4194,5201,11236,6582,15430
410380,202302,2181,4941,1515,3841,211,590,525,1167,736,1757
410390,202302,3619,8006,2463,6185,497,1516,1002,2076,1499,3592
410395,202302,1109,2939,872,2489,183,518,313,908,496,1426
410400,202302,10090,22970,7796,19057,849,2405,4896,10748,5745,13153
410405,202302,1117,2428,779,1952,111,318,386,874,497,1192
410410,202302,1968,4641,1722,4253,125,363,1146,2769,1271,3132
410420,202302,15684,38427,12017,31709,1937,5619,5463,12645,7400,18264
410425,202302,4705,11873,3310,9181,583,1732,1190,2893,1773,4625
410430,202302,16881,39065,12147,31036,1816,5159,4880,11001,6696,16160
410440,202302,3007,7748,2606,7047,399,1221,1451,3662,1850,4883
410442,202302,3096,8366,2481,7160,698,2091,593,1593,1291,3684
410445,202302,2783,7332,1911,5694,403,1305,253,786,656,2091
410450,202302,1912,4439,1430,3737,241,650,480,1149,721,1799
410460,202302,3118,7108,2253,5677,328,920,1108,2436,1436,3356
410465,202302,3709,9814,2844,8278,575,1699,877,2189,1452,3888
410470,202302,2989,7599,2146,6204,657,2139,183,509,840,2648
410480,202302,51068,115528,30367,81128,4301,12986,9240,20405,13541,33391
410490,202302,14875,37462,11002,29959,1772,5262,5000,12018,6772,17280
410500,202302,2268,5443,1494,4038,274,758,321,662,595,1420
410510,202302,2286,5291,1615,4173,350,877,494,1233,844,2110
410520,202302,3784,10637,3363,9902,1060,3343,1258,3559,2318,6902
410530,202302,1901,4450,942,2550,122,373,255,531,377,904
410540,202302,3509,8742,2486,6822,414,1305,1065,2580,1479,3885
410550,202302,9697,24210,6803,18419,1109,3363,2072,4565,3181,7928
410560,202302,1899,4589,1402,3653,299,875,387,799,686,1674
410570,202302,3355,8221,2380,6587,814,2627,231,558,1045,3185
410580,202302,37164,87298,28432,72361,4199,12093,14798,33980,18997,46073
410590,202302,2093,5398,1445,3972,195,567,427,922,622,1489
410600,202302,2269,5434,1785,4562,366,942,684,1653,1050,2595
410610,202302,856,2028,639,1653,62,181,322,731,384,912
410620,202302,3573,8866,2582,6864,633,1821,714,1612,1347,3433
410630,202302,3152,7585,2128,5696,411,1303,481,949,892,2252
410640,202302,6411,14014,4461,10782,953,2530,732,1719,1685,4249
410645,202302,1742,3969,1469,3644,128,353,1165,2839,1293,3192
410650,202302,3167,7951,2211,6085,437,1320,891,2122,1328,3442
410655,202302,1049,2399,729,1869,93,288,293,618,386,906
410657,202302,731,1850,475,1334,62,190,198,447,260,637
410660,202302,4674,10839,2902,7348,440,1212,1056,2274,1496,3486
410670,202302,1214,2869,750,2000,109,294,281,635,390,929
410680,202302,2925,8151,1997,5964,486,1471,405,1167,891,2638
410685,202302,647,1557,465,1243,102,308,198,468,300,776
410690,202302,180174,407982,127617,316105,19326,54676,56346,119936,75672,174612
410700,202302,3020,7211,2473,6404,576,1554,901,2126,1477,3680
410710,202302,1108,2636,716,1925,182,530,268,605,450,1135
410712,202302,826,2108,691,1870,99,285,375,970,474,1255
410715,202302,1069,2842,680,2038,69,230,285,765,354,995
410720,202302,4830,11077,3988,9744,537,1623,1516,3374,2053,4997
410725,202302,1465,3346,908,2399,197,568,197,399,394,967
410730,202302,1038,2485,714,1898,97,308,164,413,261,721
410740,202302,1027,2706,785,2269,58,199,412,1154,470,1353
410750,202302,2464,5536,1933,4653,312,789,895,1967,1207,2756
410752,202302,489,1126,263,709,99,252,54,128,153,380
410753,202302,418,1122,299,886,35,116,91,224,126,340
410754,202302,1407,3255,1154,2890,82,211,829,2096,911,2307
410755,202302,684,1634,501,1328,59,173,236,537,295,710
410760,202302,4472,10953,3142,8627,834,2729,787,1917,1621,4646
410765,202302,23267,57839,18619,49648,3694,10981,6239,13945,9933,24926
410770,202302,1243,2797,859,2184,82,184,424,1049,506,1233
410773,202302,1647,3894,1402,3503,210,587,846,1950,1056,2537
410775,202302,2082,4274,1829,3945,44,115,1432,2902,1476,3017
410780,202302,767,1792,527,1372,93,260,156,362,249,622
410785,202302,985,2228,711,1809,103,308,312,743,415,1051
410790,202302,1337,3602,1092,3168,221,709,164,370,385,1079
410800,202302,4281,8472,3429,7310,64,182,2372,4742,2436,4924
410810,202302,555,1373,413,1116,44,161,216,493,260,654
410820,202302,1262,3304,728,2018,152,441,149,312,301,753
410830,202302,57789,125574,42178,100696,6389,17772,21136,44814,27525,62586
410832,202302,1382,3378,1133,2968,97,315,706,1654,803,1969
410840,202302,11407,26803,6795,18282,1317,4026,1883,3811,3200,7837
410845,202302,1506,3202,1193,2777,129,350,753,1602,882,1952
410850,202302,2658,6800,2285,6180,441,1352,1069,2631,1510,3983
410855,202302,860,2033,552,1453,63,193,266,583,329,776
410860,202302,6117,13195,4869,11235,214,677,3461,7262,3675,7939
410865,202302,1781,4633,1510,4170,211,635,816,2301,1027,2936
410870,202302,1452,3595,1154,3097,151,454,633,1600,784,2054
410880,202302,5936,14669,4079,11442,716,1976,690,1976,1406,3952
410890,202302,1443,3600,1154,3085,218,581,528,1315,746,1896
410895,202302,1224,3558,1010,3110,333,1146,243,631,576,1777
410900,202302,1039,2599,690,1984,106,320,141,290,247,610
410910,202302,530,1145,339,812,17,45,192,397,209,442
410920,202302,1157,2531,869,2101,99,273,488,1089,587,1362
410930,202302,2156,5129,1493,4063,373,1137,247,555,620,1692
410940,202302,31702,78417,23507,64445,4528,13977,9429,23225,13957,37202
410950,202302,2469,6232,2197,5818,200,493,1640,4278,1840,4771
410960,202302,10948,24235,7757,19308,2076,6031,2990,6550,5066,12581
410965,202302,1379,3319,869,2379,110,338,384,940,494,1278
410970,202302,5389,13524,3821,10551,926,3037,691,1421,1617,4458
410975,202302,1829,4031,1330,3249,199,535,575,1295,774,1830
410980,202302,9556,21971,6347,16488,663,1978,3146,7156,3809,9134
410990,202302,1878,4081,1302,3244,227,645,614,1429,841,2074
411000,202302,826,2119,581,1684,106,340,167,405,273,745
411005,202302,570,1342,359,940,44,122,137,297,181,419
411007,202302,3157,7740,2338,6362,463,1392,824,2000,1287,3392
411010,202302,5806,15377,4397,12679,1207,3602,795,1935,2002,5537
411020,202302,2923,7504,2396,6664,621,1852,743,1929,1364,3781
411030,202302,862,2036,613,1564,77,210,260,572,337,782
411040,202302,1264,3014,669,1810,124,342,181,411,305,753
411050,202302,2444,7101,1947,6139,407,1426,330,829,737,2255
411060,202302,2816,6922,1840,5015,322,929,584,1285,906,2214
411065,202302,470,1135,285,771,30,92,113,277,143,369
411070,202302,9876,22459,7828,19260,1087,3144,4256,9474,5343,12618
411080,202302,2482,6028,1986,5196,468,1411,607,1395,1075,2806
411090,202302,952,2445,587,1731,82,276,137,323,219,599
411095,202302,2960,6656,1730,4583,243,637,271,588,514,1225
411100,202302,1511,3633,1009,2734,131,431,364,900,495,1331
411110,202302,796,2003,377,1128,38,107,29,44,67,151
411120,202302,2055,4937,1662,4316,276,874,812,1856,1088,2730
411125,202302,6739,17816,5919,16441,1612,4681,2199,6032,3811,10713
411130,202302,907,2226,628,1703,177,468,171,464,348,932
411140,202302,2665,7589,2180,6609,522,1653,600,1822,1122,3475
411150,202302,5015,11842,3340,8647,685,1903,323,636,1008,2539
411155,202302,1348,3059,926,2334,116,352,478,981,594,1333
411160,202302,472,1007,310,761,36,96,89,216,125,312
411170,202302,985,2604,733,2101,146,470,309,819,455,1289
411180,202302,6740,15818,5520,13742,753,2154,3091,6868,3844,9022
411190,202302,2690,6422,2055,5349,269,790,943,2117,1212,2907
411200,202302,6378,15660,4878,13085,941,2978,1680,3627,2621,6605
411210,202302,4474,9419,3191,7345,388,1058,1490,3036,1878,4094
411220,202302,1219,2845,847,2206,160,440,301,691,461,1131
411230,202302,1033,2566,766,2073,164,473,237,573,401,1046
411240,202302,1934,4283,1372,3401,243,654,503,1123,746,1777
411250,202302,2839,6895,2041,5541,436,1320,567,1327,1003,2647
411260,202302,402,980,265,718,46,149,108,251,154,400
411270,202302,2474,6126,1834,4945,280,825,848,2002,1128,2827
411275,202302,2031,4135,1458,3276,142,410,915,1808,1057,2218
411280,202302,1871,4629,1370,3719,299,885,440,1008,739,1893
411290,202302,1045,2493,691,1831,76,250,357,852,433,1102
411295,202302,1574,3775,1167,3058,211,566,496,1173,707,1739
411300,202302,1230,2938,784,2126,86,252,286,598,372,850
411310,202302,1180,2419,927,2102,162,405,488,1002,650,1407
411320,202302,7358,16880,5607,13956,790,2243,2803,5950,3593,8193
411325,202302,1863,4671,1512,4054,276,761,792,2149,1068,2910
411330,202302,3995,9953,3001,8306,715,2199,861,2178,1576,4377
411340,202302,1006,2594,600,1746,86,268,182,442,268,710
411342,202302,1295,2966,703,1814,132,393,259,526,391,919
411345,202302,1521,3493,1107,2803,70,194,738,1782,808,1976
411350,202302,3703,9272,2461,6896,613,1860,350,803,963,2663
411360,202302,954,2104,687,1679,90,266,333,686,423,952
411370,202302,74023,170942,54832,139848,4289,13107,32141,73783,36430,86890
411373,202302,1774,4109,1395,3567,160,425,667,1706,827,2131
411375,202302,1355,3200,925,2420,110,307,353,806,463,1113
411380,202302,1425,3065,964,2239,38,108,640,1346,678,1454
411390,202302,1944,4808,1513,3948,235,708,639,1352,874,2060
411400,202302,2908,6533,2205,5351,238,664,1222,2674,1460,3338
411410,202302,3668,9596,2734,7683,630,1979,680,1616,1310,3595
411420,202302,5206,12067,2867,7887,390,1190,527,1006,917,2196
411430,202302,5079,12137,3864,10025,735,2127,1369,2985,2104,5112
411435,202302,542,1365,311,896,43,133,64,142,107,275
411440,202302,3300,8278,2509,6858,535,1560,712,1689,1247,3249
411450,202302,3246,7834,2467,6590,365,958,1343,3558,1708,4516
411460,202302,5650,13680,3674,10092,524,1676,936,2035,1460,3711
411470,202302,1108,2541,862,2143,95,305,484,1048,579,1353
411480,202302,6746,16379,4906,13135,949,2988,1518,3384,2467,6372
411490,202302,2102,4870,1615,4164,201,598,766,1760,967,2358
411500,202302,1698,4196,1204,3212,200,589,275,539,475,1128
411510,202302,2839,6388,2212,5418,348,1028,674,1565,1022,2593
411520,202302,45542,104818,27646,71056,3164,9687,12374,26979,15538,36666
411530,202302,1142,2723,641,1800,87,273,123,296,210,569
411535,202302,637,1764,427,1313,46,153,117,317,163,470
411540,202302,3299,7405,2310,5686,130,342,1420,3292,1550,3634
411545,202302,1091,2898,915,2588,74,232,585,1613,659,1845
411550,202302,859,1994,655,1635,92,250,237,501,329,751
411560,202302,2379,6225,1325,3983,191,589,103,214,294,803
411570,202302,9681,20847,6883,16765,1521,4042,2318,5085,3839,9127
411573,202302,971,2394,783,2082,121,384,426,1001,547,1385
411575,202302,2490,6125,1836,4943,325,934,597,1454,922,2388
411580,202302,5404,12403,3280,8928,439,1353,566,1129,1005,2482
411585,202302,733,2072,383,1222,61,194,50,138,111,332
411590,202302,576,1428,431,1157,43,140,232,544,275,684
411600,202302,426,989,279,759,44,115,113,268,157,383
411605,202302,1960,4191,1273,3161,157,452,605,1511,762,1963
411610,202302,3645,7386,2650,5748,62,200,2009,3949,2071,4149
411620,202302,3776,8813,3111,7828,569,1505,1480,3635,2049,5140
411630,202302,1057,2508,714,1929,104,354,295,659,399,1013
411640,202302,563,1402,375,1016,46,127,129,289,175,416
411650,202302,241,656,157,487,24,78,42,107,66,185
411660,202302,1053,2502,734,1915,106,298,276,608,382,906
411670,202302,1894,4163,1282,3129,125,331,731,1594,856,1925
411680,202302,1753,4354,1305,3518,252,759,459,1094,711,1853
411690,202302,4953,11625,3671,9488,772,2006,1147,2923,1919,4929
411695,202302,782,2164,539,1581,47,148,237,629,284,777
411700,202302,1987,4868,1362,3722,313,908,311,751,624,1659
411705,202302,3019,7527,2549,6781,401,1129,1584,4175,1985,5304
411710,202302,2633,6221,1839,4821,387,1072,550,1229,937,2301
411720,202302,1285,2977,901,2306,131,339,314,719,445,1058
411721,202302,1200,2829,874,2254,146,388,270,627,416,1015
411722,202302,1186,3123,713,2051,120,360,262,607,382,967
411725,202302,1569,4160,1020,3108,233,782,238,631,471,1413
411727,202302,1720,4486,1137,3309,218,651,139,270,357,921
411729,202302,705,1704,419,1168,64,209,106,215,170,424
411730,202302,6900,16573,5308,13647,1101,3209,2180,5146,3281,8355
411740,202302,599,1496,334,956,78,202,72,165,150,367
411745,202302,935,2529,667,1961,95,308,159,349,254,657
411750,202302,8093,19489,6048,15796,787,2260,3021,7302,3808,9562
411760,202302,9405,22329,7083,18744,2119,5903,1491,3919,3610,9822
411770,202302,3995,10710,3009,8682,644,1982,664,1661,1308,3643
411780,202302,3245,8318,2734,7479,716,2002,886,2486,1602,4488
411790,202302,3949,8811,2501,6358,320,980,1013,2103,1333,3083
411800,202302,1433,3850,1062,3013,193,609,262,579,455,1188
411810,202302,1907,4599,1401,3668,214,605,526,1182,740,1787
411820,202302,21442,50803,18170,45601,4105,10584,9492,22826,13597,33410
411830,202302,588,1437,426,1142,89,210,65,165,154,375
411840,202302,15800,38690,11252,29978,1668,4916,4265,9638,5933,14554
411845,202302,792,2088,504,1474,74,249,135,328,209,577
411850,202302,10186,23991,7162,18984,1903,5458,1379,2979,3282,8437
411860,202302,930,2424,694,1962,121,365,138,351,259,716
411870,202302,735,1973,543,1578,136,462,101,210,237,672
411880,202302,3016,6614,2173,5306,339,907,961,2097,1300,3004
411885,202302,1303,3238,933,2591,127,404,243,541,370,945
411890,202302,1853,4616,1348,3772,230,707,149,389,379,1096
411900,202302,1036,2625,648,1843,174,514,77,193,251,707
411910,202302,1358,3744,976,2979,187,660,309,819,496,1479
411915,202302,20845,47547,14674,36754,2152,6030,6379,13904,8531,19934
411920,202302,1460,3831,1199,3386,279,878,443,1101,722,1979
411925,202302,594,1438,392,1059,77,213,184,444,261,657
411930,202302,6340,17162,5393,15580,2639,7986,573,1797,3212,9783
411940,202302,4127,10935,3269,9278,750,2177,1164,2937,1914,5114
411950,202302,19585,47644,16526,42846,1885,5720,10455,25263,12340,30983
411960,202302,7448,18143,5891,15352,1085,3179,2337,5318,3422,8497
411965,202302,620,1586,448,1239,66,194,205,496,271,690
411970,202302,1436,2924,1109,2498,211,397,512,1335,723,1732
411980,202302,2104,4544,1552,3729,319,773,724,1612,1043,2385
411990,202302,50943,122855,34961,95409,6097,18407,14441,35670,20538,54077
411995,202302,6321,14076,4852,11897,1331,3683,1506,3349,2837,7032
412000,202302,2445,5078,1774,4001,40,117,1355,2809,1395,2926
412010,202302,741,2049,491,1517,58,205,119,268,177,473
412015,202302,636,1657,513,1432,86,251,257,702,343,953
412020,202302,579,1555,359,1109,55,196,107,292,162,488
412030,202302,784,2040,595,1703,79,247,278,711,357,958
412033,202302,1141,2798,805,2191,92,261,340,797,432,1058
412035,202302,849,2179,547,1641,100,309,239,676,339,985
412040,202302,875,2180,565,1585,84,254,152,330,236,584
412050,202302,1759,4153,1230,3254,305,916,237,576,542,1492
412060,202302,9116,23955,7400,20707,1941,6151,2024,5080,3965,11231
412065,202302,776,1940,555,1527,99,292,151,369,250,661
412070,202302,1635,3831,1262,3172,145,425,600,1249,745,1674
412080,202302,3369,8009,2518,6467,294,847,1317,2841,1611,3688
412085,202302,409,970,172,507,13,47,48,105,61,152
412090,202302,8122,18676,6023,15238,1300,3653,2580,6210,3880,9863
412100,202302,2307,5648,1701,4643,512,1532,392,1077,904,2609
412110,202302,1160,2866,716,1991,78,236,221,503,299,739
412120,202302,2892,7349,2252,6265,468,1474,680,1593,1148,3067
412125,202302,958,2501,582,1728,89,242,131,365,220,607
412130,202302,951,2252,632,1677,118,315,135,330,253,645
412135,202302,698,1770,348,1019,43,148,136,333,179,481
412140,202302,2490,5649,1782,4457,298,797,439,1058,737,1855
412150,202302,3459,8145,2880,7167,551,1541,1438,3128,1989,4669
412160,202302,1119,3340,586,1912,38,124,43,95,81,219
412170,202302,5774,14083,4826,12661,895,2565,2316,5411,3211,7976
412175,202302,1624,4303,1335,3796,318,936,442,1212,760,2148
412180,202302,2108,5412,1559,4448,216,711,605,1545,821,2256
412190,202302,3961,9340,2833,7386,344,1034,1192,2781,1536,3815
412200,202302,2391,6290,1586,4546,404,1271,318,779,722,2050
412210,202302,796,1800,498,1324,67,208,230,547,297,755
412215,202302,4130,10191,2964,7960,645,1830,1292,3409,1937,5239
412217,202302,1238,2850,1009,2468,16,55,771,1728,787,1783
412220,202302,7461,20086,5988,17411,1358,3975,1534,4277,2892,8252
412230,202302,3449,9192,2661,7772,387,1300,479,1156,866,2456
412240,202302,10070,24621,6750,18495,1194,3566,2121,4898,3315,8464
412250,202302,2384,5799,1736,4639,419,1207,342,728,761,1935
412260,202302,1678,4016,1275,3269,226,584,433,992,659,1576
412265,202302,1266,2976,1013,2596,126,364,631,1486,757,1850
412270,202302,1333,3445,904,2570,116,366,369,896,485,1262
412280,202302,512,1327,386,1104,79,222,86,211,165,433
412290,202302,1317,3056,973,2486,170,469,377,887,547,1356
412300,202302,2238,5302,1668,4388,291,826,540,1212,831,2038
412310,202302,793,2171,572,1729,97,356,157,387,254,743
412320,202302,894,2177,555,1516,51,183,185,468,236,651
412330,202302,1973,4812,1305,3633,255,770,334,848,589,1618
412340,202302,1482,3753,1048,2936,159,486,139,354,298,840
412350,202302,3922,9710,2588,7190,438,1343,713,1622,1151,2965
412360,202302,360,851,274,699,6,21,197,473,203,494
412370,202302,1410,3539,993,2780,196,571,233,600,429,1171
412380,202302,1838,4812,1330,3854,318,990,80,239,398,1229
412382,202302,615,1416,409,1092,43,152,210,450,253,602
412385,202302,2886,6904,2286,5844,634,1578,818,2139,1452,3717
412390,202302,3075,6959,2373,5840,439,1153,746,1708,1185,2861
412395,202302,936,2340,662,1787,88,240,327,813,415,1053
412400,202302,1155,2782,809,2153,141,410,256,571,397,981
412402,202302,2991,6874,2084,5444,452,1172,592,1504,1044,2676
412405,202302,3722,9393,2470,7166,671,1923,383,1024,1054,2947
412410,202302,8109,19659,5987,16351,1081,3412,1972,4834,3053,8246
412420,202302,634,1499,405,1061,44,127,158,367,202,494
412430,202302,652,1587,359,994,52,137,134,350,186,487
412440,202302,3700,8899,2611,7086,575,1587,775,1986,1350,3573
412450,202302,644,1765,423,1257,52,162,41,74,93,236
412460,202302,1443,3268,1112,2751,209,562,491,1136,700,1698
412470,202302,1952,5550,1624,4881,387,1317,453,1201,840,2518
412480,202302,1685,3856,1159,2890,195,531,467,984,662,1515
412490,202302,1634,3677,1244,3035,81,233,739,1611,820,1844
412500,202302,2539,5881,1879,4757,305,837,624,1363,929,2200
412510,202302,2391,6651,1712,5093,437,1408,287,640,724,2048
412520,202302,1728,4137,1079,2909,207,551,151,358,358,909
412530,202302,854,2149,625,1737,113,322,149,363,262,685
412535,202302,972,2463,588,1705,83,260,73,150,156,410
412540,202302,1289,3157,908,2506,163,567,207,521,370,1088
412545,202302,897,2174,599,1610,101,294,202,511,303,805
412550,202302,47406,115099,35185,92700,4963,14521,16685,38596,21648,53117
412555,202302,357,857,241,626,27,92,80,146,107,238
412560,202302,6737,17375,5057,13900,1242,3806,1083,2485,2325,6291
412570,202302,5326,12339,3282,8680,552,1663,648,1328,1200,2991
412575,202302,1401,3152,1112,2691,275,641,494,1086,769,1727
412580,202302,1963,4564,1416,3634,125,362,786,1782,911,2144
412590,202302,547,1362,301,848,55,175,41,81,96,256
412600,202302,2125,4976,1688,4195,99,324,1111,2492,1210,2816
412610,202302,1026,2579,748,2026,100,270,326,762,426,1032
412620,202302,1588,3751,1242,3232,244,690,519,1214,763,1904
412625,202302,11808,29464,8025,22425,1541,4595,1230,2762,2771,7357
412627,202302,1402,3646,990,2876,238,774,204,526,442,1300
412630,202302,3373,9294,2381,7265,386,1289,550,1443,936,2732
412635,202302,567,1412,349,1013,57,167,94,225,151,392
412640,202302,1197,2997,703,1996,105,300,126,270,231,570
412650,202302,2060,5262,1627,4419,268,817,622,1468,890,2285
412660,202302,3593,8403,2550,6537,294,839,989,2200,1283,3039
412665,202302,523,1222,401,1022,81,221,154,357,235,578
412667,202302,2062,5174,1510,4127,227,701,608,1547,835,2248
412670,202302,1169,2487,810,1943,137,397,345,676,482,1073
412680,202302,2579,6457,1761,4995,197,646,507,1160,704,1806
412690,202302,1415,3380,989,2602,177,517,357,803,534,1320
412700,202302,2295,5539,1889,4902,388,1111,885,2095,1273,3206
412710,202302,6833,18227,5111,14880,819,2600,1379,3161,2198,5761
412720,202302,1613,4305,1315,3731,201,631,410,881,611,1512
412730,202302,3415,8180,2538,6581,405,1215,1123,2513,1528,3728
412740,202302,2528,6546,1747,5122,318,1040,293,761,611,1801
412750,202302,4884,11973,3919,10499,506,1509,2161,5340,2667,6849
412760,202302,3936,9518,3267,8463,626,1865,1768,4197,2394,6062
412770,202302,15192,37329,8936,25637,1126,3498,2210,5120,3336,8618
412780,202302,1569,3768,1148,3062,281,841,356,812,637,1653
412785,202302,2749,5889,1910,4571,258,664,1234,2778,1492,3442
412788,202302,1715,4504,1382,3944,371,1089,491,1298,862,2387
412790,202302,1693,4109,1093,3023,173,550,430,957,603,1507
412795,202302,1509,3647,889,2492,133,395,222,538,355,933
412796,202302,2741,7282,2305,6569,508,1550,714,1813,1222,3363
412800,202302,5273,11387,3844,8961,372,1095,2181,4337,2553,5432
412810,202302,16736,39579,11442,29685,1281,3809,4958,11007,6239,14816
412820,202302,7915,20226,5659,15923,1395,4166,1489,3900,2884,8066
412830,202302,415,1098,320,919,36,98,91,237,127,335
412840,202302,2473,5309,1792,4100,143,402,1144,2278,1287,2680
412850,202302,3420,8272,2588,6983,278,895,1323,3185,1601,4080
412853,202302,2027,4561,1700,4044,204,569,979,1989,1183,2558
412855,202302,1678,4061,915,2514,124,364,207,438,331,802
412860,202302,924,2203,609,1697,106,324,234,562,340,886
412862,202302,802,1919,541,1489,102,274,220,550,322,824
412863,202302,1570,4229,1380,3890,275,878,687,1723,962,2601
412865,202302,822,2107,602,1678,158,453,135,346,293,799
412870,202302,1211,2892,874,2369,262,805,227,575,489,1380
412880,202302,1160,2958,837,2396,177,536,285,736,462,1272
420005,202302,563,1558,335,1011,37,108,156,450,193,558
420010,202302,3976,8991,2650,6764,178,497,1916,4828,2094,5325
420020,202302,529,1549,375,1177,71,259,127,308,198,567
420030,202302,160,534,118,426,34,132,28,96,62,228
420040,202302,740,2150,460,1528,78,294,35,90,113,384
420050,202302,973,2235,670,1651,110,312,391,824,501,1136
420055,202302,211,599,129,403,18,71,55,146,73,217
420060,202302,239,632,176,493,28,83,85,215,113,298
420070,202302,1105,3020,875,2580,173,564,457,1247,630,1811
420075,202302,95,255,53,156,7,24,19,37,26,61
420080,202302,515,1414,365,1055,70,212,90,221,160,433
420090,202302,558,1629,367,1191,78,273,82,216,160,489
420100,202302,1883,4192,1534,3651,108,262,1135,2670,1243,2932
420110,202302,368,1085,311,963,46,158,172,509,218,667
420120,202302,809,2085,567,1586,73,232,270,669,343,901
420125,202302,465,1333,333,1037,66,205,103,288,169,493
420127,202302,407,1057,187,564,25,89,68,190,93,279
420130,202302,6145,15929,4721,13482,935,3077,1914,4602,2849,7679
420140,202302,5983,14919,4649,12661,1258,3835,1207,2848,2465,6683
420150,202302,893,2170,666,1817,61,193,367,945,428,1138
420160,202302,263,627,119,342,20,73,39,96,59,169
420165,202302,224,646,143,454,29,106,38,91,67,197
420170,202302,425,1188,336,991,45,152,160,396,205,548
420180,202302,192,599,109,398,16,73,27,86,43,159
420190,202302,263,742,164,499,33,97,46,131,79,228
420195,202302,2546,6189,1993,5296,466,1430,930,2199,1396,3629
420200,202302,10104,22504,6789,16579,829,2327,3314,6675,4143,9002
420205,202302,2807,6891,1948,5225,268,801,1010,2496,1278,3297
420207,202302,2865,6858,1927,5146,347,1059,801,1851,1148,2910
420208,202302,438,1199,274,870,87,285,59,143,146,428
420209,202302,219,655,135,422,14,50,67,183,81,233
420210,202302,5652,13563,4121,10956,664,1994,2107,5088,2771,7082
420213,202302,1021,2815,828,2408,159,501,321,876,480,1377
420215,202302,308,856,221,668,50,159,68,188,118,347
420220,202302,447,1270,311,989,53,199,121,323,174,522
420230,202302,7938,19451,6293,16499,754,2274,3570,8507,4324,10781
420240,202302,20539,53659,13939,38930,1706,5544,6357,14697,8063,20241
420243,202302,602,1423,494,1227,80,229,313,736,393,965
420245,202302,2632,6125,2047,5144,180,522,1285,2971,1465,3493
420250,202302,847,1866,742,1725,47,152,592,1284,639,1436
420253,202302,594,1362,430,1122,40,101,256,659,296,760
420257,202302,217,523,151,409,26,83,71,185,97,268
420260,202302,1593,3685,1218,3180,92,294,902,2271,994,2565
420270,202302,739,1815,388,1025,42,115,171,402,213,517
420280,202302,1942,5207,1548,4386,201,675,745,1910,946,2585
420285,202302,196,541,116,346,18,67,31,63,49,130
420287,202302,597,1286,422,1047,76,203,181,425,257,628
420290,202302,7328,19180,5886,16224,821,2642,3410,8420,4231,11062
420300,202302,10230,27247,6080,17795,1107,3471,1849,4635,2956,8106
420310,202302,1067,2277,635,1568,64,181,317,687,381,868
420315,202302,1170,2995,763,2197,92,286,383,1009,475,1295
420320,202302,8276,20779,6352,17767,1786,5345,1933,4959,3719,10304
420325,202302,425,1152,303,911,42,146,114,287,156,433
420330,202302,1375,3815,892,2750,164,548,272,726,436,1274
420340,202302,1582,3760,1229,3161,278,764,498,1108,776,1872
420350,202302,1789,3946,1385,3267,150,397,935,2095,1085,2492
420360,202302,3801,9930,2130,6434,359,1181,184,485,543,1666
420370,202302,1784,4260,1455,3706,120,394,1031,2418,1151,2812
420380,202302,5913,14491,4198,11416,752,2359,1857,4490,2609,6849
420390,202302,1416,3436,1031,2697,183,535,353,623,536,1158
420395,202302,1634,4276,1182,3444,167,538,231,493,398,1031
420400,202302,1522,3792,1105,3014,138,423,602,1513,740,1936
420410,202302,758,1863,556,1452,71,199,310,781,381,980
420415,202302,459,1223,328,926,63,197,148,394,211,591
420417,202302,789,2200,612,1822,144,412,274,849,418,1261
420419,202302,187,609,136,470,42,156,12,48,54,204
420420,202302,19225,47208,13677,36950,3364,10316,4638,10806,8002,21122
420425,202302,807,2128,573,1639,56,186,291,781,347,967
420430,202302,4374,11010,2879,7928,464,1455,1197,2778,1661,4233
420435,202302,457,1139,272,792,59,178,129,359,188,537
420440,202302,1082,2630,740,1932,248,599,243,619,491,1218
420445,202302,299,690,189,490,29,84,62,120,91,204
420450,202302,1120,3067,855,2505,152,546,343,830,495,1376
420455,202302,2696,6034,2005,5003,493,1226,778,1951,1271,3177
420460,202302,12953,31854,10227,27044,1367,4208,5749,13830,7116,18038
420470,202302,857,2170,493,1357,82,262,138,287,220,549
420475,202302,87,232,41,131,8,31,10,29,18,60
420480,202302,7325,17154,4887,13034,869,2461,2073,5224,2942,7685
420490,202302,504,1332,355,999,53,177,156,390,209,567
420500,202302,1747,4478,1179,3448,204,721,550,1444,754,2165
420510,202302,163,454,109,331,19,72,31,68,50,140
420515,202302,162,448,121,355,16,56,42,94,58,150
420517,202302,929,2222,779,1952,91,241,457,1110,548,1351
420519,202302,385,952,272,768,33,102,129,350,162,452
420520,202302,365,966,201,645,27,99,8,14,35,113
420530,202302,991,2847,689,2188,129,474,216,553,345,1027
420535,202302,266,739,107,342,15,51,28,70,43,121
420540,202302,52374,118957,38042,95312,5003,14658,16579,34947,21582,49605
420543,202302,301,824,235,675,34,116,94,230,128,346
420545,202302,1949,5554,1484,4525,296,967,563,1521,859,2488
420550,202302,5577,13539,3655,10087,593,1776,1499,3816,2092,5592
420555,202302,432,1169,298,895,36,135,154,411,190,546
420560,202302,553,1225,404,1020,54,145,224,554,278,699
420570,202302,3991,9494,3036,7817,473,1413,1634,3801,2107,5214
420580,202302,2274,6007,1609,4858,384,1270,470,1285,854,2555
420590,202302,3989,10254,2644,7441,414,1312,769,1722,1183,3034
420600,202302,1703,4306,1409,3777,110,405,923,2261,1033,2666
420610,202302,754,1958,517,1486,112,314,236,652,348,966
420620,202302,1074,2617,758,2087,134,402,297,775,431,1177
420630,202302,1366,3890,990,2997,158,539,438,1186,596,1725
420640,202302,615,1655,323,1032,80,258,17,40,97,298
420650,202302,4614,11368,3191,8561,451,1409,1428,3127,1879,4536
420660,202302,561,1374,354,938,58,164,68,140,126,304
420665,202302,919,2233,626,1728,106,332,274,636,380,968
420670,202302,1550,4192,939,2847,91,317,195,430,286,747
420675,202302,264,653,172,497,14,54,104,269,118,323
420680,202302,360,772,205,559,22,83,116,275,138,358
420690,202302,1200,3238,813,2355,114,357,268,641,382,998
420700,202302,4154,10196,3288,8695,270,823,2202,5479,2472,6302
420710,202302,1437,3874,1184,3347,153,513,671,1633,824,2146
420720,202302,1728,4391,1319,3663,200,616,773,1967,973,2583
420730,202302,4831,11711,3778,9988,652,1981,1900,4519,2552,6500
420740,202302,611,1679,359,1125,77,263,68,174,145,437
420750,202302,2830,7744,1950,5784,303,1080,734,1879,1037,2959
420757,202302,142,364,71,225,11,37,32,98,43,135
420760,202302,498,1360,273,782,45,131,83,195,128,326
420765,202302,718,1955,387,1138,60,204,190,527,250,731
420768,202302,1777,4505,1470,3944,178,473,1038,2730,1216,3203
420770,202302,398,1059,172,589,15,58,26,64,41,122
420775,202302,377,990,235,713,43,144,82,215,125,359
420780,202302,1250,3323,781,2287,141,397,133,346,274,743
420785,202302,287,705,211,557,15,42,98,198,113,240
420790,202302,1425,3793,1116,3155,210,749,636,1543,846,2292
420800,202302,994,2248,629,1591,156,410,320,753,476,1163
420810,202302,1925,5367,1605,4755,384,1349,736,1844,1120,3193
420820,202302,18648,44127,14074,36930,1975,5738,7295,17538,9270,23276
420830,202302,6552,16031,4997,13346,866,2643,2149,5266,3015,7909
420840,202302,777,2343,430,1485,72,272,39,123,111,395
420845,202302,3940,9537,2794,7584,535,1731,1208,2966,1743,4697
420850,202302,1313,3827,963,2976,175,613,307,765,482,1378
420860,202302,490,1252,305,918,78,240,81,213,159,453
420870,202302,1049,2774,729,2137,155,479,249,665,404,1144
420880,202302,1546,4303,1240,3717,261,871,501,1339,762,2210
420890,202302,9990,25914,6481,18706,937,3008,2169,5242,3106,8250
420895,202302,239,676,151,457,25,81,65,174,90,255
420900,202302,2102,4997,1320,3610,174,583,572,1281,746,1864
420910,202302,46582,115947,32947,91264,4947,15709,14691,34778,19638,50487
420915,202302,576,1946,465,1671,76,303,220,775,296,1078
420917,202302,614,1476,308,768,50,102,169,407,219,509
420920,202302,123,318,54,165,4,14,9,17,13,31
420930,202302,23798,55793,17980,45928,2440,7222,9958,22842,12398,30064
420940,202302,4703,10862,3143,8304,615,1858,920,1849,1535,3707
420945,202302,250,732,144,429,26,88,58,148,84,236
420950,202302,507,1343,337,976,58,196,96,225,154,421
420960,202302,1416,3352,1039,2737,165,500,455,1034,620,1534
420970,202302,2953,7411,2066,5824,407,1195,648,1826,1055,3021
420980,202302,326,1069,271,939,88,324,53,175,141,499
420985,202302,489,1283,283,872,54,186,75,194,129,380
420990,202302,462,1317,290,911,48,159,61,146,109,305
421000,202302,735,2121,501,1594,106,349,95,239,201,588
421003,202302,557,1337,203,588,15,39,15,37,30,76
421005,202302,134,368,95,280,13,39,40,117,53,156
421010,202302,4916,12250,3623,9934,605,1959,1397,3064,2002,5023
421020,202302,512,1502,404,1284,58,227,211,610,269,837
421030,202302,1348,3535,1037,2917,218,683,400,1014,618,1697
421040,202302,877,2020,528,1447,57,170,323,830,380,1000
421050,202302,1573,4072,1054,2901,166,521,381,818,547,1339
421055,202302,209,569,128,394,20,71,54,139,74,210
421060,202302,940,2510,690,1977,114,375,320,781,434,1156
421070,202302,842,2316,525,1546,101,325,230,585,331,910
421080,202302,673,1858,538,1594,88,318,229,612,317,930
421085,202302,425,1169,197,644,21,69,32,85,53,154
421090,202302,388,967,232,626,19,72,101,220,120,292
421100,202302,1107,2367,524,1423,85,239,127,293,212,532
421105,202302,1997,5014,1453,4015,275,799,581,1481,856,2280
421110,202302,1692,3966,1420,3581,131,399,925,2236,1056,2635
421120,202302,1419,4017,1027,3184,135,455,339,888,474,1343
421125,202302,496,1196,359,908,89,238,143,322,232,560
421130,202302,8240,21623,6961,19175,1310,3990,3657,9261,4967,13251
421140,202302,461,1214,318,931,76,218,118,310,194,528
421145,202302,527,1352,360,1018,95,303,102,224,197,527
421150,202302,972,2591,677,1981,124,410,275,668,399,1078
421160,202302,831,2145,658,1805,89,293,409,1008,498,1301
421165,202302,295,828,188,558,32,94,62,147,94,241
421170,202302,1554,3813,1344,3491,124,338,986,2509,1110,2847
421175,202302,1344,3372,819,2440,154,532,328,905,482,1437
421180,202302,502,1219,288,805,33,111,142,330,175,441
421185,202302,412,1008,295,781,45,130,139,317,184,447
421187,202302,330,987,213,698,39,121,72,232,111,353
421189,202302,513,1378,397,1155,58,196,160,407,218,603
421190,202302,18536,46658,14181,38394,2317,7208,6621,15675,8938,22883
421200,202302,1017,2610,785,2158,99,321,435,1121,534,1442
421205,202302,310,784,244,673,53,157,91,233,144,390
421210,202302,1409,3414,804,2343,176,502,259,702,435,1204
421220,202302,1818,4942,1451,4217,375,1165,473,1226,848,2391
421223,202302,534,1294,363,998,69,211,200,508,269,719
421225,202302,1356,3528,1182,3256,132,449,787,2085,919,2534
421227,202302,906,2396,590,1741,121,381,231,662,352,1043
421230,202302,821,2044,573,1603,103,311,217,560,320,871
421240,202302,340,975,171,576,26,114,39,106,65,220
421250,202302,3384,8047,2558,6723,407,1073,1495,3729,1902,4802
421260,202302,331,1013,96,309,17,56,10,22,27,78
421265,202302,1236,2766,1066,2530,92,208,861,2021,953,2229
421270,202302,478,1248,252,786,62,212,87,250,149,462
421280,202302,3386,8281,2609,6999,396,1226,1359,3347,1755,4573
421290,202302,1431,3706,722,2041,119,353,135,320,254,673
421300,202302,408,1066,205,637,28,94,33,89,61,183
421310,202302,302,808,206,606,64,193,74,189,138,382
421315,202302,382,970,241,681,50,150,81,204,131,354
421320,202302,802,2428,464,1479,41,127,60,98,101,225
421330,202302,777,2160,518,1585,104,333,149,409,253,742
421335,202302,506,1452,407,1264,60,205,196,576,256,781
421340,202302,1808,4784,1276,3837,208,690,514,1419,722,2109
421350,202302,2211,5226,1498,4060,299,849,536,1392,835,2241
421360,202302,2731,6949,1697,4887,425,1426,539,1144,964,2570
421370,202302,959,2902,627,2045,104,382,196,512,300,894
421380,202302,1111,2587,972,2381,84,262,680,1566,764,1828
421390,202302,204,538,90,291,26,89,22,56,48,145
421400,202302,827,2111,572,1617,100,316,264,666,364,982
421410,202302,230,602,127,386,35,101,25,81,60,182
421415,202302,255,665,183,497,20,60,69,167,89,227
421420,202302,779,2050,567,1588,72,221,276,696,348,917
421430,202302,121,354,81,255,12,42,14,30,26,72
421440,202302,866,2241,542,1613,107,316,214,596,321,912
421450,202302,562,1617,370,1180,48,155,40,124,88,279
421460,202302,436,1295,243,852,15,49,21,49,36,98
421470,202302,475,1281,348,1048,45,137,110,326,155,463
421480,202302,4165,10508,2977,8149,390,1268,1355,3261,1745,4529
421490,202302,152,461,99,328,13,52,26,68,39,120
421500,202302,3157,8491,2282,6684,455,1537,697,1643,1152,3180
421505,202302,408,1016,338,911,33,108,209,544,242,652
421507,202302,537,1361,326,919,50,155,133,322,183,477
421510,202302,516,1359,349,983,43,145,151,335,194,480
421520,202302,566,1486,330,927,55,155,105,243,160,398
421530,202302,427,1238,259,860,32,140,54,124,86,264
421535,202302,564,1420,358,988,49,144,190,473,239,617
421540,202302,459,1038,279,750,25,86,108,264,133,350
421545,202302,868,2419,664,2040,126,440,303,836,429,1276
421550,202302,2924,7276,2262,6114,368,1083,1170,2959,1538,4042
421555,202302,274,756,83,265,12,39,15,32,27,71
421560,202302,126,389,77,256,12,47,24,62,36,109
421565,202302,1297,3143,947,2567,222,671,392,955,614,1626
421567,202302,641,1863,480,1435,138,444,127,360,265,804
421568,202302,387,1094,214,666,40,147,65,180,105,327
421569,202302,196,539,90,268,12,41,47,118,59,159
421570,202302,2055,5393,1490,4198,281,888,606,1439,887,2327
421575,202302,417,1140,308,856,36,127,159,379,195,506
421580,202302,6403,16338,4232,11774,591,1889,1768,4105,2359,5994
421590,202302,240,642,185,531,42,135,80,210,122,345
421600,202302,775,1913,520,1389,81,248,205,437,286,685
421605,202302,873,2178,637,1794,108,297,254,712,362,1009
421610,202302,1290,3253,907,2550,183,584,356,904,539,1488
421620,202302,5055,12535,3544,9877,664,2134,1480,3618,2144,5752
421625,202302,160,445,86,258,11,30,26,64,37,94
421630,202302,3748,9333,2502,6998,409,1287,826,1966,1235,3253
421635,202302,564,1435,387,1075,30,110,228,539,258,649
421640,202302,918,2274,677,1907,164,471,324,859,488,1330
421650,202302,3515,8795,2440,6925,490,1595,800,1951,1290,3546
421660,202302,16466,42121,12459,34557,1719,5547,6379,15584,8098,21131
421670,202302,1194,3148,833,2282,156,480,346,821,502,1301
421680,202302,2306,4600,1917,4014,125,339,1509,2913,1634,3252
421690,202302,1935,5278,1379,4158,263,838,364,998,627,1836
421700,202302,799,2255,518,1587,82,276,139,342,221,618
421710,202302,275,832,160,502,18,59,67,190,85,249
421715,202302,213,530,160,400,30,97,96,208,126,305
421720,202302,2709,7015,1643,4757,351,1120,454,1062,805,2182
421725,202302,375,893,212,589,30,88,93,217,123,305
421730,202302,689,1924,469,1329,75,214,208,530,283,744
421740,202302,1092,2900,760,2221,133,420,302,732,435,1152
421750,202302,1259,2916,701,1912,161,480,225,543,386,1023
421755,202302,217,586,123,360,21,71,42,98,63,169
421760,202302,1384,3390,905,2530,167,533,339,813,506,1346
421770,202302,3259,7983,2359,6442,426,1201,901,2279,1327,3480
421775,202302,265,685,163,475,19,61,52,113,71,174
421780,202302,1236,3239,851,2466,143,444,371,947,514,1391
421790,202302,1166,2993,636,1938,128,398,193,515,321,913
421795,202302,282,806,179,534,29,96,51,130,80,226
421800,202302,4173,10624,3164,8769,507,1533,1526,3862,2033,5395
421810,202302,747,1937,514,1509,57,179,251,712,308,891
421820,202302,1451,3943,1006,2940,181,621,315,742,496,1363
421825,202302,2083,4673,1753,4172,119,316,1282,2973,1401,3289
421830,202302,2427,6669,1812,5405,381,1229,407,1121,788,2350
421835,202302,325,747,231,590,30,82,137,333,167,415
421840,202302,451,1338,358,1127,72,260,104,293,176,553
421850,202302,495,1384,288,960,57,187,46,120,103,307
421860,202302,315,800,178,532,24,86,59,130,83,216
421870,202302,6959,16311,5292,13169,593,1846,3187,6875,3780,8721
421875,202302,389,1142,171,540,23,74,34,92,57,166
421880,202302,856,2308,574,1686,115,319,145,394,260,713
421885,202302,374,1007,206,609,32,92,59,152,91,244
421890,202302,1317,3386,983,2758,141,499,590,1502,731,2001
421895,202302,535,1293,462,1177,52,110,296,782,348,892
421900,202302,1411,3547,1035,2723,131,409,480,1041,611,1450
421910,202302,421,1231,230,756,32,136,45,111,77,247
421915,202302,499,1336,308,890,72,224,59,127,131,351
421917,202302,811,1782,465,1284,115,346,100,268,215,614
421920,202302,536,1528,372,1170,111,359,109,332,220,691
421930,202302,4210,10053,2519,6952,449,1352,830,1962,1279,3314
421935,202302,547,1510,446,1313,105,291,239,702,344,993
421940,202302,448,1257,222,673,35,113,64,156,99,269
421950,202302,4261,10358,2615,7240,454,1397,753,1701,1207,3098
421960,202302,192,464,111,323,15,39,38,99,53,138
421970,202302,2651,6523,1696,4546,297,916,699,1587,996,2503
421985,202302,413,1085,286,821,31,99,141,376,172,475
422000,202302,2559,5979,2021,5188,173,526,1371,3416,1544,3942
430003,202302,767,1892,547,1515,88,267,281,743,369,1010
430005,202302,456,1029,346,855,17,51,246,550,263,601
430010,202302,2333,4947,1743,4074,335,765,905,2109,1240,2874
430020,202302,711,1526,530,1276,61,175,332,737,393,912
430030,202302,1335,2876,787,1901,104,281,453,975,557,1256
430040,202302,12520,27364,8166,20387,2117,5689,2238,4972,4355,10661
430045,202302,696,1525,518,1237,27,82,386,874,413,956
430047,202302,299,642,122,317,18,48,42,104,60,152
430050,202302,1038,2428,629,1648,106,287,267,641,373,928
430055,202302,331,753,166,433,13,36,81,180,94,216
430057,202302,120,264,60,157,17,45,14,35,31,80
430060,202302,28140,66323,22775,58327,3768,10586,12418,30216,16186,40802
430063,202302,917,2333,763,2052,151,405,421,1107,572,1512
430064,202302,1436,3545,1050,2849,183,530,551,1431,734,1961
430066,202302,134,290,105,242,8,26,84,183,92,209
430070,202302,781,1959,189,574,32,107,27,62,59,169
430080,202302,1181,2788,690,1822,99,316,354,787,453,1103
430085,202302,1145,2270,706,1616,111,293,315,677,426,970
430087,202302,1160,2605,951,2332,79,238,625,1473,704,1711
430090,202302,553,1378,227,714,43,144,49,127,92,271
430100,202302,1329,3002,796,2029,125,352,300,633,425,985
430105,202302,1838,4283,1314,3427,181,564,695,1673,876,2237
430107,202302,204,557,108,313,15,43,31,74,46,117
430110,202302,2777,6309,2112,5328,332,938,1033,2429,1365,3367
430120,202302,1595,4147,1121,3050,189,505,498,1250,687,1755
430130,202302,4450,9232,3317,7721,1147,2656,679,1876,1826,4532
430140,202302,1306,3129,933,2492,153,446,446,1100,599,1546
430150,202302,690,1702,388,1106,76,249,107,268,183,517
430155,202302,287,684,135,387,18,53,26,54,44,107
430160,202302,27821,56636,22593,49685,1737,4509,16098,33456,17835,37965
430163,202302,4434,8772,3180,7025,69,232,2581,5424,2650,5656
430165,202302,405,1009,154,479,14,38,20,48,34,86
430170,202302,1126,2794,407,1312,83,317,56,130,139,447
430175,202302,1071,2442,929,2186,161,376,540,1234,701,1610
430180,202302,849,1982,621,1593,135,341,262,653,397,994
430185,202302,773,1884,403,1125,96,291,77,172,173,463
430187,202302,1071,2052,799,1734,91,187,557,1191,648,1378
430190,202302,1853,4237,1450,3625,267,674,673,1569,940,2243
430192,202302,142,362,67,188,12,35,20,43,32,78
430195,202302,524,1435,92,291,8,24,15,35,23,59
430200,202302,1416,3679,1126,3182,306,895,260,763,566,1658
430205,202302,683,1320,637,1238,12,34,596,1127,608,1161
430210,202302,9052,21975,5560,14663,735,2093,1609,3258,2344,5351
430215,202302,417,952,260,659,35,102,122,285,157,387
430220,202302,716,1702,240,719,32,105,79,187,111,292
430222,202302,297,751,204,576,37,109,74,193,111,302
430223,202302,343,824,263,694,28,82,155,383,183,465
430225,202302,38,81,29,66,2,3,18,35,20,38
430230,202302,2606,6201,2196,5634,121,338,1747,4399,1868,4737
430235,202302,557,1410,374,1052,51,158,102,228,153,386
430237,202302,677,1375,516,1134,24,71,417,872,441,943
430240,202302,1697,3760,976,2519,122,370,453,1012,575,1382
430245,202302,943,2253,761,1935,146,354,436,1138,582,1492
430250,202302,1285,2886,941,2339,298,799,243,521,541,1320
430258,202302,158,393,123,331,11,33,55,143,66,176
430260,202302,898,2051,592,1524,69,208,339,835,408,1043
430265,202302,291,794,204,641,27,91,78,240,105,331
430270,202302,4267,8786,3464,7644,386,998,2460,5070,2846,6068
430280,202302,6491,13588,4770,10881,745,1784,2466,5261,3211,7045
430290,202302,2754,5665,2242,5048,174,443,1692,3644,1866,4087
430300,202302,13707,30024,10646,25156,1308,3593,6486,14114,7794,17707
430310,202302,17579,39823,13019,31981,1598,4342,7449,16751,9047,21093
430320,202302,1120,2659,653,1785,60,161,350,915,410,1076
430330,202302,802,1847,490,1260,85,224,167,375,252,599
430340,202302,800,1682,557,1315,77,184,359,804,436,988
430350,202302,10945,24288,8536,20423,1099,2862,5134,11487,6233,14349
430355,202302,409,1065,167,514,31,88,20,47,51,135
430360,202302,1109,2514,689,1818,164,478,199,459,363,937
430367,202302,433,879,279,645,35,112,174,349,209,461
430370,202302,557,1464,247,733,50,150,57,133,107,283
430380,202302,771,1812,411,1179,82,245,95,243,177,488
430390,202302,4449,10206,2997,7718,594,1631,374,719,968,2350
430400,202302,1322,2540,983,2097,136,352,580,1110,716,1462
430410,202302,688,1454,511,1196,45,120,371,828,416,948
430420,202302,3771,8566,2981,7092,374,1074,1878,3963,2252,5037
430430,202302,621,1494,282,824,48,154,47,121,95,275
430435,202302,2267,5111,1687,4142,284,744,840,1971,1124,2715
430440,202302,6093,13992,5029,12340,505,1440,3339,7692,3844,9132
430450,202302,9788,20755,8035,17966,1239,3252,4686,9601,5925,12853
430460,202302,50792,114177,37609,93318,5033,13925,20921,48391,25954,62316
430461,202302,255,649,104,303,20,67,37,88,57,155
430462,202302,377,920,196,564,33,101,56,135,89,236
430463,202302,9335,22326,6977,18168,1342,3950,3247,7784,4589,11734
430465,202302,718,1623,486,1216,78,223,265,629,343,852
430466,202302,6195,13848,5019,12161,809,2160,2926,6482,3735,8642
430467,202302,641,1438,480,1203,47,137,286,657,333,794
430468,202302,1856,4071,1515,3595,95,299,1171,2637,1266,2936
430469,202302,724,1946,150,465,14,43,47,106,61,149
430470,202302,7331,17392,4984,13423,1270,3918,1280,2923,2550,6841
430471,202302,960,2291,826,2073,103,315,565,1297,668,1612
430480,202302,758,1985,494,1442,77,251,153,340,230,591
430485,202302,203,499,105,281,22,49,23,60,45,109
430490,202302,545,1299,319,863,38,113,156,352,194,465
430495,202302,479,1243,329,972,52,168,159,441,211,609
430500,202302,1205,2874,858,2326,275,846,236,528,511,1374
430510,202302,35300,85133,26273,68789,4629,13644,11650,26797,16279,40441
430511,202302,400,1069,158,487,25,73,26,56,51,129
430512,202302,1289,2636,1044,2295,224,535,448,942,672,1477
430513,202302,954,2145,491,1235,64,191,271,587,335,778
430515,202302,473,1195,340,944,42,130,153,389,195,519
430517,202302,1728,4328,1330,3525,220,561,736,1919,956,2480
430520,202302,1628,3868,949,2495,140,380,235,546,375,926
430530,202302,1146,2717,492,1382,78,227,133,337,211,564
430535,202302,4573,10648,3334,8558,469,1269,1689,4080,2158,5349
430537,202302,683,1493,606,1357,66,133,448,977,514,1110
430540,202302,699,1607,432,1171,66,185,228,590,294,775
430543,202302,1326,2226,834,1659,203,381,223,497,426,878
430544,202302,834,2198,561,1624,143,440,177,488,320,928
430545,202302,3104,7184,2418,6189,393,1061,1347,3330,1740,4391
430550,202302,479,1236,338,956,96,258,91,247,187,505
430558,202302,186,407,82,205,3,7,44,101,47,108
430560,202302,356,787,188,526,25,80,63,146,88,226
430570,202302,996,2257,726,1787,149,463,333,636,482,1099
430580,202302,988,2322,724,1926,171,450,269,755,440,1205
430583,202302,212,511,47,133,5,18,12,19,17,37
430585,202302,252,582,139,364,29,82,41,93,70,175
430587,202302,245,624,185,530,21,67,80,222,101,289
430590,202302,1663,3707,1313,3163,138,348,869,2032,1007,2380
430593,202302,39,103,34,88,6,20,17,33,23,53
430595,202302,489,1197,141,423,16,44,22,34,38,78
430597,202302,548,1297,292,800,25,63,89,180,114,243
430600,202302,2364,5871,1058,2908,156,450,218,516,374,966
430605,202302,1647,3910,1209,3176,174,475,542,1348,716,1823
430607,202302,839,1765,565,1303,37,97,362,785,399,882
430610,202302,7901,16673,5773,13618,1374,3873,2295,4586,3669,8459
430613,202302,305,684,94,264,9,26,27,61,36,87
430620,202302,1000,2192,763,1794,148,417,395,773,543,1190
430630,202302,523,1363,181,513,30,87,52,123,82,210
430632,202302,519,1296,226,622,36,101,82,201,118,302
430635,202302,704,1450,521,1145,52,104,371,805,423,909
430637,202302,628,1393,472,1161,39,115,307,691,346,806
430640,202302,1385,3564,959,2741,141,424,349,864,490,1288
430642,202302,445,1177,280,796,41,128,111,280,152,408
430645,202302,199,444,102,249,16,43,35,62,51,105
430650,202302,2282,5568,1714,4683,515,1352,634,1903,1149,3255
430655,202302,381,857,232,576,27,84,135,281,162,365
430660,202302,6737,15259,5188,12864,851,2341,2716,6259,3567,8600
430670,202302,738,1651,530,1297,94,225,233,538,327,763
430673,202302,617,1329,293,777,61,156,107,255,168,411
430675,202302,283,800,67,225,10,37,7,24,17,61
430676,202302,7454,16772,5969,14504,928,2342,3581,8337,4509,10679
430680,202302,1499,3558,1004,2636,308,874,338,671,646,1545
430690,202302,4128,9529,3291,8137,1022,2611,1272,3037,2294,5648
430692,202302,246,680,197,600,13,43,153,460,166,503
430693,202302,1166,2898,726,2066,158,492,185,481,343,973
430695,202302,473,1065,295,727,52,132,134,292,186,424
430697,202302,643,1445,503,1254,72,195,327,803,399,998
430700,202302,10201,23284,6681,17195,1352,3834,1655,3495,3007,7329
430705,202302,444,982,224,603,25,74,92,213,117,287
430710,202302,2419,4274,1657,3297,72,198,1329,2478,1401,2676
430720,202302,962,2204,519,1428,63,195,271,673,334,868
430730,202302,1159,2944,807,2275,116,341,333,862,449,1203
430740,202302,833,2096,456,1307,76,252,143,365,219,617
430745,202302,609,1334,448,1042,55,186,273,509,328,695
430750,202302,2103,4725,1416,3543,349,907,598,1362,947,2269
430755,202302,570,1323,422,1044,35,105,255,565,290,670
430760,202302,3206,7227,2523,6214,517,1376,1231,2794,1748,4170
430770,202302,9689,21431,7722,18603,860,2395,5008,11417,5868,13812
430780,202302,2711,6219,1861,4841,297,841,951,2317,1248,3158
430781,202302,756,1773,514,1268,160,423,193,386,353,809
430783,202302,425,911,278,692,56,159,141,323,197,482
430786,202302,43,126,28,95,5,15,5,14,10,29
430790,202302,6196,13916,4661,11399,464,1407,2870,6270,3334,7677
430800,202302,1081,2112,828,1776,49,123,641,1299,690,1422
430805,202302,500,1097,354,823,11,36,275,591,286,627
430807,202302,725,1664,437,1136,61,189,181,381,242,570
430810,202302,947,2134,496,1296,68,195,189,415,257,610
430820,202302,1667,4355,998,2950,160,480,296,764,456,1244
430825,202302,312,713,131,313,19,47,53,107,72,154
430830,202302,2527,5685,2106,4962,127,319,1600,3574,1727,3893
430840,202302,1485,3213,1017,2476,140,339,627,1463,767,1802
430843,202302,219,515,101,277,9,22,38,94,47,116
430845,202302,630,1324,427,995,59,155,257,528,316,683
430850,202302,2948,7192,2050,5587,570,1658,525,1335,1095,2993
430860,202302,1445,3361,773,2089,119,388,318,722,437,1110
430865,202302,702,1634,437,1168,101,308,149,303,250,611
430870,202302,636,1623,286,859,50,156,50,124,100,280
430880,202302,1902,3855,1369,3034,152,408,918,1882,1070,2290
430885,202302,206,520,129,366,13,30,82,233,95,263
430890,202302,1367,3206,881,2394,162,525,103,216,265,741
430900,202302,4082,7737,2891,6124,137,410,2138,4157,2275,4567
430905,202302,1175,2721,812,2091,143,388,322,747,465,1135
430910,202302,2812,7026,2145,5692,326,1041,1011,2262,1337,3303
430912,202302,626,1645,408,1194,62,172,221,649,283,821
430915,202302,648,1711,419,1232,112,356,108,310,220,666
430920,202302,35202,79390,28449,68890,3287,8899,18404,42155,21691,51054
430925,202302,107,225,54,138,8,22,24,61,32,83
430930,202302,15582,32641,11663,27038,1304,3382,7355,15880,8659,19262
430940,202302,1583,3751,1099,2848,227,636,446,1000,673,1636
430950,202302,1085,2118,730,1569,52,153,534,1031,586,1184
430955,202302,513,1264,148,400,25,69,40,89,65,158
430957,202302,246,701,216,638,41,122,117,350,158,472
430960,202302,1755,3935,1050,2718,258,701,350,809,608,1510
430965,202302,1959,4082,1568,3518,62,144,1233,2743,1295,2887
430970,202302,457,1060,264,715,39,111,122,308,161,419
430975,202302,614,1618,474,1323,77,248,173,417,250,665
430980,202302,528,1146,305,770,40,115,142,307,182,422
430990,202302,763,1906,534,1450,75,220,262,670,337,890
430995,202302,688,1538,501,1248,83,219,272,617,355,836
431000,202302,1701,3841,773,2128,120,334,77,165,197,499
431010,202302,3388,8152,2435,6548,442,1361,906,2025,1348,3386
431020,202302,10951,22539,6673,15970,1022,2911,3172,6468,4194,9379
431030,202302,396,1036,208,649,36,131,30,85,66,216
431033,202302,5249,11420,3608,8886,771,1926,1384,3241,2155,5167
431036,202302,361,779,89,260,6,12,28,64,34,76
431040,202302,1118,2536,735,1927,74,255,425,997,499,1252
431041,202302,510,1110,353,866,61,165,160,333,221,498
431043,202302,462,1104,325,832,26,90,209,468,235,558
431046,202302,125,313,58,164,8,22,12,28,20,50
431050,202302,1585,3437,1155,2791,190,446,641,1517,831,1963
431053,202302,858,2049,476,1335,95,282,156,340,251,622
431055,202302,740,1662,568,1378,58,146,382,933,440,1079
431057,202302,255,718,165,521,33,115,57,157,90,272
431060,202302,7176,16134,5079,12844,1163,3254,1979,4447,3142,7701
431065,202302,582,1334,387,1015,53,156,203,505,256,661
431070,202302,514,1281,321,883,65,193,87,228,152,421
431075,202302,344,838,195,520,35,121,96,198,131,319
431080,202302,792,2076,565,1620,82,243,183,458,265,701
431085,202302,958,2313,524,1373,58,171,229,573,287,744
431087,202302,507,1259,414,1086,51,136,251,634,302,770
431090,202302,488,1100,197,570,36,106,38,107,74,213
431100,202302,5527,10556,4070,8754,363,901,2828,5696,3191,6597
431110,202302,1836,3903,1313,3014,177,449,691,1399,868,1848
431112,202302,785,1840,651,1610,87,244,412,960,499,1204
431113,202302,638,1496,501,1249,117,301,277,642,394,943
431115,202302,1294,3203,1010,2714,114,391,681,1688,795,2079
431120,202302,3392,7872,2328,5951,519,1505,896,1945,1415,3450
431123,202302,426,1034,276,745,44,121,136,350,180,471
431125,202302,1464,3415,1053,2690,273,703,545,1376,818,2079
431127,202302,247,640,77,234,8,29,16,35,24,64
431130,202302,4181,9388,3270,8021,528,1426,1721,3948,2249,5374
431140,202302,7179,16307,4667,11696,577,1626,2158,4508,2735,6134
431142,202302,807,1735,613,1443,84,230,405,909,489,1139
431150,202302,1266,3060,927,2483,132,390,494,1252,626,1642
431160,202302,817,2023,548,1504,142,417,170,415,312,832
431162,202302,698,1637,492,1272,44,156,290,672,334,828
431164,202302,201,459,57,173,6,16,10,24,16,40
431170,202302,579,1435,434,1157,116,298,95,228,211,526
431171,202302,1159,2262,977,2043,161,338,721,1480,882,1818
431173,202302,567,1353,403,1124,121,395,122,287,243,682
431175,202302,1616,3522,1005,2488,147,355,458,1064,605,1419
431177,202302,1168,2730,883,2299,163,482,491,1209,654,1691
431179,202302,388,843,134,381,28,82,41,110,69,192
431180,202302,2991,7267,1892,5164,415,1128,396,898,811,2026
431190,202302,712,1705,310,868,26,83,70,130,96,213
431198,202302,496,1336,408,1170,89,258,172,490,261,748
431200,202302,388,949,122,332,26,64,17,44,43,108
431205,202302,294,725,163,455,47,131,49,128,96,259
431210,202302,801,1720,643,1485,127,305,331,767,458,1072
431213,202302,333,806,254,663,22,63,126,292,148,355
431215,202302,742,1705,389,1075,47,145,179,451,226,596
431217,202302,212,504,144,373,26,74,61,139,87,213
431220,202302,732,1702,470,1237,101,283,233,542,334,825
431225,202302,1972,4051,1532,3392,158,382,1050,2255,1208,2637
431230,202302,909,2289,684,1801,139,426,336,741,475,1167
431235,202302,202,542,33,106,0,0,8,24,8,24
431237,202302,450,1255,346,1043,50,169,177,505,227,674
431238,202302,47,151,39,133,9,38,18,50,27,88
431240,202302,6831,15008,5585,13101,585,1702,3630,7803,4215,9505
431242,202302,388,862,317,732,43,115,187,396,230,511
431244,202302,477,1084,261,644,40,100,117,248,157,348
431245,202302,1589,3471,1059,2591,105,259,515,1151,620,1410
431247,202302,350,800,232,590,36,109,105,216,141,325
431250,202302,2426,5340,1880,4611,431,1043,941,2328,1372,3371
431260,202302,397,999,243,692,23,90,102,258,125,348
431261,202302,344,937,283,833,27,99,162,431,189,530
431262,202302,328,891,176,555,28,104,88,263,116,367
431265,202302,1896,4271,774,2105,136,411,217,453,353,864
431267,202302,303,708,195,511,23,74,117,278,140,352
431270,202302,3562,7329,1951,4708,455,1192,681,1489,1136,2681
431275,202302,190,480,128,341,21,68,73,168,94,236
431280,202302,325,872,156,481,29,90,38,105,67,195
431290,202302,439,1247,296,917,53,173,46,117,99,290
431295,202302,93,230,38,107,10,31,11,27,21,58
431300,202302,353,902,103,299,12,46,33,71,45,117
431301,202302,311,848,89,281,13,40,10,27,23,67
431303,202302,812,1891,498,1297,33,103,224,487,257,590
431306,202302,2859,6383,1805,4642,234,659,753,1653,987,2312
431308,202302,51,141,42,119,15,44,16,42,31,86
431310,202302,653,1567,442,1153,71,173,210,509,281,682
431320,202302,853,2198,525,1554,83,266,166,420,249,686
431330,202302,2372,5285,1353,3526,166,494,683,1559,849,2053
431333,202302,250,638,144,417,23,69,42,111,65,180
431335,202302,42,115,26,84,8,23,1,4,9,27
431337,202302,5233,10825,4428,9695,225,724,3675,7553,3900,8277
431339,202302,552,1305,382,1018,93,240,139,372,232,612
431340,202302,24242,54747,17776,44254,2419,6848,9384,21290,11803,28138
431342,202302,490,1060,364,862,49,125,242,559,291,684
431344,202302,428,1037,242,678,37,100,131,348,168,448
431346,202302,253,607,94,283,17,55,25,59,42,114
431349,202302,1220,2558,826,1825,133,324,488,998,621,1322
431350,202302,6178,13987,4854,11961,630,1742,2958,6769,3588,8511
431360,202302,699,1573,362,948,101,289,105,233,206,522
431365,202302,3029,5927,2395,5101,126,340,1977,4017,2103,4357
431370,202302,6395,13684,4799,11289,851,2236,2656,5843,3507,8079
431380,202302,1139,2774,914,2418,196,545,503,1298,699,1843
431390,202302,3388,7780,2232,5861,234,746,1202,2719,1436,3465
431395,202302,2258,4567,1765,3877,167,392,1247,2605,1414,2997
431400,202302,380,1014,220,655,39,122,43,105,82,227
431402,202302,1117,2284,829,1868,93,227,557,1178,650,1405
431403,202302,234,630,181,525,44,148,67,165,111,313
431405,202302,7262,17127,5743,14679,957,2801,2861,6610,3818,9411
431406,202302,702,1768,468,1285,116,292,150,446,266,738
431407,202302,650,1624,423,1164,73,189,191,499,264,688
431410,202302,24731,55509,17951,44634,2289,6706,10659,23789,12948,30495
431413,202302,296,806,75,231,6,19,24,59,30,78
431415,202302,911,2111,622,1628,114,347,259,576,373,923
431417,202302,668,1352,424,975,68,182,231,503,299,685
431420,202302,2121,4263,1610,3601,116,307,1104,2321,1220,2628
431430,202302,683,1642,354,1009,54,160,114,292,168,452
431440,202302,48878,100868,37912,85213,5604,14675,21452,42577,27056,57252
431442,202302,194,525,95,298,13,44,12,36,25,80
431445,202302,578,1352,300,662,12,39,186,283,198,322
431446,202302,360,958,288,825,29,92,155,424,184,516
431447,202302,921,2217,521,1440,87,239,166,449,253,688
431449,202302,979,2266,655,1682,94,249,337,781,431,1030
431450,202302,3173,5544,2502,4670,202,316,1951,3517,2153,3833
431454,202302,54,170,45,148,9,34,23,71,32,105
431455,202302,661,1478,349,880,34,79,176,403,210,482
431460,202302,3955,8337,2628,6121,518,1307,1112,2389,1630,3696
431470,202302,1715,4287,1244,3380,238,693,460,1168,698,1861
431475,202302,307,810,64,212,3,12,8,14,11,26
431477,202302,574,1354,326,885,81,194,104,260,185,454
431478,202302,280,738,62,198,9,26,7,15,16,41
431480,202302,4250,10084,3390,8767,792,2111,1356,3376,2148,5487
431490,202302,172648,356854,135907,302659,7509,21317,103743,215861,111252,237178
431500,202302,589,1376,444,1122,65,165,228,542,293,707
431505,202302,310,691,215,552,22,51,147,377,169,428
431507,202302,359,830,146,416,38,117,22,51,60,168
431510,202302,2111,4993,1448,3735,482,1271,371,943,853,2214
431513,202302,259,545,141,352,31,98,43,73,74,171
431514,202302,154,367,126,323,5,15,80,182,85,197
431515,202302,686,1468,524,1197,119,289,276,596,395,885
431517,202302,84,234,69,205,8,30,30,84,38,114
431520,202302,445,1047,189,530,27,97,77,165,104,262
431530,202302,6667,13739,4083,9866,918,2296,1693,3821,2611,6117
431531,202302,269,610,158,409,30,75,54,140,84,215
431532,202302,742,1551,439,1036,74,191,209,464,283,655
431535,202302,355,887,172,492,27,73,36,89,63,162
431540,202302,2229,6078,2018,5800,106,323,1546,4489,1652,4812
431545,202302,421,985,104,254,16,32,41,92,57,124
431550,202302,2776,6387,1977,4944,238,686,1080,2503,1318,3189
431555,202302,851,1770,513,1219,45,116,291,673,336,789
431560,202302,32848,73107,22980,58125,4242,10553,9395,23605,13637,34158
431570,202302,7067,13645,6100,12322,354,921,5085,9657,5439,10578
431575,202302,485,1053,418,949,74,161,254,537,328,698
431580,202302,830,1970,566,1478,67,223,326,748,393,971
431590,202302,974,2478,677,1858,168,492,238,556,406,1048
431595,202302,445,1108,293,807,58,170,101,246,159,416
431600,202302,2322,5233,1665,4222,294,836,712,1606,1006,2442
431610,202302,1785,3927,1171,2880,208,502,470,1236,678,1738
431620,202302,570,1342,311,798,59,190,170,352,229,542
431630,202302,1595,3708,755,2083,173,518,226,542,399,1060
431640,202302,8928,18011,7460,16124,887,2160,5046,10450,5933,12610
431642,202302,807,1699,504,1177,93,210,239,508,332,718
431643,202302,452,1070,217,587,20,44,81,201,101,245
431645,202302,3113,5428,2488,4652,36,85,2198,3973,2234,4058
431647,202302,369,851,128,367,14,36,24,59,38,95
431650,202302,181,484,134,406,18,61,61,155,79,216
431660,202302,1095,2694,565,1652,88,304,142,342,230,646
431670,202302,1513,3382,913,2327,140,383,442,997,582,1380
431673,202302,250,634,102,326,12,43,34,94,46,137
431675,202302,437,1082,119,393,14,49,18,40,32,89
431680,202302,12738,27999,9684,22823,1829,4946,4988,10483,6817,15429
431690,202302,35340,77689,25994,61975,3873,10846,14675,31751,18548,42597
431695,202302,280,638,175,450,25,98,98,202,123,300
431697,202302,570,1232,437,1034,82,192,245,573,327,765
431700,202302,1834,4030,1435,3377,233,490,750,1782,983,2272
431710,202302,19415,39366,14555,32917,1704,4384,9369,20055,11073,24439
431720,202302,8820,19679,5424,13886,1339,3668,1174,2416,2513,6084
431725,202302,44,112,32,90,10,37,14,32,24,69
431730,202302,5809,12392,3954,9687,727,1984,1977,4410,2704,6394
431740,202302,6582,14654,4508,11362,1001,2840,1383,3019,2384,5859
431750,202302,10908,25253,7917,20515,1895,5186,2739,6736,4634,11922
431755,202302,376,987,104,331,13,45,21,60,34,105
431760,202302,6869,14377,4836,11178,522,1483,2964,6129,3486,7612
431770,202302,2602,5311,1973,4477,353,769,1240,2805,1593,3574
431775,202302,260,627,142,397,33,105,37,83,70,188
431780,202302,2645,5915,1754,4382,319,868,575,1330,894,2198
431790,202302,940,2352,654,1802,142,410,274,722,416,1132
431795,202302,319,760,157,448,23,62,43,107,66,169
431800,202302,10569,23204,6952,17749,1910,5765,846,1758,2756,7523
431805,202302,317,791,70,242,3,5,2,3,5,8
431810,202302,4096,8538,2682,6151,389,1021,1515,3124,1904,4145
431820,202302,2786,6572,2136,5617,488,1446,936,2289,1424,3735
431830,202302,10977,22760,8041,18832,2361,6271,1273,2984,3634,9255
431840,202302,3682,8169,2974,7134,462,1218,1783,4128,2245,5346
431842,202302,595,1403,210,599,39,118,43,103,82,221
431843,202302,368,940,247,683,59,186,104,250,163,436
431844,202302,210,561,80,257,18,59,16,50,34,109
431845,202302,594,1418,391,1029,33,97,233,588,266,685
431846,202302,376,810,327,742,13,34,293,650,306,684
431848,202302,190,471,108,306,11,36,28,59,39,95
431849,202302,432,1038,87,244,11,34,14,29,25,63
431850,202302,5428,13267,4158,10970,1022,2907,1251,3045,2273,5952
431860,202302,815,1791,464,1152,69,192,280,647,349,839
431861,202302,118,299,76,212,16,52,26,58,42,110
431862,202302,614,1793,504,1608,96,364,235,694,331,1058
431870,202302,30719,68515,24787,59775,2365,6638,16372,36905,18737,43543
431880,202302,5119,11906,3788,9692,485,1476,2065,4845,2550,6321
431890,202302,6295,14433,4095,10427,1118,2947,1050,2524,2168,5471
431900,202302,1327,3098,876,2325,149,447,406,938,555,1385
431910,202302,922,2077,367,963,55,159,94,187,149,346
431912,202302,683,1520,562,1335,79,197,362,835,441,1032
431915,202302,1447,2984,1172,2582,68,172,934,1974,1002,2146
431920,202302,1674,3218,1371,2849,34,78,1215,2467,1249,2545
431930,202302,908,2135,623,1640,213,561,197,505,410,1066
431935,202302,102,256,76,213,10,27,14,29,24,56
431936,202302,384,971,219,590,39,112,119,304,158,416
431937,202302,194,475,129,356,30,74,44,113,74,187
431940,202302,3761,8047,2493,5915,169,469,1618,3557,1787,4026
431950,202302,2828,6478,2203,5500,518,1379,910,2122,1428,3501
431960,202302,3766,8400,2841,6845,818,2078,726,1667,1544,3745
431970,202302,527,1283,256,686,44,135,81,173,125,308
431971,202302,93,227,50,145,13,37,13,35,26,72
431973,202302,709,1948,490,1508,46,148,339,1039,385,1187
431975,202302,133,268,43,110,10,29,12,22,22,51
431980,202302,1585,3358,1257,2880,130,395,860,1745,990,2140
431990,202302,8881,18991,6353,15550,419,1275,4209,9775,4628,11050
432000,202302,20122,41920,15383,35005,1748,4692,10174,21338,11922,26030
432010,202302,3516,7595,2392,5867,550,1380,835,1873,1385,3253
432020,202302,1952,4863,1254,3452,380,1102,229,589,609,1691
432023,202302,646,1428,322,837,40,101,142,317,182,418
432026,202302,1260,3079,978,2562,288,764,348,942,636,1706
432030,202302,548,1235,322,850,26,68,185,448,211,516
432032,202302,410,988,271,716,26,77,136,307,162,384
432035,202302,875,2228,733,1994,175,450,335,928,510,1378
432040,202302,1122,2636,539,1507,54,176,237,562,291,738
432045,202302,237,588,140,403,19,65,61,159,80,224
432050,202302,694,1581,515,1288,66,201,257,610,323,811
432055,202302,860,1991,585,1508,179,450,154,403,333,853
432057,202302,181,446,154,387,11,28,105,236,116,264
432060,202302,529,1225,159,482,19,66,29,73,48,139
432065,202302,283,704,220,579,52,158,107,256,159,414
432067,202302,1017,2536,852,2202,101,267,546,1380,647,1647
432070,202302,2077,4736,1546,3828,221,606,779,1734,1000,2340
432080,202302,6484,13491,4843,11102,835,2299,2370,4833,3205,7132
432085,202302,506,1248,395,1078,84,254,194,475,278,729
432090,202302,3447,8027,2116,5586,456,1135,868,2101,1324,3236
432100,202302,1149,2736,566,1651,88,251,98,223,186,474
432110,202302,2788,6464,2063,5272,452,1285,602,1269,1054,2554
432120,202302,4636,11263,3787,9916,613,1855,1933,4588,2546,6443
432130,202302,3554,7865,2947,7034,526,1274,1465,3493,1991,4767
432132,202302,327,828,183,515,25,83,88,213,113,296
432135,202302,1262,2609,876,1993,101,222,551,1270,652,1492
432140,202302,2465,6008,2000,5205,233,695,1318,3247,1551,3942
432143,202302,1949,4628,1467,3882,131,393,904,2300,1035,2693
432145,202302,2244,5528,1491,4080,237,728,484,1041,721,1769
432146,202302,164,415,133,379,45,146,37,97,82,243
432147,202302,690,1766,376,1095,123,368,61,175,184,543
432149,202302,615,1369,290,731,32,81,123,272,155,353
432150,202302,5266,11795,4032,9867,767,2194,2077,4435,2844,6629
432160,202302,8362,18929,6426,16094,1543,4143,2502,5967,4045,10110
432162,202302,233,509,41,117,7,21,9,14,16,35
432163,202302,208,496,44,124,2,6,7,9,9,15
432166,202302,824,2090,668,1812,126,377,243,564,369,941
432170,202302,1923,4811,1351,3802,235,722,527,1309,762,2031
432180,202302,3616,7996,1931,4965,275,813,887,1938,1162,2751
432183,202302,483,1261,377,1044,72,246,181,448,253,694
432185,202302,1090,2545,674,1781,135,406,320,753,455,1159
432190,202302,2832,6139,2082,5023,174,525,1413,3099,1587,3624
432195,202302,1243,2983,777,2128,143,404,246,656,389,1060
432200,202302,4801,10548,3699,8934,286,755,2629,6050,2915,6805
432210,202302,530,1240,365,951,44,121,196,449,240,570
432215,202302,790,1979,664,1766,79,187,366,998,445,1185
432218,202302,272,624,130,345,16,49,46,91,62,140
432220,202302,4626,9832,3358,7843,559,1376,1870,4080,2429,5456
432225,202302,204,503,141,385,23,58,57,158,80,216
432230,202302,942,2135,460,1236,63,204,175,376,238,580
432232,202302,608,1400,389,1033,72,205,177,420,249,625
432234,202302,355,846,193,534,35,88,49,117,84,205
432235,202302,63,159,35,89,6,18,18,39,24,57
432237,202302,381,901,329,815,13,30,273,660,286,690
432240,202302,22263,47572,16714,40441,1577,3760,11372,27045,12949,30805
432250,202302,8942,21799,6820,17802,1192,3494,3701,8894,4893,12388
432252,202302,583,1297,384,935,49,136,198,433,247,569
432253,202302,1151,3006,814,2224,224,658,207,485,431,1143
432254,202302,751,1697,234,657,29,90,42,85,71,175
432255,202302,129,314,83,224,9,27,43,101,52,128
432260,202302,7557,17000,5711,13813,1062,2929,2948,6317,4010,9246
432270,202302,2889,6872,2350,5958,697,1814,806,1977,1503,3791
432280,202302,1547,3711,837,2379,132,418,253,582,385,1000
432285,202302,160,476,33,98,3,9,9,25,12,34
432290,202302,434,1063,284,758,62,194,99,207,161,401
432300,202302,40635,88754,31866,75625,2656,7786,22432,49556,25088,57342
432310,202302,1329,2820,1026,2337,123,255,779,1784,902,2039
432320,202302,246,543,121,318,18,51,43,88,61,139
432330,202302,255,554,94,279,20,56,15,45,35,101
432335,202302,193,551,77,269,9,27,10,27,19,54
432340,202302,386,938,195,585,33,108,72,202,105,310
432345,202302,1070,1973,916,1794,14,36,808,1535,822,1571
432350,202302,382,903,202,581,40,133,62,141,102,274
432360,202302,257,736,53,170,4,13,15,42,19,55
432370,202302,437,987,246,664,25,74,133,340,158,414
432375,202302,644,1470,444,1098,136,356,136,333,272,689
432377,202302,194,566,47,164,4,14,12,32,16,46
432380,202302,2473,6335,1728,4980,280,901,833,2292,1113,3193
500020,202302,4355,9658,3059,7707,303,931,2021,4857,2324,5788
500025,202302,1413,3236,910,2344,108,289,504,1231,612,1520
500060,202302,10466,26268,7551,20518,920,2723,4324,11364,5244,14087
500070,202302,6484,14626,4704,11803,840,2295,2273,5459,3113,7754
500080,202302,1944,4448,1217,3201,197,579,479,1095,676,1674
500085,202302,2560,5908,1797,4605,439,1226,688,1572,1127,2798
500090,202302,2563,6172,1764,4888,276,826,513,1501,789,2327
500100,202302,4965,11497,3712,9572,606,1721,1519,3600,2125,5321
500110,202302,13503,30100,9346,23744,1832,5058,4447,10830,6279,15888
500124,202302,2757,6963,2227,6177,339,916,1356,3783,1695,4699
500150,202302,1972,4063,1386,3290,224,615,764,1638,988,2253
500190,202302,6369,15200,4235,11301,895,2518,1408,3348,2303,5866
500200,202302,3410,7220,2293,5449,199,497,1425,3180,1624,3677
500210,202302,6506,13638,4683,11343,1260,3224,2314,5361,3574,8585
500215,202302,1785,4486,1330,3740,144,427,716,1972,860,2399
500220,202302,4311,10538,3211,8747,436,1270,1711,4292,2147,5562
500230,202302,2674,5738,2068,4915,280,727,1300,2924,1580,3651
500240,202302,5291,14108,3891,11363,536,1706,1588,4584,2124,6290
500260,202302,4102,8169,2640,6190,274,730,1608,3498,1882,4228
500270,202302,192253,418684,127751,318057,16849,48208,60126,132327,76975,180535
500280,202302,1730,3969,1133,3088,180,498,623,1676,803,2174
500290,202302,4692,10610,2888,7637,434,1340,1098,2541,1532,3881
500295,202302,5288,11714,3592,8897,563,1598,1605,3414,2168,5012
500310,202302,1319,2442,865,1886,116,196,485,1050,601,1246
500315,202302,6222,13190,5157,11798,298,783,4311,9553,4609,10336
500320,202302,26168,63365,18274,50795,4470,12308,7403,21333,11873,33641
500325,202302,7709,15570,5505,12649,647,1669,3458,7494,4105,9163
500330,202302,8695,18278,5802,14184,563,1436,3305,7970,3868,9406
500345,202302,2788,6406,1913,5025,339,942,687,1641,1026,2583
500348,202302,2985,6826,2286,5706,187,532,1567,3785,1754,4317
500350,202302,1473,3796,863,2559,100,326,299,807,399,1133
500370,202302,35880,86249,26710,71856,3535,10835,13091,33338,16626,44173
500375,202302,3259,8018,2063,5686,269,807,751,1782,1020,2589
500380,202302,4508,10475,3162,8305,875,2304,510,1344,1385,3648
500390,202302,888,1701,538,1290,80,219,339,806,419,1025
500400,202302,2016,4828,1364,3622,221,659,499,1162,720,1821
500410,202302,3020,6512,2111,5245,239,570,1154,2968,1393,3538
500430,202302,3575,8183,2467,6584,396,1042,959,2782,1355,3824
500440,202302,2023,4523,1137,3031,197,546,432,1146,629,1692
500450,202302,2457,5703,1558,4244,303,850,392,985,695,1835
500460,202302,4872,11869,3045,8460,517,1603,677,1680,1194,3283
500470,202302,3525,8891,2388,6678,551,1718,678,1558,1229,3276
500480,202302,2391,6897,1960,6221,213,720,1359,4350,1572,5070
500490,202302,1461,3237,891,2379,169,531,221,573,390,1104
500500,202302,5169,12678,3457,10086,1090,3656,356,1064,1446,4720
500510,202302,894,2110,608,1607,45,156,378,876,423,1032
500515,202302,2064,4901,1568,4154,221,633,831,2160,1052,2793
500520,202302,4344,11309,3321,9629,724,2081,1586,4682,2310,6763
500525,202302,1254,3340,1002,2963,149,478,564,1600,713,2078
500540,202302,6584,16146,4035,11728,1069,3471,654,1562,1723,5033
500560,202302,7194,16956,5825,15263,263,797,4795,12486,5058,13283
500568,202302,5856,11900,3708,8736,750,1831,1586,3332,2336,5163
500570,202302,11309,24144,7946,18866,1037,2902,4547,9671,5584,12573
500580,202302,3937,9335,2852,7516,708,1935,1151,2954,1859,4889
500600,202302,4678,10913,3402,8942,767,2146,948,2381,1715,4527
500620,202302,10510,25056,7370,19412,1059,2991,3748,9086,4807,12077
500625,202302,702,1761,491,1362,72,229,215,530,287,759
500627,202302,987,2520,619,1879,101,328,182,500,283,828
500630,202302,9902,20752,5964,14667,1232,3342,1912,4237,3144,7579
500635,202302,3282,9808,2419,8588,295,951,1549,6025,1844,6976
500640,202302,2219,4450,1501,3538,73,178,1034,2311,1107,2489
500660,202302,27223,61688,18758,49650,5378,14898,6448,16796,11826,31694
500690,202302,3458,8186,2341,6428,790,2339,764,2013,1554,4352
500710,202302,4240,10367,3044,8353,691,2098,862,2206,1553,4304
500720,202302,6362,15288,4288,11940,824,2473,1346,3493,2170,5966
500730,202302,1311,2976,739,1982,147,375,238,625,385,1000
500740,202302,5850,13058,3748,9877,889,2397,1358,3446,2247,5843
500750,202302,1446,3296,1033,2636,136,393,474,1065,610,1458
500755,202302,1434,3457,914,2519,156,476,263,605,419,1081
500769,202302,6558,15246,3656,10032,882,2447,452,1072,1334,3519
500770,202302,1764,4411,1236,3579,237,726,414,1147,651,1873
500780,202302,1607,3767,1044,2804,178,540,257,537,435,1077
500790,202302,9625,23846,6979,19207,1356,4084,2500,6614,3856,10698
500793,202302,2680,6275,1934,5018,361,1015,795,1833,1156,2848
500795,202302,3829,7966,3113,7047,186,424,2576,5838,2762,6262
500797,202302,1037,2420,709,1836,227,647,208,486,435,1133
500800,202302,4446,9446,2828,7081,689,1960,700,1686,1389,3646
500830,202302,26824,61360,18082,46160,3760,10276,6521,15132,10281,25408
500840,202302,1797,4054,1153,2875,122,325,572,1272,694,1597
510010,202302,2247,4531,1616,3752,207,470,1079,2492,1286,2962
510020,202302,5170,12434,2884,8127,481,1390,724,1792,1205,3182
510025,202302,9572,21511,6286,16460,680,1949,3492,8558,4172,10507
510030,202302,3959,8120,2589,6043,254,645,1286,2898,1540,3543
510035,202302,1385,3493,893,2703,237,731,302,991,539,1722
510040,202302,3066,6260,2297,5304,299,662,1399,3310,1698,3972
510050,202302,2879,5411,2035,4375,213,550,1474,3012,1687,3562
510060,202302,1984,4723,1372,3648,332,946,289,600,621,1546
510080,202302,1940,4657,1257,3555,186,573,460,1111,646,1684
510100,202302,888,1850,638,1488,72,194,385,813,457,1007
510120,202302,334,562,198,406,10,17,156,308,166,325
510125,202302,2598,6190,1981,5238,239,752,933,2197,1172,2949
510130,202302,2078,4748,1489,3865,303,874,720,1720,1023,2594
510140,202302,3807,9404,2609,7822,1042,3432,718,2158,1760,5590
510160,202302,2511,5342,1964,4661,45,124,1772,4175,1817,4299
510170,202302,6405,15116,4898,12793,891,2584,2382,5873,3273,8457
510180,202302,19217,39095,13180,30912,2010,5177,6798,15796,8808,20973
510185,202302,2184,5322,1434,4248,531,1659,392,1329,923,2988
510190,202302,3098,7958,1966,6138,478,1632,434,1335,912,2967
510250,202302,22584,51333,16855,43020,2438,6824,9533,23970,11971,30794
510260,202302,2262,9060,1897,8466,277,1204,1117,5641,1394,6845
510263,202302,4884,12709,3305,9681,571,1831,776,1878,1347,3709
510267,202302,7173,19342,4301,13054,710,2268,817,2094,1527,4362
510268,202302,1556,3846,1094,3079,311,950,213,458,524,1408
510269,202302,1167,2958,769,2243,151,487,320,853,471,1340
510270,202302,3725,9925,2614,8062,390,1335,1081,3224,1471,4559
510279,202302,2259,5493,1305,3797,193,611,384,980,577,1591
510285,202302,1317,3252,854,2460,216,696,272,677,488,1373
510300,202302,5236,11504,3968,9865,261,690,2947,7240,3208,7930
510305,202302,1885,4817,1284,3777,275,823,403,1172,678,1995
510310,202302,1339,3069,952,2471,253,628,346,939,599,1567
510320,202302,5147,11604,3515,9038,768,2200,1078,2408,1846,4608
510325,202302,5603,15283,3850,11939,875,2897,810,2433,1685,5330
510330,202302,3315,8621,2241,6890,547,1856,876,2603,1423,4459
510335,202302,6227,16243,4748,13914,884,2825,2424,6970,3308,9795
510336,202302,640,1667,462,1402,72,199,243,802,315,1001
510337,202302,1876,4998,1237,3888,431,1494,295,839,726,2333
510340,202302,127335,265780,88621,212278,17575,48875,39454,84475,57029,133350
510343,202302,1576,3530,1066,2733,139,397,563,1333,702,1730
510345,202302,1711,4172,1300,3455,241,690,676,1602,917,2292
510350,202302,4069,9588,2723,7460,783,2216,625,1650,1408,3866
510360,202302,2475,4551,1483,3419,60,118,1082,2583,1142,2701
510370,202302,2245,5878,1727,5102,309,879,991,3027,1300,3906
510380,202302,676,1534,399,1083,48,153,162,416,210,569
510385,202302,1548,4745,1169,4080,110,444,784,2797,894,3241
510390,202302,1818,3970,1249,3311,228,661,776,2003,1004,2664
510395,202302,874,1754,588,1356,34,73,418,968,452,1041
510410,202302,6753,16366,5082,13698,701,1976,3217,8596,3918,10572
510420,202302,3333,6021,2311,4698,65,145,1858,3673,1923,3818
510450,202302,657,1485,391,1056,87,234,136,332,223,566
510452,202302,1177,3035,882,2494,128,385,497,1368,625,1753
510454,202302,1522,3680,1057,2912,190,492,586,1735,776,2227
510455,202302,1149,2879,757,2155,155,488,291,746,446,1234
510460,202302,2485,5820,1753,4738,638,2003,475,867,1113,2870
510480,202302,6097,13857,4024,10168,715,2007,1709,3821,2424,5828
510490,202302,2175,4950,1625,4257,278,745,989,2607,1267,3352
510500,202302,1851,4248,1126,3145,268,806,279,741,547,1547
510510,202302,5005,12847,3499,10388,1045,3387,998,2877,2043,6264
510515,202302,6916,16723,4830,13219,900,2672,1864,4658,2764,7330
510517,202302,1998,4761,1391,3894,532,1668,362,866,894,2534
510520,202302,2828,5509,1536,3833,164,440,677,1737,841,2177
510523,202302,1464,3207,1045,2592,149,401,619,1447,768,1848
510525,202302,10508,26977,7752,21773,1465,4448,2795,7090,4260,11538
510530,202302,708,1661,537,1432,46,137,375,980,421,1117
510550,202302,3277,8622,2481,7305,497,1553,1220,3469,1717,5022
510558,202302,2813,7087,2071,5981,279,769,1060,3237,1339,4006
510560,202302,2379,6297,1544,4734,375,1194,312,985,687,2179
510562,202302,7666,16675,5737,13569,895,2263,3036,6628,3931,8891
510590,202302,4102,9191,2989,7777,286,794,2128,5495,2414,6289
510600,202302,1545,3078,1075,2438,258,771,476,815,734,1586
510610,202302,3518,7705,2468,6322,343,1048,1463,3543,1806,4591
510615,202302,3593,8345,2526,6711,398,1123,1406,3673,1804,4796
510617,202302,1318,3578,1055,3196,136,449,742,2315,878,2764
510618,202302,1627,3919,1168,3217,215,696,606,1566,821,2262
510619,202302,917,2207,520,1497,109,316,106,236,215,552
510620,202302,1697,3622,842,2294,306,936,72,141,378,1077
510621,202302,1970,4943,1201,3567,268,830,326,841,594,1671
510622,202302,7080,18217,4534,13058,1245,3818,628,1545,1873,5363
510623,202302,3479,7921,2498,6448,519,1455,964,2375,1483,3830
510624,202302,2052,5090,1117,3403,119,408,215,570,334,978
510625,202302,4506,10138,2806,7295,521,1483,954,2391,1475,3874
510626,202302,1732,4087,1172,3230,279,870,294,768,573,1638
510627,202302,789,1906,452,1287,115,346,120,358,235,704
510628,202302,1838,3816,1162,2968,368,1068,421,968,789,2036
510629,202302,2205,5697,1433,4270,310,1035,359,992,669,2027
510630,202302,4265,10904,2743,8279,618,1925,659,2120,1277,4045
510631,202302,744,1598,571,1361,24,47,442,1064,466,1111
510637,202302,4585,9970,3254,8141,839,2377,1162,2709,2001,5086
510642,202302,7420,18597,5749,16240,1003,3262,3338,9062,4341,12324
510645,202302,1260,2340,753,1700,182,394,334,769,516,1163
510650,202302,9495,20637,7466,18435,983,1558,5365,14671,6348,16229
510665,202302,2137,4386,1353,3198,292,627,541,1378,833,2005
510670,202302,521,1067,319,802,37,89,164,411,201,500
510675,202302,8431,21530,5772,16706,1401,4554,1131,2805,2532,7359
510677,202302,2799,6672,2003,5515,357,1078,1087,2933,1444,4011
510680,202302,878,2103,494,1436,90,280,132,323,222,603
510682,202302,2187,5697,1635,4837,517,1717,561,1557,1078,3274
510685,202302,663,1712,484,1392,49,130,281,807,330,937
510700,202302,5468,11853,3793,9537,378,1096,2564,6198,2942,7294
510704,202302,14420,31915,9817,24565,2270,6118,3097,6826,5367,12944
510706,202302,3096,8366,2155,6796,400,1308,854,2869,1254,4177
510710,202302,3723,8567,2341,6095,624,1601,579,1370,1203,2971
510715,202302,793,1589,505,1187,55,158,310,685,365,843
510718,202302,2828,6215,1719,4740,350,1011,773,2367,1123,3378
510719,202302,588,1177,341,836,44,130,154,305,198,435
510720,202302,1137,2428,760,1910,168,486,318,708,486,1194
510724,202302,1104,2952,749,2273,102,354,325,892,427,1246
510726,202302,1105,2010,650,1469,68,150,370,814,438,964
510729,202302,726,1604,335,901,34,106,106,275,140,381
510730,202302,3687,8272,2538,6576,347,1056,1371,3219,1718,4275
510735,202302,1632,4152,1320,3712,111,284,1051,2987,1162,3271
510740,202302,1222,2716,847,2102,82,240,525,1151,607,1391
510757,202302,647,1948,505,1714,134,510,207,654,341,1164
510760,202302,57730,119205,36285,88292,7275,20211,13607,28780,20882,48991
510770,202302,5303,10626,3778,8737,257,557,2651,6237,2908,6794
510774,202302,497,1198,344,973,63,178,183,541,246,719
510775,202302,849,2033,537,1549,118,368,143,375,261,743
510776,202302,927,2250,631,1682,114,342,292,743,406,1085
510777,202302,1730,4328,1241,3698,240,843,735,2021,975,2864
510779,202302,1005,2519,742,2093,83,212,460,1359,543,1571
510780,202302,5452,12262,3937,10100,725,1774,1979,5406,2704,7180
510785,202302,2630,6402,1547,4491,339,1036,432,1225,771,2261
510787,202302,4394,11521,3021,8914,1018,3121,295,757,1313,3878
510788,202302,666,1448,437,1113,67,154,186,539,253,693
510790,202302,24877,60869,15909,45390,3134,9824,1566,3802,4700,13626
510792,202302,13584,35552,8902,26745,2036,6682,1898,4841,3934,11523
510794,202302,1615,4142,1147,3394,344,1165,204,476,548,1641
510795,202302,13836,32610,9864,26035,2156,6362,3487,8186,5643,14548
510800,202302,1824,4597,1259,3679,343,1106,156,320,499,1426
510805,202302,1883,4875,1214,3669,246,807,446,1229,692,2036
510810,202302,837,1594,541,1210,166,333,261,613,427,946
510820,202302,964,1755,562,1265,27,68,376,802,403,870
510830,202302,1094,2397,835,2070,91,234,552,1397,643,1631
510835,202302,762,1634,488,1254,56,162,300,728,356,890
510840,202302,80323,155448,58605,129374,9193,19892,35591,78709,44784,98601
510850,202302,2220,5359,1445,4161,425,1383,97,158,522,1541
510860,202302,3341,8133,2234,6453,774,2415,408,1171,1182,3586
510880,202302,895,2390,647,1962,185,576,131,377,316,953
510885,202302,752,1771,487,1359,92,231,114,321,206,552
510890,202302,1056,2757,756,2234,221,716,195,533,416,1249
510895,202302,1863,4407,1229,3346,212,683,581,1395,793,2078
520005,202302,4702,11253,3764,10031,1144,2718,1443,4609,2587,7327
520010,202302,3665,8932,2730,7218,572,1678,1104,2486,1676,4164
520013,202302,4500,10541,2938,7758,745,1970,766,2124,1511,4094
520015,202302,641,1505,469,1253,104,269,166,474,270,743
520017,202302,1510,3504,1049,2785,189,573,445,1035,634,1608
520020,202302,703,1259,546,1080,50,93,417,806,467,899
520025,202302,50285,121377,43013,111356,6229,17010,27296,69187,33525,86197
520030,202302,9048,18989,7538,16998,589,1302,5744,12737,6333,14039
520050,202302,498,1146,283,748,52,126,117,308,169,434
520055,202302,2114,4926,1296,3281,205,501,540,1267,745,1768
520060,202302,2388,5657,1628,4386,297,887,409,1062,706,1949
520080,202302,2342,5439,1793,4724,364,915,878,2403,1242,3318
520082,202302,1005,2384,703,1873,127,360,289,797,416,1157
520085,202302,1270,2910,1019,2579,237,591,477,1177,714,1768
520090,202302,1143,2044,839,1720,115,155,641,1388,756,1543
520110,202302,56416,138389,38836,109582,10199,30975,3076,7489,13275,38464
520120,202302,309,696,168,449,27,88,65,152,92,240
520130,202302,4925,10859,3786,9123,709,1796,1583,3619,2292,5415
520140,202302,65178,159227,45794,127322,14752,43952,5714,15672,20466,59624
520145,202302,742,1600,468,1203,105,281,163,375,268,656
520150,202302,862,1919,655,1657,78,194,369,893,447,1087
520160,202302,1096,2469,748,1861,140,316,310,785,450,1101
520170,202302,5929,11628,3934,9221,483,1188,2574,5844,3057,7032
520180,202302,3509,8049,2853,7151,370,1089,1847,4411,2217,5500
520215,202302,2268,4981,1688,4158,196,552,1026,2392,1222,2944
520235,202302,954,1870,634,1441,93,240,393,836,486,1076
520250,202302,2160,5035,1585,4174,594,1687,237,736,831,2423
520260,202302,929,2058,566,1474,104,268,198,504,302,772
520280,202302,1069,2212,839,1882,180,399,420,924,600,1323
520310,202302,1251,2513,833,1913,182,495,388,851,570,1346
520320,202302,2522,6008,1918,5098,252,673,1003,2690,1255,3363
520330,202302,6458,15033,5025,12749,692,2111,2977,6908,3669,9019
520340,202302,2819,5752,1667,4128,176,394,799,2103,975,2497
520350,202302,3928,8926,2804,7248,921,2484,814,2091,1735,4575
520355,202302,2401,6047,1757,4885,508,1495,284,681,792,2176
520357,202302,1093,2342,795,1929,32,82,634,1511,666,1593
520360,202302,1015,2337,795,2003,128,375,375,858,503,1233
520380,202302,1708,4041,1027,2821,165,487,308,716,473,1203
520390,202302,1502,3284,955,2541,245,742,197,542,442,1284
520393,202302,870,1861,595,1458,83,220,269,601,352,821
520396,202302,1110,2521,933,2256,59,140,649,1487,708,1627
520400,202302,2030,4428,1575,3841,97,247,1159,2812,1256,3059
520410,202302,2817,5674,1945,4445,277,726,1106,2333,1383,3059
520420,202302,478,1000,375,847,23,66,279,596,302,662
520425,202302,1908,4402,1072,2859,285,821,209,453,494,1274
520430,202302,3117,6821,1871,4763,378,973,328,731,706,1704
520440,202302,3750,8581,2182,5814,438,1303,471,1155,909,2458
520450,202302,18034,40295,12498,31740,3172,8399,3442,8480,6614,16879
520455,202302,1015,2432,710,1988,202,584,205,583,407,1167
520460,202302,1329,2889,1018,2478,221,477,581,1500,802,1977
520465,202302,1134,2442,926,2176,54,153,710,1630,764,1783
520470,202302,2962,6592,2305,5783,759,2056,867,2164,1626,4220
520480,202302,1244,3105,921,2578,208,598,383,1010,591,1608
520485,202302,1888,5180,1503,4589,256,857,747,2149,1003,3006
520490,202302,5436,12851,4174,10970,649,1841,2437,6178,3086,8019
520495,202302,2061,3928,1558,3271,119,253,1142,2355,1261,2608
520500,202302,2249,5026,1684,4108,217,622,950,2096,1167,2718
520505,202302,1215,2259,951,1941,108,180,718,1466,826,1646
520510,202302,12846,28816,9759,24288,1622,4737,4804,10912,6426,15649
520520,202302,1467,3417,1133,2931,305,845,453,1128,758,1973
520530,202302,3142,7679,2286,6207,435,1176,1061,3054,1496,4230
520540,202302,3878,9372,2627,7089,453,1315,839,1973,1292,3288
520545,202302,1864,4170,1451,3557,352,867,647,1545,999,2412
520547,202302,1733,4124,1348,3482,273,700,675,1721,948,2421
520549,202302,21715,49987,18037,44831,2203,6139,12024,28440,14227,34579
520551,202302,6522,14714,5451,13213,464,1397,4099,9419,4563,10816
520552,202302,1199,2849,940,2477,201,522,467,1266,668,1788
520570,202302,682,1438,432,1055,72,154,187,451,259,605
520580,202302,2745,5633,2077,4863,392,869,1161,2754,1553,3623
520590,202302,1733,3992,1198,3143,276,750,450,1122,726,1872
520620,202302,12384,28814,10041,25583,1801,4999,5557,13670,7358,18669
520630,202302,1098,2538,773,2029,88,240,355,890,443,1130
520640,202302,2862,6496,2138,5258,518,1293,648,1640,1166,2933
520650,202302,1348,2662,992,2192,218,437,492,1142,710,1579
520660,202302,647,1528,378,1070,75,232,97,269,172,501
520670,202302,1220,2862,1004,2544,97,223,682,1695,779,1918
520680,202302,1053,2252,840,1962,125,246,527,1244,652,1490
520690,202302,432,1000,294,781,88,221,80,194,168,415
520710,202302,548,1213,373,933,21,55,240,561,261,616
520725,202302,1752,3886,1175,2960,211,585,548,1309,759,1894
520735,202302,1154,2517,786,1947,227,530,247,608,474,1138
520740,202302,3175,6682,2294,5516,487,1175,1048,2508,1535,3683
520750,202302,936,1944,674,1577,99,245,387,852,486,1097
520753,202302,1646,3932,1249,3267,224,666,591,1412,815,2078
520760,202302,1838,3492,1544,3148,32,65,1419,2896,1451,2961
520780,202302,1911,4266,1399,3544,198,501,700,1701,898,2202
520790,202302,3960,8753,2718,6793,427,975,1402,3677,1829,4652
520800,202302,23764,54164,18648,46770,3222,8266,10497,26289,13719,34555
520810,202302,1503,2976,1113,2529,261,591,542,1341,803,1932
520815,202302,736,2086,537,1663,95,302,159,473,254,775
520830,202302,2202,4359,1583,3627,95,219,1205,2706,1300,2925
520840,202302,3692,8990,2956,8013,812,2428,1019,2717,1831,5145
520850,202302,1167,2343,882,1954,172,445,446,928,618,1373
520860,202302,11948,29041,8815,23729,2114,5967,3140,8047,5254,14014
520870,202302,195527,415179,142545,337162,26268,66175,66145,145078,92413,211253
520880,202302,12238,31839,9825,27610,2060,5937,4070,11009,6130,16946
520890,202302,6164,12582,4365,9936,670,1800,2352,4895,3022,6695
520910,202302,5970,13842,3944,10438,796,2255,1078,2514,1874,4769
520915,202302,1011,2441,682,1810,124,371,283,684,407,1055
520920,202302,5861,11819,4289,9937,825,1761,2327,5562,3152,7323
520929,202302,791,1756,600,1475,108,212,260,684,368,896
520940,202302,1194,2886,933,2500,76,248,713,1851,789,2099
520945,202302,581,1199,423,990,38,75,252,579,290,654
520960,202302,1430,2953,1097,2487,385,822,392,978,777,1800
520970,202302,4605,10869,3459,9112,1174,3155,706,1950,1880,5105
520980,202302,983,2080,716,1739,98,242,354,804,452,1046
520990,202302,3921,8556,3199,7689,516,1095,2180,5368,2696,6463
520993,202302,1547,3528,1021,2591,247,652,353,837,600,1489
520995,202302,3186,7371,2338,6079,594,1533,586,1610,1180,3143
521000,202302,12244,29098,8224,21907,1275,3530,2682,6497,3957,10027
521010,202302,5091,11825,3738,9566,559,1597,1963,4662,2522,6259
521015,202302,989,2255,692,1745,45,119,448,1059,493,1178
521020,202302,5565,12787,3443,9050,749,2099,890,2178,1639,4277
521030,202302,1008,1719,785,1431,23,51,677,1185,700,1236
521040,202302,10790,24589,7909,20187,1920,4934,2491,6650,4411,11584
521056,202302,1302,3143,898,2468,265,714,189,554,454,1268
521060,202302,1244,3021,863,2323,185,543,294,752,479,1295
521080,202302,1272,2594,701,1738,125,321,276,640,401,961
521090,202302,3939,9911,2653,7380,621,1889,285,706,906,2595
521100,202302,2483,5051,1848,4206,246,596,1165,2619,1411,3215
521120,202302,6410,14136,4832,12145,1044,2412,1647,4846,2691,7258
521130,202302,1274,2821,598,1595,60,171,308,808,368,979
521140,202302,2069,4730,1509,3787,194,498,860,2024,1054,2522
521150,202302,18027,37585,11835,28716,2859,7615,4783,11010,7642,18625
521160,202302,1036,1959,654,1383,64,120,429,868,493,988
521170,202302,1375,2954,996,2391,152,398,457,999,609,1397
521180,202302,11061,26178,8564,22184,1667,4664,3901,9763,5568,14427
521190,202302,14555,33883,9520,25818,2220,6530,2814,7041,5034,13571
521200,202302,892,2019,603,1566,88,254,270,630,358,884
521205,202302,764,1666,587,1400,27,66,459,1047,486,1113
521210,202302,1048,2613,635,1779,142,434,150,306,292,740
521220,202302,4938,10709,3282,8153,806,2275,1268,2763,2074,5038
521225,202302,548,1047,413,901,33,70,320,699,353,769
521230,202302,1847,4234,1528,3814,649,1694,463,1121,1112,2815
521250,202302,48250,109249,39406,97404,8885,23813,21589,50911,30474,74724
521260,202302,662,1396,494,1161,71,199,283,604,354,803
521270,202302,2685,5786,2223,5205,221,475,1599,3804,1820,4279
521280,202302,2317,5713,1723,4777,342,1025,651,1760,993,2785
521290,202302,721,1508,486,1204,48,131,292,672,340,803
521295,202302,1477,3005,1110,2528,168,355,665,1482,833,1837
521300,202302,2307,5205,1739,4381,348,849,892,2261,1240,3110
521305,202302,826,1764,567,1410,55,149,354,847,409,996
521308,202302,6068,14620,4241,11397,388,1150,2584,6549,2972,7699
521310,202302,14035,32498,9674,24939,1897,5382,3851,9034,5748,14416
521340,202302,500,1060,339,842,28,70,189,444,217,514
521350,202302,2406,5662,1821,4797,129,380,1296,3299,1425,3679
521370,202302,1594,3872,1028,2957,311,972,172,511,483,1483
521375,202302,2009,4853,1350,3730,261,717,322,944,583,1661
521377,202302,1686,3327,1222,2750,141,256,878,2107,1019,2363
521380,202302,8011,19893,5177,14876,793,2406,1000,2917,1793,5323
521385,202302,870,1900,649,1614,95,213,345,904,440,1117
521390,202302,853,2066,579,1630,140,453,106,268,246,721
521400,202302,3788,8119,2992,7092,396,995,1808,4143,2204,5138
521405,202302,1700,4187,1138,3140,132,397,549,1427,681,1824
521410,202302,1180,2596,933,2238,229,491,476,1196,705,1687
521440,202302,1855,4174,1412,3528,422,1003,601,1558,1023,2561
521450,202302,5332,14406,3992,11900,988,2992,874,2627,1862,5619
521460,202302,7834,18411,5608,14537,1405,3841,1880,4632,3285,8473
521470,202302,1053,2413,728,1843,133,308,329,782,462,1090
521480,202302,651,1346,445,1019,63,158,236,460,299,618
521483,202302,2961,6599,2137,5400,592,1459,780,2010,1372,3469
521486,202302,2197,4860,1685,4133,155,286,1084,2656,1239,2942
521487,202302,600,1284,437,1069,82,192,268,660,350,852
521490,202302,1067,2576,790,2141,36,127,565,1430,601,1557
521500,202302,2600,6168,1972,5304,191,704,1158,2859,1349,3563
521520,202302,1058,2225,824,1918,122,252,485,1130,607,1382
521523,202302,18585,49313,15309,44226,4448,13403,5532,15257,9980,28660
521525,202302,1337,2930,1011,2466,96,296,659,1506,755,1802
521530,202302,2838,6933,1808,4952,335,933,497,1243,832,2176
521540,202302,995,2349,718,1911,166,500,288,699,454,1199
521550,202302,2151,5109,1132,3095,209,607,259,736,468,1343
521560,202302,7194,16659,5246,14035,1481,4029,2114,5845,3595,9874
521565,202302,847,1950,586,1525,103,268,259,659,362,927
521570,202302,5324,13224,3721,10361,723,2226,488,1321,1211,3547
521580,202302,699,1496,453,1108,76,199,181,394,257,593
521590,202302,1087,2170,785,1761,98,229,477,1005,575,1234
521600,202302,532,1294,327,909,57,172,151,374,208,546
521630,202302,2146,4330,1337,3189,407,1003,341,740,748,1743
521640,202302,2462,5433,1566,4086,346,1033,459,1091,805,2124
521645,202302,646,1581,373,1089,154,439,21,42,175,481
521680,202302,1826,4504,1420,3872,354,999,553,1461,907,2460
521690,202302,663,1533,553,1391,86,233,315,765,401,998
521710,202302,4466,10046,2968,7595,503,1456,837,1786,1340,3242
521720,202302,3122,6475,2005,4825,254,664,1097,2550,1351,3214
521730,202302,5176,12891,3794,10606,1001,3152,874,1997,1875,5149
521740,202302,5932,13705,4684,11924,1451,4017,1488,3402,2939,7419
521760,202302,24713,56220,20244,50122,3870,10921,11644,27115,15514,38036
521770,202302,4177,9084,2708,6845,525,1363,603,1477,1128,2840
521800,202302,8997,21388,6417,17254,1934,5316,1728,5079,3662,10395
521805,202302,1434,2757,946,2123,201,417,462,1109,663,1526
521810,202302,940,2005,680,1647,128,308,378,929,506,1237
521830,202302,7674,18565,6215,16349,506,1552,4439,11228,4945,12780
521839,202302,1133,2381,867,1974,81,214,611,1280,692,1494
521850,202302,9011,19342,5639,14313,1715,4296,683,1642,2398,5938
521860,202302,2066,5221,1430,4071,244,754,438,1121,682,1875
521870,202302,886,2247,652,1833,114,364,238,562,352,926
521878,202302,1040,2533,681,1821,63,177,355,873,418,1050
521880,202302,30940,69993,22449,57044,4650,12707,9862,23413,14512,36120
521890,202302,4314,10134,2927,7809,757,2014,776,1938,1533,3952
521900,202302,1702,3774,915,2452,233,520,19,46,252,566
521910,202302,1798,3629,1272,2984,311,702,486,1103,797,1805
521920,202302,693,1625,539,1390,65,201,332,790,397,991
521925,202302,1020,2403,755,2013,152,448,327,823,479,1271
521930,202302,6912,15569,4669,12293,1392,3094,1754,5125,3146,8219
521935,202302,1257,2825,869,2181,81,216,517,1215,598,1431
521940,202302,1695,3433,1125,2649,188,488,593,1333,781,1821
521945,202302,817,1900,565,1465,86,221,295,743,381,964
521950,202302,920,2019,643,1596,98,250,304,739,402,989
521960,202302,848,2047,578,1550,56,187,337,815,393,1002
521970,202302,3543,7327,2694,6293,247,489,2001,4820,2248,5309
521971,202302,955,2180,654,1699,161,416,165,391,326,807
521973,202302,2078,4974,1537,4054,186,482,903,2304,1089,2786
521975,202302,17730,40880,14480,36364,2437,6720,8579,20682,11016,27402
521980,202302,2861,6138,2147,5207,152,376,1609,3859,1761,4235
521990,202302,1858,4078,1570,3677,271,712,974,2246,1245,2958
522000,202302,3441,8171,2652,7159,922,2650,942,2582,1864,5232
522005,202302,474,1014,309,775,51,139,113,271,164,410
522010,202302,5891,13567,4166,10765,896,2480,1472,3513,2368,5993
522015,202302,1361,3223,1011,2702,271,752,409,1048,680,1800
522020,202302,6870,14878,4634,11546,953,2464,2023,4989,2976,7453
522026,202302,939,2269,605,1694,92,312,178,405,270,717
522028,202302,651,1458,452,1127,71,212,223,488,294,700
522040,202302,4796,9521,3349,7589,389,995,2116,4383,2505,5378
522045,202302,26603,66584,20085,55975,4370,12928,5204,13716,9574,26644
522050,202302,1526,3613,1091,2889,198,589,471,1076,669,1665
522060,202302,3894,9480,2827,7804,529,1392,1223,3396,1752,4788
522068,202302,2346,5009,1885,4478,121,239,1520,3650,1641,3889
522070,202302,1060,2050,868,1773,25,50,758,1505,783,1555
522100,202302,1123,2590,731,1930,105,284,328,807,433,1091
522108,202302,1448,2931,1140,2525,52,129,898,1902,950,2031
522119,202302,2514,5295,2012,4688,346,701,1209,2874,1555,3575
522130,202302,673,1482,516,1275,41,86,387,980,428,1066
522140,202302,31716,74882,22429,58734,4729,13229,6778,16028,11507,29257
522145,202302,978,2173,689,1754,138,396,371,909,509,1305
522150,202302,1403,3062,942,2354,214,546,287,685,501,1231
522155,202302,1261,3008,949,2520,135,325,544,1441,679,1766
522157,202302,932,1847,758,1643,46,93,581,1259,627,1352
522160,202302,7881,18549,5126,13863,1312,3827,515,1472,1827,5299
522170,202302,3425,8101,2637,6936,366,957,1593,4167,1959,5124
522180,202302,938,1993,627,1448,115,280,192,450,307,730
522185,202302,31235,70182,23074,59485,9283,26068,4185,11321,13468,37389
522190,202302,1020,2125,692,1631,136,339,311,650,447,989
522200,202302,2647,6629,1962,5481,493,1381,680,1867,1173,3248
522205,202302,2000,4546,1462,3739,481,1298,379,904,860,2202
522220,202302,1477,3219,1086,2706,138,328,638,1638,776,1966
522230,202302,1669,3674,1306,3152,185,505,789,1834,974,2339
530010,202302,340093,798756,286898,720116,40239,110091,172039,409753,212278,519844
110001,202301,4912,12720,3297,9753,764,2517,1055,2976,1819,5493
110002,202301,16994,40134,12441,32797,3158,8996,3510,8835,6668,17831
110003,202301,908,2498,658,2016,161,523,145,386,306,909
110004,202301,17391,40924,12077,32116,2616,7405,4186,10546,6802,17951
110005,202301,3132,7628,2237,6237,519,1458,682,1972,1201,3430
110006,202301,1762,4707,1115,3415,201,675,225,627,426,1302
110007,202301,1515,3633,974,2737,281,808,208,657,489,1465
110008,202301,4291,10033,3209,8563,648,1521,1760,5270,2408,6791
110009,202301,5553,14345,3601,10895,787,2600,1314,3756,2101,6356
110010,202301,10124,27880,7803,23908,1823,5077,3616,12625,5439,17702
110011,202301,9437,23018,6567,18091,1824,5236,1429,3761,3253,8997
110012,202301,21627,50254,14471,38599,3655,9910,3334,8346,6989,18256
110013,202301,7122,18693,4934,14552,1809,5699,818,2391,2627,8090
110014,202301,4722,11358,3219,8650,487,1446,1591,4071,2078,5517
110015,202301,7530,17776,4909,13144,995,3022,1510,3355,2505,6377
110018,202301,5594,13122,3587,9771,737,2136,881,2154,1618,4290
110020,202301,115911,242411,88836,206901,18470,44201,46146,107392,64616,151593
110025,202301,5893,13314,4236,10611,664,1873,2242,5277,2906,7150
110026,202301,693,1733,496,1412,111,333,146,423,257,756
110028,202301,9157,21789,5899,16277,1426,4420,666,1767,2092,6187
110029,202301,1915,4440,1191,3241,215,573,466,1268,681,1841
110030,202301,17338,38099,11067,28902,3127,8822,1520,4043,4647,12865
110032,202301,4570,11724,2782,8216,879,2616,477,1465,1356,4081
110033,202301,5862,15935,4407,13319,1372,4274,1425,4518,2797,8792
110034,202301,3876,8659,2629,6930,927,2715,615,1745,1542,4460
110037,202301,1935,5345,1359,4276,362,1182,408,1267,770,2449
110040,202301,3585,9280,2597,7572,669,2124,679,1817,1348,3941
110045,202301,5572,14766,4085,12152,1154,3716,1347,3924,2501,7640
110050,202301,2105,5323,1393,4107,451,1513,184,440,635,1953
110060,202301,1137,3134,754,2268,188,590,175,506,363,1096
110070,202301,1890,5423,1341,4246,344,1196,316,864,660,2060
110080,202301,8020,17854,6014,15238,1332,3480,2873,7504,4205,10984
110090,202301,711,1832,493,1434,118,396,144,392,262,788
110092,202301,1660,4439,1184,3580,267,834,563,1711,830,2545
110094,202301,3451,9385,2565,7748,967,3089,348,1090,1315,4179
110100,202301,2166,5739,1709,4939,601,1823,538,1558,1139,3381
110110,202301,2197,5498,1570,4529,471,1472,303,923,774,2395
110120,202301,1620,4251,1140,3345,279,858,314,893,593,1751
110130,202301,3360,7789,2067,5557,406,1124,260,663,666,1787
110140,202301,3029,7885,2255,6444,461,1463,1005,2688,1466,4151
110143,202301,1734,4383,1260,3562,347,1098,396,1024,743,2122
110145,202301,1161,2807,713,1985,175,477,277,796,452,1273
110146,202301,638,1563,429,1222,125,338,149,470,274,808
110147,202301,955,2261,646,1713,87,259,325,761,412,1020
110148,202301,1170,3012,615,1836,143,476,66,145,209,621
110149,202301,4224,10048,2912,8061,989,2856,679,1967,1668,4823
110150,202301,3034,7299,1961,5644,609,1928,307,931,916,2859
110155,202301,1034,2779,717,2054,136,438,293,740,429,1178
110160,202301,1763,4860,1283,3890,453,1423,228,692,681,2115
110170,202301,2556,6034,1659,4438,255,760,943,2322,1198,3082
110175,202301,2627,6832,1815,5179,328,1009,784,2103,1112,3112
110180,202301,1615,4043,1141,3171,167,491,536,1452,703,1943
120001,202301,4326,10905,3496,9703,486,1578,2279,6132,2765,7710
120005,202301,2427,8210,2166,7792,257,949,1589,5846,1846,6795
120010,202301,7665,18245,6642,16863,571,1336,5147,13150,5718,14486
120013,202301,3106,8837,2667,8233,832,2487,1147,3991,1979,6478
120017,202301,3781,9085,3208,8301,438,1093,2094,5701,2532,6794
120020,202301,19659,60582,18154,58016,1274,4467,14331,45650,15605,50117
120025,202301,4706,10559,3884,9641,567,1404,2556,6623,3123,8027
120030,202301,7681,27350,7107,26405,505,2187,5325,20282,5830,22469
120032,202301,2107,8291,1979,8044,101,615,1660,6635,1761,7250
120033,202301,5362,16112,5022,15553,127,557,4411,13463,4538,14020
120034,202301,3586,10639,3109,9890,166,683,2586,8080,2752,8763
120035,202301,5135,15830,4762,15216,259,962,4069,12888,4328,13850
120038,202301,4019,10350,3467,9535,513,1489,2112,5932,2625,7421
120039,202301,2476,9301,2307,8986,152,745,1837,7131,1989,7876
120040,202301,76931,185034,66698,170491,8439,22951,44125,110962,52564,133913
120042,202301,4348,13075,3999,12484,201,771,3303,10160,3504,10931
120043,202301,1819,6451,1540,6051,55,349,1275,4918,1330,5267
120045,202301,7434,16865,6224,15417,565,1500,4703,11642,5268,13142
120050,202301,12300,36388,11329,35063,526,1954,9563,29560,10089,31514
120060,202301,12184,40339,11142,38859,500,2337,9529,33042,10029,35379
120070,202301,4286,11776,3678,10958,622,1720,2280,7257,2902,8977
120080,202301,6928,15978,6212,15002,732,1720,4704,11415,5436,13135
130002,202301,4132,13158,3625,12472,458,1213,2838,10378,3296,11591
130006,202301,3149,9862,2618,9048,600,1903,1432,5511,2032,7414
130008,202301,3290,9883,2838,9256,184,599,2262,7587,2446,8186
130010,202301,5447,12729,4697,11873,164,384,4235,10722,4399,11106
130014,202301,4886,12238,3658,10418,707,2032,2040,6103,2747,8135
130020,202301,3385,11938,2961,11349,137,763,2405,9104,2542,9867
130030,202301,19894,40675,18585,39224,195,501,17770,37161,17965,37662
130040,202301,4944,13313,4070,12210,568,1613,2910,9053,3478,10666
130050,202301,8925,29032,7558,27294,407,1375,6457,23887,6864,25262
130060,202301,9013,32111,7696,30444,393,2196,6403,24930,6796,27126
130063,202301,7799,22706,6903,21714,192,852,6272,19653,6464,20505
130068,202301,4686,13436,3941,12477,215,878,3109,9773,3324,10651
130070,202301,9215,23358,7569,21562,671,1624,5868,17355,6539,18979
130080,202301,9399,27864,8093,26380,401,1178,6954,23124,7355,24302
130083,202301,3464,9940,3033,9410,268,835,2401,7692,2669,8527
130090,202301,5161,12514,4606,11891,104,227,4073,10813,4177,11040
130100,202301,9199,25364,7690,23768,159,412,7082,22222,7241,22634
130110,202301,10922,26314,8914,23857,1711,4083,5538,16314,7249,20397
130115,202301,6301,17275,5431,16290,155,454,4684,14270,4839,14724
130120,202301,20427,56118,18219,53343,1506,4823,15138,44159,16644,48982
130130,202301,7326,19250,5704,17225,641,1795,4067,13082,4708,14877
130140,202301,8806,26898,7724,25672,354,1418,6657,22220,7011,23638
130150,202301,4794,14312,4508,13998,77,387,4184,12959,4261,13346
130160,202301,8052,21277,6965,19975,380,928,6071,17703,6451,18631
130165,202301,4087,13364,3843,13086,162,615,3417,11691,3579,12306
130170,202301,17557,39664,14643,36472,443,1375,13115,32368,13558,33743
130180,202301,5328,15089,5091,14834,38,229,4920,14262,4958,14491
130185,202301,25134,52713,20766,48049,1694,2174,17527,42871,19221,45045
130190,202301,25840,71993,21251,65580,1889,5606,16068,50319,17957,55925
130195,202301,3035,9824,2564,9255,117,453,2148,7902,2265,8355
130200,202301,3789,8761,3102,7881,200,625,2483,6144,2683,6769
130210,202301,1936,6354,1735,6107,155,681,1372,4780,1527,5461
130220,202301,3173,8794,2620,8149,94,298,2327,7388,2421,7686
130230,202301,6207,21595,5433,20582,201,1043,4795,18193,4996,19236
130240,202301,18069,40136,15111,36524,153,691,14108,33575,14261,34266
130250,202301,32304,85109,27621,79733,1710,4232,22594,67330,24304,71562
130255,202301,6168,16504,5279,15033,254,671,4295,12216,4549,12887
130260,202301,461228,1011052,394369,925171,72051,182250,256587,585780,328638,768030
130270,202301,12165,37265,10099,34245,1968,6148,6313,22559,8281,28707
130280,202301,4590,15077,4186,14622,152,595,3850,13496,4002,14091
130290,202301,21582,50982,19461,48519,628,1734,17899,44394,18527,46128
130300,202301,6171,17567,5493,16692,148,630,4739,14275,4887,14905
130310,202301,10813,24745,9581,23297,445,1090,8417,20394,8862,21484
130320,202301,4230,12587,3516,11621,459,1438,2477,8507,2936,9945
130330,202301,5601,15609,4506,14330,217,793,3769,12189,3986,12982
130340,202301,31240,79476,26904,74696,1576,3832,22778,65107,24354,68939
130350,202301,4596,15091,4104,14473,163,773,3556,12518,3719,13291
130353,202301,9977,23723,8140,21382,1277,3073,5409,14891,6686,17964
130356,202301,7096,19198,6023,17622,1158,3311,3552,10897,4710,14208
130360,202301,3666,10869,2957,9997,86,364,2621,8878,2707,9242
130370,202301,6161,24372,5184,22955,763,4044,3094,13767,3857,17811
130380,202301,9357,36768,8742,35877,746,3557,6983,28633,7729,32190
130390,202301,8929,30103,7823,28523,401,1844,6898,25007,7299,26851
130395,202301,3065,8512,2544,7712,179,622,2055,6117,2234,6739
130400,202301,3533,9465,2994,8762,102,317,2636,7747,2738,8064
130406,202301,14354,44513,12197,41902,2423,7584,8002,28996,10425,36580
130410,202301,5503,16770,4762,15670,1269,4261,2567,8798,3836,13059
130420,202301,18783,55638,15821,51995,2009,6464,11212,37861,13221,44325
130423,202301,5348,15097,4649,14282,243,999,4030,12186,4273,13185
130426,202301,3924,12118,3519,11675,65,194,3108,10857,3173,11051
130430,202301,6219,13556,5362,12505,204,488,4768,10985,4972,11473
130440,202301,7342,17274,6322,16078,121,383,5947,15072,6068,15455
140002,202301,3075,8049,2647,7546,219,567,2072,6148,2291,6715
140005,202301,4076,10574,3552,9967,980,2698,2102,6200,3082,8898
140010,202301,64793,165549,52395,147881,12710,37772,21166,60886,33876,98658
140015,202301,6613,14186,5676,13171,348,699,4981,11814,5329,12513
140017,202301,7390,16723,6519,15681,411,933,5438,13268,5849,14201
140020,202301,7146,17338,6139,16118,473,1262,4772,12675,5245,13937
140023,202301,3453,8796,2772,7875,328,995,2079,5948,2407,6943
140028,202301,2545,5880,2137,5382,136,358,1655,4173,1791,4531
140030,202301,8054,16360,7315,15530,354,503,6642,14403,6996,14906
140040,202301,3567,12231,3273,11856,106,532,2978,10766,3084,11298
140045,202301,4548,14381,3959,13607,1056,2895,2157,8555,3213,11450
140047,202301,7692,19716,6448,17941,843,2420,4410,12490,5253,14910
140050,202301,2185,5541,1852,5077,317,773,1204,3456,1521,4229
140060,202301,2755,5828,2465,5455,253,481,2036,4576,2289,5057
140070,202301,2508,11742,2423,11590,153,1019,2064,9695,2217,10714
150010,202301,65631,133460,59113,125445,1410,2726,53284,111854,54694,114580
150013,202301,2750,5647,2319,5181,154,259,1945,4447,2099,4706
150020,202301,19205,47885,17629,45809,1783,3636,14055,37863,15838,41499
150030,202301,11500,35735,10344,34407,779,2066,8350,29851,9129,31917
150034,202301,5494,11630,4435,10346,266,595,3663,8630,3929,9225
150040,202301,20223,46555,17741,43833,1150,1513,15643,40571,16793,42084
150050,202301,9911,26475,8962,25260,245,655,8119,23167,8364,23822
150060,202301,29745,71688,24112,63574,3508,9315,15194,40576,18702,49891
150070,202301,11027,30402,9797,28981,228,836,9097,26845,9325,27681
150080,202301,115073,242882,95171,217084,25620,58171,32254,83515,57874,141686
150085,202301,12209,26982,11116,25726,163,373,10498,24318,10661,24691
150090,202301,15866,40062,14813,38429,612,1604,13033,33422,13645,35026
150095,202301,9253,19514,8125,18176,923,1178,6630,15672,7553,16850
150100,202301,3647,11240,3196,10542,224,705,2589,8685,2813,9390
150110,202301,5748,19484,5342,19046,176,664,4918,17830,5094,18494
150120,202301,9968,26650,9214,25756,359,681,8193,23366,8552,24047
150125,202301,1098,2535,800,2123,103,317,496,1277,599,1594
150130,202301,30721,76727,26343,70392,5149,12195,15780,44944,20929,57139
150140,202301,376171,722039,322501,655084,30421,62020,233811,462261,264232,524281
150145,202301,5109,14640,4189,13212,1547,4789,1414,5255,2961,10044
150150,202301,22701,49163,19293,44979,1575,3441,14594,33993,16169,37434
150157,202301,4492,10991,3535,9701,443,1200,2285,6457,2728,7657
150160,202301,5112,10672,4731,10180,388,939,3844,8019,4232,8958
150170,202301,36208,90411,32311,84438,5439,12373,20886,58093,26325,70466
150172,202301,7266,15943,5927,14195,331,811,4689,11161,5020,11972
150175,202301,2422,6043,2046,5456,179,628,1545,3903,1724,4531
150178,202301,15886,32977,12148,28738,1251,1673,9508,24450,10759,26123
150180,202301,36042,90505,32564,86684,2857,4715,26317,75845,29174,80560
150190,202301,9695,23531,8940,22658,142,464,8346,20988,8488,21452
150195,202301,6469,17539,5992,16891,188,658,5445,15226,5633,15884
150200,202301,7231,18216,6500,17390,56,171,5974,16012,6030,16183
150210,202301,40940,105111,38621,102385,1293,3325,34668,92638,35961,95963
150215,202301,13038,33328,11130,30325,1873,5276,6647,17971,8520,23247
150220,202301,17243,40761,15090,37905,830,2013,11700,29003,12530,31016
150230,202301,17756,41489,15762,38896,1225,2630,12109,30299,13334,32929
150240,202301,45681,109799,38414,98459,8064,21229,17974,43971,26038,65200
150250,202301,5289,17484,4949,17117,437,1545,4274,14973,4711,16518
150260,202301,3597,9574,3151,8938,104,314,2674,7535,2778,7849
150270,202301,11105,28524,7874,22954,2176,6616,2204,6561,4380,13177
150275,202301,9702,24229,8884,23182,196,702,7940,20274,8136,20976
150276,202301,2909,7052,2536,6605,302,692,1781,5030,2083,5722
150277,202301,7062,15210,5610,13559,696,1728,4017,9866,4713,11594
150280,202301,9119,29466,8760,28941,636,1684,7363,25254,7999,26938
150285,202301,4377,12696,3770,11735,231,677,2949,9230,3180,9907
150290,202301,13917,32054,12579,30653,532,787,11354,28356,11886,29143
150293,202301,12250,26567,9590,23176,1036,2566,6667,16034,7703,18600
150295,202301,9213,22276,6505,18542,2138,6023,2171,7096,4309,13119
150300,202301,4244,8566,3906,8172,37,105,3693,7647,3730,7752
150304,202301,5449,13976,4560,12652,672,1654,3092,8940,3764,10594
150307,202301,7077,19836,6372,18727,304,877,5108,15025,5412,15902
150309,202301,8063,20478,6531,18083,871,2338,4073,11519,4944,13857
150310,202301,8932,30783,8383,30106,282,1222,7386,26883,7668,28105
150320,202301,11661,27268,10559,25760,867,1927,7949,19495,8816,21422
150330,202301,19003,50055,17509,48082,2373,5004,12142,36549,14515,41553
150340,202301,2975,7941,2604,7429,323,859,1863,5352,2186,6211
150345,202301,11387,26851,10046,25165,385,1075,8801,21854,9186,22929
150350,202301,12823,26043,11539,24451,861,1366,9775,20987,10636,22353
150360,202301,31467,76539,25268,68931,2519,4827,18996,54401,21515,59228
150370,202301,14322,36726,11739,33334,1514,3589,8332,25270,9846,28859
150375,202301,4849,17372,4375,16730,279,1060,3795,14660,4074,15720
150380,202301,13008,28798,10494,25546,263,782,9001,21590,9264,22372
150390,202301,9442,33491,8312,31674,1781,5776,4982,20926,6763,26702
150400,202301,8149,25296,7698,24595,149,512,6574,21617,6723,22129
150405,202301,11096,25256,9534,23420,761,1296,7541,19269,8302,20565
150410,202301,2405,6463,2032,5895,195,497,1419,4174,1614,4671
150420,202301,58553,140486,46160,123054,10493,29374,22132,60185,32625,89559
150430,202301,10207,25698,9248,24533,656,1278,7829,21166,8485,22444
150440,202301,8326,19754,7532,18755,505,1190,6288,15622,6793,16812
150442,202301,39052,77997,33044,70989,2058,4455,26328,55287,28386,59742
150445,202301,10174,23463,9143,22068,176,471,8392,20044,8568,20515
150450,202301,8030,23777,7485,23084,308,1442,6850,20604,7158,22046
150460,202301,10817,29376,9767,28091,528,1244,8106,24230,8634,25474
150470,202301,25852,60915,23039,57567,429,1486,20971,51722,21400,53208
150475,202301,6900,18628,5835,17004,952,2430,3794,11669,4746,14099
150480,202301,17822,47119,16013,44611,3488,8154,10120,30898,13608,39052
150490,202301,10112,31155,9088,29754,722,1999,7177,24431,7899,26430
150495,202301,6919,18858,6479,18295,169,669,5911,16513,6080,17182
150497,202301,3387,9488,2689,8318,527,1669,1448,4704,1975,6373
150500,202301,3889,9055,3422,8406,211,529,2707,6484,2918,7013
150503,202301,6961,16601,5048,14180,1632,4169,1870,5881,3502,10050
150506,202301,16682,40881,14279,37716,2416,5846,9620,26956,12036,32802
150510,202301,15786,41175,13780,38000,1143,2963,10793,29845,11936,32808
150520,202301,10156,30793,9709,30273,150,846,9164,28312,9314,29158
150530,202301,15246,45858,13171,42952,1186,3292,10169,34090,11355,37382
150540,202301,6619,14748,5682,13392,332,740,4730,11038,5062,11778
150543,202301,9160,22817,7571,20825,657,1825,5691,16013,6348,17838
150548,202301,13087,34774,11594,32707,539,1473,10007,28426,10546,29899
150549,202301,2399,6013,1998,5448,83,268,1616,4365,1699,4633
150550,202301,25489,67258,20755,59883,5550,16457,7899,23527,13449,39984
150553,202301,48186,119955,37111,101894,9397,26625,15688,42806,25085,69431
150555,202301,2521,5979,1961,5156,182,443,1298,3515,1480,3958
150560,202301,2427,6024,2149,5563,242,603,1426,3668,1668,4271
150563,202301,3293,8709,2680,7655,554,1648,1434,4059,1988,5707
150565,202301,5470,15735,4827,14766,140,484,3820,11899,3960,12383
150570,202301,9916,23215,9095,22158,284,853,8138,19546,8422,20399
150580,202301,14128,47719,12048,45424,1564,4585,9281,37428,10845,42013
150590,202301,10379,30112,8889,28373,245,952,8038,25685,8283,26637
150600,202301,13110,34218,12104,33013,405,1005,10927,30084,11332,31089
150610,202301,4060,9115,3619,8490,142,411,3114,7109,3256,7520
150611,202301,4100,9680,3556,8949,82,277,3112,7639,3194,7916
150613,202301,18323,45641,13985,38684,2673,7894,6943,18512,9616,26406
150616,202301,4702,11909,3403,9713,662,2052,1561,4263,2223,6315
150618,202301,9008,22746,7320,20200,1026,3040,4486,12326,5512,15366
150619,202301,8235,20775,6707,18695,774,1814,4799,13901,5573,15715
150620,202301,9363,26855,8201,24958,1681,4702,4562,14685,6243,19387
150630,202301,8925,18696,8154,17776,155,380,7456,15992,7611,16372
150635,202301,6843,16162,5742,14454,699,1611,3767,9574,4466,11185
150640,202301,2566,6825,2317,6515,50,138,2095,5924,2145,6062
150650,202301,15168,36316,13183,33392,3580,8723,5922,15944,9502,24667
150655,202301,6937,17173,6254,16229,108,368,5603,14316,5711,14684
150658,202301,5492,14574,3985,12086,1003,3201,1696,5201,2699,8402
150660,202301,6946,17663,6046,16379,1251,3275,3430,9312,4681,12587
150670,202301,12650,24436,10085,21525,911,1865,7904,17209,8815,19074
150680,202301,98134,242917,78671,214458,16968,43559,41247,119721,58215,163280
150690,202301,3288,7063,2827,6521,134,247,2443,5732,2577,5979
150700,202301,8521,21332,7565,20171,925,1848,5553,15710,6478,17558
150710,202301,4724,13413,4222,12678,526,1501,2922,9013,3448,10514
150715,202301,6833,16133,5615,14438,325,811,4576,11740,4901,12551
150720,202301,10625,26131,9797,25040,352,1105,8686,21892,9038,22997
150730,202301,16467,43965,14027,40479,1966,5884,9640,28322,11606,34206
150740,202301,4960,12179,4285,11191,490,1022,3115,8420,3605,9442
150745,202301,6933,17004,5594,15164,701,2002,3906,10767,4607,12769
150746,202301,2175,5475,1927,5133,57,162,1599,4173,1656,4335
150747,202301,6799,16694,6055,15651,479,1067,4746,12401,5225,13468
150750,202301,4713,12480,3809,11197,430,1273,2628,8060,3058,9333
150760,202301,14576,37339,13080,35305,2451,6006,8239,23449,10690,29455
150770,202301,8816,25891,8082,25071,257,557,7343,23486,7600,24043
150775,202301,1476,3456,1162,3068,143,416,795,2087,938,2503
150780,202301,6180,16129,5466,15306,323,870,4802,13693,5125,14563
150790,202301,7699,18071,6466,16748,587,1149,4259,13179,4846,14328
150795,202301,20717,52822,17886,48866,3295,8969,11043,30927,14338,39896
150796,202301,5287,10494,4536,9648,206,391,3946,8393,4152,8784
150797,202301,5622,14376,4767,13190,537,1387,3696,10299,4233,11686
150800,202301,18124,48560,16157,46028,2722,7163,10554,31567,13276,38730
150803,202301,10884,25079,10019,23959,279,761,9070,21376,9349,22137
150805,202301,4476,12107,3776,11178,366,1033,2806,8504,3172,9537
150808,202301,8193,21817,6061,18378,2043,6937,903,2857,2946,9794
150810,202301,27079,60398,20669,52805,4529,11230,10734,30185,15263,41415
150812,202301,8235,18658,7307,17290,451,1374,5850,13134,6301,14508
150815,202301,11795,31054,9840,28744,1368,3982,7376,21943,8744,25925
150820,202301,19078,38514,16757,35836,1976,2948,12941,29491,14917,32439
150830,202301,16474,45995,15302,44585,643,1578,13620,40464,14263,42042
150835,202301,4444,11564,3794,10592,428,1219,2638,7310,3066,8529
150840,202301,10672,26436,8692,23441,1205,3662,5309,13771,6514,17433
160005,202301,1792,3770,1576,3521,76,193,1372,3041,1448,3234
160010,202301,2715,6625,2504,6404,20,83,2419,6146,2439,6229
160015,202301,5145,10315,4656,9765,85,210,4405,9159,4490,9369
160020,202301,3209,8102,2769,7537,347,803,2018,5798,2365,6601
160021,202301,1551,5035,1373,4821,66,278,1004,3671,1070,3949
160023,202301,1738,5188,1541,4874,285,837,928,3107,1213,3944
160025,202301,2457,6156,2285,5971,63,103,2171,5729,2234,5832
160027,202301,14718,29554,13315,27889,765,1676,11580,24010,12345,25686
160030,202301,111584,261070,93082,237803,17309,42021,54938,147495,72247,189516
160040,202301,7682,21653,6757,20431,491,1390,5713,17524,6204,18914
160050,202301,8071,19181,6796,17580,2553,5584,3104,9621,5657,15205
160053,202301,5438,13873,4769,12967,286,700,3947,10961,4233,11661
160055,202301,2107,3945,2027,3858,31,87,1950,3674,1981,3761
160060,202301,39267,82012,33314,75388,3210,5861,26384,61786,29594,67647
160070,202301,3833,11636,3342,10922,435,1153,2382,8426,2817,9579
160080,202301,4056,10565,3539,10007,54,162,3264,9342,3318,9504
170025,202301,765,1909,469,1355,82,229,142,386,224,615
170030,202301,1355,3777,1002,3141,190,581,370,1198,560,1779
170035,202301,1770,4200,1297,3483,113,334,764,1942,877,2276
170040,202301,2262,5506,1746,4802,265,740,928,2656,1193,3396
170070,202301,2334,4946,1654,4097,99,264,970,2428,1069,2692
170100,202301,3001,7385,2428,6521,345,851,1514,4130,1859,4981
170105,202301,790,2090,520,1566,113,345,170,447,283,792
170110,202301,1243,3279,951,2816,70,275,582,1625,652,1900
170130,202301,1759,4358,1315,3642,125,396,832,2223,957,2619
170190,202301,1923,4454,1491,3815,202,645,907,2168,1109,2813
170200,202301,2440,5334,1597,4037,272,722,635,1506,907,2228
170210,202301,33785,84023,25567,71073,7019,21024,4760,13409,11779,34433
170215,202301,1539,3724,1213,3285,61,223,911,2418,972,2641
170220,202301,6907,19478,5616,17308,2229,6930,1350,4814,3579,11744
170230,202301,1507,3927,1127,3260,273,807,361,1024,634,1831
170240,202301,3574,8171,2866,7101,190,551,2122,5095,2312,5646
170255,202301,4545,12064,3346,10090,582,1821,1578,4754,2160,6575
170270,202301,1032,2357,698,1854,87,238,374,946,461,1184
170290,202301,3798,9327,3262,8622,289,542,2472,6840,2761,7382
170300,202301,2634,5935,2134,5219,155,370,1596,3774,1751,4144
170305,202301,803,1996,652,1742,79,203,344,927,423,1130
170307,202301,1304,3611,1085,3240,154,499,672,1911,826,2410
170310,202301,1907,4315,1355,3500,181,502,704,1786,885,2288
170320,202301,1275,3114,943,2590,121,374,555,1497,676,1871
170330,202301,1203,3248,1095,3094,32,139,957,2624,989,2763
170360,202301,698,1617,505,1334,24,79,329,788,353,867
170370,202301,1582,3645,1129,2949,186,504,570,1388,756,1892
170380,202301,2171,5640,1645,4847,134,436,952,2875,1086,3311
170382,202301,607,1599,488,1409,23,84,342,945,365,1029
170384,202301,2055,6265,1706,5661,333,1096,920,3015,1253,4111
170386,202301,1118,2876,683,2047,81,290,245,651,326,941
170388,202301,874,2118,631,1736,84,252,336,864,420,1116
170389,202301,1015,2919,803,2555,89,309,490,1588,579,1897
170390,202301,2217,4354,1680,3732,37,97,1458,3246,1495,3343
170410,202301,747,1697,545,1385,26,86,374,880,400,966
170460,202301,482,1230,378,1065,51,152,236,660,287,812
170510,202301,1091,2756,779,2241,33,131,502,1316,535,1447
170550,202301,8207,19806,6230,16852,1654,4903,2015,5182,3669,10085
170555,202301,1648,3960,1296,3437,146,341,635,1741,781,2082
170560,202301,1189,2979,892,2572,106,285,513,1541,619,1826
170600,202301,1666,4060,1300,3533,228,570,727,2028,955,2598
170610,202301,2008,4597,1494,3857,120,373,993,2431,1113,2804
170625,202301,530,1260,359,968,44,105,141,349,185,454
170650,202301,1805,4445,1473,3949,136,438,983,2506,1119,2944
170700,202301,4309,11466,3275,9555,661,1998,1425,3944,2086,5942
170710,202301,2041,4384,1553,3712,174,423,1046,2425,1220,2848
170720,202301,2188,4825,1648,4010,138,399,1172,2731,1310,3130
170730,202301,1307,3149,989,2688,114,264,601,1656,715,1920
170740,202301,2402,7080,2044,6468,148,557,1527,4714,1675,5271
170755,202301,1009,2471,714,2011,141,426,318,831,459,1257
170765,202301,1384,3241,980,2621,156,408,487,1281,643,1689
170770,202301,2236,5689,1798,5044,159,470,1298,3564,1457,4034
170820,202301,4760,12332,3661,10536,693,2028,1849,5224,2542,7252
170825,202301,1302,2617,1071,2333,107,234,805,1726,912,1960
170830,202301,1619,3820,1194,3148,275,866,576,1312,851,2178
170900,202301,3633,9768,3123,9083,383,953,2380,7131,2763,8084
170930,202301,4847,12010,3699,10013,844,2433,1197,2997,2041,5430
170950,202301,14022,36121,10009,29304,2924,9278,1336,3867,4260,13145
170980,202301,605,1383,417,1084,49,154,234,558,283,712
171050,202301,2002,5616,1714,5135,134,433,1303,3929,1437,4362
171070,202301,1621,4052,1369,3704,293,702,675,2117,968,2819
171090,202301,1191,2871,920,2474,147,409,470,1249,617,1658
171110,202301,678,1729,469,1351,67,199,219,576,286,775
171150,202301,1173,2693,719,1956,62,197,431,1125,493,1322
171180,202301,872,2243,554,1660,102,284,206,645,308,929
171190,202301,2358,6702,1982,6072,313,993,1155,3526,1468,4519
171195,202301,1000,2799,786,2413,108,418,480,1365,588,1783
171200,202301,735,1893,534,1569,131,442,166,437,297,879
171215,202301,467,1135,363,968,42,123,192,494,234,617
171240,202301,898,2629,699,2298,15,91,481,1517,496,1608
171245,202301,909,2393,697,1988,58,189,398,1028,456,1217
171250,202301,1140,2922,791,2332,125,394,336,974,461,1368
171270,202301,568,1820,440,1551,68,294,217,745,285,1039
171280,202301,1057,2816,846,2481,66,201,540,1581,606,1782
171320,202301,4674,12088,3580,10224,704,2021,1415,4029,2119,6050
171330,202301,3433,8586,2622,7233,677,1928,1149,3108,1826,5036
171360,202301,1810,4519,1354,3879,142,384,861,2635,1003,3019
171370,202301,849,1955,644,1678,75,198,396,1005,471,1203
171380,202301,1734,4320,1417,3892,182,455,946,2732,1128,3187
171395,202301,1197,2835,803,2193,98,295,486,1280,584,1575
171420,202301,2386,5936,1799,4933,320,947,934,2437,1254,3384
171430,202301,1310,3410,1070,2990,75,232,694,1817,769,2049
171488,202301,2991,7525,2310,6450,403,1123,1187,3281,1590,4404
171500,202301,1042,2457,732,1954,88,265,422,1083,510,1348
171510,202301,986,2783,841,2539,76,282,561,1631,637,1913
171515,202301,587,1325,413,1064,32,101,267,627,299,728
171525,202301,855,2061,642,1717,86,237,385,972,471,1209
171550,202301,401,1049,303,919,39,156,152,409,191,565
171570,202301,1297,3388,1076,3026,158,464,627,1764,785,2228
171575,202301,2008,4861,1330,3739,132,378,683,1855,815,2233
171610,202301,7264,18916,5415,15918,1303,4243,1145,3528,2448,7771
171620,202301,3617,8080,3093,7379,172,435,2551,6061,2723,6496
171630,202301,1320,3123,993,2664,144,411,625,1672,769,2083
171650,202301,2713,7065,2077,6045,495,1581,570,1655,1065,3236
171660,202301,2785,6393,1975,5151,166,461,1287,3272,1453,3733
171665,202301,1489,3813,1162,3301,249,758,499,1397,748,2155
171670,202301,2262,5484,1670,4519,252,730,785,2013,1037,2743
171700,202301,1378,3460,1022,2845,129,373,576,1549,705,1922
171720,202301,905,2131,683,1798,74,204,457,1192,531,1396
171750,202301,1693,4688,1211,3808,260,822,343,1250,603,2072
171780,202301,1554,3501,1097,2818,107,324,708,1733,815,2057
171790,202301,1647,4908,1316,4253,191,632,673,2119,864,2751
171800,202301,851,2078,650,1797,65,191,370,964,435,1155
171820,202301,14357,36869,10668,30973,2488,7817,2726,8024,5214,15841
171830,202301,1855,5253,1578,4808,328,941,782,2564,1110,3505
171840,202301,850,2045,635,1723,19,67,380,974,399,1041
171845,202301,815,1790,614,1502,49,158,427,972,476,1130
171850,202301,1187,3210,1003,2855,40,172,794,2162,834,2334
171855,202301,1238,3436,1019,3060,109,328,590,1725,699,2053
171865,202301,591,1520,498,1382,63,202,297,762,360,964
171870,202301,946,2391,667,1920,115,350,314,887,429,1237
171875,202301,1761,4206,1452,3759,59,234,1149,2838,1208,3072
171880,202301,1769,4131,1535,3834,48,139,1240,3052,1288,3191
171884,202301,1337,3173,1015,2658,217,528,516,1366,733,1894
171886,202301,1795,4508,1312,3823,330,1062,333,1029,663,2091
171888,202301,680,1822,463,1404,29,111,265,759,294,870
171889,202301,504,1409,334,1065,76,264,107,309,183,573
171890,202301,1464,3845,1081,3227,141,460,649,1865,790,2325
171900,202301,668,2039,516,1746,72,208,237,807,309,1015
172000,202301,673,1856,516,1574,99,303,196,586,295,889
172010,202301,1506,4181,1260,3801,126,348,779,2369,905,2717
172015,202301,434,1372,333,1187,63,219,139,496,202,715
172020,202301,3459,8587,3004,8033,256,717,2162,5901,2418,6618
172025,202301,839,2084,599,1722,48,144,406,1134,454,1278
172030,202301,1454,3931,1174,3481,86,297,850,2469,936,2766
172049,202301,1453,3362,948,2652,125,346,487,1397,612,1743
172065,202301,1741,3952,1371,3492,146,287,941,2656,1087,2943
172080,202301,2838,7487,2278,6547,121,402,1518,4256,1639,4658
172085,202301,523,1330,331,942,58,173,117,299,175,472
172090,202301,4983,10681,3894,9279,143,365,3145,7294,3288,7659
172093,202301,534,1489,378,1209,31,139,219,653,250,792
172097,202301,822,1980,546,1528,88,277,197,515,285,792
172100,202301,61992,141082,46360,118027,8523,24120,19678,48161,28201,72281
172110,202301,2033,6310,1732,5874,115,485,1345,4533,1460,5018
172120,202301,6246,16248,4874,14122,503,1582,2958,8383,3461,9965
172125,202301,490,1204,372,1020,33,110,205,504,238,614
172130,202301,694,1635,525,1359,23,85,340,800,363,885
172208,202301,3045,6659,2354,5774,197,433,1697,4150,1894,4583
172210,202301,3189,7063,2458,6176,243,579,1622,4209,1865,4788
210005,202301,23271,60403,17528,51443,4534,13991,7316,21615,11850,35606
210010,202301,2655,6526,2436,6280,40,183,2249,5697,2289,5880
210015,202301,3743,10166,3212,9474,143,432,2658,7864,2801,8296
210020,202301,9980,19141,8651,17603,580,764,7606,15801,8186,16565
210030,202301,5322,16098,4826,15345,493,1638,3765,12065,4258,13703
210040,202301,2594,5024,2265,4638,58,161,2050,4095,2108,4256
210043,202301,6911,17727,5784,16233,387,1154,4535,12740,4922,13894
210047,202301,8204,21867,6463,19627,156,652,5567,16835,5723,17487
210050,202301,2944,8068,2353,7046,163,659,1771,5072,1934,5731
210055,202301,2498,6471,2183,6040,54,153,1893,5319,1947,5472
210060,202301,8774,28971,7747,27207,828,3035,5203,18693,6031,21728
210070,202301,8133,19114,7519,18357,94,247,7048,17134,7142,17381
210080,202301,5265,14521,4949,14184,42,224,4611,13159,4653,13383
210083,202301,7269,16661,6117,15414,101,328,5764,14448,5865,14776
210087,202301,3177,8209,2673,7547,152,486,2148,5998,2300,6484
210090,202301,10871,29830,10005,28468,385,999,8653,24548,9038,25547
210095,202301,7449,22452,6715,21498,530,1594,5268,17591,5798,19185
210100,202301,7604,21095,6586,19371,920,2627,4267,12750,5187,15377
210110,202301,3643,9298,3329,8916,48,219,3033,8026,3081,8245
210120,202301,35243,74931,30062,68595,1546,2976,24271,55622,25817,58598
210125,202301,5333,12842,4622,12052,820,1609,3212,9063,4032,10672
210130,202301,4996,11399,4059,10260,81,193,3576,9005,3657,9198
210135,202301,2164,4733,1791,4212,55,124,1564,3649,1619,3773
210140,202301,25416,60247,19881,53151,2786,7380,12530,33740,15316,41120
210150,202301,5608,11853,4888,10897,115,312,4224,9189,4339,9501
210160,202301,26411,59127,22589,54400,1847,3908,17664,43199,19511,47107
210170,202301,21382,53188,19448,50670,1901,4026,15125,40836,17026,44862
210173,202301,2651,9064,2501,8835,108,496,2173,7637,2281,8133
210177,202301,3764,9514,3223,8830,461,1130,2364,6713,2825,7843
210180,202301,1835,4084,1608,3815,36,89,1450,3436,1486,3525
210190,202301,6781,15044,5701,13637,102,284,4919,11580,5021,11864
210193,202301,1611,4038,1374,3679,48,136,1069,2841,1117,2977
210197,202301,2318,6530,2080,6202,154,419,1655,5049,1809,5468
210200,202301,9581,26495,8383,24761,535,1708,6621,19474,7156,21182
210203,202301,8425,22060,7039,20290,568,1595,5487,16206,6055,17801
210207,202301,4534,9971,3707,9027,149,329,3078,7563,3227,7892
210210,202301,8762,24970,7837,23711,137,707,6753,20174,6890,20881
210215,202301,2839,8024,2456,7486,151,628,2004,6013,2155,6641
210220,202301,8284,22984,7789,22308,142,828,7061,19680,7203,20508
210230,202301,6870,17246,6215,16272,154,389,5645,14776,5799,15165
210232,202301,14424,38838,11851,35152,1686,4883,7879,24250,9565,29133
210235,202301,4041,10910,3523,10186,162,572,2920,8408,3082,8980
210237,202301,4908,10657,4209,9881,29,121,4003,9282,4032,9403
210240,202301,2974,8163,2662,7695,81,245,2169,6236,2250,6481
210250,202301,7244,17891,6563,17050,116,412,6005,15480,6121,15892
210255,202301,3138,8588,2654,7745,317,1021,1631,4587,1948,5608
210260,202301,6347,16831,5471,15595,413,1246,4390,12437,4803,13683
210270,202301,5790,13932,5080,13064,75,343,4592,11650,4667,11993
210275,202301,3992,9039,3376,8312,171,366,2765,6849,2936,7215
210280,202301,7511,17269,6202,15450,156,659,5136,12217,5292,12876
210290,202301,9919,21554,8879,20320,110,307,8391,19083,8501,19390
210300,202301,38693,97486,31352,87262,6178,16438,15386,47652,21564,64090
210310,202301,3588,8003,3119,7374,39,116,2844,6660,2883,6776
210312,202301,3458,7223,3069,6802,25,85,2831,6163,2856,6248
210315,202301,4376,9330,3924,8836,121,261,3633,8175,3754,8436
210317,202301,5175,14262,4683,13684,108,461,4259,12366,4367,12827
210320,202301,33058,70209,30802,67493,246,1130,29115,62623,29361,63753
210325,202301,4108,10565,3408,9645,411,1186,2483,7094,2894,8280
210330,202301,31351,74789,25335,67623,3898,8430,16656,49006,20554,57436
210340,202301,15258,33239,13736,31393,738,1370,11514,26835,12252,28205
210350,202301,11594,27691,10170,25961,130,420,9213,23302,9343,23722
210355,202301,4493,13715,3945,12874,108,500,3301,10720,3409,11220
210360,202301,14631,41913,13093,39532,566,2338,9822,28600,10388,30938
210370,202301,14436,26974,10836,23214,312,479,9962,21651,10274,22130
210375,202301,3855,9680,2801,8105,958,2940,654,1987,1612,4927
210380,202301,6604,15023,5690,13939,249,688,4914,11904,5163,12592
210390,202301,3827,9699,3560,9320,63,261,3261,8406,3324,8667
210400,202301,5477,14005,4815,13247,247,487,4257,12026,4504,12513
210405,202301,9011,20798,7341,18591,1201,2689,4491,11941,5692,14630
210407,202301,2427,6915,2035,6252,137,416,1537,4742,1674,5158
210408,202301,3181,10311,2936,10000,177,737,2350,8044,2527,8781
210409,202301,4462,13634,3984,12977,218,782,3196,10656,3414,11438
210410,202301,4310,11246,3620,10058,80,333,2979,8029,3059,8362
210420,202301,4400,12690,3873,11785,216,630,3169,9663,3385,10293
210430,202301,2639,6959,2285,6483,194,544,1857,5308,2051,5852
210440,202301,5066,12256,4391,11442,187,382,3904,10234,4091,10616
210450,202301,2674,7081,2298,6553,263,629,1672,4963,1935,5592
210455,202301,5803,13331,4514,11740,1053,2876,2176,5661,3229,8537
210460,202301,4170,11005,3474,10081,119,414,2895,8335,3014,8749
210462,202301,1938,5329,1618,4856,66,186,1259,3809,1325,3995
210465,202301,3113,8003,2685,7440,132,498,2242,6080,2374,6578
210467,202301,7381,19325,6344,18006,610,1569,4964,14494,5574,16063
210470,202301,2161,5482,1601,4713,168,457,1122,3366,1290,3823
210480,202301,20053,53396,16516,49115,2178,4673,11445,37656,13623,42329
210490,202301,3897,8850,3078,7761,92,232,2600,6519,2692,6751
210500,202301,7468,24855,6886,23933,359,1549,5787,19926,6146,21475
210510,202301,8025,20834,7165,19929,127,360,6659,18607,6786,18967
210515,202301,4449,11793,3760,10964,199,617,3107,9196,3306,9813
210520,202301,3024,7949,2706,7540,139,431,2255,6210,2394,6641
210530,202301,67511,151670,52979,131312,9916,26327,22880,59570,32796,85897
210535,202301,4358,12008,3952,11453,134,461,3457,10003,3591,10464
210540,202301,18148,46689,15113,42402,2160,5323,9820,29336,11980,34659
210542,202301,7620,16547,5917,14625,513,1191,4606,11505,5119,12696
210545,202301,2518,7122,2308,6788,52,191,1966,5713,2018,5904
210547,202301,4324,13835,3829,13015,223,768,2961,10275,3184,11043
210550,202301,6847,19177,5257,16695,650,2210,3187,10341,3837,12551
210560,202301,4284,12027,3772,11242,91,340,3206,9398,3297,9738
210565,202301,1760,4692,1438,4259,103,355,1077,3225,1180,3580
210570,202301,12797,31855,11308,30042,267,733,10088,26928,10355,27661
210580,202301,3435,8084,2693,7174,188,452,1965,5477,2153,5929
210590,202301,4813,13108,4096,12219,85,413,3620,10737,3705,11150
210592,202301,3355,8178,3114,7820,30,136,2756,6748,2786,6884
210594,202301,2859,7296,2234,6358,208,546,1547,4561,1755,5107
210596,202301,3409,10282,3013,9611,348,1103,2212,7269,2560,8372
210598,202301,2409,5817,2151,5487,84,240,1878,4765,1962,5005
210600,202301,3484,8812,2809,7867,343,888,1822,5144,2165,6032
210610,202301,3651,8356,3097,7697,55,214,2703,6599,2758,6813
210620,202301,3546,7734,2887,6927,149,314,2455,5809,2604,6123
210630,202301,3717,10667,3290,9975,173,626,2599,7807,2772,8433
210632,202301,7254,16371,6481,15388,187,615,5792,13416,5979,14031
210635,202301,1890,6215,1767,5999,192,586,1318,4613,1510,5199
210637,202301,3110,8796,2610,8105,158,559,1984,6245,2142,6804
210640,202301,5911,16982,5483,16506,61,311,5103,15280,5164,15591
210650,202301,8171,20695,7321,19661,112,383,6529,17481,6641,17864
210660,202301,9499,24613,8511,23110,162,714,7367,19404,7529,20118
210663,202301,3612,8168,3195,7683,317,500,2378,6217,2695,6717
210667,202301,2246,6487,1994,6109,56,191,1707,5342,1763,5533
210670,202301,6759,17113,6101,16139,122,469,5489,14255,5611,14724
210675,202301,6443,14405,5402,13124,583,1221,4164,10361,4747,11582
210680,202301,5804,11770,4906,10742,87,152,4593,10042,4680,10194
210690,202301,11256,25074,9559,23188,249,740,8741,20932,8990,21672
210700,202301,3289,8047,2611,7091,175,432,1991,5462,2166,5894
210710,202301,6334,16420,5570,15456,114,432,4976,13702,5090,14134
210720,202301,3583,10095,3116,9536,102,421,2719,8296,2821,8717
210725,202301,1533,4428,1314,4104,53,172,932,3026,985,3198
210730,202301,1715,3530,1427,3154,61,112,1244,2747,1305,2859
210735,202301,5388,13745,4546,12717,322,780,3675,10690,3997,11470
210740,202301,6148,14029,5209,12983,129,278,4426,10952,4555,11230
210745,202301,4944,12126,4463,11543,58,203,4000,10253,4058,10456
210750,202301,31139,73264,27013,68076,4131,9055,17195,45936,21326,54991
210760,202301,7578,15455,6421,14235,125,230,5963,13413,6088,13643
210770,202301,7362,16286,6275,15065,54,223,5864,13904,5918,14127
210780,202301,8733,24225,7510,22279,518,1546,5840,17284,6358,18830
210790,202301,5184,14106,4553,13270,283,751,3716,11112,3999,11863
210800,202301,5784,13699,4955,12611,78,295,4463,11148,4541,11443
210805,202301,4875,15254,4455,14646,211,712,3720,12344,3931,13056
210810,202301,5781,15043,5194,14309,421,1009,4229,11988,4650,12997
210820,202301,8487,21904,7055,19691,1023,2673,4185,12085,5208,14758
210825,202301,9901,23175,9001,22062,221,634,8236,19991,8457,20625
210830,202301,10641,24487,9663,23332,921,1530,7841,19874,8762,21404
210840,202301,5900,10190,5435,9651,30,121,5163,8927,5193,9048
210845,202301,7261,17381,6388,16420,59,167,6081,15679,6140,15846
210850,202301,8311,21988,6911,20009,480,1379,5516,16029,5996,17408
210860,202301,25390,55750,21008,50555,945,2081,17510,43013,18455,45094
210870,202301,8889,19531,7069,17490,174,404,6303,15557,6477,15961
210880,202301,4862,13047,4296,12313,228,676,3395,9681,3623,10357
210890,202301,5950,12978,5453,12418,196,499,4899,10977,5095,11476
210900,202301,5758,15146,4491,12984,1593,4650,919,3010,2512,7660
210905,202301,2693,5635,2302,5162,44,75,2158,4841,2202,4916
210910,202301,8701,24497,7190,22136,1005,3043,4496,13967,5501,17010
210920,202301,3721,10347,3263,9755,65,286,2959,8735,3024,9021
210923,202301,2326,5199,1997,4747,95,231,1644,3808,1739,4039
210927,202301,5397,16186,4671,15308,664,2113,3078,10561,3742,12674
210930,202301,3468,8968,3048,8243,86,358,2647,6899,2733,7257
210940,202301,4201,11019,3785,10517,337,1506,3064,7792,3401,9298
210945,202301,9899,22447,8843,21260,798,1300,7059,17860,7857,19160
210950,202301,6390,15783,4926,13763,613,1324,3306,9934,3919,11258
210955,202301,1774,4911,1476,4449,266,787,874,2666,1140,3453
210960,202301,10840,29164,9260,26761,3068,8756,3613,11505,6681,20261
210970,202301,2043,4731,1688,4183,91,273,1412,3354,1503,3627
210975,202301,2015,5560,1812,5261,199,574,1307,3792,1506,4366
210980,202301,12804,24650,11389,23187,176,282,10770,21926,10946,22208
210990,202301,21009,51715,16328,45827,1689,4094,11454,33543,13143,37637
211000,202301,17323,43999,14220,40188,2780,6917,9200,27821,11980,34738
211003,202301,7478,17534,6263,16131,111,420,5551,14278,5662,14698
211010,202301,8253,23492,7447,22513,77,358,6829,20722,6906,21080
211020,202301,10683,25566,9383,24141,204,631,8338,21762,8542,22393
211023,202301,2446,7022,2236,6762,137,395,1811,5479,1948,5874
211027,202301,4610,11230,4347,10841,102,331,4026,9882,4128,10213
211030,202301,4548,11289,4019,10635,394,976,2986,8066,3380,9042
211040,202301,5200,16586,4757,15848,124,626,4221,13944,4345,14570
211050,202301,10959,24504,9799,23091,125,383,8935,20911,9060,21294
211060,202301,9077,22246,8223,21136,169,611,7409,18730,7578,19341
211065,202301,2956,6687,2472,6097,124,252,2119,5295,2243,5547
211070,202301,10001,26820,8488,24643,349,1090,7170,20751,7519,21841
211080,202301,1579,3791,1241,3289,30,159,957,2345,987,2504
211085,202301,2582,6399,2139,5844,201,385,1655,4793,1856,5178
211090,202301,3686,9022,3313,8610,32,125,3059,7886,3091,8011
211100,202301,8681,18064,7988,17290,37,107,7530,16221,7567,16328
211102,202301,3959,11113,3579,10580,366,1109,2794,8296,3160,9405
211105,202301,2755,7741,2317,7011,116,358,1774,5275,1890,5633
211107,202301,5521,15660,4681,14455,173,582,3730,11983,3903,12565
211110,202301,7717,17781,6136,15517,258,751,5022,12337,5280,13088
211120,202301,60107,130355,49473,117958,8177,18029,31489,77694,39666,95723
211125,202301,2238,6110,1889,5603,34,162,1601,4712,1635,4874
211130,202301,228376,488472,196509,447792,26370,53921,128866,300845,155236,354766
211140,202301,5470,14729,4722,13780,171,524,3973,11672,4144,12196
211150,202301,11533,26986,9651,24692,575,1132,7755,20440,8330,21572
211153,202301,3496,8466,2422,7133,443,1167,1474,4622,1917,5789
211157,202301,1498,4123,1274,3722,90,268,918,2656,1008,2924
211160,202301,6402,13988,5225,12423,131,447,4349,9785,4480,10232
211163,202301,1745,5058,1572,4820,62,206,1335,4130,1397,4336
211167,202301,2028,5199,1877,5001,31,110,1743,4608,1774,4718
211170,202301,8756,17026,8101,16299,62,165,7689,15281,7751,15446
211172,202301,2996,7548,2522,6861,83,274,2021,5268,2104,5542
211174,202301,3377,8482,3039,8115,31,159,2877,7604,2908,7763
211176,202301,4969,12745,3889,11222,303,951,3006,8615,3309,9566
211178,202301,6359,12081,5504,11184,35,122,5299,10661,5334,10783
211180,202301,4911,14319,4474,13706,169,679,3686,11151,3855,11830
211190,202301,3890,9524,3280,8666,33,173,2984,7748,3017,7921
211195,202301,1909,4390,1658,4035,63,151,1450,3514,1513,3665
211200,202301,2492,6725,1944,5866,200,629,1339,3977,1539,4606
211210,202301,7225,20023,6439,18964,521,1530,5115,15144,5636,16674
211220,202301,52178,110889,43559,100527,4118,8891,32829,75834,36947,84725
211223,202301,6270,15143,5044,13531,654,1774,3232,8697,3886,10471
211227,202301,1978,5611,1698,5220,57,213,1400,4325,1457,4538
211230,202301,10216,24756,8749,22742,320,676,7556,19720,7876,20396
211240,202301,12335,27715,11638,26885,144,565,11093,25189,11237,25754
211245,202301,9421,22876,8321,21729,170,398,7898,20655,8068,21053
211250,202301,18226,46557,16469,44008,1399,3703,12796,34078,14195,37781
211260,202301,9780,26879,8395,25305,173,688,7552,22845,7725,23533
211270,202301,11952,33390,10182,31176,407,1515,8290,25537,8697,27052
211280,202301,19051,40107,17079,37756,373,818,15707,34532,16080,35350
211285,202301,2363,6548,2091,6209,171,561,1571,4658,1742,5219
211290,202301,8440,22726,7518,21488,341,1030,6141,17464,6482,18494
211300,202301,8408,22580,7276,20765,480,1437,5505,15447,5985,16884
211400,202301,14065,34582,11400,30998,1513,3906,7475,21247,8988,25153
220005,202301,2357,5240,2146,4971,56,129,1787,4003,1843,4132
220010,202301,1758,4457,1423,3907,65,153,1088,2983,1153,3136
220020,202301,5521,11584,4797,10649,254,532,4130,9027,4384,9559
220025,202301,2773,5409,2366,4831,63,111,1987,3902,2050,4013
220027,202301,1647,3527,1425,3240,30,90,1232,2726,1262,2816
220030,202301,4679,9676,4313,9218,96,249,3841,8003,3937,8252
220040,202301,9687,25875,8435,23639,1563,4077,4784,13820,6347,17897
220045,202301,1905,4817,1581,4328,21,103,1360,3605,1381,3708
220050,202301,6654,14078,5799,13048,64,217,5445,12028,5509,12245
220060,202301,3533,5922,3055,5384,70,91,2866,5040,2936,5131
220070,202301,2830,6538,2338,5847,67,148,1952,4797,2019,4945
220080,202301,869,2243,748,2073,19,77,624,1685,643,1762
220090,202301,2041,4347,1651,3783,66,101,1375,3159,1441,3260
220095,202301,1192,2097,1135,2038,20,32,1061,1890,1081,1922
220100,202301,1690,4031,1335,3512,32,129,1084,2709,1116,2838
220105,202301,2424,6556,2083,5995,163,506,1526,4358,1689,4864
220110,202301,4230,9916,3656,9005,43,177,3258,7878,3301,8055
220115,202301,3428,8639,3129,8264,159,458,2714,7083,2873,7541
220117,202301,1650,3496,1294,3017,17,57,1078,2418,1095,2475
220120,202301,20928,39518,19407,37713,86,282,18449,35251,18535,35533
220130,202301,1337,3130,1115,2838,27,110,986,2433,1013,2543
220140,202301,2839,5072,2417,4597,89,161,2156,4137,2245,4298
220150,202301,7722,19466,6968,18261,149,549,5833,14833,5982,15382
220155,202301,1395,3626,1109,3131,22,79,789,2140,811,2219
220157,202301,1328,2773,1114,2471,33,74,897,1941,930,2015
220160,202301,3368,8210,2862,7341,56,187,2336,5775,2392,5962
220170,202301,1830,4444,1527,4013,35,122,1299,3370,1334,3492
220173,202301,2497,6296,2016,5486,45,175,1573,4156,1618,4331
220177,202301,2860,6114,2716,5960,8,28,2672,5840,2680,5868
220180,202301,1426,2880,1175,2496,3,17,980,1931,983,1948
220190,202301,10142,20091,8656,18254,652,1164,6631,14322,7283,15486
220191,202301,1953,5139,1767,4845,144,431,1282,3407,1426,3838
220192,202301,2420,5709,1762,4610,39,129,1419,3632,1458,3761
220194,202301,2220,5287,1939,4854,44,163,1620,3852,1664,4015
220196,202301,2590,5814,2354,5483,17,77,2030,4615,2047,4692
220198,202301,1587,3531,1338,3228,14,33,1222,2957,1236,2990
220200,202301,5983,15643,5207,14601,148,544,4350,12056,4498,12600
220202,202301,2575,6254,2184,5655,29,121,1857,4700,1886,4821
220205,202301,3254,7552,2893,6959,84,248,2473,5771,2557,6019
220207,202301,910,2416,774,2200,79,201,486,1425,565,1626
220208,202301,2121,5868,1717,5147,294,933,873,2573,1167,3506
220209,202301,1860,4895,1544,4340,34,114,1170,3217,1204,3331
220210,202301,2317,4629,2023,4215,21,58,1777,3580,1798,3638
220211,202301,2054,4211,1871,3979,18,61,1651,3430,1669,3491
220213,202301,2151,4998,1844,4509,30,97,1475,3415,1505,3512
220217,202301,2888,6846,2666,6596,163,238,2351,6031,2514,6269
220220,202301,16432,32600,14192,29511,467,1048,11992,24244,12459,25292
220225,202301,1217,2696,989,2414,2,12,931,2246,933,2258
220230,202301,7060,15355,6085,14058,452,886,5040,11721,5492,12607
220240,202301,3829,9578,3100,8368,96,384,2505,6553,2601,6937
220245,202301,2497,4341,1929,3682,10,37,1799,3368,1809,3405
220250,202301,3655,8765,3193,8205,27,100,2974,7583,3001,7683
220253,202301,1976,4778,1659,4302,30,98,1412,3580,1442,3678
220255,202301,2362,4879,1995,4378,43,143,1707,3580,1750,3723
220260,202301,6153,15040,5344,13711,271,661,4262,10870,4533,11531
220265,202301,1844,4757,1671,4535,81,275,1404,3711,1485,3986
220270,202301,7293,20899,6841,20144,174,843,5757,16249,5931,17092
220271,202301,1818,4005,1589,3700,51,125,1371,3150,1422,3275
220272,202301,2023,5296,1749,4799,51,174,1334,3493,1385,3667
220273,202301,1500,3867,1237,3406,66,215,932,2520,998,2735
220275,202301,3199,5983,2594,5192,74,103,2314,4606,2388,4709
220277,202301,2860,5920,2414,5324,91,180,2011,4342,2102,4522
220280,202301,2395,4338,2023,3889,26,49,1840,3469,1866,3518
220285,202301,2031,4028,1757,3706,11,47,1679,3481,1690,3528
220290,202301,8409,20492,6695,18192,606,1503,4676,13158,5282,14661
220300,202301,2331,6034,1819,5381,39,181,1467,4302,1506,4483
220310,202301,3876,8964,3049,8019,47,169,2649,6908,2696,7077
220320,202301,3697,9361,2815,7869,71,300,2215,5926,2286,6226
220323,202301,2052,5030,1572,4283,47,166,1323,3479,1370,3645
220325,202301,1433,3922,1187,3502,34,136,949,2739,983,2875
220327,202301,1998,4818,1756,4450,65,216,1459,3576,1524,3792
220330,202301,6544,12629,5643,11588,94,268,5182,10404,5276,10672
220335,202301,2243,5500,2045,5241,130,230,1704,4461,1834,4691
220340,202301,2110,5221,1580,4349,92,306,993,2610,1085,2916
220342,202301,1505,3718,1342,3494,124,222,1000,2713,1124,2935
220345,202301,3715,7381,2827,6195,19,57,2526,5416,2545,5473
220350,202301,3919,9057,3128,7913,223,514,2191,5496,2414,6010
220360,202301,1582,3563,1214,2969,16,53,992,2337,1008,2390
220370,202301,10908,26866,9849,25299,396,1038,8291,21037,8687,22075
220375,202301,2066,4793,1830,4514,15,24,1760,4358,1775,4382
220380,202301,1887,3767,1519,3274,28,46,1319,2819,1347,2865
220385,202301,1124,2223,919,1887,5,9,825,1652,830,1661
220390,202301,15525,32928,12465,28663,1981,4675,6988,15696,8969,20371
220400,202301,1803,3850,1376,3208,17,58,1074,2358,1091,2416
220410,202301,1442,3507,1157,3039,30,103,948,2428,978,2531
220415,202301,1006,2330,802,1990,23,45,619,1498,642,1543
220420,202301,2208,5764,1772,4955,78,257,1266,3444,1344,3701
220430,202301,3511,7456,3114,6952,42,99,2824,6193,2866,6292
220435,202301,2477,5253,2144,4755,28,88,1841,3929,1869,4017
220440,202301,3934,8912,3344,8103,57,265,2970,6881,3027,7146
220450,202301,3324,7322,2759,6631,57,194,2437,5733,2494,5927
220455,202301,1704,4171,1605,4049,21,62,1461,3700,1482,3762
220460,202301,1406,2793,1291,2642,27,66,1147,2260,1174,2326
220465,202301,2897,7827,2554,7325,185,527,1996,5735,2181,6262
220470,202301,4676,11064,4125,10232,220,436,3152,7758,3372,8194
220480,202301,3159,7453,2507,6491,238,440,1662,4323,1900,4763
220490,202301,2891,6423,2464,5906,27,129,2154,5029,2181,5158
220500,202301,3986,8520,3339,7577,133,242,2573,5718,2706,5960
220510,202301,3251,7623,2625,6595,113,271,2042,5171,2155,5442
220515,202301,2148,4407,1963,4157,72,95,1675,3533,1747,3628
220520,202301,6219,13801,5625,12997,106,228,4824,11056,4930,11284
220525,202301,1685,3618,1397,3274,40,83,1234,2909,1274,2992
220527,202301,1983,4205,1650,3725,63,131,1445,3271,1508,3402
220530,202301,2013,4054,1677,3635,170,350,1262,2828,1432,3178
220535,202301,1025,2455,941,2330,27,95,766,1809,793,1904
220540,202301,3844,10709,3514,10079,229,624,2795,7984,3024,8608
220545,202301,1771,4618,1606,4367,87,306,1346,3583,1433,3889
220550,202301,10472,29513,9178,27181,540,1748,6656,19137,7196,20885
220551,202301,1760,4153,1520,3774,25,78,1264,3064,1289,3142
220552,202301,1930,5024,1554,4395,25,123,1249,3375,1274,3498
220553,202301,2552,5001,2151,4492,27,50,1953,4028,1980,4078
220554,202301,1162,2547,898,2165,80,153,630,1491,710,1644
220555,202301,4751,8440,4227,7838,31,84,3812,6980,3843,7064
220556,202301,1567,3925,1324,3516,42,181,958,2367,1000,2548
220557,202301,2004,5479,1644,4741,99,372,1201,3301,1300,3673
220558,202301,1757,4011,1408,3540,24,93,1210,2929,1234,3022
220559,202301,2244,4741,1900,4231,65,112,1547,3415,1612,3527
220560,202301,2372,4433,1994,3985,19,35,1875,3706,1894,3741
220570,202301,9819,24935,8780,23446,680,1636,6828,18203,7508,19839
220580,202301,8128,19459,7332,18308,103,284,6499,16119,6602,16403
220585,202301,2477,6854,2031,6030,62,151,1629,4832,1691,4983
220590,202301,1995,4194,1659,3740,104,207,1347,2977,1451,3184
220595,202301,3343,7863,2989,7397,82,270,2551,6151,2633,6421
220600,202301,2236,3753,1939,3422,21,38,1830,3187,1851,3225
220605,202301,1743,4645,1473,4173,25,122,1167,3174,1192,3296
220610,202301,3577,8443,3335,8118,15,84,3153,7580,3168,7664
220620,202301,10846,25910,9879,24641,135,637,9077,22138,9212,22775
220630,202301,419,1119,321,948,28,90,197,545,225,635
220635,202301,2142,5610,1875,5107,66,189,1505,3984,1571,4173
220640,202301,2845,7053,2425,6472,87,291,1932,5068,2019,5359
220650,202301,2937,6525,2505,5900,72,161,2089,4887,2161,5048
220660,202301,3100,8575,2584,7754,79,351,2113,6155,2192,6506
220665,202301,1643,4088,1409,3728,32,141,1217,3110,1249,3251
220667,202301,1929,5064,1742,4759,84,265,1406,3780,1490,4045
220669,202301,1973,5096,1874,4961,37,151,1675,4312,1712,4463
220670,202301,2847,5977,2294,5229,31,86,2025,4529,2056,4615
220672,202301,4161,8992,3433,8131,100,344,3041,7009,3141,7353
220675,202301,1545,3792,1371,3497,89,261,1026,2558,1115,2819
220680,202301,3741,7844,3546,7606,214,326,3119,6781,3333,7107
220690,202301,1873,4412,1604,4014,103,289,1207,2948,1310,3237
220695,202301,1114,2763,1003,2579,19,57,836,2113,855,2170
220700,202301,15002,28973,12296,25532,452,996,10127,20291,10579,21287
220710,202301,1048,2524,759,2052,26,85,574,1486,600,1571
220720,202301,2748,5435,2455,5075,27,75,2198,4427,2225,4502
220730,202301,1663,3887,1429,3533,15,61,1247,2988,1262,3049
220735,202301,1239,2475,959,2066,40,74,729,1529,769,1603
220740,202301,1652,3774,1309,3328,55,125,1063,2722,1118,2847
220750,202301,5328,10928,4707,10125,270,427,4151,9011,4421,9438
220755,202301,1824,3668,1527,3265,40,84,1271,2655,1311,2739
220760,202301,4284,9039,3738,8341,48,160,3503,7742,3551,7902
220770,202301,33909,84690,29249,77398,7475,21179,12759,33096,20234,54275
220775,202301,1690,3413,1513,3203,5,23,1476,3093,1481,3116
220777,202301,1881,4278,1485,3704,50,97,1032,2700,1082,2797
220779,202301,1463,3525,1252,3209,40,118,1034,2593,1074,2711
220780,202301,7119,15291,6352,14229,394,899,4966,11041,5360,11940
220785,202301,1747,3404,1533,3143,19,40,1442,2923,1461,2963
220790,202301,12654,30572,11281,28716,232,786,9700,24258,9932,25044
220793,202301,1190,2612,965,2251,15,33,820,1878,835,1911
220795,202301,1674,3811,1470,3537,29,81,1285,3076,1314,3157
220800,202301,26520,49367,22854,44737,963,1809,18835,35803,19798,37612
220810,202301,3735,8983,3140,8046,75,157,2549,6595,2624,6752
220820,202301,7367,15217,6485,14014,297,489,5458,11768,5755,12257
220830,202301,9376,20765,8306,19284,454,1020,6728,15280,7182,16300
220840,202301,16260,40930,13870,36777,1913,4967,8789,22685,10702,27652
220850,202301,3608,9821,3184,9302,54,252,2824,8236,2878,8488
220855,202301,1053,1972,921,1809,23,56,841,1632,864,1688
220860,202301,1447,2822,1241,2542,27,70,1147,2301,1174,2371
220865,202301,2698,6739,2061,5655,50,200,1526,4018,1576,4218
220870,202301,4011,8845,3295,7940,41,167,3006,7119,3047,7286
220880,202301,8169,14465,7050,13145,136,292,6491,11959,6627,12251
220885,202301,1827,4389,1518,3944,94,270,1207,3089,1301,3359
220887,202301,1987,3629,1685,3244,34,50,1556,2969,1590,3019
220890,202301,1707,4550,1453,4187,58,202,1160,3324,1218,3526
220900,202301,2644,5192,2234,4665,25,60,2011,4101,2036,4161
220910,202301,2165,4639,1857,4203,290,467,1316,3155,1606,3622
220915,202301,1087,2697,867,2331,9,31,639,1619,648,1650
220920,202301,1922,4891,1656,4557,113,301,1356,3759,1469,4060
220930,202301,2421,5074,2042,4581,21,56,1841,4194,1862,4250
220935,202301,1249,3308,972,2736,18,79,656,1728,674,1807
220937,202301,1730,4082,1458,3663,35,115,1160,2826,1195,2941
220940,202301,2283,4800,1872,4141,41,115,1603,3397,1644,3512
220945,202301,587,1783,464,1568,22,114,315,1033,337,1147
220950,202301,1631,3399,1111,2631,10,25,892,2003,902,2028
220955,202301,2031,4333,1677,3769,14,26,1473,3253,1487,3279
220960,202301,885,2098,642,1700,37,123,434,1058,471,1181
220965,202301,2214,5021,1925,4621,21,94,1704,3964,1725,4058
220970,202301,2619,5044,1960,4140,7,25,1729,3524,1736,3549
220975,202301,920,2101,786,1939,14,55,689,1636,703,1691
220980,202301,1557,3571,1381,3344,35,92,1207,2858,1242,2950
220985,202301,1770,3750,1531,3401,91,162,1193,2603,1284,2765
220987,202301,1814,4615,1607,4294,55,184,1335,3508,1390,3692
220990,202301,1958,4865,1716,4516,26,97,1431,3708,1457,3805
220995,202301,1711,3807,1408,3321,14,45,1212,2809,1226,2854
220997,202301,2923,7466,2652,7042,45,176,2337,6037,2382,6213
221000,202301,5899,13455,5119,12399,188,520,4279,10192,4467,10712
221005,202301,2017,4323,1836,4047,25,98,1593,3335,1618,3433
221010,202301,1567,2953,1244,2567,38,54,1093,2233,1131,2287
221020,202301,1788,4958,1604,4660,23,96,1254,3603,1277,3699
221030,202301,2068,4155,1768,3794,24,62,1583,3399,1607,3461
221035,202301,1927,4177,1624,3782,46,69,1405,3296,1451,3365
221037,202301,838,2022,698,1794,11,42,524,1260,535,1302
221038,202301,618,1553,485,1342,25,76,341,912,366,988
221039,202301,1003,2453,821,2171,27,95,655,1677,682,1772
221040,202301,5313,13559,4545,12324,243,640,3586,9704,3829,10344
221050,202301,5690,11014,5110,10311,70,189,4686,9329,4756,9518
221060,202301,11796,27912,9714,24629,510,1149,7681,19270,8191,20419
221062,202301,1627,4030,1394,3688,119,250,1075,2891,1194,3141
221063,202301,1489,3403,1296,3132,59,164,1074,2512,1133,2676
221065,202301,3538,7418,3066,6675,15,51,2767,5900,2782,5951
221070,202301,3984,11005,3187,9431,488,1415,1863,5597,2351,7012
221080,202301,4393,9403,3592,8243,53,182,3022,6639,3075,6821
221090,202301,1702,3692,1413,3274,18,43,1227,2773,1245,2816
221093,202301,2039,4509,1842,4200,180,348,1350,3011,1530,3359
221095,202301,1089,2499,897,2230,33,86,722,1775,755,1861
221097,202301,985,2257,733,1846,19,58,563,1338,582,1396
221100,202301,180269,398503,153631,357930,10384,27696,113156,249064,123540,276760
221110,202301,13905,32790,12649,31240,399,874,11113,27350,11512,28224
221120,202301,5943,15107,5279,14160,209,624,4488,11939,4697,12563
221130,202301,7328,15560,5810,12996,1008,1983,3639,7905,4647,9888
221135,202301,2443,5003,2112,4591,89,161,1813,4001,1902,4162
221140,202301,1940,3514,1601,3114,49,78,1410,2709,1459,2787
221150,202301,1353,2992,1025,2471,27,110,806,1823,833,1933
221160,202301,885,1958,783,1832,39,50,613,1444,652,1494
221170,202301,1275,2931,1181,2783,6,17,1086,2499,1092,2516
230010,202301,3637,8607,2937,7452,76,203,2375,5820,2451,6023
230015,202301,4399,11480,3825,10389,222,648,2729,7268,2951,7916
230020,202301,18735,47220,17333,45137,956,2417,14232,37052,15188,39469
230030,202301,15798,34547,13188,31112,565,1169,10587,25294,11152,26463
230040,202301,5594,12064,4653,10671,49,192,3814,8807,3863,8999
230050,202301,3095,8819,2387,7277,308,1030,1183,3262,1491,4292
230060,202301,2972,7001,2296,5891,39,143,1849,4586,1888,4729
230070,202301,5385,11965,4276,10101,570,1271,2728,6424,3298,7695
230075,202301,12074,31866,10930,30016,531,1764,8858,23657,9389,25421
230080,202301,3760,6842,2891,5796,11,25,2683,5322,2694,5347
230090,202301,5681,11726,4754,10347,156,325,3967,8356,4123,8681
230100,202301,27519,58213,23899,53636,2175,4961,16905,37313,19080,42274
230110,202301,16792,44325,14191,39625,2183,6429,7863,20986,10046,27415
230120,202301,9949,22917,8542,20826,759,1859,5995,14498,6754,16357
230125,202301,3761,8720,3114,7723,65,246,2571,6089,2636,6335
230130,202301,6854,18502,5532,15831,362,1012,3819,10719,4181,11731
230140,202301,4334,11232,3604,9888,106,411,2808,7355,2914,7766
230150,202301,1951,5143,1613,4489,203,541,942,2612,1145,3153
230160,202301,9036,18068,7783,16319,241,448,6684,13696,6925,14144
230170,202301,7445,19261,6018,16530,451,1177,4098,11016,4549,12193
230180,202301,2013,4868,1620,4177,15,62,1317,3237,1332,3299
230185,202301,5676,13329,4669,11780,461,1152,3296,8338,3757,9490
230190,202301,17683,47802,14456,41870,1937,5737,7984,22412,9921,28149
230195,202301,7060,17792,6329,16625,345,900,4837,12616,5182,13516
230200,202301,5880,14697,4841,12871,326,846,3484,9036,3810,9882
230205,202301,5727,13260,5002,12276,484,976,3754,9267,4238,10243
230210,202301,13340,26870,11376,24352,470,988,9207,19158,9677,20146
230220,202301,19080,40704,16730,37531,965,2181,13606,29864,14571,32045
230230,202301,8799,21911,7915,20324,565,1312,5982,15195,6547,16507
230240,202301,16996,37821,14384,33745,896,1806,11115,25826,12011,27632
230250,202301,11463,27747,10616,26535,539,1368,7910,19137,8449,20505
230260,202301,18661,46869,15980,42461,2252,5766,9671,25353,11923,31119
230270,202301,8842,21189,6743,17592,869,2085,3865,10378,4734,12463
230280,202301,24821,56215,20585,49643,426,1634,16808,38173,17234,39807
230290,202301,6437,14471,5448,12786,235,526,4369,9894,4604,10420
230300,202301,6202,13865,5546,13000,80,210,4875,11369,4955,11579
230310,202301,5665,14502,4690,12776,170,594,3398,8894,3568,9488
230320,202301,9238,23797,7635,21122,252,957,5907,15765,6159,16722
230330,202301,5854,13991,4542,11641,150,486,3425,8408,3575,8894
230340,202301,4682,12959,4019,11692,266,816,2804,7891,3070,8707
230350,202301,23639,54206,20554,49968,1013,2937,15130,35473,16143,38410
230360,202301,3781,8569,2936,7199,165,386,2146,5239,2311,5625
230365,202301,3739,7942,3097,7053,78,219,2717,6088,2795,6307
230370,202301,100382,212095,88485,196417,4860,12782,70639,149092,75499,161874
230380,202301,7522,18559,5897,15691,138,488,4450,11278,4588,11766
230390,202301,4121,10449,3512,9528,78,317,2795,7328,2873,7645
230393,202301,4148,10290,3311,8721,86,416,2660,6599,2746,7015
230395,202301,6835,16832,5782,15098,539,1406,3826,9736,4365,11142
230400,202301,6875,16329,6037,15081,84,385,4898,11598,4982,11983
230410,202301,16203,43223,13431,38532,1075,3159,9103,25846,10178,29005
230420,202301,37249,88900,30613,78313,3027,8148,19223,46858,22250,55006
230423,202301,5501,14604,4812,13395,312,930,3457,9315,3769,10245
230425,202301,7517,19751,6908,18657,725,1886,4797,12809,5522,14695
230426,202301,3269,7558,2353,5908,43,157,1789,4269,1832,4426
230427,202301,2129,5470,1547,4351,142,456,839,2125,981,2581
230428,202301,12252,29786,10513,27369,1505,3969,6179,15505,7684,19474
230430,202301,5887,15045,4608,12861,195,546,3419,9332,3614,9878
230435,202301,7829,17554,6382,15227,895,2049,3718,8723,4613,10772
230440,202301,612729,1249618,525125,1132693,34333,82633,392073,805745,426406,888378
230445,202301,4978,12351,4071,10881,248,670,2732,6961,2980,7631
230450,202301,4632,11283,4022,10429,196,689,3052,7473,3248,8162
230460,202301,2743,6352,2341,5737,65,222,1974,4703,2039,4925
230465,202301,5108,12375,4256,10848,145,419,3296,8061,3441,8480
230470,202301,14256,39990,12789,37424,823,2786,9451,26591,10274,29377
230480,202301,1873,4573,1535,4008,54,212,1184,2892,1238,3104
230490,202301,3328,8201,2749,7130,215,653,1842,4402,2057,5055
230495,202301,7473,18258,6504,16683,824,2226,4079,10085,4903,12311
230500,202301,11235,32164,9851,29796,429,1358,7759,23456,8188,24814
230510,202301,2157,5209,1702,4372,162,437,1081,2620,1243,3057
230520,202301,5851,13928,5021,12580,397,962,3662,8923,4059,9885
230523,202301,20170,53367,15873,45104,3542,9740,4194,12248,7736,21988
230526,202301,4826,11502,4069,10350,331,654,2843,7473,3174,8127
230530,202301,6630,18807,5541,16838,1193,3723,3009,9092,4202,12815
230533,202301,6084,11524,4865,9775,65,185,4194,8002,4259,8187
230535,202301,5997,15479,5052,14003,350,1071,3332,9069,3682,10140
230540,202301,18385,45608,15751,41812,273,965,12925,33670,13198,34635
230550,202301,28197,63551,23237,55869,1937,4741,16035,37088,17972,41829
230560,202301,9364,19522,7428,16685,173,336,6273,14005,6446,14341
230565,202301,3771,9159,3126,8046,95,297,2483,6174,2578,6471
230570,202301,4067,9306,3399,8397,74,220,2802,6752,2876,6972
230580,202301,14957,32253,12846,29335,509,1114,10816,24312,11325,25426
230590,202301,11650,28623,9700,25445,736,1837,6995,18020,7731,19857
230600,202301,4545,10092,3575,8535,144,351,2498,5907,2642,6258
230610,202301,8157,19516,7171,17964,479,1227,5634,13918,6113,15145
230620,202301,2502,6003,1949,5018,90,282,1303,3106,1393,3388
230625,202301,12392,29434,10681,26696,2080,5465,5063,12003,7143,17468
230630,202301,14323,35327,12573,32363,1505,3560,8100,20889,9605,24449
230640,202301,32585,88827,29449,83938,1456,4911,23361,64987,24817,69898
230650,202301,6293,14893,5265,13239,179,643,4291,10285,4470,10928
230655,202301,11958,33494,11241,32391,907,2381,8928,26100,9835,28481
230660,202301,7270,19000,5824,16534,176,724,4674,12901,4850,13625
230670,202301,7216,15293,5184,12219,156,414,4130,9379,4286,9793
230680,202301,3354,8066,2738,7063,162,329,1909,4876,2071,5205
230690,202301,8386,22257,7046,19783,538,1576,4401,12239,4939,13815
230700,202301,12964,28002,10350,23506,417,1014,8032,17504,8449,18518
230710,202301,7984,22738,6963,20741,652,1986,4612,13383,5264,15369
230720,202301,2301,6090,1910,5422,141,389,1260,3472,1401,3861
230725,202301,5747,14722,5182,13825,369,1154,3566,9041,3935,10195
230730,202301,74616,175091,58884,153383,12527,33124,24077,63650,36604,96774
230740,202301,7193,18091,6007,16254,175,493,4723,12669,4898,13162
230750,202301,10094,23973,8237,21090,140,486,6620,16308,6760,16794
230760,202301,14226,32902,12285,30111,484,1502,9447,22080,9931,23582
230763,202301,5804,13899,4747,12205,95,369,3780,9285,3875,9654
230765,202301,56653,132380,48399,120282,4879,13145,31161,73179,36040,86324
230770,202301,36249,71610,30900,65030,2001,4365,24085,48975,26086,53340
230780,202301,8036,24387,7222,22626,974,2863,4325,13679,5299,16542
230790,202301,3846,9334,3426,8696,127,421,2717,6544,2844,6965
230800,202301,10695,29181,9288,26572,1126,3390,5585,15181,6711,18571
230810,202301,12823,34946,11346,32627,554,1721,8676,24407,9230,26128
230820,202301,4234,12293,3516,10871,341,1239,2167,6333,2508,7572
230830,202301,9410,22059,7983,19849,335,720,6295,15321,6630,16041
230835,202301,5009,10572,3941,9033,118,282,3205,7105,3323,7387
230837,202301,4769,10706,4314,10006,76,288,3772,8349,3848,8637
230840,202301,11473,30107,9789,27317,790,2211,7125,19682,7915,21893
230850,202301,12458,30236,10527,26919,598,1437,7782,19608,8380,21045
230860,202301,7934,14863,6693,13225,220,343,5899,11465,6119,11808
230870,202301,22578,44472,19363,39584,751,1461,15953,31608,16704,33069
230880,202301,2417,6518,2188,6147,74,310,1701,4580,1775,4890
230890,202301,5507,15314,4962,14413,228,792,3667,10394,3895,11186
230900,202301,3953,9895,3303,8689,129,454,2418,6004,2547,6458
230910,202301,4241,9259,3298,7884,66,255,2774,6456,2840,6711
230920,202301,5674,14117,4542,12285,124,408,3478,9067,3602,9475
230930,202301,8326,20772,6800,18199,356,1044,4738,12284,5094,13328
230940,202301,10064,22061,8705,20174,205,450,7443,16988,7648,17438
230945,202301,7921,19836,6740,17779,332,973,4873,12326,5205,13299
230950,202301,7662,16669,6760,15484,144,339,5759,13123,5903,13462
230960,202301,15759,40720,13617,36970,2136,5917,6937,18028,9073,23945
230970,202301,19316,44591,16407,40384,1602,4115,10793,25577,12395,29692
230980,202301,4290,9158,3716,8266,330,715,2765,6001,3095,6716
230990,202301,2060,5097,1707,4458,65,241,1258,3078,1323,3319
231000,202301,3348,7665,2624,6364,67,208,2019,4611,2086,4819
231010,202301,4589,8954,3546,7346,35,135,3160,6270,3195,6405
231020,202301,10923,27868,9683,25734,1542,3739,5925,15962,7467,19701
231025,202301,10480,23627,9294,21890,628,1384,7277,16876,7905,18260
231030,202301,8682,23440,6624,19414,846,2448,3824,11068,4670,13516
231040,202301,3815,8877,3247,7933,87,244,2717,6367,2804,6611
231050,202301,14963,32654,12186,28206,478,1224,9605,21330,10083,22554
231060,202301,3533,8556,3133,7978,109,332,2494,6315,2603,6647
231070,202301,9908,25183,8555,22940,755,2005,5798,15231,6553,17236
231080,202301,4633,11700,3817,10401,228,654,2650,7122,2878,7776
231085,202301,9036,18902,7216,16746,253,600,5697,12895,5950,13495
231090,202301,5175,12204,3814,9709,122,435,2698,6428,2820,6863
231095,202301,2627,7223,2063,6063,188,547,1355,3923,1543,4470
231100,202301,3510,9154,2876,8036,141,453,2177,5879,2318,6332
231110,202301,4430,11700,4049,11038,344,1078,2856,7405,3200,8483
231120,202301,2928,7309,2461,6568,111,293,1835,4785,1946,5078
231123,202301,2334,5439,1828,4582,113,268,1285,3171,1398,3439
231126,202301,6673,16253,5407,14017,317,751,3957,10108,4274,10859
231130,202301,30793,62437,25766,56259,1247,3506,20401,42154,21648,45660
231135,202301,5072,12669,4189,11085,169,476,3038,7852,3207,8328
231140,202301,21609,51707,17623,45464,788,2556,13149,32225,13937,34781
231150,202301,7088,17391,5042,13520,824,2286,1885,4881,2709,7167
231160,202301,8565,21705,7621,20088,752,1972,5086,13113,5838,15085
231170,202301,5642,14267,4674,12565,297,849,3349,8581,3646,9430
231180,202301,19131,46917,15659,40443,2370,6108,8297,20681,10667,26789
231190,202301,5007,12253,3932,10423,97,320,3002,7671,3099,7991
231195,202301,5957,16152,4880,14150,309,993,3445,9901,3754,10894
231200,202301,10287,25196,9013,22952,147,656,7574,18327,7721,18983
231210,202301,5840,15034,4886,13494,143,575,3902,10378,4045,10953
231220,202301,16276,35162,12867,29403,617,1336,9574,20840,10191,22176
231230,202301,12068,33749,10607,31173,775,2401,7817,22675,8592,25076
231240,202301,14550,38393,12773,35321,1704,4604,7859,21397,9563,26001
231250,202301,2526,5504,1680,3843,66,154,1170,2483,1236,2637
231260,202301,4041,9609,3407,8656,344,755,2323,5954,2667,6709
231270,202301,7846,17719,6363,15404,155,545,4885,11167,5040,11712
231280,202301,2141,5918,1845,5412,169,480,1262,3701,1431,4181
231290,202301,44469,119478,37514,107395,5032,14380,19691,54151,24723,68531
231300,202301,5034,12296,3895,10160,177,555,2703,6687,2880,7242
231310,202301,10290,21754,8202,18295,577,1475,6067,12738,6644,14213
231320,202301,8324,21087,6453,17802,172,453,5007,13634,5179,14087
231325,202301,2898,6760,2266,5772,146,278,1622,4099,1768,4377
231330,202301,13474,33657,11223,29684,1407,3624,7205,18912,8612,22536
231335,202301,6766,15804,5633,14105,155,476,4787,11783,4942,12259
231340,202301,22701,61323,20256,57470,1569,4347,15052,43016,16621,47363
231350,202301,19570,46684,17785,44267,307,952,15854,38920,16161,39872
231355,202301,5318,13793,4701,12724,228,653,3658,9695,3886,10348
231360,202301,9611,25620,8276,23509,424,1315,6471,18059,6895,19374
231370,202301,2439,6130,1931,5262,43,126,1469,3935,1512,4061
231375,202301,4916,13419,4378,12559,186,523,3464,9968,3650,10491
231380,202301,7436,16791,6533,15619,209,415,5428,12907,5637,13322
231390,202301,4066,10662,3597,9925,117,462,2716,7184,2833,7646
231395,202301,5344,13382,4487,12061,322,831,3122,8228,3444,9059
231400,202301,11936,29674,9936,26222,294,1159,7721,19431,8015,20590
231410,202301,20103,49675,18222,46979,888,2150,15045,38570,15933,40720
240010,202301,3082,7263,2395,6115,357,923,1194,2912,1551,3835
240020,202301,17337,40412,14406,35629,844,2493,10229,24004,11073,26497
240030,202301,4764,8774,4295,8134,84,249,3912,7105,3996,7354
240040,202301,934,2470,773,2191,24,75,510,1378,534,1453
240050,202301,4185,9893,3280,8341,74,186,2512,6210,2586,6396
240060,202301,1792,4157,1397,3485,48,125,1090,2657,1138,2782
240070,202301,3218,7855,2850,7123,219,612,2036,4757,2255,5369
240080,202301,3523,8541,2755,7267,122,365,1932,4927,2054,5292
240090,202301,2826,5876,2321,5111,44,88,2002,4306,2046,4394
240100,202301,13615,28184,10956,23938,226,672,8898,18279,9124,18951
240110,202301,5965,14734,4968,12993,172,576,3783,9396,3955,9972
240120,202301,4058,10281,3385,9377,255,838,2409,6452,2664,7290
240130,202301,4870,8444,3976,7327,29,69,3629,6556,3658,6625
240140,202301,2161,5940,1808,5317,201,685,1125,3170,1326,3855
240145,202301,8309,20964,6656,18237,745,2085,4238,11400,4983,13485
240150,202301,1279,3005,1065,2617,50,155,838,1966,888,2121
240160,202301,1755,4552,1436,3991,43,185,1052,2787,1095,2972
240165,202301,1168,2809,967,2461,26,93,797,1952,823,2045
240170,202301,3449,7932,2898,7036,292,704,1902,4508,2194,5212
240180,202301,3652,9750,2957,8392,621,1746,1331,3882,1952,5628
240185,202301,1651,4449,1474,4154,46,175,1156,3114,1202,3289
240190,202301,1384,3315,1131,2927,29,101,914,2308,943,2409
240200,202301,16065,34065,13014,29324,1443,3378,8046,17169,9489,20547
240210,202301,4271,8618,3536,7480,35,140,3093,6226,3128,6366
240220,202301,8755,23691,7771,22228,518,1761,5896,16528,6414,18289
240230,202301,7089,15904,5546,13472,312,624,4041,9928,4353,10552
240240,202301,2099,5588,1467,4260,190,598,518,1261,708,1859
240250,202301,3801,8354,3254,7570,61,197,2735,6100,2796,6297
240260,202301,19764,50113,17170,46045,4946,12824,7167,21291,12113,34115
240270,202301,3004,7609,2471,6797,111,325,1693,4743,1804,5068
240280,202301,1954,4548,1615,4013,65,156,1265,3088,1330,3244
240290,202301,1380,3584,1127,3099,32,131,761,1886,793,2017
240300,202301,2670,6243,1958,5081,100,264,1208,3014,1308,3278
240310,202301,10378,24982,8232,21388,1137,2919,4144,10449,5281,13368
240320,202301,2260,5688,1586,4399,102,317,1054,2760,1156,3077
240325,202301,46110,104597,38119,92166,4425,12084,23301,52447,27726,64531
240330,202301,2153,5289,1680,4469,73,248,1147,2857,1220,3105
240340,202301,2532,4897,2039,4199,60,145,1696,3316,1756,3461
240350,202301,3035,6212,2688,5816,60,141,2449,5250,2509,5391
240360,202301,15468,36169,13800,33721,2141,5017,8748,21341,10889,26358
240370,202301,2664,5728,2060,4686,93,257,1528,3233,1621,3490
240375,202301,1150,2488,926,2143,40,125,673,1391,713,1516
240380,202301,2757,6941,2142,5733,215,546,1237,3201,1452,3747
240390,202301,1165,2597,804,1961,24,53,524,1182,548,1235
240400,202301,1731,3866,1282,3135,42,149,911,2078,953,2227
240410,202301,704,1906,577,1672,60,212,317,852,377,1064
240420,202301,6252,18180,5599,16964,450,1719,3867,11122,4317,12841
240430,202301,4283,9665,3585,8548,109,346,2803,6329,2912,6675
240440,202301,3397,6760,2896,6082,285,543,2187,4520,2472,5063
240450,202301,5305,13026,4189,11086,320,1017,2614,6321,2934,7338
240460,202301,4231,9710,3793,9055,305,657,3004,7199,3309,7856
240470,202301,4058,11340,3098,9424,657,1810,1411,4550,2068,6360
240480,202301,692,1713,425,1154,30,63,206,540,236,603
240485,202301,2528,6440,2001,5543,155,461,1272,3502,1427,3963
240490,202301,1963,4326,1500,3551,90,175,1085,2495,1175,2670
240500,202301,2611,6251,2256,5684,113,274,1803,4478,1916,4752
240510,202301,1994,4815,1708,4397,64,196,1383,3444,1447,3640
240520,202301,1948,3916,1494,3338,103,215,1167,2595,1270,2810
240530,202301,2873,6763,2544,6261,157,284,2043,5008,2200,5292
240540,202301,2819,6066,2514,5621,45,115,2257,4994,2302,5109
240550,202301,1076,2307,956,2122,13,50,854,1822,867,1872
240560,202301,4824,9909,4164,9076,155,273,3503,7578,3658,7851
240570,202301,3299,8061,2231,5872,297,812,863,1999,1160,2811
240580,202301,10577,26478,9341,24443,530,1506,7555,19397,8085,20903
240590,202301,1129,2173,980,1972,22,32,809,1568,831,1600
240600,202301,2104,5107,1534,4037,59,164,1060,2631,1119,2795
240610,202301,5538,12651,4726,11301,237,605,3458,7890,3695,8495
240615,202301,1564,3518,1250,3021,90,246,928,2107,1018,2353
240620,202301,2366,5630,2019,5073,67,205,1668,4059,1735,4264
240630,202301,2777,6184,2495,5756,210,343,1878,4405,2088,4748
240640,202301,1109,2617,871,2234,35,107,648,1595,683,1702
240650,202301,4814,12754,3988,11158,314,837,2673,7403,2987,8240
240660,202301,5223,9266,4786,8718,65,119,4486,8071,4551,8190
240670,202301,3082,7505,2439,6289,213,589,1580,3885,1793,4474
240680,202301,1936,4466,1545,3835,53,159,1204,2844,1257,3003
240690,202301,1458,3039,1143,2538,20,71,957,1985,977,2056
240700,202301,2838,7535,2280,6563,110,334,1667,4721,1777,5055
240710,202301,24550,50753,21079,45603,1738,3898,15807,32788,17545,36686
240720,202301,6278,14200,5251,12769,645,1613,3414,8102,4059,9715
240725,202301,1291,3349,977,2792,41,118,624,1713,665,1831
240730,202301,2722,6743,2124,5670,66,217,1620,4167,1686,4384
240740,202301,2259,5643,1808,4779,86,272,1266,3141,1352,3413
240750,202301,2777,7959,2337,7091,279,893,1357,3942,1636,4835
240760,202301,2075,4162,1518,3373,114,162,1112,2574,1226,2736
240770,202301,4022,9558,3387,8708,136,437,2804,7011,2940,7448
240780,202301,6484,15468,5431,13795,741,1907,3499,8660,4240,10567
240790,202301,1058,2637,866,2317,26,119,628,1570,654,1689
240800,202301,72274,145899,58414,126364,5309,12272,38766,78050,44075,90322
240810,202301,134387,288781,117952,264483,10901,25270,84703,182891,95604,208161
240820,202301,7698,20188,6749,18542,1004,2797,4047,11081,5051,13878
240830,202301,10362,26245,8974,24275,334,1135,7121,18891,7455,20026
240840,202301,1298,2933,1030,2520,49,99,719,1705,768,1804
240850,202301,1654,4137,1131,3075,87,223,654,1674,741,1897
240860,202301,1776,3870,1348,3164,35,122,1108,2475,1143,2597
240870,202301,1243,2853,950,2391,159,386,472,1207,631,1593
240880,202301,1517,4379,1307,3976,105,400,915,2685,1020,3085
240890,202301,6580,14577,5215,12337,461,1277,3466,7407,3927,8684
240895,202301,3575,9528,3230,8997,404,1064,2338,6603,2742,7667
240910,202301,4160,10092,3424,8843,60,201,2771,6907,2831,7108
240920,202301,1283,2810,1031,2463,115,203,662,1626,777,1829
240930,202301,4382,8924,3531,7899,268,409,2321,5688,2589,6097
240933,202301,1942,4353,1620,3905,40,162,1359,3124,1399,3286
240940,202301,8951,18503,7168,15752,680,1460,4855,10125,5535,11585
240950,202301,1315,3524,1121,3152,33,138,871,2323,904,2461
240960,202301,860,2166,768,1983,15,53,601,1476,616,1529
240970,202301,2409,5136,1950,4436,63,184,1620,3540,1683,3724
240980,202301,4815,10955,4321,10209,67,275,3815,8657,3882,8932
240990,202301,3582,8205,3157,7491,234,683,2333,5144,2567,5827
241000,202301,1243,2697,970,2250,14,49,786,1705,800,1754
241010,202301,3823,9871,3466,9210,139,464,2808,7164,2947,7628
241020,202301,2537,6046,1918,4905,101,309,1365,3259,1466,3568
241025,202301,1919,5048,1541,4402,39,154,1096,3009,1135,3163
241030,202301,2965,8354,2397,7251,258,760,1564,4645,1822,5405
241040,202301,2583,7189,2202,6569,105,421,1663,4889,1768,5310
241050,202301,1716,4271,1355,3635,40,127,1016,2641,1056,2768
241060,202301,995,2416,834,2099,43,110,590,1396,633,1506
241070,202301,847,2017,703,1796,17,41,544,1323,561,1364
241080,202301,1340,3403,1043,2825,34,114,733,1894,767,2008
241090,202301,2495,6239,1980,5403,79,300,1470,3819,1549,4119
241100,202301,1387,3510,1059,2889,53,117,689,1831,742,1948
241105,202301,1289,3375,1049,2956,199,587,484,1295,683,1882
241110,202301,1079,2795,808,2252,50,145,502,1326,552,1471
241120,202301,9128,23291,7757,21073,809,2239,5050,13599,5859,15838
241140,202301,3973,9586,3025,7770,131,386,2169,5372,2300,5758
241142,202301,898,2215,687,1845,60,147,407,1017,467,1164
241150,202301,7085,16323,6173,14971,256,608,4855,11583,5111,12191
241160,202301,1395,3563,1068,2969,164,494,558,1445,722,1939
241170,202301,1591,3629,1343,3209,30,90,1114,2554,1144,2644
241180,202301,1240,2842,921,2305,89,232,512,1210,601,1442
241190,202301,1438,3249,1183,2806,23,77,884,1981,907,2058
241200,202301,31957,67560,28292,62192,3002,6988,19667,40783,22669,47771
241210,202301,1988,4495,1438,3533,108,288,908,2137,1016,2425
241220,202301,12283,30338,10825,28068,2447,6343,5278,13783,7725,20126
241230,202301,3513,8233,3032,7553,112,264,2472,6093,2584,6357
241240,202301,1431,3708,878,2546,99,307,296,801,395,1108
241250,202301,7536,17804,6051,15293,139,582,4776,11358,4915,11940
241255,202301,3238,8517,2736,7620,159,511,1994,5346,2153,5857
241260,202301,5954,13735,4771,11878,168,503,3634,8621,3802,9124
241270,202301,1914,5062,1588,4463,113,347,1108,3025,1221,3372
241280,202301,3131,6188,2735,5542,88,177,2360,4647,2448,4824
241290,202301,3863,8497,2827,6920,99,294,2236,5260,2335,5554
241300,202301,1890,4409,1540,3868,46,158,1089,2570,1135,2728
241310,202301,2863,5791,2469,5273,60,112,2139,4492,2199,4604
241320,202301,1134,3346,967,3038,103,349,577,1760,680,2109
241330,202301,2086,4721,1665,4173,29,82,1467,3635,1496,3717
241335,202301,4469,10879,3916,9958,127,423,3185,7788,3312,8211
241340,202301,2126,5006,1679,4201,202,617,951,2149,1153,2766
241350,202301,2625,6271,2268,5671,108,268,1739,4244,1847,4512
241355,202301,1638,3926,1308,3319,51,109,967,2409,1018,2518
241360,202301,2459,5656,1788,4398,56,166,1316,3055,1372,3221
241370,202301,1627,3883,1255,3206,60,178,910,2148,970,2326
241380,202301,845,1997,671,1715,70,175,392,984,462,1159
241390,202301,3274,8450,2874,7863,153,482,2206,5971,2359,6453
241400,202301,4375,10841,3833,10040,213,665,2946,7483,3159,8148
241410,202301,2968,7971,2389,6828,237,740,1530,4267,1767,5007
241415,202301,2313,5440,1962,4846,44,169,1616,3784,1660,3953
241420,202301,3806,9704,3415,9102,594,1668,2053,5444,2647,7112
241430,202301,848,1906,556,1380,20,56,380,862,400,918
241440,202301,10355,27034,9316,25391,271,906,7618,20269,7889,21175
241445,202301,1665,3383,1433,3082,30,65,1281,2727,1311,2792
241450,202301,3681,7546,2976,6508,221,438,2312,4977,2533,5415
241460,202301,4730,11397,3738,9500,332,910,2459,5888,2791,6798
241470,202301,1723,4064,1371,3557,44,151,1143,2897,1187,3048
241475,202301,1454,3539,1138,2980,20,74,850,2078,870,2152
241480,202301,3750,10293,3096,8995,854,2478,1092,3389,1946,5867
241490,202301,903,1816,643,1434,16,45,527,1131,543,1176
241500,202301,953,2286,846,2160,10,23,744,1897,754,1920
250010,202301,3287,8412,2656,7200,75,244,2007,5216,2082,5460
250020,202301,1918,4528,1422,3660,86,155,1057,2701,1143,2856
250030,202301,8558,20554,7457,18948,934,2461,5106,12831,6040,15292
250040,202301,5719,14532,4977,13299,770,1997,2993,7897,3763,9894
250050,202301,4498,10396,3982,9756,178,448,3274,8112,3452,8560
250053,202301,1550,3902,1402,3685,145,315,961,2535,1106,2850
250057,202301,906,2481,822,2362,11,43,751,2147,762,2190
250060,202301,7521,16644,6613,15403,477,1126,5076,11735,5553,12861
250070,202301,4848,11865,4027,10520,46,194,3225,8068,3271,8262
250073,202301,974,2255,771,1940,8,24,624,1534,632,1558
250077,202301,3242,6827,2516,5749,33,100,2137,4695,2170,4795
250080,202301,7336,14088,6114,12649,67,191,5597,11353,5664,11544
250090,202301,4776,8930,4209,8237,64,135,3751,7119,3815,7254
250100,202301,4124,11205,3709,10492,271,695,2748,7644,3019,8339
250110,202301,6076,14816,5503,14040,358,1039,4212,10486,4570,11525
250115,202301,928,1919,709,1610,11,37,572,1242,583,1279
250120,202301,2247,5840,1916,5336,23,111,1530,4119,1553,4230
250130,202301,7642,15946,6533,14498,48,206,5820,12500,5868,12706
250135,202301,1672,3843,1447,3471,64,150,1199,2837,1263,2987
250140,202301,2684,6993,2449,6716,176,521,1957,5435,2133,5956
250150,202301,5729,15902,5149,15001,202,713,4078,11552,4280,12265
250153,202301,1672,3972,1380,3563,76,159,1067,2722,1143,2881
250157,202301,2662,6072,2348,5593,51,161,1971,4531,2022,4692
250160,202301,4705,10140,3778,8917,84,211,3230,7511,3314,7722
250170,202301,2266,5258,2018,4909,39,129,1712,4044,1751,4173
250180,202301,30736,59798,26595,54730,1293,3243,21493,42115,22786,45358
250190,202301,5208,11897,4383,10761,430,998,3071,7288,3501,8286
250200,202301,3239,6014,2793,5474,37,82,2514,4767,2551,4849
250205,202301,980,2799,824,2555,22,93,636,1953,658,2046
250210,202301,1717,4670,1510,4339,73,256,1152,3227,1225,3483
250215,202301,1931,4785,1628,4378,103,291,935,2527,1038,2818
250220,202301,824,2031,644,1757,31,112,455,1171,486,1283
250230,202301,2002,4064,1418,3247,23,56,1112,2456,1135,2512
250240,202301,3754,8171,3326,7510,35,142,2973,6498,3008,6640
250250,202301,5915,13803,5215,12866,441,721,4003,10448,4444,11169
250260,202301,1886,4865,1568,4309,71,184,1183,3253,1254,3437
250270,202301,1429,3869,1302,3720,94,286,926,2765,1020,3051
250280,202301,4916,10473,4355,9768,275,473,3399,7748,3674,8221
250290,202301,2262,4702,1895,4192,31,71,1582,3355,1613,3426
250300,202301,7480,15936,6705,15036,215,681,5640,12220,5855,12901
250310,202301,1466,3746,1193,3291,58,142,861,2341,919,2483
250320,202301,18271,33506,16042,31041,191,518,14812,27945,15003,28463
250330,202301,3267,7244,2773,6595,70,237,2416,5509,2486,5746
250340,202301,1525,3166,1312,2888,19,45,1177,2563,1196,2608
250350,202301,4603,11915,3983,10857,329,690,2955,8315,3284,9005
250355,202301,2720,6427,2404,6054,15,61,2227,5573,2242,5634
250360,202301,2186,5066,1939,4743,67,200,1619,3816,1686,4016
250370,202301,20134,40785,17175,36616,238,746,15213,31216,15451,31962
250375,202301,1579,3326,1270,2972,5,13,1159,2753,1164,2766
250380,202301,2204,4588,2024,4380,45,141,1809,3762,1854,3903
250390,202301,2384,5181,2020,4649,136,307,1554,3552,1690,3859
250400,202301,90915,204933,69843,174119,20020,52813,21403,52555,41423,105368
250403,202301,2948,5925,2614,5564,55,254,2259,4476,2314,4730
250407,202301,1898,3743,1352,2977,143,245,868,2023,1011,2268
250410,202301,858,1998,742,1815,21,57,608,1429,629,1486
250415,202301,2428,5680,2125,5246,30,108,1867,4498,1897,4606
250420,202301,1740,3590,1570,3366,13,29,1465,3092,1478,3121
250430,202301,9453,18457,8141,16784,272,553,6961,13860,7233,14413
250435,202301,1927,4903,1502,4205,30,104,1130,3049,1160,3153
250440,202301,5303,12840,4583,11913,105,263,3957,10171,4062,10434
250450,202301,2197,5047,1801,4522,92,175,1395,3592,1487,3767
250460,202301,9512,22723,8337,21112,583,1594,6400,15942,6983,17536
250470,202301,2170,4612,1785,4030,69,149,1457,3170,1526,3319
250480,202301,4641,11355,3890,10434,77,179,3291,8843,3368,9022
250485,202301,838,1740,625,1449,70,104,414,944,484,1048
250490,202301,7081,13605,6275,12706,108,312,5656,11117,5764,11429
250500,202301,2436,6016,2135,5523,50,148,1742,4414,1792,4562
250510,202301,7133,14747,6126,13424,251,342,5118,11353,5369,11695
250520,202301,2199,5358,1871,4929,83,257,1467,3761,1550,4018
250523,202301,2790,5785,2447,5336,196,471,1895,3988,2091,4459
250527,202301,2065,4462,1864,4242,19,56,1687,3803,1706,3859
250530,202301,806,1851,689,1685,18,49,558,1318,576,1367
250535,202301,1622,4211,1443,3911,26,115,1151,3000,1177,3115
250540,202301,4151,7538,3512,6858,430,478,2808,5805,3238,6283
250550,202301,906,2675,794,2473,52,171,541,1653,593,1824
250560,202301,2068,5047,1769,4631,50,189,1469,3712,1519,3901
250570,202301,3308,8593,2846,7808,168,480,2120,5760,2288,6240
250580,202301,1250,2949,1100,2751,59,203,889,2141,948,2344
250590,202301,1285,2639,1165,2483,27,71,1044,2149,1071,2220
250600,202301,9204,22369,7601,20186,288,819,5852,15179,6140,15998
250610,202301,3461,8834,3069,8267,130,401,2454,6558,2584,6959
250620,202301,1130,2380,944,2098,42,121,758,1596,800,1717
250625,202301,2781,7304,2470,6818,47,221,2096,5641,2143,5862
250630,202301,15349,33899,12999,30296,1160,2936,9271,20507,10431,23443
250640,202301,4568,10431,4060,9790,88,320,3515,8257,3603,8577
250650,202301,1296,2731,1017,2369,11,51,871,1975,882,2026
250660,202301,1875,4133,1488,3593,34,88,1227,2835,1261,2923
250670,202301,2922,7737,2645,7267,45,182,2293,6120,2338,6302
250680,202301,7461,14499,6704,13656,37,151,6284,12457,6321,12608
250690,202301,8826,17179,7424,15532,159,305,6421,13188,6580,13493
250700,202301,5588,14062,4869,12959,708,1925,3151,8219,3859,10144
250710,202301,5196,13548,4495,12587,383,1118,3205,8950,3588,10068
250720,202301,3413,8188,3012,7622,66,254,2596,6429,2662,6683
250730,202301,5476,12249,4806,11380,213,594,4065,9306,4278,9900
250740,202301,2511,5455,2063,4880,133,288,1549,3668,1682,3956
250750,202301,159728,334210,138351,305653,9091,22690,106057,223598,115148,246288
250760,202301,3682,6840,3308,6321,71,160,3014,5588,3085,5748
250770,202301,4921,13233,4362,12500,675,1660,2820,8487,3495,10147
250780,202301,2307,5203,1951,4622,60,174,1597,3639,1657,3813
250790,202301,3154,8053,2743,7468,98,383,2204,5758,2302,6141
250800,202301,2979,6919,2577,6300,107,211,2088,5034,2195,5245
250810,202301,1777,3841,1473,3436,161,236,1088,2690,1249,2926
250820,202301,2589,5858,2375,5616,45,152,2143,4981,2188,5133
250830,202301,7448,19793,6147,17343,224,817,4421,11805,4645,12622
250840,202301,882,2585,769,2382,38,138,558,1727,596,1865
250850,202301,2193,5603,1911,5135,27,119,1563,4070,1590,4189
250855,202301,1357,3265,1206,3055,41,118,995,2451,1036,2569
250860,202301,4217,10885,3514,9808,482,1393,1998,5425,2480,6818
250870,202301,1270,3003,1062,2691,65,144,808,2053,873,2197
250880,202301,1948,4456,1591,3943,123,296,1179,2874,1302,3170
250890,202301,14821,29946,13080,27805,260,1057,11504,23080,11764,24137
250900,202301,4019,9075,3509,8271,79,227,2996,6814,3075,7041
250905,202301,3024,7414,2776,7103,45,172,2511,6363,2556,6535
250910,202301,9265,17518,7949,16085,83,251,7239,14376,7322,14627
250915,202301,2643,5302,1923,4528,29,52,1694,4002,1723,4054
250920,202301,4772,10059,4293,9401,263,514,3561,7636,3824,8150
250930,202301,2851,6781,2530,6389,113,339,2052,5040,2165,5379
250933,202301,1502,3875,1304,3549,51,191,1010,2657,1061,2848
250937,202301,985,2300,818,2054,24,77,669,1658,693,1735
250939,202301,2500,5447,2181,5042,46,119,1830,4123,1876,4242
250940,202301,4775,11029,4133,10187,59,164,3625,8815,3684,8979
250950,202301,2024,4792,1630,4272,47,153,1281,3267,1328,3420
250960,202301,1369,3471,1196,3198,29,128,982,2509,1011,2637
250970,202301,11117,24405,9612,22032,363,785,7802,17467,8165,18252
250980,202301,2898,6738,2603,6342,21,92,2268,5341,2289,5433
250990,202301,2576,6820,2186,6173,110,368,1643,4497,1753,4865
251000,202301,2368,6044,1903,5279,47,164,1521,4169,1568,4333
251010,202301,3034,7419,2662,6879,33,146,2318,5850,2351,5996
251020,202301,1910,4696,1709,4393,31,138,1490,3713,1521,3851
251030,202301,1235,2963,1010,2582,73,163,678,1706,751,1869
251040,202301,2225,5454,1891,4929,25,107,1611,4124,1636,4231
251050,202301,1188,3101,990,2733,44,158,697,1809,741,1967
251060,202301,1352,2644,999,2192,38,81,736,1604,774,1685
251065,202301,559,1413,413,1141,12,37,287,755,299,792
251070,202301,922,2035,769,1826,15,50,643,1464,658,1514
251080,202301,26541,56970,21900,50403,3622,8336,12509,28978,16131,37314
251090,202301,3430,8788,2878,7886,71,199,2342,6285,2413,6484
251100,202301,942,2722,809,2467,32,104,592,1707,624,1811
251110,202301,2248,5152,1862,4478,134,307,1374,3219,1508,3526
251120,202301,9856,22595,8309,20709,544,1505,6244,15100,6788,16605
251130,202301,5985,10112,5284,9342,57,119,4968,8639,5025,8758
251140,202301,4844,12469,4249,11640,129,419,3358,9107,3487,9526
251150,202301,3394,8543,3092,8091,59,281,2654,6723,2713,7004
251160,202301,2969,6911,2571,6339,27,134,2316,5556,2343,5690
251170,202301,2262,4860,2004,4545,34,105,1809,3981,1843,4086
251180,202301,3395,7657,2809,6877,287,560,1904,4822,2191,5382
251190,202301,6777,13401,6114,12666,64,258,5511,10903,5575,11161
251200,202301,5639,13652,4933,12768,163,356,4132,10787,4295,11143
251203,202301,1181,3418,1043,3109,58,165,678,1957,736,2122
251207,202301,1339,3242,1010,2723,22,95,684,1774,706,1869
251210,202301,9940,21841,8094,19339,652,1242,5666,13980,6318,15222
251220,202301,1649,3331,1211,2775,97,204,924,2114,1021,2318
251230,202301,5699,14286,4882,12894,113,392,3877,9830,3990,10222
251240,202301,4463,11443,3738,10235,316,776,2445,6745,2761,7521
251250,202301,15011,33685,13147,30707,794,1982,10130,22670,10924,24652
251260,202301,665,1543,587,1417,14,60,475,1079,489,1139
251270,202301,5551,14347,4942,13534,275,681,3867,10852,4142,11533
251272,202301,1749,3910,1605,3739,47,177,1416,3164,1463,3341
251274,202301,1018,2603,813,2253,68,179,497,1346,565,1525
251275,202301,1923,3998,1630,3556,75,183,1344,2805,1419,2988
251276,202301,1623,3938,1391,3625,36,143,1118,2794,1154,2937
251278,202301,815,1873,717,1724,30,84,574,1334,604,1418
251280,202301,3450,7002,3144,6606,51,164,2833,5738,2884,5902
251290,202301,10214,17763,9363,16803,299,584,8336,14601,8635,15185
251300,202301,1057,2700,924,2500,15,62,773,2056,788,2118
251310,202301,3443,8536,2952,7784,49,226,2474,6316,2523,6542
251315,202301,2221,6119,1992,5710,105,275,1542,4371,1647,4646
251320,202301,2025,4729,1542,3926,40,144,1172,2849,1212,2993
251330,202301,2628,5246,2110,4643,37,82,1832,4000,1869,4082
251335,202301,1338,3322,1195,3113,21,97,1066,2701,1087,2798
251340,202301,4732,9716,3779,8525,137,326,3001,6614,3138,6940
251350,202301,1309,3280,1180,3084,33,90,977,2515,1010,2605
251360,202301,2229,5384,1741,4684,26,77,1368,3597,1394,3674
251365,202301,952,2257,694,1780,21,55,537,1353,558,1408
251370,202301,34359,78313,29581,71925,4430,10484,17855,43666,22285,54150
251380,202301,1878,4013,1617,3630,53,125,1389,3051,1442,3176
251385,202301,952,2218,719,1823,28,79,505,1211,533,1290
251390,202301,9618,22107,8532,20552,701,1719,6258,14729,6959,16448
251392,202301,1265,3023,1045,2687,39,104,810,2062,849,2166
251394,202301,808,2049,658,1797,66,180,440,1152,506,1332
251396,202301,863,2114,721,1875,26,74,499,1226,525,1300
251398,202301,1213,2856,848,2216,21,78,608,1513,629,1591
251400,202301,1802,3448,1449,2997,53,103,1184,2329,1237,2432
251410,202301,1952,3907,1537,3318,14,46,1313,2676,1327,2722
251420,202301,2576,5714,2083,5147,52,173,1686,4021,1738,4194
251430,202301,1809,4848,1627,4540,58,197,1350,3692,1408,3889
251440,202301,1309,3195,1064,2784,71,157,776,2053,847,2210
251445,202301,2105,4861,1918,4621,28,97,1664,3876,1692,3973
251450,202301,5667,14043,5059,13150,57,221,4384,11149,4441,11370
251455,202301,1054,2785,942,2599,31,97,746,2000,777,2097
251460,202301,1170,2884,936,2507,76,204,668,1773,744,1977
251465,202301,601,1502,502,1335,13,57,382,955,395,1012
251470,202301,1386,3534,1044,2872,121,389,545,1345,666,1734
251480,202301,1227,2879,934,2384,19,62,701,1684,720,1746
251490,202301,2493,5657,2023,5042,139,268,1512,3747,1651,4015
251500,202301,2692,6016,2451,5708,72,185,2103,4737,2175,4922
251510,202301,3155,8624,2621,7628,123,403,1777,4962,1900,5365
251520,202301,1213,2859,909,2346,77,158,576,1446,653,1604
251530,202301,19351,38839,15924,34697,168,721,14220,30019,14388,30740
251540,202301,3615,9248,3205,8565,85,323,2627,6761,2712,7084
251550,202301,5418,10135,4444,8983,123,212,3783,7540,3906,7752
251560,202301,660,1823,585,1716,41,162,431,1186,472,1348
251570,202301,1118,2858,919,2475,19,96,720,1861,739,1957
251580,202301,2763,5345,2467,4930,25,96,2159,4067,2184,4163
251590,202301,2016,4228,1707,3867,61,142,1458,3200,1519,3342
251593,202301,1161,3098,1031,2883,89,305,701,1885,790,2190
251597,202301,2760,6272,2489,5928,15,68,2296,5359,2311,5427
251600,202301,7721,18814,6705,17308,274,789,5454,13771,5728,14560
251610,202301,4135,9962,3589,9032,294,707,2627,6477,2921,7184
251615,202301,1663,3500,1322,3010,22,65,1120,2448,1142,2513
251620,202301,24811,48081,19398,41618,229,463,16902,36090,17131,36553
251630,202301,6492,12744,5264,11085,286,638,4153,8302,4439,8940
251640,202301,2662,6327,2361,5899,20,85,2120,5189,2140,5274
251650,202301,5149,11416,4427,10505,136,327,3761,8750,3897,9077
251660,202301,4431,11276,3889,10387,57,254,3258,8389,3315,8643
251670,202301,5822,12569,5182,11744,52,206,4768,10525,4820,10731
251675,202301,1082,2248,974,2111,44,117,851,1799,895,1916
251680,202301,3204,7263,2698,6625,112,197,2175,5380,2287,5577
251690,202301,3945,9929,3347,8964,133,375,2510,6640,2643,7015
251700,202301,2788,6741,2312,6103,45,174,1925,4875,1970,5049
251710,202301,962,2226,697,1734,42,115,441,1001,483,1116
251720,202301,1578,3985,1252,3451,21,97,967,2536,988,2633
251740,202301,805,1972,643,1703,32,101,481,1220,513,1321
260005,202301,38997,73064,32696,65344,1851,3819,26278,50697,28129,54516
260010,202301,12737,29624,10495,26161,623,1709,6743,16072,7366,17781
260020,202301,8570,16827,7033,14752,79,283,6046,12244,6125,12527
260030,202301,9991,19662,8497,17613,78,294,7542,15034,7620,15328
260040,202301,8998,20312,7583,18444,454,1168,5609,13548,6063,14716
260050,202301,18214,38071,15692,35253,253,667,14637,32624,14890,33291
260060,202301,5242,11022,4482,9910,393,657,3300,7545,3693,8202
260070,202301,14675,29407,12716,26763,199,680,11056,22275,11255,22955
260080,202301,8659,16163,7550,14797,132,312,6572,12458,6704,12770
260090,202301,6857,14483,6092,13515,441,873,4823,10716,5264,11589
260100,202301,4028,8621,3462,7856,34,154,3091,6788,3125,6942
260105,202301,6177,14501,5527,13658,103,378,4713,11280,4816,11658
260110,202301,26557,66838,23466,62477,1133,3453,18858,49111,19991,52564
260120,202301,19846,43345,16921,39348,1887,3991,11742,27210,13629,31201
260130,202301,4081,8728,3518,7978,88,197,2881,6284,2969,6481
260140,202301,17245,32102,14970,29454,416,903,13028,24936,13444,25839
260150,202301,4764,8940,4180,8246,114,224,3754,7331,3868,7555
260160,202301,9419,17991,8198,16561,136,270,7539,15131,7675,15401
260170,202301,27866,55518,23919,50397,1149,2559,19462,39826,20611,42385
260180,202301,4406,9967,3742,9055,81,298,3166,7493,3247,7791
260190,202301,26916,43925,23080,39573,183,362,21276,35535,21459,35897
260200,202301,13715,28919,11853,26574,491,954,10331,23079,10822,24033
260210,202301,13730,34203,11539,30826,403,1227,9172,24175,9575,25402
260220,202301,15390,28581,14237,27195,341,586,12737,23888,13078,24474
260230,202301,16418,30571,14333,28011,328,630,12430,23711,12758,24341
260240,202301,3400,8799,2919,7947,66,280,2338,6152,2404,6432
260250,202301,2963,6415,2522,5765,98,238,2021,4450,2119,4688
260260,202301,17618,38680,15597,35929,1156,2427,11897,27724,13053,30151
260270,202301,6395,11684,5709,10932,81,239,5185,9648,5266,9887
260280,202301,16506,39437,14995,37336,346,1286,13352,32183,13698,33469
260290,202301,54177,120406,46963,110690,4077,10121,33845,77337,37922,87458
260300,202301,13312,28381,11484,25879,277,808,9864,21618,10141,22426
260310,202301,8196,16281,7383,15312,391,661,6229,12932,6620,13593
260320,202301,8957,23499,7482,21153,149,545,6170,17170,6319,17715
260330,202301,2919,8080,2466,7188,65,230,1959,5540,2024,5770
260340,202301,2773,6121,2426,5637,33,122,2148,4792,2181,4914
260345,202301,37462,81355,32019,74057,2994,7500,21773,47489,24767,54989
260350,202301,7872,14234,6867,13126,27,93,6387,11926,6414,12019
260360,202301,2943,6842,2564,6172,103,290,1826,4217,1929,4507
260370,202301,6906,16573,5884,14947,158,556,4736,11427,4894,11983
260380,202301,6135,15692,5222,14247,246,581,3950,10740,4196,11321
260390,202301,5631,15077,4508,12964,224,627,2991,8367,3215,8994
260392,202301,4950,12008,4488,11446,55,317,3965,9926,4020,10243
260400,202301,28021,52005,24535,47615,337,999,21168,38690,21505,39689
260410,202301,103230,218921,83337,192226,14564,36039,42215,95722,56779,131761
260415,202301,5840,12537,5039,11404,35,140,4430,9705,4465,9845
260420,202301,17207,28667,14822,26091,79,242,14167,24530,14246,24772
260430,202301,3232,9218,2724,8270,180,584,1811,5389,1991,5973
260440,202301,5348,10713,4752,9969,31,117,4380,8994,4411,9111
260450,202301,6931,15446,6179,14489,379,690,5097,12122,5476,12812
260460,202301,6979,17044,5987,15454,437,1335,4180,10184,4617,11519
260470,202301,6298,13152,5306,12041,141,299,4649,10816,4790,11115
260480,202301,4677,10700,3930,9698,324,849,2808,6853,3132,7702
260490,202301,7070,13208,6221,12106,33,118,5774,10964,5807,11082
260500,202301,7545,16493,6461,15032,498,1118,4564,10548,5062,11666
260510,202301,14377,27750,12321,24976,138,441,11133,21889,11271,22330
260515,202301,5733,12944,4515,10831,103,296,3388,7537,3491,7833
260520,202301,20427,41453,17882,38323,1037,2238,14627,30605,15664,32843
260530,202301,12774,29599,10970,27039,103,468,9833,23595,9936,24063
260540,202301,9920,17472,8887,16243,124,255,8255,14837,8379,15092
260545,202301,155,406,103,301,17,58,36,83,53,141
260550,202301,3823,9292,3050,8030,194,651,2046,4988,2240,5639
260560,202301,6970,15796,5766,14036,149,461,4870,11507,5019,11968
260570,202301,11756,23459,10317,21690,211,580,9188,18757,9399,19337
260580,202301,6447,11924,5863,11194,24,53,5476,10286,5500,10339
260590,202301,10114,17326,8730,15822,100,235,8020,14224,8120,14459
260600,202301,44025,94720,36933,84620,1204,3401,29929,65220,31133,68621
260610,202301,9645,21930,8443,20392,387,1027,6500,15328,6887,16355
260620,202301,27700,54911,24782,51193,1151,3151,20471,39862,21622,43013
260630,202301,2880,6849,2361,6050,59,156,1941,4860,2000,5016
260640,202301,32752,59807,28208,54723,959,1901,24277,46176,25236,48077
260650,202301,7835,17313,6310,15454,497,903,5179,12787,5676,13690
260660,202301,9603,19896,8450,18501,278,753,7592,16293,7870,17046
260670,202301,2814,6387,2299,5578,80,223,1781,4103,1861,4326
260680,202301,39631,80634,33696,72814,2095,4824,25635,52849,27730,57673
260690,202301,4161,9553,3424,8469,89,307,2709,6490,2798,6797
260700,202301,9252,18804,8654,18166,56,195,8405,17568,8461,17763
260710,202301,1641,3818,1364,3406,55,183,1092,2652,1147,2835
260720,202301,38816,75608,33874,69794,1811,4131,27860,55744,29671,59875
260730,202301,10312,25029,8938,23168,201,723,7776,19651,7977,20374
260740,202301,1650,3981,1331,3467,26,107,1091,2795,1117,2902
260750,202301,9769,21146,7689,18651,217,385,6745,16760,6962,17145
260760,202301,8638,16465,7590,15271,121,343,6855,13469,6976,13812
260765,202301,10705,25884,9398,24151,640,1882,6849,17030,7489,18912
260770,202301,4753,10542,3879,9178,92,280,3137,7178,3229,7458
260775,202301,7549,16593,6652,15290,153,519,5470,11815,5623,12334
260780,202301,4676,11839,4132,10994,362,1164,2689,6575,3051,7739
260790,202301,190073,355951,162043,321245,19438,39713,114431,218144,133869,257857
260795,202301,4686,8801,4041,8007,146,312,3483,6770,3629,7082
260800,202301,8026,14333,7274,13383,257,421,6419,11547,6676,11968
260805,202301,4736,10899,4098,9911,139,442,3321,7655,3460,8097
260810,202301,8362,19181,7323,17370,301,799,5856,13241,6157,14040
260820,202301,6121,11425,5463,10699,75,216,4842,9354,4917,9570
260825,202301,3576,9391,3124,8666,123,393,2417,6574,2540,6967
260830,202301,5356,13451,4495,12046,536,1172,2987,8199,3523,9371
260840,202301,5869,11974,5237,11168,240,456,4552,9590,4792,10046
260845,202301,5708,12863,5050,11839,200,576,4035,8997,4235,9573
260850,202301,6220,14537,5203,12797,380,1002,3569,8225,3949,9227
260860,202301,4122,10495,3523,9467,150,448,2794,7295,2944,7743
260870,202301,5760,11211,4972,10274,133,257,4399,9002,4532,9259
260875,202301,10687,20803,8852,18332,694,1379,6427,13190,7121,14569
260880,202301,14300,31546,12599,28980,280,789,10864,24196,11144,24985
260890,202301,16941,36682,14609,33363,1160,2745,9988,22284,11148,25029
260900,202301,6970,17237,5776,15594,550,1492,3655,9774,4205,11266
260910,202301,4339,9612,3796,8852,144,345,3033,6927,3177,7272
260915,202301,7379,15342,6712,14581,28,111,6346,13595,6374,13706
260920,202301,4438,8399,3814,7748,115,194,3378,6803,3493,6997
260930,202301,5010,12783,4280,11605,167,569,3376,8825,3543,9394
260940,202301,19767,39574,17189,36149,1173,2602,13341,27072,14514,29674
260950,202301,9684,21457,7895,18694,367,1044,5582,12165,5949,13209
260960,202301,117799,211965,100102,190688,7449,15030,76514,138586,83963,153616
260970,202301,6972,15843,6038,14664,391,722,4540,11170,4931,11892
260980,202301,5938,14220,5182,13300,75,192,4708,12080,4783,12272
260990,202301,21041,51206,17702,46747,737,2261,14026,36130,14763,38391
261000,202301,21843,42158,18405,37945,555,1369,15464,30689,16019,32058
261010,202301,2763,6097,2368,5580,93,242,2026,4721,2119,4963
261020,202301,8599,18809,7576,17253,338,801,6169,13473,6507,14274
261030,202301,5076,12767,4448,11740,109,408,3617,9116,3726,9524
261040,202301,6750,16500,5531,14431,176,586,4362,10827,4538,11413
261050,202301,9904,21737,8938,20405,210,452,7562,16977,7772,17429
261060,202301,18883,39846,16482,37051,393,1010,13999,30677,14392,31687
261070,202301,94226,180111,79556,161566,7428,15060,58071,114222,65499,129282
261080,202301,8828,17756,7964,16740,96,196,7487,15604,7583,15800
261090,202301,26401,50200,23533,46612,752,1417,20519,39934,21271,41351
261100,202301,11134,25601,9696,23604,612,1478,7397,17644,8009,19122
261110,202301,97336,229148,82864,204813,9917,26675,52082,122921,61999,149596
261120,202301,5009,9963,4392,9149,104,245,3840,7740,3944,7985
261130,202301,9804,19626,8657,18163,177,351,7575,15630,7752,15981
261140,202301,5009,9581,4416,8829,308,555,3436,6808,3744,7363
261150,202301,7211,15001,6354,13833,237,454,5395,11587,5632,12041
261153,202301,2313,6195,1884,5400,78,246,1327,3727,1405,3973
261160,202301,316681,631679,264076,564237,63987,138710,116625,251374,180612,390084
261170,202301,9814,18617,8583,17056,252,494,7524,14492,7776,14986
261180,202301,11930,25488,10485,23721,475,1019,8235,18344,8710,19363
261190,202301,6633,14927,5962,13949,136,563,5075,11291,5211,11854
261200,202301,4448,8510,3854,7755,131,273,3257,6374,3388,6647
261210,202301,2269,4910,1943,4471,116,191,1596,3667,1712,3858
261220,202301,18885,43604,16170,39347,1432,3654,11278,25950,12710,29604
261230,202301,4748,11749,3915,10688,43,154,3300,8977,3343,9131
261240,202301,8041,15325,7157,14116,204,423,6321,12135,6525,12558
261245,202301,4744,11153,3868,9724,64,281,3184,7585,3248,7866
261247,202301,3757,9839,3118,8745,345,937,1990,5618,2335,6555
261250,202301,38118,69783,33884,65009,3272,6642,27006,50960,30278,57602
261255,202301,4908,12707,3966,10986,174,573,2981,8008,3155,8581
261260,202301,20442,39636,18174,36871,223,813,17029,33577,17252,34390
261270,202301,6704,12360,5948,11487,214,397,5316,10057,5530,10454
261280,202301,3210,7692,2771,7010,106,350,2215,5338,2321,5688
261290,202301,3711,7978,3119,7333,86,263,2557,6001,2643,6264
261300,202301,17248,38362,14884,34826,371,1228,12184,26971,12555,28199
261310,202301,12632,26383,10914,24154,889,2031,8177,17525,9066,19556
261320,202301,7562,18262,6545,16712,96,307,5593,13953,5689,14260
261330,202301,8163,15775,7399,14827,182,448,6645,12974,6827,13422
261340,202301,7560,14970,6797,14074,93,300,6257,12590,6350,12890
261350,202301,10229,27208,8900,25041,299,808,6900,19242,7199,20050
261360,202301,11195,21884,9527,19639,408,865,7773,15459,8181,16324
261370,202301,31050,67299,26396,61379,2194,5346,19036,42883,21230,48229
261380,202301,5559,13223,4795,12025,483,1200,3357,8358,3840,9558
261390,202301,21315,53278,17857,48084,1215,3674,12349,32074,13564,35748
261400,202301,6317,15309,5513,13871,223,726,4393,10450,4616,11176
261410,202301,12544,26194,10403,23126,300,859,8798,18681,9098,19540
261420,202301,10742,25500,9710,24325,613,1840,7738,18954,8351,20794
261430,202301,5519,11083,4781,10037,37,135,4336,8771,4373,8906
261440,202301,1671,4531,1361,3965,53,230,988,2730,1041,2960
261450,202301,18989,42468,16749,39307,621,1473,13545,31352,14166,32825
261460,202301,9681,22474,8210,20290,280,714,6673,16298,6953,17012
261470,202301,4736,10475,4070,9569,54,204,3444,7888,3498,8092
261480,202301,6870,17515,5849,15887,242,871,4593,11957,4835,12828
261485,202301,7055,16824,6179,15567,432,1270,4668,11313,5100,12583
261500,202301,8602,18432,7482,16959,635,1181,5260,12315,5895,13496
261510,202301,2184,5802,1889,5346,67,241,1453,4061,1520,4302
261520,202301,2931,7551,2607,6957,131,375,1920,4958,2051,5333
261530,202301,15491,38286,12707,33831,715,2560,8094,19671,8809,22231
261540,202301,12214,29635,11181,28263,2796,6416,5516,15525,8312,21941
261550,202301,4690,10716,4085,9820,222,612,3084,7061,3306,7673
261560,202301,11918,26620,10509,24702,346,967,8830,20163,9176,21130
261570,202301,4445,10630,3478,9079,276,772,2377,5958,2653,6730
261580,202301,9078,19368,7979,17953,64,289,7435,16412,7499,16701
261590,202301,3520,7466,2852,6532,70,222,2339,5112,2409,5334
261600,202301,7804,14829,6731,13410,174,354,5736,10952,5910,11306
261610,202301,2739,7029,2190,6071,229,641,1270,3547,1499,4188
261618,202301,3636,6816,3220,6275,70,212,2845,5298,2915,5510
261620,202301,5987,13899,5501,13234,595,1285,4053,10088,4648,11373
261630,202301,7413,18835,6322,16849,489,1434,4084,10273,4573,11707
261640,202301,49956,94219,42739,85801,2246,3610,33949,68486,36195,72096
261650,202301,5544,11054,4710,10068,222,442,3873,8184,4095,8626
270010,202301,5106,15241,4387,14089,157,766,3476,10825,3633,11591
270020,202301,5175,10571,4526,9792,115,438,4008,8203,4123,8641
270030,202301,42947,104745,36420,94953,2460,6867,27746,70605,30206,77472
270040,202301,12550,29389,10597,27082,654,1803,8462,21429,9116,23232
270050,202301,6753,13613,5779,12530,148,358,5323,11439,5471,11797
270060,202301,2733,6280,2324,5792,152,400,1864,4564,2016,4964
270070,202301,6450,14276,5648,13211,86,346,5032,11313,5118,11659
270080,202301,1688,4097,1409,3676,84,213,1056,2691,1140,2904
270090,202301,2210,5740,2005,5395,31,139,1766,4636,1797,4775
270100,202301,8807,16403,7714,15008,162,373,6917,13069,7079,13442
270110,202301,4062,8526,3311,7669,214,347,2624,6355,2838,6702
270120,202301,3044,7558,2667,7057,86,264,2186,5688,2272,5952
270130,202301,6137,13904,5254,12874,147,464,4525,10909,4672,11373
270135,202301,2388,5053,2024,4656,26,116,1868,4240,1894,4356
270140,202301,10565,23438,8439,20616,322,1017,6553,15144,6875,16161
270150,202301,3845,8620,3554,8236,18,68,3405,7834,3423,7902
270160,202301,6314,15934,5425,14860,171,599,4848,13126,5019,13725
270170,202301,3838,10169,3203,9284,202,834,2299,6308,2501,7142
270180,202301,2791,7444,2512,7101,36,190,2232,6171,2268,6361
270190,202301,3046,6005,2792,5719,34,95,2633,5306,2667,5401
270200,202301,3166,8324,2730,7713,355,873,1805,5252,2160,6125
270210,202301,7278,14564,6259,13413,79,249,5842,12301,5921,12550
270220,202301,2082,4531,1702,4028,106,305,1299,2898,1405,3203
270230,202301,12237,29377,10360,26667,934,2617,7695,19261,8629,21878
270235,202301,7252,19922,6352,18555,258,817,5155,14865,5413,15682
270240,202301,14258,33633,11875,30471,970,2652,8925,22527,9895,25179
270250,202301,4158,8228,3759,7709,152,303,3339,6745,3491,7048
270255,202301,5247,13478,4153,11652,139,496,3249,8832,3388,9328
270260,202301,6435,17754,5831,16786,95,443,5044,14226,5139,14669
270270,202301,1206,2854,1001,2612,118,288,736,1908,854,2196
270280,202301,4544,9670,3607,8548,269,566,2693,6543,2962,7109
270290,202301,9597,26744,8660,25339,170,740,7716,22280,7886,23020
270300,202301,4918,11514,3830,10324,166,381,3097,8475,3263,8856
270310,202301,8166,20492,6984,18794,162,563,5839,15486,6001,16049
270320,202301,6496,17398,5554,15712,233,810,4175,11219,4408,12029
270330,202301,5233,14300,4594,13400,185,805,3851,10989,4036,11794
270340,202301,1965,4611,1671,4219,79,158,1404,3539,1483,3697
270350,202301,2309,4646,1874,4148,151,281,1374,3108,1525,3389
270360,202301,4216,7933,3830,7512,46,120,3672,7134,3718,7254
270370,202301,1595,4450,1441,4181,34,159,1221,3484,1255,3643
270375,202301,4798,8594,4190,7946,16,48,4041,7602,4057,7650
270380,202301,6799,15876,5749,14637,621,1419,4253,11092,4874,12511
270390,202301,1486,3232,1180,2878,10,59,1006,2424,1016,2483
270400,202301,7858,18298,6539,16388,257,695,5092,12409,5349,13104
270410,202301,5912,14774,5155,13697,137,460,4413,11559,4550,12019
270420,202301,8316,19308,7591,18318,166,605,6824,15978,6990,16583
270430,202301,203766,417279,163841,367878,19913,46767,102913,222732,122826,269499
270440,202301,5632,13512,4924,12638,133,415,4306,11001,4439,11416
270450,202301,11146,23211,9914,21777,493,889,8364,18619,8857,19508
270460,202301,4715,9201,4022,8373,232,368,3558,7467,3790,7835
270470,202301,14494,34991,12635,32493,676,2025,10137,25495,10813,27520
270480,202301,3716,8488,3111,7672,173,513,2565,6117,2738,6630
270490,202301,1078,2682,937,2514,35,117,779,2039,814,2156
270500,202301,5956,15686,5293,14632,269,832,4267,11642,4536,12474
270510,202301,7864,16991,6626,15472,321,926,5353,11961,5674,12887
270520,202301,4947,12233,3950,10746,744,2131,1913,5167,2657,7298
270530,202301,1596,4171,1359,3808,96,244,940,2664,1036,2908
270540,202301,2738,6532,2297,5974,66,214,1997,5100,2063,5314
270550,202301,7905,18273,6219,16417,610,1486,4521,12208,5131,13694
270560,202301,3572,8035,2984,7276,163,491,2382,5612,2545,6103
270570,202301,6919,14245,6069,13109,515,1231,4990,10364,5505,11595
270580,202301,2907,6981,2624,6608,107,297,2287,5678,2394,5975
270590,202301,1737,4778,1596,4584,16,69,1496,4284,1512,4353
270600,202301,3299,8879,2995,8433,57,213,2652,7369,2709,7582
270610,202301,4404,10269,3849,9563,134,262,3401,8427,3535,8689
270620,202301,1442,3912,1314,3701,27,106,1130,3085,1157,3191
270630,202301,23699,48490,20690,44552,712,1938,17971,37407,18683,39345
270640,202301,6624,16508,5466,14689,145,552,4453,11690,4598,12242
270642,202301,3069,8664,2691,8068,202,661,2001,5858,2203,6519
270644,202301,4840,10543,4037,9550,265,627,3226,7536,3491,8163
270650,202301,4550,10499,4008,9834,263,795,3367,8058,3630,8853
270660,202301,2405,5310,2067,4864,85,201,1620,3722,1705,3923
270670,202301,23533,44992,20061,40841,679,1420,17433,34528,18112,35948
270680,202301,8014,14510,7289,13736,315,411,6702,12793,7017,13204
270690,202301,12594,26945,10533,24326,263,780,8863,19859,9126,20639
270700,202301,675,1795,582,1653,60,183,389,1070,449,1253
270710,202301,6884,18142,6033,16884,385,1108,4703,12994,5088,14102
270720,202301,4530,11113,4032,10331,96,314,3569,8940,3665,9254
270730,202301,9674,19196,8353,17820,1032,1319,6229,14606,7261,15925
270740,202301,2775,6710,2427,6307,79,244,2027,5200,2106,5444
270750,202301,6882,15618,6069,14607,99,389,5461,12838,5560,13227
270760,202301,4048,9844,3354,8917,54,241,2838,7376,2892,7617
270770,202301,28908,63531,23686,57040,3346,8160,15212,36183,18558,44343
270780,202301,2488,5342,2292,5093,47,158,2099,4563,2146,4721
270790,202301,2116,4922,1804,4533,138,336,1434,3561,1572,3897
270800,202301,14649,32614,13191,30665,579,1409,11042,25325,11621,26734
270810,202301,4060,9805,3223,8592,183,592,2433,6278,2616,6870
270820,202301,1928,5171,1640,4736,55,225,1327,3754,1382,3979
270830,202301,6299,13592,5129,12188,203,572,4193,9725,4396,10297
270840,202301,9846,26491,8559,24585,357,1510,6881,19006,7238,20516
270850,202301,11007,22193,9668,20675,662,1562,8201,17321,8863,18883
270860,202301,17737,35211,14266,31357,572,1391,11905,25535,12477,26926
270870,202301,2745,7044,2212,6182,208,587,1454,4016,1662,4603
270880,202301,9296,25328,8307,23878,205,823,6917,19408,7122,20231
270890,202301,4234,10275,3595,9387,458,1173,2141,5519,2599,6692
270895,202301,4659,10889,4164,10285,138,393,3676,8915,3814,9308
270900,202301,1893,4441,1460,3784,19,71,1209,3046,1228,3117
270910,202301,5181,12961,4508,12018,229,490,3713,9843,3942,10333
270915,202301,11485,28883,9340,25616,846,2742,6347,16543,7193,19285
270920,202301,7319,18258,6389,16962,125,489,5517,14257,5642,14746
270930,202301,22235,45061,17513,39716,2005,4033,12687,29540,14692,33573
270940,202301,7278,17358,6097,16019,177,744,4981,12617,5158,13361
280010,202301,699,1824,542,1517,21,80,376,950,397,1030
280020,202301,6562,13861,5573,12415,402,915,4267,9126,4669,10041
280030,202301,124238,241687,103885,214665,15930,33988,62766,125066,78696,159054
280040,202301,3752,8600,3255,7917,157,475,2530,5877,2687,6352
280050,202301,5119,13078,4285,11757,927,2533,2146,5822,3073,8355
280060,202301,9428,20178,7695,17740,1001,2605,4822,10672,5823,13277
280067,202301,9012,18422,7684,16501,624,1018,5654,12090,6278,13108
280070,202301,2063,5684,1892,5428,119,404,1477,4096,1596,4500
280100,202301,5355,11949,4529,10742,545,1141,2899,7111,3444,8252
280110,202301,1980,4141,1702,3764,25,75,1551,3347,1576,3422
280120,202301,9785,23508,8664,21830,1149,2531,6068,15636,7217,18167
280130,202301,10655,22276,9283,20440,617,1391,7314,15807,7931,17198
280140,202301,7726,14851,6828,13648,698,1143,5128,10462,5826,11605
280150,202301,4856,11029,4186,10105,486,1057,2957,7063,3443,8120
280160,202301,1615,3862,1387,3516,140,393,959,2280,1099,2673
280170,202301,7339,15075,6591,14164,214,492,5679,11906,5893,12398
280190,202301,2107,3426,1919,3190,38,103,1795,2896,1833,2999
280200,202301,1496,3548,1228,3162,77,239,896,2200,973,2439
280210,202301,22222,46596,19311,42678,2132,4711,13093,28089,15225,32800
280220,202301,2121,4789,1809,4392,111,254,1443,3514,1554,3768
280230,202301,5033,11429,4070,10007,270,526,2788,6852,3058,7378
280240,202301,3921,9221,3437,8536,34,170,2995,7206,3029,7376
280250,202301,1222,2363,1038,2118,59,131,810,1569,869,1700
280260,202301,3079,5928,2724,5499,41,95,2518,5024,2559,5119
280270,202301,2999,6978,2636,6481,115,356,2262,5395,2377,5751
280280,202301,4726,12402,4177,11642,584,1369,2842,8172,3426,9541
280290,202301,27643,58773,23724,53521,2234,5231,15189,34515,17423,39746
280300,202301,16706,31603,14517,29257,1188,1607,11438,24146,12626,25753
280310,202301,1668,3811,1384,3377,47,122,1092,2566,1139,2688
280320,202301,11524,26026,10020,23886,982,2425,7343,16681,8325,19106
280330,202301,5589,12327,4638,11028,344,786,3400,7880,3744,8666
280340,202301,6462,11999,5402,10835,199,299,4760,9563,4959,9862
280350,202301,40566,73374,36012,67611,1040,2364,31205,56249,32245,58613
280360,202301,6931,17176,6000,15743,657,1871,3808,9742,4465,11613
280370,202301,2912,5963,2354,5091,142,257,1763,3723,1905,3980
280380,202301,1276,2945,1079,2684,97,212,758,1885,855,2097
280390,202301,5200,10203,4397,9045,283,460,3572,7289,3855,7749
280400,202301,5116,10581,4455,9746,430,864,3357,7298,3787,8162
280410,202301,3455,8080,2905,7233,290,766,1869,4402,2159,5168
280420,202301,5481,12217,4923,11553,116,276,4442,10408,4558,10684
280430,202301,2925,5842,2598,5430,63,173,2280,4596,2343,4769
280440,202301,5564,12248,4914,11341,186,497,4200,9336,4386,9833
280445,202301,2666,6332,2405,5926,53,165,1924,4563,1977,4728
280450,202301,12064,26605,10436,24443,2301,5457,5157,12373,7458,17830
280460,202301,8858,18011,8021,16918,421,992,6823,13979,7244,14971
280470,202301,2004,5008,1659,4388,126,358,1211,3075,1337,3433
280480,202301,63890,128822,55628,117938,5341,12145,39720,80976,45061,93121
280490,202301,4221,11110,3529,9950,137,547,2637,7055,2774,7602
280500,202301,1294,2615,1065,2335,27,78,884,1931,911,2009
280510,202301,4448,7506,3949,6889,57,155,3637,6089,3694,6244
280520,202301,2342,4773,2050,4386,170,297,1557,3329,1727,3626
280530,202301,2840,6436,2467,5944,119,280,1953,4618,2072,4898
280540,202301,10252,24546,9209,23124,406,1015,7818,19506,8224,20521
280550,202301,8335,16717,6966,14874,122,451,5947,12062,6069,12513
280560,202301,9149,21432,8542,20586,122,395,7702,18197,7824,18592
280570,202301,8861,17790,7364,16010,311,726,5890,12385,6201,13111
280580,202301,7758,16242,6864,15042,459,900,5548,11958,6007,12858
280590,202301,3375,7070,2844,6447,163,423,2141,4606,2304,5029
280600,202301,5278,11222,4650,10339,154,370,3699,8015,3853,8385
280610,202301,3496,6883,3116,6416,132,308,2679,5308,2811,5616
280620,202301,7768,15692,6654,14323,571,848,4860,10861,5431,11709
280630,202301,5117,11434,4691,10911,425,851,3611,8544,4036,9395
280640,202301,2983,6602,2596,6176,104,219,2293,5475,2397,5694
280650,202301,1463,3440,1215,3095,116,285,848,2077,964,2362
280660,202301,4890,9006,4285,8316,127,220,3827,7309,3954,7529
280670,202301,25641,52413,22128,47982,3175,6673,14552,31350,17727,38023
280680,202301,3574,7515,3067,6814,292,535,2096,4814,2388,5349
280690,202301,1284,2598,1088,2360,51,133,908,1886,959,2019
280700,202301,1456,3036,1246,2748,32,76,1032,2206,1064,2282
280710,202301,19051,36637,16255,33530,1038,1551,13858,28876,14896,30427
280720,202301,3254,6371,2677,5706,53,118,2224,4724,2277,4842
280730,202301,1222,2849,1035,2572,78,212,739,1741,817,1953
280740,202301,21451,40174,18588,36284,994,2186,15188,28327,16182,30513
280750,202301,4115,10355,3534,9402,231,667,2529,6569,2760,7236
280760,202301,9170,19306,7822,17538,785,1580,5615,12563,6400,14143
290010,202301,3894,7083,2577,5169,21,53,2250,4301,2271,4354
290020,202301,7614,15280,6943,14496,531,824,5798,12325,6329,13149
290030,202301,5726,11233,4688,10074,339,615,3685,8110,4024,8725
290035,202301,6598,12136,5346,10559,263,436,4334,8449,4597,8885
290040,202301,7257,12210,6270,11082,313,424,5453,9622,5766,10046
290050,202301,2502,7214,2117,6450,147,478,1428,4222,1575,4700
290060,202301,1887,3650,1381,2974,170,395,979,2018,1149,2413
290070,202301,53271,99669,45910,90621,2928,5565,36007,69170,38935,74735
290080,202301,8260,19059,7170,17555,739,1814,5142,12550,5881,14364
290090,202301,2806,4485,2053,3686,27,58,1906,3368,1933,3426
290100,202301,12139,27731,9794,24413,1689,3967,5083,13045,6772,17012
290110,202301,6949,15711,5969,14215,808,1794,3613,8598,4421,10392
290115,202301,4878,12864,4148,11646,361,1046,3194,8873,3555,9919
290120,202301,8331,17511,6988,15704,206,545,5984,13086,6190,13631
290130,202301,5606,11709,4357,10098,291,566,3092,7401,3383,7967
290135,202301,5701,11435,4660,9801,164,404,3804,7529,3968,7933
290140,202301,5441,12386,4207,10789,223,520,3397,8774,3620,9294
290150,202301,4190,7714,3673,7139,154,386,3133,5869,3287,6255
290160,202301,4383,8436,3888,7779,198,351,3278,6461,3476,6812
290170,202301,4687,9293,4154,8727,136,276,3700,7770,3836,8046
290180,202301,3691,8664,3098,7767,69,241,2634,6399,2703,6640
290190,202301,6263,13142,5605,12320,118,339,4915,10544,5033,10883
290195,202301,3403,6750,2705,5889,178,320,2202,4805,2380,5125
290200,202301,4966,12349,3888,10557,264,598,2713,7402,2977,8000
290205,202301,4546,9740,4001,8964,175,438,3263,7117,3438,7555
290210,202301,18038,39729,15920,36683,1574,3036,12073,28204,13647,31240
290220,202301,4182,7728,3702,7169,91,222,3280,6159,3371,6381
290225,202301,4015,6922,3108,5997,44,120,2884,5421,2928,5541
290230,202301,3927,7475,3590,7104,174,240,2975,6032,3149,6272
290240,202301,5302,10353,4354,9244,79,248,3856,7979,3935,8227
290250,202301,4975,12089,4053,10797,157,369,3347,9056,3504,9425
290260,202301,6673,14118,5663,12712,260,655,4764,10324,5024,10979
290265,202301,3962,10611,3184,9219,296,896,2062,5824,2358,6720
290270,202301,13099,39412,11942,37510,859,2789,9104,28611,9963,31400
290280,202301,7370,20202,6312,18198,551,1810,4278,11855,4829,13665
290290,202301,11751,31140,9373,26987,1016,3165,5814,16312,6830,19477
290300,202301,5104,12299,3734,9854,204,594,2625,6664,2829,7258
290310,202301,2855,4939,2350,4364,23,78,2201,3987,2224,4065
290320,202301,36789,81708,30000,72107,4981,12343,17642,41427,22623,53770
290323,202301,4660,11234,3960,10159,108,290,3103,7888,3211,8178
290327,202301,5125,12872,4310,11407,410,978,2856,7456,3266,8434
290330,202301,3083,5063,2492,4437,23,29,2323,4132,2346,4161
290340,202301,7969,16224,6235,14193,498,1071,4945,11207,5443,12278
290350,202301,5688,14409,4707,12785,253,768,3423,9092,3676,9860
290360,202301,6787,13929,5945,12857,104,271,5261,11169,5365,11440
290370,202301,5779,12650,4191,10578,168,414,2980,7434,3148,7848
290380,202301,7262,15462,6036,13846,189,306,5107,11803,5296,12109
290390,202301,18956,47110,15627,41916,1454,3920,10792,28581,12246,32501
290395,202301,3569,8780,2819,7556,70,260,2208,5749,2278,6009
290400,202301,4574,11100,3656,9652,182,553,2737,6975,2919,7528
290405,202301,5407,13965,4540,12506,473,1251,2972,8351,3445,9602
290410,202301,6689,16069,5092,13663,183,671,3857,9970,4040,10641
290420,202301,3758,9090,3034,8003,106,283,2350,6158,2456,6441
290430,202301,4534,9635,3777,8580,163,478,3045,6549,3208,7027
290440,202301,3449,7649,2496,6190,175,392,1770,4390,1945,4782
290450,202301,5353,10003,4317,8606,91,225,3842,7338,3933,7563
290460,202301,15471,39740,12769,34907,2697,7568,5093,13638,7790,21206
290470,202301,6173,12059,4708,10169,419,942,3210,6654,3629,7596
290475,202301,8013,20017,6631,17770,95,431,5565,14536,5660,14967
290480,202301,2287,4933,1858,4332,69,219,1422,3107,1491,3326
290485,202301,5679,14260,4938,13233,219,653,3975,10614,4194,11267
290490,202301,12082,23500,10969,22082,450,925,9168,18247,9618,19172
290500,202301,5047,13638,3925,11462,703,2193,1552,4301,2255,6494
290510,202301,4519,9255,3784,8337,104,230,3311,7315,3415,7545
290515,202301,4200,10401,3629,9618,28,87,3283,8733,3311,8820
290520,202301,15137,37509,11648,31051,521,1717,7887,19425,8408,21142
290530,202301,5861,15064,4899,13566,96,380,4133,11269,4229,11649
290540,202301,4691,10547,4284,10106,176,467,3785,8896,3961,9363
290550,202301,5205,11519,4529,10731,47,97,4150,9901,4197,9998
290560,202301,7819,17826,6019,15297,555,1580,3859,9241,4414,10821
290570,202301,71803,150504,64480,141421,4394,10407,51910,110644,56304,121051
290580,202301,11388,25977,9924,24035,967,2030,7265,18023,8232,20053
290590,202301,8312,23108,6935,20787,161,552,5694,17066,5855,17618
290600,202301,22945,56993,19799,52107,1071,2954,15634,40456,16705,43410
290610,202301,2930,8304,2292,7093,96,316,1602,4878,1698,5194
290620,202301,7289,18902,6286,17327,440,1128,4981,13754,5421,14882
290630,202301,13127,25112,10854,22320,794,1605,8668,17677,9462,19282
290640,202301,3395,7392,2649,6389,278,521,1793,4547,2071,5068
290650,202301,23276,43833,21330,41714,953,2174,19117,36589,20070,38763
290660,202301,4586,10661,3598,9074,191,537,2539,6351,2730,6888
290670,202301,10715,21135,9389,19338,221,580,8272,16573,8493,17153
290680,202301,13629,32059,11219,28662,232,908,9376,23306,9608,24214
290682,202301,6827,13730,5936,12604,502,686,4387,10087,4889,10773
290685,202301,4339,8752,3146,7092,489,1017,1765,4132,2254,5149
290687,202301,10234,21639,8535,19121,1193,2505,5434,12323,6627,14828
290689,202301,3384,8337,2560,6953,322,891,1614,4362,1936,5253
290690,202301,7116,16123,5828,14355,392,977,4260,10259,4652,11236
290700,202301,3951,7857,3506,7329,66,176,3143,6436,3209,6612
290710,202301,11358,25491,9621,23202,223,727,8447,19964,8670,20691
290720,202301,25922,57844,23184,53875,1657,3392,18142,41500,19799,44892
290730,202301,8657,18264,7276,16657,496,924,5220,12301,5716,13225
290740,202301,1318,3010,1000,2523,23,47,875,2181,898,2228
290750,202301,17364,34017,14900,30500,342,909,12475,23958,12817,24867
290755,202301,2388,6189,1918,5380,107,273,1330,3738,1437,4011
290760,202301,4579,11852,3792,10511,227,520,2680,7528,2907,8048
290770,202301,3777,8726,3492,8399,81,201,3111,7448,3192,7649
290780,202301,9476,21371,8026,19453,327,630,6198,15119,6525,15749
290790,202301,6305,14865,5393,13591,283,699,4425,11140,4708,11839
290800,202301,8635,15163,6243,12456,401,648,4632,9373,5033,10021
290810,202301,7087,15050,5718,13149,233,540,4450,10149,4683,10689
290820,202301,6518,14550,5648,13288,322,681,4047,9325,4369,10006
290830,202301,5250,11575,4599,10576,104,336,3701,7943,3805,8279
290840,202301,22516,52264,18979,46962,2094,4368,12337,32056,14431,36424
290850,202301,11410,20439,9883,18805,477,708,8321,15661,8798,16369
290860,202301,7960,18762,6938,17591,382,853,5828,15050,6210,15903
290870,202301,5844,14284,4448,11754,352,845,2947,7686,3299,8531
290880,202301,1699,3697,1342,3258,206,447,757,1989,963,2436
290890,202301,12111,20973,10679,19393,364,614,9586,17308,9950,17922
290900,202301,2759,6696,2097,5576,188,478,1275,3320,1463,3798
290910,202301,6273,12962,4800,10827,48,123,4173,9258,4221,9381
290920,202301,6445,13743,5562,12700,160,229,4716,11347,4876,11576
290930,202301,8748,22284,6949,19236,279,961,5164,13834,5443,14795
290940,202301,4102,10529,3366,9442,163,544,2614,7192,2777,7736
290950,202301,1719,3868,1378,3373,120,284,891,2200,1011,2484
290960,202301,7477,15951,6616,14918,310,571,5523,12417,5833,12988
290970,202301,3686,10227,2993,8967,121,420,2262,6681,2383,7101
290980,202301,17896,36434,15570,33135,836,2008,11267,22570,12103,24578
290990,202301,12102,27774,10746,25771,338,1101,9046,20867,9384,21968
291000,202301,4013,9045,3083,7918,164,419,2452,6353,2616,6772
291005,202301,21747,45867,19183,42715,1035,2298,15804,34560,16839,36858
291010,202301,3529,10010,2766,8400,150,502,1776,5205,1926,5707
291020,202301,1551,3470,1259,3009,34,101,907,2001,941,2102
291030,202301,3087,6521,2278,5260,208,425,1432,3212,1640,3637
291040,202301,6396,15492,5184,13821,267,772,3975,10617,4242,11389
291050,202301,14532,28147,12880,25986,1507,2943,9454,18739,10961,21682
291060,202301,10841,23765,9510,22090,947,2044,7134,16525,8081,18569
291070,202301,22496,48479,19128,43498,351,1142,16609,36457,16960,37599
291072,202301,35950,76548,27633,64066,3987,9341,15780,35054,19767,44395
291075,202301,6442,14298,5769,13293,101,288,4791,10571,4892,10859
291077,202301,2010,4743,1553,3979,91,172,1090,2784,1181,2956
291080,202301,169472,352442,137916,311289,28196,64356,67964,149786,96160,214142
291085,202301,6729,15159,5434,13216,224,608,4414,10452,4638,11060
291090,202301,2634,4336,1954,3596,48,89,1686,3008,1734,3097
291100,202301,4078,7452,2891,6076,125,245,2288,4743,2413,4988
291110,202301,7055,19259,5894,17368,368,1282,4420,12629,4788,13911
291120,202301,10627,21066,9143,19285,578,1173,7199,15030,7777,16203
291125,202301,2904,4419,2217,3660,101,136,1922,3144,2023,3280
291130,202301,3794,9676,2836,7924,87,306,2183,5841,2270,6147
291140,202301,5853,13862,4251,11104,701,1615,2398,6272,3099,7887
291150,202301,3503,5959,2774,5168,52,78,2595,4805,2647,4883
291160,202301,6121,15042,5032,13506,561,1535,3179,8306,3740,9841
291165,202301,2458,6260,1769,4964,26,117,1205,3229,1231,3346
291170,202301,27299,61733,22759,54507,1654,4014,14952,33960,16606,37974
291180,202301,9961,16976,7855,14364,260,512,6915,12269,7175,12781
291185,202301,4355,9192,3870,8508,214,446,3104,6755,3318,7201
291190,202301,9422,20149,7791,18147,308,696,6060,14317,6368,15013
291200,202301,3256,8177,2393,6611,88,323,1597,4108,1685,4431
291210,202301,9493,16957,7053,14221,388,681,5444,10921,5832,11602
291220,202301,6117,14119,5431,13138,530,1213,3702,8856,4232,10069
291230,202301,6176,10486,4928,9143,66,99,4589,8463,4655,8562
291240,202301,5020,11597,4254,10372,82,232,3672,8770,3754,9002
291250,202301,3858,10415,2977,8877,189,542,1793,5422,1982,5964
291260,202301,1781,3624,1449,3204,40,75,1184,2645,1224,2720
291270,202301,6839,15033,5360,13043,527,1167,3800,9426,4327,10593
291280,202301,3471,7472,2579,6203,172,432,1793,4096,1965,4528
291290,202301,6857,16176,5235,13747,510,1412,3459,8817,3969,10229
291300,202301,4777,11244,3805,9700,204,497,2806,7031,3010,7528
291310,202301,6405,14759,5515,13306,128,378,4740,11139,4868,11517
291320,202301,8025,19183,6279,16364,1301,3268,3259,8636,4560,11904
291330,202301,2245,5150,1834,4492,67,184,1386,3278,1453,3462
291340,202301,5105,11757,4045,10082,218,420,2729,6741,2947,7161
291345,202301,3638,9005,3251,8453,200,536,2581,6691,2781,7227
291350,202301,8851,18292,6972,16019,193,481,5858,13220,6051,13701
291360,202301,55457,104878,44659,92549,5366,10863,29669,61948,35035,72811
291370,202301,10084,23993,8881,22214,670,1912,6652,15856,7322,17768
291380,202301,5852,11446,5239,10665,116,308,4682,9282,4798,9590
291390,202301,16965,30915,13137,26713,637,1133,11137,22375,11774,23508
291400,202301,20649,41693,17316,36989,1646,3307,12104,25804,13750,29111
291410,202301,3581,8429,2796,7140,59,194,2075,5090,2134,5284
291420,202301,2302,4944,1807,4346,24,76,1560,3706,1584,3782
291430,202301,3145,7837,2673,7082,98,345,2096,5343,2194,5688
291440,202301,8081,19970,6894,18175,541,1336,4986,13397,5527,14733
291450,202301,13769,25068,11435,22432,315,451,10233,20243,10548,20694
291460,202301,22598,48424,19779,44466,1797,3739,14463,31893,16260,35632
291465,202301,10865,23291,8608,20723,267,904,7344,17173,7611,18077
291470,202301,25984,46837,22199,42577,1181,2100,17768,33713,18949,35813
291480,202301,53914,105048,43512,91064,4862,10249,26751,53748,31613,63997
291490,202301,9228,17586,8232,16498,258,574,7490,14830,7748,15404
291500,202301,6865,12982,5798,11660,174,399,5312,10581,5486,10980
291510,202301,5946,11426,4560,9702,76,215,4010,8334,4086,8549
291520,202301,5605,11311,4297,9693,278,632,3435,7645,3713,8277
291530,202301,2893,5812,2115,4834,232,523,1429,3295,1661,3818
291535,202301,4688,11341,3928,10087,215,476,3098,8007,3313,8483
291540,202301,2717,5155,1916,4211,57,139,1639,3561,1696,3700
291550,202301,8386,15161,6634,13082,537,923,4894,9503,5431,10426
291560,202301,22488,47976,16813,40745,3663,8537,7899,19855,11562,28392
291570,202301,2975,5816,2301,5054,78,174,2020,4432,2098,4606
291580,202301,7837,17447,6171,15342,320,915,4700,11260,5020,12175
291590,202301,3481,6316,3096,5882,75,186,2842,5256,2917,5442
291600,202301,6899,13973,5327,11732,497,1193,3565,7597,4062,8790
291610,202301,8770,16751,7808,15691,727,995,6137,12854,6864,13849
291620,202301,3700,7226,2811,6259,222,392,2072,4747,2294,5139
291630,202301,4359,8007,3347,6795,583,858,2338,5009,2921,5867
291640,202301,22750,45808,17707,39095,1523,3518,11269,23506,12792,27024
291650,202301,12883,25526,11410,23838,933,1317,9303,20116,10236,21433
291660,202301,2433,5295,1791,4368,113,351,1235,2763,1348,3114
291670,202301,2418,5762,1983,5142,201,452,1332,3566,1533,4018
291680,202301,5019,10811,4078,9571,557,1298,2502,5925,3059,7223
291685,202301,5700,12701,4550,11142,192,403,3486,8483,3678,8886
291690,202301,5597,9887,4045,7860,139,293,3525,6637,3664,6930
291700,202301,11851,27547,10455,25389,333,1036,8964,21073,9297,22109
291710,202301,6898,13587,5288,11482,350,789,3993,8322,4343,9111
291720,202301,5290,14401,4356,12677,870,2617,2278,6484,3148,9101
291730,202301,9968,18426,8618,16757,412,809,7331,14085,7743,14894
291733,202301,3576,8023,2938,7181,121,227,2156,5480,2277,5707
291735,202301,3163,7988,2404,6652,85,202,1677,4653,1762,4855
291740,202301,4688,11125,3235,8479,119,256,2265,5872,2384,6128
291750,202301,27636,56117,23031,49615,3057,5863,15169,32818,18226,38681
291760,202301,13888,34549,10882,30133,3318,10699,2799,7127,6117,17826
291770,202301,9307,21814,7722,19169,385,1200,5895,13797,6280,14997
291780,202301,6492,14634,5838,13791,166,444,5011,11597,5177,12041
291790,202301,3801,8206,3465,7810,394,602,2558,6062,2952,6664
291800,202301,44914,92995,36025,81005,4250,10263,22832,48493,27082,58756
291810,202301,13503,27826,11551,25550,476,894,9631,21434,10107,22328
291820,202301,4883,11057,4226,10223,142,361,3449,8240,3591,8601
291830,202301,6027,11458,4931,10072,367,515,3842,7943,4209,8458
291835,202301,7820,21112,6237,18333,690,2068,4011,11824,4701,13892
291840,202301,65186,151493,56917,139527,6000,15639,40383,96821,46383,112460
291845,202301,4258,8132,3549,7301,271,421,2855,6048,3126,6469
291850,202301,5490,12908,4630,11624,138,346,3942,9830,4080,10176
291855,202301,2968,4738,2402,4135,40,71,2257,3852,2297,3923
291860,202301,2520,6230,1719,4717,46,119,1157,3065,1203,3184
291870,202301,1501,3493,998,2624,55,165,661,1680,716,1845
291875,202301,3438,9523,2922,8499,68,279,2151,6001,2219,6280
291880,202301,6705,16361,5627,14680,343,818,4241,11173,4584,11991
291890,202301,2108,3832,1397,3008,198,423,895,1880,1093,2303
291900,202301,1651,3408,1262,2840,38,86,1010,2178,1048,2264
291905,202301,2732,6450,2224,5683,106,327,1665,4068,1771,4395
291910,202301,4510,8407,3887,7688,83,171,3471,6810,3554,6981
291915,202301,8940,22409,7195,19609,275,700,5245,14625,5520,15325
291920,202301,44605,94743,39267,88000,1979,5445,31633,67709,33612,73154
291930,202301,3414,7475,2899,6789,305,664,2082,4952,2387,5616
291940,202301,4520,10382,3039,8024,273,681,1828,4732,2101,5413
291950,202301,10982,30651,9160,27422,516,1583,6063,18023,6579,19606
291955,202301,25123,53145,22495,49869,1464,3495,18017,39282,19481,42777
291960,202301,4722,9398,3973,8468,309,486,3159,6934,3468,7420
291970,202301,6208,12643,5251,11522,201,481,4239,9128,4440,9609
291980,202301,12375,30974,10008,27205,926,2370,6696,18348,7622,20718
291990,202301,2748,6213,2291,5667,32,113,2107,5149,2139,5262
291992,202301,5937,11674,5056,10583,217,472,4234,8561,4451,9033
291995,202301,2843,6259,2349,5534,80,249,1947,4412,2027,4661
292000,202301,3402,6755,2821,6080,88,227,2380,5034,2468,5261
292010,202301,7155,14257,5839,12415,105,362,5015,10262,5120,10624
292020,202301,5857,14027,4973,12635,142,526,4087,9920,4229,10446
292030,202301,2542,6562,2195,5981,149,435,1454,3827,1603,4262
292040,202301,5814,12239,4654,10644,170,414,3853,8668,4023,9082
292045,202301,5757,11081,4594,9466,26,74,4313,8815,4339,8889
292050,202301,7825,19366,6287,16837,276,860,4294,11098,4570,11958
292060,202301,16430,30834,15209,29407,509,882,13572,25731,14081,26613
292070,202301,8705,17217,7667,16018,539,1070,6487,13477,7026,14547
292080,202301,4707,8786,3912,7813,47,149,3633,7131,3680,7280
292090,202301,5285,10189,3760,8343,222,532,2965,6540,3187,7072
292100,202301,16228,34133,13921,31317,2070,4634,8536,19297,10606,23931
292105,202301,4013,9237,3470,8509,47,158,2921,7078,2968,7236
292110,202301,8419,16521,6128,13481,720,1734,4065,8615,4785,10349
292120,202301,8847,19737,7259,17208,755,1561,5003,11765,5758,13326
292130,202301,4148,8749,3367,7798,208,521,2488,5625,2696,6146
292140,202301,7196,13800,6104,12316,184,379,5410,10710,5594,11089
292145,202301,3214,7623,2676,6786,151,280,2012,5215,2163,5495
292150,202301,19694,42882,16988,38730,389,1020,14566,32159,14955,33179
292160,202301,3569,7542,2707,6478,34,100,2119,5337,2153,5437
292170,202301,10762,25406,8933,22575,516,1518,6699,16366,7215,17884
292180,202301,3478,8701,2609,7162,193,547,1622,4279,1815,4826
292190,202301,3755,8446,3150,7592,277,713,2212,5276,2489,5989
292200,202301,11702,25508,8863,21618,1839,4607,4236,10434,6075,15041
292205,202301,4719,11268,4115,10418,115,313,3503,8839,3618,9152
292210,202301,8358,15849,6954,14147,84,276,6471,12890,6555,13166
292220,202301,2774,5584,2373,5014,192,391,1726,3492,1918,3883
292225,202301,3821,9840,3315,9116,68,270,2854,7710,2922,7980
292230,202301,10826,22475,9471,20751,312,828,7944,16944,8256,17772
292240,202301,6128,15447,5246,13902,315,787,3734,9811,4049,10598
292250,202301,7777,16907,6926,15754,311,790,5575,12261,5886,13051
292260,202301,4123,9557,3623,8944,62,186,3215,7879,3277,8065
292265,202301,4516,10363,3731,9180,65,251,3170,7540,3235,7791
292270,202301,6228,11249,5102,9940,195,304,4302,8271,4497,8575
292273,202301,3458,6591,2750,5743,162,264,1973,4343,2135,4607
292275,202301,2378,5126,1947,4580,52,159,1626,3736,1678,3895
292280,202301,3401,6822,2713,6040,117,199,2305,5223,2422,5422
292285,202301,3195,6555,2508,5670,109,202,2034,4652,2143,4854
292290,202301,9267,20589,7412,18044,203,504,6219,14904,6422,15408
292300,202301,13045,28930,10282,25215,1473,3606,6252,15422,7725,19028
292303,202301,4201,9293,3659,8501,58,137,3270,7464,3328,7601
292305,202301,2799,6696,2539,6350,53,171,2274,5605,2327,5776
292310,202301,8648,18256,7474,16848,147,447,6557,14416,6704,14863
292320,202301,7049,16876,5617,14520,174,527,4368,10944,4542,11471
292330,202301,4042,6735,3393,6024,155,228,2870,5135,3025,5363
292335,202301,6232,14225,5473,13123,266,601,4524,10869,4790,11470
292340,202301,6118,15844,5019,13764,367,916,3509,9578,3876,10494
292350,202301,3390,7748,2846,7046,145,395,2346,5735,2491,6130
292360,202301,6076,14254,5053,12652,272,732,3690,9019,3962,9751
292370,202301,13769,27182,11849,24726,87,334,11216,22975,11303,23309
292380,202301,8416,20560,7463,18975,450,1200,5808,14387,6258,15587
292390,202301,6162,9667,4747,8080,110,188,4312,7284,4422,7472
292400,202301,28880,70017,24826,64073,2380,6013,17326,44271,19706,50284
292405,202301,5590,11835,4638,10410,144,326,3632,8264,3776,8590
292410,202301,3090,5701,2675,5225,90,156,2376,4621,2466,4777
292420,202301,6236,11938,5607,11119,126,254,5081,9828,5207,10082
292430,202301,5970,15977,4493,13344,340,1091,2986,8686,3326,9777
292440,202301,11467,29288,10502,27930,126,600,9529,24936,9655,25536
292450,202301,4916,12436,3709,10221,100,307,2868,7765,2968,8072
292460,202301,7942,16102,6742,14371,162,451,5883,12095,6045,12546
292465,202301,3151,7041,2631,6381,133,274,1767,4566,1900,4840
292467,202301,2691,6155,2394,5778,333,672,1656,4223,1989,4895
292470,202301,3408,8025,2566,6742,151,349,1806,4778,1957,5127
292480,202301,8464,15512,6997,13796,168,334,6334,12352,6502,12686
292490,202301,3462,6589,2865,5839,81,165,2313,4704,2394,4869
292500,202301,9034,19972,7218,17228,417,887,5318,12407,5735,13294
292510,202301,17624,39414,13893,33857,1075,2537,9781,23590,10856,26127
292520,202301,9310,20524,8223,19004,422,1144,6611,14827,7033,15971
292525,202301,8236,16121,6819,14526,136,318,6144,13012,6280,13330
292530,202301,45090,101304,36354,88246,6990,18108,18644,43539,25634,61647
292540,202301,5455,8818,4375,7684,139,217,3952,6952,4091,7169
292550,202301,10445,24812,8124,22024,653,1639,5547,15797,6200,17436
292560,202301,5588,12269,4628,10969,173,506,3565,8084,3738,8590
292570,202301,4589,10399,3825,9135,57,205,3264,7481,3321,7686
292575,202301,8212,21244,7455,20228,892,2320,5359,14804,6251,17124
292580,202301,9992,20369,8296,18023,529,742,6813,14899,7342,15641
292590,202301,8839,20978,7419,18527,313,1021,6105,14689,6418,15710
292593,202301,3547,7819,2807,6615,80,195,2318,5349,2398,5544
292595,202301,7062,15848,6112,14702,331,674,4995,12231,5326,12905
292600,202301,13945,32524,11986,29747,672,1515,9435,23419,10107,24934
292610,202301,5641,12160,4753,10775,157,350,3860,8534,4017,8884
292620,202301,8522,18817,7057,17071,121,286,6467,15628,6588,15914
292630,202301,11593,24014,9356,20646,965,2355,6436,13492,7401,15847
292640,202301,9722,24982,8108,22381,489,1344,5528,15263,6017,16607
292650,202301,5129,11471,4526,10692,64,200,4136,9630,4200,9830
292660,202301,13100,32719,11155,29908,646,1580,8357,22622,9003,24202
292665,202301,2450,6448,2064,5940,121,281,1592,4725,1713,5006
292670,202301,4106,10448,3190,8812,255,817,2051,5396,2306,6213
292680,202301,4784,11219,3800,9586,106,277,2939,7155,3045,7432
292690,202301,2998,7171,2056,5686,221,559,1255,3553,1476,4112
292700,202301,13028,29741,11192,27081,666,1443,8390,20031,9056,21474
292710,202301,4209,8912,3943,8598,77,152,3739,8128,3816,8280
292720,202301,10870,22201,9111,20181,480,903,6980,15936,7460,16839
292730,202301,6903,13074,6216,12151,359,583,5236,10148,5595,10731
292740,202301,513398,1019753,458871,948121,48501,103379,329892,657538,378393,760917
292750,202301,8734,18287,7663,16920,311,630,6502,14228,6813,14858
292760,202301,4782,11940,4113,10845,196,571,3120,8032,3316,8603
292770,202301,9674,20692,7997,18471,983,2307,5557,12890,6540,15197
292780,202301,2635,4462,1956,3677,44,107,1682,2980,1726,3087
292790,202301,4694,8688,3573,7490,311,563,2792,5943,3103,6506
292800,202301,14973,31448,12855,28395,937,1835,9951,22007,10888,23842
292805,202301,4704,9351,3763,8216,141,336,3162,6742,3303,7078
292810,202301,17003,32672,14022,28438,475,1251,11879,22747,12354,23998
292820,202301,8245,21133,6013,17439,490,1585,4087,11560,4577,13145
292830,202301,3635,7406,3114,6801,152,309,2537,5638,2689,5947
292840,202301,12705,25576,10954,23352,156,468,9963,20675,10119,21143
292850,202301,3192,7353,2695,6678,241,561,1876,4578,2117,5139
292860,202301,23256,42939,20856,40114,415,1007,18489,34494,18904,35501
292870,202301,29012,59220,25132,54004,1719,3613,18028,37135,19747,40748
292880,202301,13606,33938,11335,30442,440,1535,8182,20840,8622,22375
292890,202301,10872,23324,9657,21685,216,661,8472,18461,8688,19122
292895,202301,4256,7609,3318,6288,247,386,2651,5013,2898,5399
292900,202301,3744,8073,3366,7575,56,202,2853,6133,2909,6335
292905,202301,5477,12233,4360,10618,153,417,3384,7923,3537,8340
292910,202301,6930,15144,6098,14090,180,388,4969,11190,5149,11578
292920,202301,12342,28898,11339,27572,336,1020,9751,23120,10087,24140
292925,202301,6297,16302,5158,14239,452,1025,3474,9612,3926,10637
292930,202301,8561,21817,7394,19784,969,2650,4241,10972,5210,13622
292935,202301,3486,6354,2821,5627,20,58,2600,5145,2620,5203
292937,202301,3376,7725,2785,6937,396,735,1523,4318,1919,5053
292940,202301,3706,8165,2965,7084,499,1061,1780,4385,2279,5446
292950,202301,11218,26183,9740,24124,570,1365,7298,17691,7868,19056
292960,202301,6770,14102,5702,12670,218,391,4586,10061,4804,10452
292970,202301,4883,11887,4294,11080,120,324,3543,9204,3663,9528
292975,202301,5394,10349,4804,9693,104,232,4403,8795,4507,9027
292980,202301,4876,9142,4090,8082,61,180,3676,7059,3737,7239
292990,202301,13964,34360,11599,30438,410,1282,9071,22942,9481,24224
293000,202301,3314,7097,2779,6282,168,320,2090,4755,2258,5075
293010,202301,23581,51668,19130,45296,2437,5997,12190,28316,14627,34313
293015,202301,10492,28237,8250,24171,702,2095,5523,16145,6225,18240
293020,202301,12882,30271,11676,28625,167,588,10616,25743,10783,26331
293030,202301,6235,14728,4831,12623,422,769,3144,8642,3566,9411
293040,202301,5305,11979,4276,10593,132,345,3587,8802,3719,9147
293050,202301,32086,62392,28248,57111,1962,3849,21760,42647,23722,46496
293060,202301,4653,10920,3739,9308,232,594,2709,6460,2941,7054
293070,202301,42281,80136,37839,74765,2291,4770,30588,58369,32879,63139
293075,202301,4382,11764,3785,10843,69,350,3245,9224,3314,9574
293076,202301,4218,9012,3815,8555,112,207,3364,7607,3476,7814
293077,202301,8052,19032,6509,16729,923,2138,3736,10194,4659,12332
293080,202301,5493,14374,4614,12887,90,364,3782,10306,3872,10670
293090,202301,3694,9966,2847,8547,194,601,1956,5784,2150,6385
293100,202301,7134,16789,5730,14444,335,715,4351,10938,4686,11653
293105,202301,4594,13093,3891,11726,250,776,2668,8006,2918,8782
293110,202301,3189,6472,2689,5791,133,278,2140,4520,2273,4798
293120,202301,6611,13524,6036,12749,522,722,4851,10637,5373,11359
293130,202301,4475,10554,3858,9780,129,412,3320,8242,3449,8654
293135,202301,39709,84954,29442,71379,5444,14496,11972,28045,17416,42541
293140,202301,3657,6068,3219,5571,102,140,2871,4891,2973,5031
293150,202301,6224,16473,5110,14498,410,1256,3462,9491,3872,10747
293160,202301,5228,10473,4616,9791,565,758,3551,8181,4116,8939
293170,202301,6855,11100,5862,9991,108,241,5180,8581,5288,8822
293180,202301,5643,13578,4667,11920,101,344,3801,9383,3902,9727
293190,202301,20920,42309,18489,39045,126,502,17006,34958,17132,35460
293200,202301,11835,23115,9756,20074,589,918,7974,16339,8563,17257
293210,202301,6729,14774,5692,13325,572,1191,4096,9718,4668,10909
293220,202301,7599,15222,5768,12439,767,1613,3825,7888,4592,9501
293230,202301,6028,11698,4605,9959,370,694,3459,7535,3829,8229
293240,202301,5584,12507,4466,10828,210,369,3299,8356,3509,8725
293245,202301,4974,11514,4489,10848,279,648,3669,8734,3948,9382
293250,202301,7143,15143,5744,13275,415,1000,4318,9793,4733,10793
293260,202301,6000,13315,4871,11672,179,342,3544,8512,3723,8854
293270,202301,9559,17759,7635,15734,627,774,6113,13371,6740,14145
293280,202301,5653,12559,4927,11585,307,655,3915,9154,4222,9809
293290,202301,21508,51336,19017,47641,1763,4546,13622,33462,15385,38008
293300,202301,8474,16789,7276,15102,562,1145,5563,11164,6125,12309
293305,202301,5437,10912,4617,9907,40,109,4207,8956,4247,9065
293310,202301,2740,6044,2313,5413,32,115,1913,4321,1945,4436
293315,202301,5853,11136,4874,9809,480,678,3844,7882,4324,8560
293317,202301,3515,7132,3118,6588,311,468,2263,4879,2574,5347
293320,202301,17716,33906,15819,31853,219,536,14493,28582,14712,29118
293325,202301,2286,4896,1781,4275,203,473,1172,2798,1375,3271
293330,202301,98087,222770,81536,196726,9548,26015,49662,110781,59210,136796
293340,202301,2609,6535,2116,5700,166,456,1427,3777,1593,4233
293345,202301,4760,10819,3816,9461,497,912,2437,6685,2934,7597
293350,202301,7122,17672,6062,16364,156,437,5268,14246,5424,14683
293360,202301,19533,40594,16817,37119,567,1201,14563,32332,15130,33533
310010,202301,1217,2521,843,2042,103,284,368,771,471,1055
310020,202301,3945,9378,2996,7771,516,1445,1243,2929,1759,4374
310030,202301,2434,6129,1915,5268,263,771,1227,3240,1490,4011
310040,202301,1018,2393,791,2016,68,228,454,1003,522,1231
310050,202301,2032,5071,1709,4599,150,486,1150,2959,1300,3445
310060,202301,3900,9431,3270,8608,145,468,2427,6444,2572,6912
310070,202301,440,957,334,814,13,43,252,593,265,636
310080,202301,930,2334,691,1928,95,290,337,888,432,1178
310090,202301,6643,13980,5517,12327,206,587,4467,9529,4673,10116
310100,202301,4634,10422,3859,9275,105,369,3281,7604,3386,7973
310110,202301,5965,14012,4685,11923,604,1772,2822,6700,3426,8472
310120,202301,833,1871,551,1465,92,307,276,616,368,923
310130,202301,538,1202,465,1096,28,93,362,793,390,886
310140,202301,433,1111,331,969,70,227,171,441,241,668
310150,202301,7983,17740,6105,14633,524,1532,3648,7810,4172,9342
310160,202301,13011,28538,10079,24123,1582,4403,5017,10897,6599,15300
310163,202301,1451,3959,1121,3331,255,855,310,761,565,1616
310170,202301,12329,26743,10086,23488,954,2265,7151,16239,8105,18504
310180,202301,2539,5445,1852,4411,195,531,1197,2696,1392,3227
310190,202301,3319,8711,2662,7622,596,1839,549,1422,1145,3261
310200,202301,2477,6367,1875,5343,373,1252,822,2057,1195,3309
310205,202301,1428,3512,1156,3117,148,420,743,2007,891,2427
310210,202301,2951,7221,2385,6236,128,317,1667,4207,1795,4524
310220,202301,1409,3535,1048,2874,87,282,650,1667,737,1949
310230,202301,2929,6848,2419,5995,286,846,1507,3432,1793,4278
310240,202301,1258,3231,1063,2929,59,202,721,1877,780,2079
310250,202301,1528,3227,1278,2873,38,106,1032,2223,1070,2329
310260,202301,4687,11251,3221,8614,756,2349,1098,2346,1854,4695
310270,202301,3674,7037,2997,6186,103,240,2503,5111,2606,5351
310280,202301,3603,6952,2821,5934,141,380,2146,4164,2287,4544
310285,202301,2251,6321,1848,5618,185,621,1121,3370,1306,3991
310290,202301,1993,4708,1686,4171,203,593,1054,2340,1257,2933
310300,202301,2064,5173,1598,4375,168,564,850,2050,1018,2614
310310,202301,414,888,280,677,46,120,144,314,190,434
310320,202301,588,1362,400,1053,24,73,221,548,245,621
310330,202301,605,1349,356,904,58,152,145,333,203,485
310340,202301,10248,23403,7956,19666,956,2387,4198,10049,5154,12436
310350,202301,17184,38298,12429,30907,1800,5034,6568,14968,8368,20002
310360,202301,763,1493,630,1329,27,68,432,863,459,931
310370,202301,1479,4281,1265,3920,244,837,419,1334,663,2171
310375,202301,1088,2460,765,2008,227,580,233,590,460,1170
310380,202301,455,997,268,720,24,67,142,353,166,420
310390,202301,736,2005,596,1740,105,341,254,659,359,1000
310400,202301,15800,35169,12001,29633,888,2623,7991,18440,8879,21063
310410,202301,1311,3473,810,2445,92,311,339,874,431,1185
310420,202301,6319,15130,4758,12460,555,1626,2484,5887,3039,7513
310430,202301,2134,5360,1531,4311,254,742,660,1577,914,2319
310440,202301,804,1884,537,1423,89,224,244,608,333,832
310445,202301,1640,4176,1251,3448,84,217,877,2343,961,2560
310450,202301,5999,12603,4597,10515,270,797,3513,7529,3783,8326
310460,202301,2162,5356,1593,4341,203,601,474,1078,677,1679
310470,202301,4167,8663,3215,7433,464,986,1994,4690,2458,5676
310480,202301,1245,2914,945,2437,107,353,555,1277,662,1630
310490,202301,3765,9058,2976,7812,388,1184,1626,3854,2014,5038
310500,202301,1929,4484,1534,3874,207,551,969,2325,1176,2876
310510,202301,3009,6973,2230,5625,389,1059,989,2336,1378,3395
310520,202301,1373,3256,970,2537,142,407,459,1151,601,1558
310530,202301,1045,2497,779,2071,113,348,313,687,426,1035
310540,202301,3632,9576,2969,8346,530,1624,1325,3391,1855,5015
310550,202301,1580,3470,1139,2755,82,248,736,1588,818,1836
310560,202301,21375,50452,15886,40925,1768,5344,8263,18267,10031,23611
310570,202301,1539,3263,1216,2845,57,176,1006,2258,1063,2434
310590,202301,5352,12461,4284,10599,277,804,2614,5859,2891,6663
310600,202301,1742,4516,1437,3933,170,511,765,1908,935,2419
310610,202301,599,1529,371,1140,93,306,75,209,168,515
310620,202301,293931,657878,227683,544722,22275,64340,135916,287209,158191,351549
310630,202301,5792,14370,4431,11819,543,1489,2572,6495,3115,7984
310640,202301,1927,4392,1576,3836,115,378,1118,2439,1233,2817
310650,202301,2898,7108,2143,5769,137,437,1271,3198,1408,3635
310660,202301,1782,4083,1457,3653,23,62,1263,3122,1286,3184
310665,202301,1742,3767,1457,3404,47,145,1171,2689,1218,2834
310670,202301,85299,190124,71773,168785,6342,17290,49828,108834,56170,126124
310680,202301,985,2051,818,1820,19,71,676,1427,695,1498
310690,202301,3194,6664,2391,5533,240,580,1622,3499,1862,4079
310700,202301,665,1233,520,1055,11,28,436,849,447,877
310710,202301,7803,19962,5624,16640,1270,4264,932,2396,2202,6660
310720,202301,1444,2918,1146,2540,41,121,869,1843,910,1964
310730,202301,12902,29529,10961,26668,521,1591,8173,18759,8694,20350
310740,202301,8727,21281,6705,17618,774,2413,3428,7874,4202,10287
310750,202301,1697,3592,1291,3021,138,365,766,1596,904,1961
310760,202301,889,1993,641,1620,70,137,389,999,459,1136
310770,202301,1324,3283,927,2663,122,411,447,1103,569,1514
310780,202301,5167,10723,4166,9354,305,742,2958,6492,3263,7234
310790,202301,2302,6620,1962,5942,415,1439,475,1167,890,2606
310800,202301,2830,7910,2059,6375,456,1568,128,320,584,1888
310810,202301,1896,3985,1564,3487,75,210,1190,2476,1265,2686
310820,202301,1479,3421,885,2444,162,443,258,660,420,1103
310825,202301,3293,8127,2623,7113,47,229,2173,5613,2220,5842
310830,202301,2668,6494,2049,5450,372,1102,1016,2415,1388,3517
310840,202301,2802,6968,2146,5906,442,1365,689,1606,1131,2971
310850,202301,1624,4015,1333,3602,57,213,936,2387,993,2600
310855,202301,4102,9504,3238,8196,231,625,2367,5768,2598,6393
310860,202301,8402,21588,6848,18882,821,2056,4037,11238,4858,13294
310870,202301,1134,2511,904,2197,56,145,643,1487,699,1632
310880,202301,1083,2962,823,2427,99,308,450,1282,549,1590
310890,202301,2753,7342,1831,5564,346,1103,274,714,620,1817
310900,202301,5325,13615,4014,11060,725,2263,1718,4124,2443,6387
310910,202301,2705,6105,1864,4802,266,751,517,1160,783,1911
310920,202301,2319,5390,1764,4602,214,633,1106,2731,1320,3364
310925,202301,1348,3010,1062,2593,51,154,794,1819,845,1973
310930,202301,6702,15680,4678,12592,877,2468,2190,6004,3067,8472
310940,202301,8683,17641,7038,15402,266,729,5573,11591,5839,12320
310945,202301,1661,3808,1293,3238,156,433,744,1710,900,2143
310950,202301,2261,6246,1454,4481,237,839,384,914,621,1753
310960,202301,868,2197,519,1509,78,238,136,364,214,602
310970,202301,1420,3985,1034,3210,254,816,187,551,441,1367
310980,202301,411,892,244,621,20,59,121,281,141,340
310990,202301,1867,4386,1523,3849,174,510,920,2097,1094,2607
311000,202301,5408,13163,4138,11141,700,2125,2261,5542,2961,7667
311010,202301,1232,2933,1013,2580,220,584,516,1281,736,1865
311020,202301,1438,3340,942,2502,73,228,515,1274,588,1502
311030,202301,2322,5300,1699,4310,410,1187,691,1587,1101,2774
311040,202301,359,1037,279,864,81,285,66,172,147,457
311050,202301,3886,8813,2978,7492,444,1303,1518,3457,1962,4760
311060,202301,4519,10418,3388,8496,422,1221,1557,3417,1979,4638
311070,202301,3137,6878,2254,5576,322,973,1175,2603,1497,3576
311080,202301,1426,2827,1124,2397,38,113,886,1761,924,1874
311090,202301,2856,8037,2339,7145,523,1701,722,2132,1245,3833
311100,202301,3077,7940,2048,6037,385,1272,569,1391,954,2663
311110,202301,4607,9095,2469,5985,566,1363,454,1045,1020,2408
311115,202301,1800,3359,1496,2980,41,92,1296,2500,1337,2592
311120,202301,9019,21492,6943,17937,1025,2995,2997,6539,4022,9534
311130,202301,2334,5638,1798,4906,168,573,1043,2650,1211,3223
311140,202301,1948,4444,1501,3848,158,458,961,2395,1119,2853
311150,202301,1762,5113,1414,4475,192,671,735,2178,927,2849
311160,202301,5151,13239,3816,10927,654,2142,1584,4112,2238,6254
311170,202301,1154,2709,950,2450,57,165,592,1603,649,1768
311180,202301,1900,3897,1292,3045,195,455,698,1556,893,2011
311190,202301,1056,2775,795,2266,116,365,332,796,448,1161
311200,202301,2813,6836,2122,5614,365,1099,922,2024,1287,3123
311205,202301,1128,2940,899,2524,35,115,589,1544,624,1659
311210,202301,1263,3341,1115,3142,141,358,765,2247,906,2605
311220,202301,1101,2449,966,2222,27,86,759,1596,786,1682
311230,202301,9701,26429,7222,21497,1423,4413,2542,7431,3965,11844
311240,202301,1424,3201,1130,2797,160,465,646,1449,806,1914
311250,202301,1661,4158,1302,3564,242,720,517,1242,759,1962
311260,202301,3281,7448,2158,5596,285,843,1048,2331,1333,3174
311265,202301,1702,3646,1233,2941,49,148,936,2105,985,2253
311270,202301,3732,9818,3192,8999,207,776,2181,5795,2388,6571
311280,202301,1504,3696,923,2618,205,633,232,553,437,1186
311290,202301,2159,6032,1940,5622,118,360,1270,3593,1388,3953
311300,202301,5482,13355,4537,11856,189,610,3662,9283,3851,9893
311310,202301,672,1703,568,1531,46,123,350,899,396,1022
311320,202301,3869,10585,3283,9348,316,1048,1728,4306,2044,5354
311330,202301,7793,16834,6109,14370,670,1700,3199,7449,3869,9149
311340,202301,13492,33883,10769,29282,2314,6735,3503,8753,5817,15488
311350,202301,2843,6393,2068,5075,256,700,989,2069,1245,2769
311360,202301,1400,3111,1014,2594,267,738,441,1095,708,1833
311370,202301,5751,12725,4204,10357,492,1413,2327,5243,2819,6656
311380,202301,485,1367,370,1142,57,186,181,535,238,721
311390,202301,2125,5910,1701,5338,660,2266,420,1119,1080,3385
311400,202301,2022,5005,1468,4020,241,713,476,1029,717,1742
311410,202301,2337,6276,1885,5547,280,931,905,2455,1185,3386
311420,202301,2020,5319,1535,4473,311,987,482,1137,793,2124
311430,202301,5669,13604,3839,10199,544,1532,1570,3842,2114,5374
311440,202301,3818,9621,2929,8159,909,2913,573,1285,1482,4198
311450,202301,2981,8008,1897,5744,458,1613,434,984,892,2597
311455,202301,1345,2816,960,2275,98,239,579,1314,677,1553
311460,202301,723,2001,474,1483,92,327,106,259,198,586
311470,202301,593,1691,414,1326,97,367,61,158,158,525
311480,202301,1437,2950,1183,2586,85,201,949,2021,1034,2222
311490,202301,333,909,255,755,42,152,115,288,157,440
311500,202301,627,1419,494,1224,56,164,299,694,355,858
311510,202301,4394,9739,3188,7851,322,943,1765,3808,2087,4751
311520,202301,815,1988,708,1799,56,169,450,1108,506,1277
311530,202301,11601,24551,8193,19488,1741,4801,2930,6169,4671,10970
311535,202301,1101,2701,805,2147,125,372,387,946,512,1318
311540,202301,659,1741,576,1609,79,240,396,1080,475,1320
311545,202301,2373,6122,2054,5645,97,297,1577,4243,1674,4540
311547,202301,2200,4248,1926,3885,46,89,1669,3259,1715,3348
311550,202301,3672,8961,2996,7855,427,1305,1383,3205,1810,4510
311560,202301,369,733,231,521,33,78,84,163,117,241
311570,202301,1753,3806,1227,3091,58,156,881,2261,939,2417
311580,202301,2800,4908,1978,3944,181,342,1376,2641,1557,2983
311590,202301,774,1790,646,1615,63,192,426,1009,489,1201
311600,202301,1841,4106,1495,3656,177,521,1031,2406,1208,2927
311610,202301,2777,7465,2221,6492,155,529,1405,3888,1560,4417
311615,202301,4463,10172,3607,8850,137,427,2909,6845,3046,7272
311620,202301,702,1742,532,1460,69,211,312,809,381,1020
311630,202301,1548,3945,1232,3314,106,320,737,1909,843,2229
311640,202301,967,2327,765,2014,111,320,426,1029,537,1349
311650,202301,2303,5134,1855,4491,225,579,1108,2529,1333,3108
311660,202301,3843,10054,2858,8206,395,1316,814,1751,1209,3067
311670,202301,2020,4543,1502,3684,166,467,781,1799,947,2266
311680,202301,2830,6707,2186,5669,148,370,1537,3972,1685,4342
311690,202301,773,1455,565,1197,44,103,379,802,423,905
311700,202301,2459,5308,1880,4497,26,104,1566,3582,1592,3686
311710,202301,1935,5146,1448,4342,379,1257,444,1228,823,2485
311720,202301,514,1404,419,1234,49,170,234,661,283,831
311730,202301,5719,12857,4114,10044,834,2303,1999,4308,2833,6611
311740,202301,1170,2823,958,2531,71,142,736,1987,807,2129
311750,202301,4906,12964,3951,11315,320,1116,2561,6757,2881,7873
311760,202301,909,2288,709,1923,113,398,295,589,408,987
311770,202301,2724,6966,2149,6015,455,1372,788,1988,1243,3360
311780,202301,1867,4764,1409,3958,280,836,497,1218,777,2054
311783,202301,2854,6508,2336,5711,50,199,1921,4460,1971,4659
311787,202301,971,2582,749,2124,115,371,293,679,408,1050
311790,202301,1888,4850,1298,3770,255,855,325,805,580,1660
311800,202301,6228,17005,4944,14437,1054,3174,884,2013,1938,5187
311810,202301,1255,3066,1043,2733,59,180,782,1926,841,2106
311820,202301,1233,2589,941,2169,73,183,652,1409,725,1592
311830,202301,11197,28835,8288,23060,2218,6476,1604,4140,3822,10616
311840,202301,4875,10764,3902,9437,290,750,2800,6721,3090,7471
311850,202301,428,984,334,829,14,57,233,530,247,587
311860,202301,96474,212147,76998,180709,7898,21475,49282,106043,57180,127518
311870,202301,2262,5521,1612,4461,253,838,695,1663,948,2501
311880,202301,7663,17816,6379,16057,455,1091,4648,11781,5103,12872
311890,202301,2360,4706,1895,4091,48,170,1533,3068,1581,3238
311900,202301,799,1857,597,1592,103,260,318,853,421,1113
311910,202301,5368,12095,4200,10580,696,1893,2318,5516,3014,7409
311920,202301,2749,6076,2234,5364,135,321,1566,3685,1701,4006
311930,202301,6118,12193,4675,10322,753,1963,2712,5305,3465,7268
311940,202301,19416,46290,14203,37059,1961,5569,6211,14672,8172,20241
311950,202301,2906,6775,2185,5580,180,512,1333,3337,1513,3849
311960,202301,585,1365,454,1167,56,166,210,469,266,635
311970,202301,477,1448,364,1171,67,245,93,249,160,494
311980,202301,559,1376,310,916,35,107,119,312,154,419
311990,202301,643,1438,418,1101,66,222,180,389,246,611
311995,202301,1150,3069,592,1823,40,142,96,182,136,324
312000,202301,978,2042,747,1724,34,83,562,1255,596,1338
312010,202301,1386,3125,1116,2750,71,184,764,1806,835,1990
312015,202301,1609,4030,1397,3706,64,256,1115,2834,1179,3090
312020,202301,2228,6180,1550,4670,263,861,358,913,621,1774
312030,202301,2685,5242,2274,4779,77,212,2044,4201,2121,4413
312040,202301,1022,2784,748,2259,115,356,327,904,442,1260
312050,202301,1469,4102,1211,3653,221,824,431,1128,652,1952
312060,202301,1230,2735,784,2133,185,527,298,767,483,1294
312070,202301,1097,2877,748,2144,36,135,465,1218,501,1353
312080,202301,3644,7989,2853,6854,142,407,1993,4351,2135,4758
312083,202301,1369,2826,1081,2412,58,179,868,1828,926,2007
312087,202301,3085,6801,2510,5970,87,230,2023,4726,2110,4956
312090,202301,14689,33915,11649,29280,1192,3618,6995,15984,8187,19602
312100,202301,2041,5014,1594,4284,113,370,980,2387,1093,2757
312110,202301,1213,3452,997,3004,169,627,474,1249,643,1876
312120,202301,1290,3266,894,2587,222,761,283,656,505,1417
312125,202301,2466,5406,2102,4917,95,258,1719,3876,1814,4134
312130,202301,1473,3104,1094,2517,74,225,651,1277,725,1502
312140,202301,906,2404,739,2080,185,550,300,755,485,1305
312150,202301,633,1510,537,1340,33,91,373,858,406,949
312160,202301,12037,28170,9411,23864,982,2994,5068,11420,6050,14414
312170,202301,1079,2496,833,2061,55,157,552,1297,607,1454
312180,202301,1709,4037,1387,3502,148,419,815,1909,963,2328
312190,202301,1012,2411,784,2038,73,231,424,1003,497,1234
312200,202301,5807,14040,4536,12090,537,1472,2735,6994,3272,8466
312210,202301,1799,3349,1380,2794,64,141,1124,2187,1188,2328
312220,202301,2035,5546,1734,5033,187,569,1107,3199,1294,3768
312230,202301,25571,58280,18881,47050,3587,10213,6883,13963,10470,24176
312235,202301,2723,5621,2227,4968,134,342,1735,3664,1869,4006
312240,202301,981,2848,764,2428,154,517,226,667,380,1184
312245,202301,4092,7540,3515,6762,43,104,3248,6104,3291,6208
312247,202301,1278,2661,888,2094,113,282,541,1191,654,1473
312250,202301,1122,2760,716,2007,96,296,257,666,353,962
312260,202301,1261,2903,1027,2551,74,201,788,1859,862,2060
312270,202301,892,2230,680,1812,32,117,410,961,442,1078
312280,202301,535,1472,437,1306,103,343,166,440,269,783
312290,202301,1176,3048,991,2760,160,515,387,960,547,1475
312300,202301,1439,3917,1068,3067,227,711,255,576,482,1287
312310,202301,1260,3378,973,2809,125,437,497,1311,622,1748
312320,202301,2601,6001,1857,4753,355,893,558,1284,913,2177
312330,202301,1133,2923,930,2558,131,419,528,1348,659,1767
312340,202301,297,687,206,546,29,103,115,260,144,363
312350,202301,308,595,227,504,14,39,157,308,171,347
312352,202301,1801,5188,1590,4815,280,912,743,2404,1023,3316
312360,202301,4413,11232,3330,9275,671,2030,1358,3333,2029,5363
312370,202301,2590,5834,2070,5067,247,704,1283,2923,1530,3627
312380,202301,2648,5296,2173,4691,21,52,1866,3881,1887,3933
312385,202301,1529,3723,1198,3175,391,1065,295,810,686,1875
312390,202301,2311,5964,1734,4894,267,839,493,1158,760,1997
312400,202301,3779,9839,3213,8970,1061,3233,683,1849,1744,5082
312410,202301,19228,44377,15919,39314,1840,4915,10309,24052,12149,28967
312420,202301,4967,12027,4029,10556,794,2380,1939,4696,2733,7076
312430,202301,11211,24152,9266,21011,275,828,7259,15484,7534,16312
312440,202301,1279,3669,1079,3295,516,1671,204,573,720,2244
312450,202301,1681,4459,1289,3771,336,1064,489,1408,825,2472
312460,202301,616,1325,448,1092,24,65,308,717,332,782
312470,202301,562,1306,357,962,53,147,104,227,157,374
312480,202301,1317,3010,960,2498,85,261,526,1263,611,1524
312490,202301,3260,6485,2575,5546,201,492,1608,3243,1809,3735
312500,202301,1347,2829,1145,2573,54,161,895,1942,949,2103
312510,202301,6258,15235,4283,11566,803,2175,1196,2902,1999,5077
312520,202301,453,1025,355,877,65,196,218,497,283,693
312530,202301,880,1802,737,1634,42,99,560,1222,602,1321
312540,202301,1888,4646,1287,3538,151,409,695,1803,846,2212
312550,202301,999,2316,723,1823,33,96,463,1052,496,1148
312560,202301,2175,5179,1654,4373,108,322,1163,2999,1271,3321
312570,202301,3361,7055,2518,6009,411,997,1307,3060,1718,4057
312580,202301,789,1962,548,1493,50,166,277,664,327,830
312590,202301,1841,4802,1416,3988,166,547,775,1970,941,2517
312595,202301,2609,6638,2146,5945,305,783,1188,3540,1493,4323
312600,202301,1710,3887,1148,2736,169,491,382,864,551,1355
312610,202301,8624,20398,5921,15585,969,2868,1976,4370,2945,7238
312620,202301,3077,6836,2349,5847,60,247,1933,4695,1993,4942
312630,202301,405,1040,297,853,48,163,128,326,176,489
312640,202301,662,1674,497,1418,62,205,247,638,309,843
312650,202301,2528,5603,1778,4303,51,173,1323,2935,1374,3108
312660,202301,1623,3503,1262,2936,89,217,884,1918,973,2135
312670,202301,7546,15666,6338,13864,126,510,5227,10603,5353,11113
312675,202301,1454,3328,1190,2966,60,172,937,2260,997,2432
312680,202301,1964,4249,1778,4004,38,143,1601,3471,1639,3614
312690,202301,3679,6845,2771,5734,111,234,2244,4532,2355,4766
312695,202301,1259,2884,1064,2594,51,90,882,2124,933,2214
312700,202301,2475,6142,1793,4958,191,624,947,2404,1138,3028
312705,202301,2072,3801,1812,3468,13,45,1717,3240,1730,3285
312707,202301,1639,4202,1161,3383,53,221,758,2015,811,2236
312710,202301,9274,19925,6122,15224,1551,3858,1850,4661,3401,8519
312720,202301,1329,3154,1046,2725,100,294,685,1664,785,1958
312730,202301,1941,4221,1399,3499,118,302,897,2172,1015,2474
312733,202301,1561,3820,1170,3127,48,162,774,1895,822,2057
312735,202301,968,2261,746,1865,50,142,482,1099,532,1241
312737,202301,1018,2035,739,1647,71,172,514,1092,585,1264
312738,202301,998,2242,717,1771,65,198,464,1015,529,1213
312740,202301,529,1288,334,960,70,219,87,181,157,400
312750,202301,1743,4514,1273,3662,148,491,581,1520,729,2011
312760,202301,2234,6016,1640,4888,238,738,623,1724,861,2462
312770,202301,56950,126542,37612,94582,6166,17419,15269,34710,21435,52129
312780,202301,3221,8154,2706,7318,338,912,1630,4309,1968,5221
312790,202301,284,640,143,409,4,14,32,52,36,66
312800,202301,7220,17322,5797,14857,538,1730,3616,8419,4154,10149
312810,202301,1983,5008,1323,3920,372,1194,385,1015,757,2209
312820,202301,2140,5090,1725,4420,112,292,1198,3014,1310,3306
312825,202301,1909,3615,1601,3232,37,77,1383,2727,1420,2804
312830,202301,3396,8640,2291,6591,536,1635,711,1771,1247,3406
312840,202301,1814,4228,1417,3612,155,447,737,1713,892,2160
312850,202301,1412,2707,1069,2251,19,69,813,1527,832,1596
312860,202301,1282,3085,886,2467,231,678,264,646,495,1324
312870,202301,7319,18269,4773,13600,817,2496,1383,3465,2200,5961
312880,202301,1859,4120,1452,3489,237,529,717,1724,954,2253
312890,202301,2863,6262,2119,5122,133,318,1269,2873,1402,3191
312900,202301,1575,3652,1276,3254,172,470,748,1908,920,2378
312910,202301,1794,3169,1090,2277,152,301,592,1202,744,1503
312920,202301,1145,2845,814,2320,128,428,288,682,416,1110
312930,202301,2974,6532,2174,5364,356,930,1094,2670,1450,3600
312940,202301,1214,2983,967,2651,94,308,510,1283,604,1591
312950,202301,4223,9173,3086,7506,442,1261,1739,3804,2181,5065
312960,202301,2079,4971,1720,4437,109,257,1232,3277,1341,3534
312965,202301,1997,4835,1610,4231,165,413,1028,2704,1193,3117
312970,202301,1979,4966,1592,4377,157,548,938,2359,1095,2907
312980,202301,32487,80610,26337,70050,4934,13898,11687,28823,16621,42721
312990,202301,630,1443,426,1117,78,233,194,457,272,690
313000,202301,585,1508,446,1275,30,126,276,706,306,832
313005,202301,2938,7655,2445,6876,119,362,1755,4751,1874,5113
313010,202301,7413,17922,6031,15796,940,2787,3524,8707,4464,11494
313020,202301,1214,3400,955,2902,185,616,194,483,379,1099
313030,202301,1492,3058,1059,2467,76,212,764,1669,840,1881
313040,202301,1090,2984,921,2677,37,151,571,1548,608,1699
313050,202301,2246,5689,1590,4718,249,842,417,1051,666,1893
313055,202301,2291,5530,1959,5034,650,1883,943,2243,1593,4126
313060,202301,1319,2964,970,2388,202,597,233,503,435,1100
313065,202301,2098,5091,1857,4713,30,124,1584,3859,1614,3983
313070,202301,1065,2632,839,2272,93,278,424,1074,517,1352
313080,202301,488,1232,371,1036,62,216,148,332,210,548
313090,202301,6842,15507,5659,13716,250,698,4095,9592,4345,10290
313100,202301,1631,3818,1302,3359,61,214,940,2299,1001,2513
313110,202301,1832,4451,1306,3535,133,405,653,1579,786,1984
313115,202301,3548,8901,2863,7670,266,850,1670,3984,1936,4834
313120,202301,4559,10053,3319,8419,247,618,2194,5577,2441,6195
313130,202301,40753,94340,31229,78061,3132,8970,18292,41730,21424,50700
313140,202301,973,1860,656,1466,43,106,492,1069,535,1175
313150,202301,1710,4491,1236,3635,346,1153,198,467,544,1620
313160,202301,1748,3878,1314,3246,28,86,1010,2364,1038,2450
313170,202301,14464,37231,10939,30750,1733,5328,4245,10429,5978,15757
313180,202301,3166,7375,2414,5908,170,444,1640,3790,1810,4234
313190,202301,5733,14719,4319,12080,725,2222,1761,4333,2486,6555
313200,202301,1390,3227,1184,2886,32,95,960,2248,992,2343
313210,202301,5206,12117,4318,10782,439,1237,2877,6748,3316,7985
313220,202301,2421,5817,1646,4365,218,648,770,1723,988,2371
313230,202301,3437,8389,2779,7562,61,211,2270,6152,2331,6363
313240,202301,14367,31776,10425,25780,1026,3175,5995,13328,7021,16503
313250,202301,7629,20243,5891,16723,1093,3283,2671,7006,3764,10289
313260,202301,982,2216,695,1779,64,230,397,861,461,1091
313270,202301,8696,16666,7345,14959,448,883,6098,12280,6546,13163
313280,202301,560,1379,377,1041,46,148,176,451,222,599
313290,202301,1264,3746,994,3252,253,938,342,1034,595,1972
313300,202301,2291,5692,1757,4795,368,1081,614,1491,982,2572
313310,202301,1837,4962,1494,4263,257,819,486,1094,743,1913
313320,202301,2474,6006,1816,5002,400,1191,624,1707,1024,2898
313330,202301,5155,11822,3856,9940,280,814,2523,6317,2803,7131
313340,202301,2121,4292,1648,3668,107,275,1230,2594,1337,2869
313350,202301,3686,9277,2546,6926,291,931,1160,2614,1451,3545
313360,202301,2111,4694,1479,3705,240,717,776,1698,1016,2415
313370,202301,2064,5078,1584,4202,317,904,608,1393,925,2297
313375,202301,2328,5655,1506,4191,279,891,416,963,695,1854
313380,202301,8726,19986,6484,16080,949,2764,3198,6804,4147,9568
313390,202301,963,2694,828,2458,50,206,565,1586,615,1792
313400,202301,4612,10083,3470,8422,147,419,2598,6088,2745,6507
313410,202301,1753,4027,1317,3326,336,852,696,1673,1032,2525
313420,202301,19469,40830,11296,27856,2578,7150,2955,6313,5533,13463
313430,202301,1563,3499,1312,3068,65,247,1024,2174,1089,2421
313440,202301,9095,16801,6716,13947,188,486,5380,10664,5568,11150
313450,202301,888,2190,629,1722,105,326,221,472,326,798
313460,202301,2957,7540,2382,6645,416,1299,1106,2936,1522,4235
313470,202301,3413,7699,2744,6755,152,427,2109,5062,2261,5489
313480,202301,1411,3707,897,2645,89,297,382,984,471,1281
313490,202301,3727,9022,2127,6056,381,1186,550,1373,931,2559
313500,202301,689,1628,470,1223,68,164,209,498,277,662
313505,202301,13123,29720,11173,27104,493,1242,8938,21281,9431,22523
313507,202301,1674,3824,1324,3296,50,159,1015,2421,1065,2580
313510,202301,19343,45740,15172,38062,1376,3780,8852,20132,10228,23912
313520,202301,19679,45312,16031,39577,710,2147,12464,29322,13174,31469
313530,202301,710,1956,524,1572,71,259,219,553,290,812
313535,202301,2776,7096,2215,6040,249,658,1322,3513,1571,4171
313540,202301,1086,2804,854,2310,109,338,397,925,506,1263
313545,202301,1367,4056,1148,3663,172,565,523,1607,695,2172
313550,202301,2566,6639,2141,5736,240,685,1394,3628,1634,4313
313560,202301,3777,6008,2875,4967,42,68,2569,4355,2611,4423
313570,202301,1230,3186,976,2755,195,583,438,1125,633,1708
313580,202301,7731,16139,6157,13727,341,936,4514,9409,4855,10345
313590,202301,1426,3378,1151,3006,234,644,605,1602,839,2246
313600,202301,5570,11612,4756,10445,92,310,4262,9046,4354,9356
313610,202301,1223,2788,997,2407,81,227,648,1431,729,1658
313620,202301,7143,17191,5886,15065,550,1694,3811,9169,4361,10863
313630,202301,11189,24784,8160,20389,825,2463,4958,11630,5783,14093
313640,202301,1647,3043,1145,2416,91,219,846,1732,937,1951
313650,202301,1992,5489,1556,4763,135,452,931,2858,1066,3310
313652,202301,1097,2756,964,2521,63,205,702,1713,765,1918
313655,202301,1466,3133,1152,2749,77,198,859,2000,936,2198
313657,202301,1356,3223,1053,2751,42,168,754,1795,796,1963
313660,202301,1461,3355,1212,2957,72,257,911,2050,983,2307
313665,202301,7238,16739,5817,14380,489,1491,3838,8670,4327,10161
313670,202301,71338,159428,50263,125648,6394,17649,25366,58110,31760,75759
313680,202301,1314,3026,1058,2633,42,110,708,1656,750,1766
313690,202301,1212,3358,893,2744,160,549,198,529,358,1078
313695,202301,2163,5198,1610,4317,116,293,1051,2854,1167,3147
313700,202301,3467,9622,2981,9006,238,752,2364,7178,2602,7930
313710,202301,1781,3704,1272,3044,114,340,817,1860,931,2200
313720,202301,8008,19934,5968,15987,769,2289,2848,6715,3617,9004
313730,202301,1726,3320,1290,2767,75,144,864,1813,939,1957
313740,202301,2028,6732,1712,6004,369,1460,439,1313,808,2773
313750,202301,2944,6796,2385,5932,337,1004,1447,3240,1784,4244
313753,202301,2557,5846,1713,4526,332,961,636,1587,968,2548
313760,202301,7648,19160,6136,16455,920,2817,3029,7258,3949,10075
313770,202301,4968,12794,3943,11228,206,565,2968,8576,3174,9141
313780,202301,4993,11839,3689,9879,602,1597,1243,3221,1845,4818
313790,202301,737,1898,625,1688,68,211,389,978,457,1189
313800,202301,1664,3441,1211,2831,113,312,709,1515,822,1827
313810,202301,2263,4740,1820,4115,66,212,1470,3148,1536,3360
313820,202301,21587,51059,14605,37137,2328,6191,4494,10162,6822,16353
313830,202301,487,1331,366,1090,73,250,134,347,207,597
313835,202301,1158,2882,862,2416,77,260,455,1146,532,1406
313840,202301,10221,24043,8067,20766,1833,4966,2331,5664,4164,10630
313850,202301,1230,2649,982,2314,162,416,529,1113,691,1529
313860,202301,3540,8342,2695,6921,370,1023,1341,3088,1711,4111
313862,202301,1458,3003,775,2021,48,145,383,956,431,1101
313865,202301,3208,7342,2652,6510,74,232,2049,4762,2123,4994
313867,202301,1655,4739,1322,4096,283,903,594,1879,877,2782
313868,202301,2053,5554,1631,4805,59,229,1227,3428,1286,3657
313870,202301,1319,3075,889,2325,125,349,388,891,513,1240
313880,202301,2770,6408,2121,5359,289,876,1129,2437,1418,3313
313890,202301,2989,5275,2208,4295,64,139,1760,3276,1824,3415
313900,202301,6748,17090,4800,13356,1211,3575,1422,3334,2633,6909
313910,202301,942,2541,718,2120,136,413,179,510,315,923
313920,202301,3471,9255,2880,8152,523,1535,1443,4033,1966,5568
313925,202301,2047,4600,1600,3860,199,427,965,2259,1164,2686
313930,202301,6272,15291,5024,13298,419,1083,3309,8658,3728,9741
313940,202301,12552,33315,9697,28737,2047,6591,2282,7159,4329,13750
313950,202301,7040,13501,5462,11552,272,652,4041,8258,4313,8910
313960,202301,7222,15779,4924,12104,707,2036,2172,4599,2879,6635
313970,202301,2004,4615,1684,4109,51,137,1177,2685,1228,2822
313980,202301,1845,4384,1325,3623,233,708,556,1401,789,2109
313990,202301,2723,7152,2142,6057,324,1122,1227,2996,1551,4118
314000,202301,13322,29790,10677,25478,708,2099,6888,15697,7596,17796
314010,202301,1656,3574,1291,3081,74,221,951,2139,1025,2360
314015,202301,3056,7365,2439,6331,258,812,1476,3442,1734,4254
314020,202301,625,1541,420,1218,141,497,36,92,177,589
314030,202301,1042,2688,766,2172,105,298,316,843,421,1141
314040,202301,772,1961,651,1754,86,282,361,914,447,1196
314050,202301,2509,5832,1895,4797,112,348,1212,2759,1324,3107
314053,202301,2562,6550,2053,5620,316,810,1190,3349,1506,4159
314055,202301,2858,6278,2406,5656,74,214,1993,4666,2067,4880
314060,202301,1558,3702,1155,3068,40,122,827,2122,867,2244
314070,202301,6314,15003,5164,13100,733,1968,2878,6820,3611,8788
314080,202301,2362,5768,1789,4792,154,486,889,2106,1043,2592
314085,202301,2896,6922,2300,6074,233,659,1470,3832,1703,4491
314090,202301,6206,14496,5291,13227,496,1301,3408,8624,3904,9925
314100,202301,3648,8074,2783,6894,83,213,2060,5056,2143,5269
314110,202301,6215,15756,5111,13802,639,1908,2681,6514,3320,8422
314120,202301,836,1837,413,1104,74,223,152,359,226,582
314130,202301,867,2039,627,1612,23,82,439,1045,462,1127
314140,202301,5677,13716,4489,11665,477,1354,2526,6187,3003,7541
314150,202301,1741,4012,1252,3198,123,360,763,1862,886,2222
314160,202301,2955,6695,2080,5278,217,543,864,2099,1081,2642
314170,202301,1153,2828,911,2382,48,175,615,1431,663,1606
314180,202301,6769,16527,5276,14205,624,1691,2690,7128,3314,8819
314190,202301,783,1763,593,1493,69,229,349,773,418,1002
314200,202301,3665,9170,3017,8159,299,792,1912,5056,2211,5848
314210,202301,2413,5763,1871,4832,304,823,646,1526,950,2349
314220,202301,2111,5188,1675,4515,257,816,770,1856,1027,2672
314225,202301,1259,3327,990,2836,104,329,607,1643,711,1972
314230,202301,1090,2586,860,2264,119,354,491,1220,610,1574
314240,202301,1326,3321,1041,2905,224,642,429,1191,653,1833
314250,202301,505,1365,329,997,44,147,124,325,168,472
314260,202301,1352,3179,1073,2822,354,959,348,820,702,1779
314270,202301,4050,9931,3324,8798,88,277,2545,6543,2633,6820
314280,202301,4428,9486,3089,7580,321,908,1836,4161,2157,5069
314290,202301,5666,12772,4806,11371,253,668,3563,8027,3816,8695
314300,202301,2420,6315,1576,4569,337,1057,464,1142,801,2199
314310,202301,4748,11675,3352,9417,877,2808,496,1167,1373,3975
314315,202301,1213,3347,957,2825,60,230,649,1793,709,2023
314320,202301,4159,10040,2893,7780,433,1363,1210,2860,1643,4223
314330,202301,69706,179925,53883,153029,12517,36469,14922,40604,27439,77073
314340,202301,3350,7784,2322,6048,426,1357,908,1893,1334,3250
314345,202301,2006,4827,1623,4184,119,307,1167,2880,1286,3187
314350,202301,1154,2966,764,2241,124,377,161,342,285,719
314360,202301,655,1743,439,1306,69,200,126,323,195,523
314370,202301,929,2113,753,1868,76,206,507,1188,583,1394
314380,202301,1526,3815,1096,3098,248,780,339,888,587,1668
314390,202301,19583,43895,13962,34761,1923,5513,6239,13267,8162,18780
314400,202301,4891,13521,3778,11414,1201,3854,1094,3375,2295,7229
314410,202301,3700,9717,2559,7504,573,1928,534,1377,1107,3305
314420,202301,934,2112,680,1731,26,92,445,1060,471,1152
314430,202301,9922,21325,7141,17054,1001,2509,3487,7799,4488,10308
314435,202301,2269,5521,1766,4751,304,846,919,2333,1223,3179
314437,202301,1092,2465,807,2029,66,183,518,1232,584,1415
314440,202301,733,1965,534,1587,127,438,148,343,275,781
314450,202301,1820,4301,1486,3760,180,516,828,1881,1008,2397
314460,202301,4321,11683,3342,9794,759,2472,1269,3208,2028,5680
314465,202301,2837,7054,2294,6084,49,183,1767,4431,1816,4614
314467,202301,1207,2805,987,2461,106,309,648,1548,754,1857
314470,202301,2854,7308,2369,6440,422,1250,1126,2771,1548,4021
314480,202301,11114,27559,8538,22559,1210,3585,3939,9040,5149,12625
314490,202301,1287,3021,934,2389,77,224,585,1408,662,1632
314500,202301,2341,5154,1688,4305,475,1205,447,1134,922,2339
314505,202301,2866,5629,2345,4944,152,271,1826,3751,1978,4022
314510,202301,2624,6411,1933,5430,574,1869,625,1606,1199,3475
314520,202301,9466,25722,7643,22345,1589,4961,1810,4736,3399,9697
314530,202301,6757,18120,5978,16774,348,1216,4434,11885,4782,13101
314535,202301,3556,7539,2874,6594,161,400,2283,5150,2444,5550
314537,202301,1476,3686,1129,3143,77,197,740,1997,817,2194
314540,202301,523,1194,381,977,18,54,217,501,235,555
314545,202301,2345,4874,2077,4566,65,185,1664,3640,1729,3825
314550,202301,923,2039,607,1523,48,155,321,697,369,852
314560,202301,6106,15881,4681,13071,608,2017,2184,5170,2792,7187
314570,202301,390,1018,286,844,34,113,144,408,178,521
314580,202301,591,1590,470,1353,104,304,154,426,258,730
314585,202301,914,2470,690,2028,60,213,331,888,391,1101
314587,202301,2784,6682,2180,5758,601,1586,1069,2734,1670,4320
314590,202301,5536,13377,4254,11186,492,1468,2128,5078,2620,6546
314600,202301,2227,5725,1448,4301,325,1071,179,468,504,1539
314610,202301,12072,27516,9503,23619,1075,3227,4684,11468,5759,14695
314620,202301,3100,6049,2503,5328,164,273,1962,4248,2126,4521
314625,202301,1974,4394,1675,3989,43,188,1443,3295,1486,3483
314630,202301,6150,13896,4929,12253,192,557,3884,9464,4076,10021
314640,202301,1039,2019,805,1676,31,89,620,1182,651,1271
314650,202301,1043,2289,709,1784,70,208,407,908,477,1116
314655,202301,1800,4500,1278,3629,149,401,686,1932,835,2333
314660,202301,442,846,335,684,10,22,258,489,268,511
314670,202301,1962,3993,1363,3175,31,84,959,2112,990,2196
314675,202301,2063,4716,1746,4229,105,250,1337,3171,1442,3421
314690,202301,2567,6387,1971,5513,511,1481,742,1995,1253,3476
314700,202301,14684,36319,10295,28627,1585,4863,4571,11645,6156,16508
314710,202301,10210,26210,7719,21182,1140,3428,3006,7087,4146,10515
314720,202301,2932,8017,2088,6340,403,1340,425,1050,828,2390
314730,202301,3097,7472,2184,5867,393,1177,748,1698,1141,2875
314740,202301,4040,10175,3201,8776,547,1646,1605,4021,2152,5667
314750,202301,376,898,296,740,28,92,177,376,205,468
314760,202301,2246,6093,1478,4422,218,784,436,950,654,1734
314770,202301,1251,3414,741,2239,124,369,179,486,303,855
314780,202301,444,1023,311,817,32,101,179,432,211,533
314790,202301,14915,36304,10915,29402,1858,5596,4559,11315,6417,16911
314795,202301,1822,4199,1534,3738,66,196,1186,2748,1252,2944
314800,202301,14753,35036,10179,27128,1683,4965,3772,8637,5455,13602
314810,202301,13310,31752,10177,26701,2457,6866,3958,9570,6415,16436
314820,202301,1554,3434,1213,2939,78,236,778,1777,856,2013
314830,202301,2151,5388,1767,4757,164,457,1096,2770,1260,3227
314840,202301,1092,2969,863,2566,85,322,568,1569,653,1891
314850,202301,3369,5704,2794,5019,37,79,2594,4578,2631,4657
314860,202301,4126,10210,3436,9060,145,514,2548,6409,2693,6923
314870,202301,8609,16775,6648,14467,293,619,5066,11116,5359,11735
314875,202301,2211,6005,1934,5615,192,506,1402,4092,1594,4598
314880,202301,951,2149,729,1810,44,131,452,1063,496,1194
314890,202301,631,1753,466,1395,63,218,235,613,298,831
314900,202301,1130,2462,874,2068,103,278,488,1072,591,1350
314910,202301,2047,5375,1532,4551,279,1002,681,1810,960,2812
314915,202301,2551,6723,2060,5902,190,547,1264,3592,1454,4139
314920,202301,709,1589,514,1323,23,68,373,945,396,1013
314930,202301,8025,20165,6318,17116,990,3050,2879,6852,3869,9902
314940,202301,520,1104,423,962,44,109,274,583,318,692
314950,202301,825,1883,562,1478,54,195,308,726,362,921
314960,202301,1179,2518,924,2120,76,170,630,1407,706,1577
314970,202301,1374,3764,1076,3195,190,631,451,1184,641,1815
314980,202301,2598,5928,2118,5260,211,573,1445,3480,1656,4053
314990,202301,3380,9022,2447,7013,399,1191,677,1647,1076,2838
314995,202301,2083,5170,1610,4342,67,232,1029,2565,1096,2797
315000,202301,1323,3074,949,2506,84,253,611,1544,695,1797
315010,202301,496,1214,395,1064,37,128,248,619,285,747
315015,202301,3101,7520,2716,6922,255,803,1919,4638,2174,5441
315020,202301,959,2552,691,2049,58,210,332,880,390,1090
315030,202301,834,1980,586,1561,185,462,138,331,323,793
315040,202301,1228,2875,1032,2581,162,461,662,1537,824,1998
315050,202301,1419,3326,1047,2779,87,269,500,1219,587,1488
315053,202301,1512,3425,1117,2773,130,334,638,1495,768,1829
315057,202301,2208,5637,1746,4890,152,365,1109,3293,1261,3658
315060,202301,872,2365,636,1893,118,383,178,486,296,869
315070,202301,1095,2135,846,1788,75,207,622,1173,697,1380
315080,202301,4058,9613,3073,7884,151,454,2193,5300,2344,5754
315090,202301,1000,2693,765,2292,107,352,348,940,455,1292
315100,202301,1766,4749,1196,3536,150,513,496,1264,646,1777
315110,202301,2785,5897,2051,4854,169,390,1174,2695,1343,3085
315120,202301,15928,33441,11727,27344,1189,2801,6965,15779,8154,18580
315130,202301,2214,5410,1895,4895,196,603,1027,2340,1223,2943
315140,202301,4093,10175,3313,8880,582,1707,1783,4423,2365,6130
315150,202301,5602,13179,4095,10779,669,1978,1879,4662,2548,6640
315160,202301,2452,5345,1735,4264,248,654,973,2261,1221,2915
315170,202301,1751,5130,1237,3950,232,783,347,1037,579,1820
315180,202301,22386,51220,13602,35806,1816,5437,4979,11092,6795,16529
315190,202301,2766,5582,2110,4730,201,439,1561,3502,1762,3941
315200,202301,5803,14298,4414,12082,1255,3737,1513,3651,2768,7388
315210,202301,10809,25942,7741,20077,799,2311,3738,8342,4537,10653
315213,202301,1252,3045,1090,2819,22,83,894,2238,916,2321
315217,202301,3276,8406,2434,7014,91,387,1708,4659,1799,5046
315220,202301,10476,25886,8128,22015,631,1510,4551,12378,5182,13888
315230,202301,3693,7270,3038,6432,174,310,2199,4613,2373,4923
315240,202301,3090,7928,2523,6993,609,1797,1123,2979,1732,4776
315250,202301,18990,46359,14414,38263,2160,6434,6604,15562,8764,21996
315260,202301,1186,2956,735,2088,140,404,138,307,278,711
315270,202301,1212,3116,943,2665,123,421,435,1016,558,1437
315280,202301,4009,9315,2732,7135,708,1956,730,1753,1438,3709
315290,202301,1501,3394,969,2586,206,615,387,935,593,1550
315300,202301,822,1826,609,1525,35,101,432,1043,467,1144
315310,202301,1598,3599,1206,2955,76,250,825,1796,901,2046
315320,202301,776,2078,550,1638,79,248,203,556,282,804
315330,202301,895,2639,547,1786,66,244,225,629,291,873
315340,202301,3451,7880,2397,6322,555,1488,902,2272,1457,3760
315350,202301,2380,5298,2004,4750,141,401,1541,3466,1682,3867
315360,202301,2112,5530,1677,4729,221,656,796,2048,1017,2704
315370,202301,701,1754,578,1546,76,217,262,621,338,838
315380,202301,295,768,207,588,38,106,28,54,66,160
315390,202301,1568,3989,1288,3534,126,429,738,1790,864,2219
315400,202301,5175,12344,4147,10669,499,1413,2421,5821,2920,7234
315410,202301,2908,6021,2077,4829,379,1039,595,1229,974,2268
315415,202301,1824,4605,1475,4054,423,1376,296,678,719,2054
315420,202301,1869,4801,1352,3911,319,1004,349,830,668,1834
315430,202301,4381,9907,3056,7976,499,1450,1446,3546,1945,4996
315440,202301,1271,2958,1000,2563,102,295,613,1440,715,1735
315445,202301,2832,5482,2094,4505,125,261,1627,3451,1752,3712
315450,202301,2683,6585,2180,5793,210,604,1428,3606,1638,4210
315460,202301,59101,140385,50261,126061,4850,14712,33005,75688,37855,90400
315470,202301,817,2106,590,1603,54,160,289,695,343,855
315480,202301,1852,4648,1343,3623,186,542,625,1497,811,2039
315490,202301,3514,8078,2471,6482,382,1104,949,2256,1331,3360
315500,202301,634,1556,400,1091,26,80,230,552,256,632
315510,202301,1703,3684,1397,3261,17,71,1205,2672,1222,2743
315520,202301,1367,3073,1150,2763,42,111,961,2225,1003,2336
315530,202301,991,2197,842,1965,61,194,650,1385,711,1579
315540,202301,2074,4962,1386,3730,116,379,616,1481,732,1860
315550,202301,2251,5682,1576,4481,269,902,498,1352,767,2254
315560,202301,8096,21081,7006,19269,437,1138,5078,13770,5515,14908
315570,202301,3069,7071,2203,5579,305,946,1162,2470,1467,3416
315580,202301,4086,8514,3221,7256,421,1069,1479,3009,1900,4078
315590,202301,1593,3011,1330,2643,41,159,1100,1965,1141,2124
315600,202301,2992,8217,2117,6594,502,1520,837,2744,1339,4264
315610,202301,1196,2751,903,2263,117,378,465,967,582,1345
315620,202301,646,1573,483,1325,35,108,254,693,289,801
315630,202301,1481,3603,1137,2971,170,466,543,1272,713,1738
315640,202301,499,1099,391,966,32,84,255,587,287,671
315645,202301,1186,2860,838,2332,131,390,229,583,360,973
315650,202301,2224,4462,1816,3911,57,146,1486,3084,1543,3230
315660,202301,2482,5935,1880,4889,198,509,1086,2728,1284,3237
315670,202301,20737,49369,16361,41871,2744,7541,8248,19417,10992,26958
315680,202301,3877,9722,2919,8081,386,1176,1516,3942,1902,5118
315690,202301,4741,10859,2944,7876,593,1549,808,2257,1401,3806
315700,202301,10778,26075,8289,21451,752,2207,4781,11256,5533,13463
315710,202301,2181,4762,1548,3862,75,224,1034,2404,1109,2628
315720,202301,5511,13404,4541,11796,216,794,3237,7829,3453,8623
315725,202301,2813,6404,2230,5553,215,508,1463,3771,1678,4279
315727,202301,762,1765,565,1456,65,210,294,680,359,890
315730,202301,736,2016,624,1806,130,396,227,578,357,974
315733,202301,1873,4242,1461,3631,222,593,678,1522,900,2115
315737,202301,1419,3495,1050,2810,32,115,736,1854,768,1969
315740,202301,1041,2640,856,2284,73,239,571,1385,644,1624
315750,202301,1611,3669,1223,3118,92,230,789,2023,881,2253
315760,202301,1526,3035,1261,2694,26,91,1073,2181,1099,2272
315765,202301,2565,5387,2112,4824,25,89,1908,4337,1933,4426
315770,202301,1492,3816,1208,3439,411,1254,303,839,714,2093
315780,202301,39342,96177,33042,85411,2107,6633,21980,52698,24087,59331
315790,202301,4268,11991,3603,10801,329,982,2105,6618,2434,7600
315800,202301,1650,4826,1282,4023,157,593,560,1489,717,2082
315810,202301,1703,3643,1415,3203,56,162,1136,2450,1192,2612
315820,202301,3643,7885,2964,7009,271,620,2096,4902,2367,5522
315830,202301,1535,4184,1046,3132,110,366,297,700,407,1066
315840,202301,1059,2348,773,1898,68,179,403,880,471,1059
315850,202301,1452,3791,1148,3295,165,516,609,1642,774,2158
315860,202301,700,1771,529,1486,102,318,183,413,285,731
315870,202301,551,1388,442,1224,22,71,310,816,332,887
315880,202301,1396,3143,1028,2549,115,342,496,1021,611,1363
315890,202301,2219,5628,1822,5106,543,1684,693,1902,1236,3586
315895,202301,7906,19642,5935,16040,664,2033,2794,6749,3458,8782
315900,202301,1049,2524,881,2304,125,372,506,1235,631,1607
315910,202301,778,1752,676,1612,46,137,539,1250,585,1387
315920,202301,1750,4105,1028,2809,160,555,375,841,535,1396
315930,202301,1426,2859,1002,2295,82,210,576,1233,658,1443
315935,202301,1373,3637,1100,3150,208,609,491,1366,699,1975
315940,202301,749,1813,591,1586,81,245,313,774,394,1019
315950,202301,1560,3755,1318,3389,126,364,983,2503,1109,2867
315960,202301,6683,17288,4653,13313,1079,3331,986,2014,2065,5345
315970,202301,689,1711,558,1540,70,221,363,986,433,1207
315980,202301,5362,10844,3205,7443,562,1394,1574,3235,2136,4629
315990,202301,4263,10061,3352,8546,443,1196,1761,4163,2204,5359
316000,202301,965,2030,762,1750,65,187,488,1025,553,1212
316010,202301,846,2232,647,1877,83,262,273,646,356,908
316020,202301,1134,2867,919,2494,89,295,565,1424,654,1719
316030,202301,3350,8165,2546,6811,372,1030,1490,4008,1862,5038
316040,202301,3279,8829,2299,7034,382,1330,595,1498,977,2828
316045,202301,2807,5704,2579,5424,156,225,2246,4817,2402,5042
316050,202301,511,1229,389,1042,27,80,244,575,271,655
316060,202301,895,1884,653,1570,31,92,473,1071,504,1163
316070,202301,7444,18101,6108,15710,951,2458,3038,7319,3989,9777
316080,202301,983,2722,784,2340,168,561,274,697,442,1258
316090,202301,650,1576,542,1382,47,148,342,770,389,918
316095,202301,1521,4318,1150,3443,252,818,409,1109,661,1927
316100,202301,2997,7783,2209,6202,322,1066,960,2362,1282,3428
316105,202301,857,2057,668,1759,50,127,426,1145,476,1272
316110,202301,18396,42784,15286,37909,924,2832,11397,26672,12321,29504
316120,202301,1506,3774,990,2737,152,482,345,752,497,1234
316130,202301,1586,3261,1064,2445,93,251,628,1309,721,1560
316140,202301,1307,3270,805,2342,142,414,275,755,417,1169
316150,202301,2732,5665,2154,4822,157,446,1274,2600,1431,3046
316160,202301,1218,2904,979,2512,40,143,710,1740,750,1883
316165,202301,1088,2347,863,2042,83,212,568,1270,651,1482
316170,202301,1755,3532,1385,3037,72,223,1032,2059,1104,2282
316180,202301,1965,5058,1382,3967,271,831,414,1008,685,1839
316190,202301,3280,8646,1924,5575,225,707,827,2010,1052,2717
316200,202301,4658,11468,3741,10003,594,1831,1865,4493,2459,6324
316210,202301,6930,18597,5027,14424,1525,4752,505,1218,2030,5970
316220,202301,880,2459,620,1969,124,419,133,402,257,821
316225,202301,1986,4021,1507,3311,54,189,1171,2326,1225,2515
316230,202301,615,1457,480,1242,107,304,241,584,348,888
316240,202301,6979,17742,6062,16156,442,1299,4431,11393,4873,12692
316245,202301,3872,10705,3446,10030,195,850,2534,6885,2729,7735
316250,202301,14194,31213,10923,26043,1935,5004,4597,10378,6532,15382
316255,202301,3589,9294,3092,8503,178,505,2238,6143,2416,6648
316257,202301,1924,3941,1452,3231,139,297,1012,2158,1151,2455
316260,202301,3351,6597,2626,5545,264,514,1733,3582,1997,4096
316265,202301,1316,3254,1036,2795,28,82,743,1908,771,1990
316270,202301,4638,12667,3933,11247,489,1515,2189,5785,2678,7300
316280,202301,3723,9007,3094,7941,384,1045,1719,4213,2103,5258
316290,202301,5020,12086,3885,10048,473,1298,1631,3804,2104,5102
316292,202301,7616,18211,6196,16033,672,1972,4074,9907,4746,11879
316294,202301,1161,3182,885,2727,188,672,262,697,450,1369
316295,202301,4514,11282,3722,10009,293,948,2409,5998,2702,6946
316300,202301,1373,3227,1105,2859,55,163,813,1995,868,2158
316310,202301,975,2443,689,1956,142,469,214,546,356,1015
316320,202301,817,2120,629,1838,119,381,130,332,249,713
316330,202301,1269,2944,983,2493,55,159,744,1822,799,1981
316340,202301,1282,3027,1004,2568,74,264,667,1551,741,1815
316350,202301,1768,4146,1508,3730,161,417,1075,2548,1236,2965
316360,202301,788,1891,665,1708,68,164,497,1311,565,1475
316370,202301,7463,17057,5783,14348,622,1941,3180,6734,3802,8675
316380,202301,2158,4526,1733,3960,96,194,1274,2856,1370,3050
316390,202301,918,2306,688,1927,250,805,148,346,398,1151
316400,202301,1500,3916,966,2894,106,348,344,877,450,1225
316410,202301,1529,3449,1282,3082,37,120,1076,2476,1113,2596
316420,202301,2336,5658,1958,5125,31,125,1581,3966,1612,4091
316430,202301,1114,2684,786,2132,121,381,319,751,440,1132
316440,202301,1045,2992,851,2674,152,547,237,668,389,1215
316443,202301,698,1777,493,1395,101,338,167,424,268,762
316447,202301,2733,5966,2343,5407,34,99,2071,4652,2105,4751
316450,202301,2580,6791,1949,5597,230,702,1149,3171,1379,3873
316460,202301,1676,4026,1389,3586,128,368,880,2104,1008,2472
316470,202301,9277,23935,7038,19695,945,3035,3177,7743,4122,10778
316480,202301,272,637,229,583,33,94,133,309,166,403
316490,202301,412,1076,296,861,52,184,94,222,146,406
316500,202301,1618,4534,1135,3450,195,618,324,857,519,1475
316510,202301,971,2847,797,2530,134,418,374,1177,508,1595
316520,202301,1701,3789,1283,3090,201,543,531,1083,732,1626
316530,202301,1414,3240,1070,2665,94,336,639,1367,733,1703
316540,202301,1326,2992,1058,2632,182,515,496,1102,678,1617
316550,202301,1811,4403,1530,3943,56,188,1268,3172,1324,3360
316553,202301,6073,15937,4534,12605,577,1816,2106,4975,2683,6791
316555,202301,3334,8625,2889,8063,88,331,2429,6660,2517,6991
316556,202301,683,1465,515,1193,40,106,296,575,336,681
316557,202301,1524,4115,1320,3806,436,1407,531,1403,967,2810
316560,202301,499,1392,360,1128,59,215,123,337,182,552
316570,202301,1756,4488,1466,3996,367,911,468,1389,835,2300
316580,202301,490,982,337,752,34,83,177,362,211,445
316590,202301,1594,3639,1100,2751,143,331,632,1480,775,1811
316600,202301,1211,3117,1050,2828,145,440,651,1620,796,2060
316610,202301,759,2003,608,1759,60,197,371,1009,431,1206
316620,202301,2785,6203,2434,5709,172,373,1924,4452,2096,4825
316630,202301,1883,5139,1588,4609,436,1217,610,2020,1046,3237
316640,202301,207,519,164,447,33,102,66,154,99,256
316650,202301,1384,3488,1126,3106,80,225,760,2009,840,2234
316660,202301,219,504,109,288,11,31,39,84,50,115
316670,202301,1988,4620,1496,3891,392,1058,471,1095,863,2153
316680,202301,2875,6760,2171,5489,176,496,1450,3511,1626,4007
316690,202301,1644,4359,1200,3553,212,676,223,491,435,1167
316695,202301,1145,3081,926,2707,23,88,617,1728,640,1816
316700,202301,628,1075,537,976,15,30,481,842,496,872
316710,202301,4373,11886,3531,10303,403,1419,2038,5359,2441,6778
316720,202301,28670,70057,22603,59362,3269,9478,11619,27696,14888,37174
316730,202301,666,1444,534,1241,55,142,311,637,366,779
316740,202301,1083,2660,956,2486,158,449,636,1622,794,2071
316750,202301,495,1267,369,1058,67,213,162,415,229,628
316760,202301,4956,13733,4228,12449,1382,4607,1606,4533,2988,9140
316770,202301,1921,3879,1436,3251,48,129,1125,2545,1173,2674
316780,202301,747,1990,612,1758,208,678,128,259,336,937
316790,202301,872,2146,646,1735,107,308,176,447,283,755
316800,202301,8260,20682,6610,17954,874,2564,3358,8589,4232,11153
316805,202301,1504,2685,1231,2376,31,82,1061,1981,1092,2063
316810,202301,932,2266,718,1901,81,234,499,1292,580,1526
316820,202301,486,953,299,668,17,59,197,381,214,440
316830,202301,1128,2578,870,2173,96,245,534,1274,630,1519
316840,202301,3719,8231,3023,7190,162,485,2342,5286,2504,5771
316850,202301,2838,6240,2175,5194,179,520,1416,3048,1595,3568
316860,202301,29355,64951,22691,55327,2888,8453,12352,27712,15240,36165
316870,202301,11171,26679,8570,22099,953,2889,4682,10656,5635,13545
316880,202301,1428,3295,1214,3016,143,426,762,1732,905,2158
316890,202301,1414,3013,900,2358,111,365,556,1337,667,1702
316900,202301,3278,7767,2638,6672,414,1143,1253,2783,1667,3926
316905,202301,596,1632,485,1426,223,664,111,346,334,1010
316910,202301,1280,3073,897,2464,218,644,227,564,445,1208
316920,202301,2449,5038,1868,4221,185,547,1315,2660,1500,3207
316930,202301,12006,30238,9584,26273,1848,5616,3996,9745,5844,15361
316935,202301,5475,13056,4123,10701,675,1976,1921,4427,2596,6403
316940,202301,7651,20401,6137,17576,1005,3146,2747,6974,3752,10120
316950,202301,2513,4992,1953,4266,76,154,1650,3529,1726,3683
316960,202301,6662,13210,4888,10939,388,961,3480,7535,3868,8496
316970,202301,5226,12624,4426,11332,566,1626,2336,5351,2902,6977
316980,202301,1086,2780,842,2401,232,738,331,861,563,1599
316990,202301,16395,39676,12482,32426,2907,8051,2931,6468,5838,14519
317000,202301,3220,7924,2829,7428,187,413,2236,5902,2423,6315
317005,202301,3222,8162,2531,6856,390,1189,1316,3304,1706,4493
317010,202301,37010,80695,26610,65285,3956,10865,14492,33334,18448,44199
317020,202301,94172,208859,61623,154840,11378,31329,22480,49847,33858,81176
317030,202301,823,2002,659,1772,16,59,491,1277,507,1336
317040,202301,14437,33703,10041,26583,2368,6764,2772,7354,5140,14118
317043,202301,1137,2215,847,1844,37,86,681,1443,718,1529
317047,202301,1400,2972,984,2330,47,137,697,1554,744,1691
317050,202301,1491,4345,1074,3400,165,592,379,956,544,1548
317052,202301,3086,7195,2464,6275,215,605,1680,4053,1895,4658
317057,202301,2782,5169,2165,4303,33,101,1788,3311,1821,3412
317060,202301,598,1508,369,1049,54,173,143,356,197,529
317065,202301,1350,3542,1116,3107,77,263,710,1777,787,2040
317070,202301,10206,26365,8196,22746,1210,3940,3929,9687,5139,13627
317075,202301,1390,3127,1093,2673,140,363,661,1484,801,1847
317080,202301,8328,17727,6359,14691,1143,2815,3138,6913,4281,9728
317090,202301,5793,14658,5048,13525,375,918,3685,9825,4060,10743
317100,202301,3218,7140,2211,5575,424,1143,963,2239,1387,3382
317103,202301,3093,6428,2636,5814,145,419,2155,4499,2300,4918
317107,202301,1851,4245,1389,3435,51,163,940,1992,991,2155
317110,202301,834,1823,481,1277,79,235,185,463,264,698
317115,202301,1359,3519,1122,3110,138,404,652,1774,790,2178
317120,202301,24515,57080,20232,50561,1391,4305,13519,31087,14910,35392
317130,202301,14400,31011,10252,24407,1385,3643,4089,9351,5474,12994
317140,202301,1182,2569,897,2136,72,177,618,1434,690,1611
317150,202301,1311,2663,1011,2277,30,101,869,1870,899,1971
317160,202301,4180,9345,2722,7040,282,680,1338,3661,1620,4341
317170,202301,2543,5765,1984,4811,90,277,1345,2881,1435,3158
317180,202301,2272,6491,1674,5180,315,1021,361,1029,676,2050
317190,202301,1326,3336,985,2784,183,560,452,1188,635,1748
317200,202301,8051,19683,6008,15876,1307,3602,1464,3376,2771,6978
317210,202301,1518,3199,1178,2759,43,149,845,1933,888,2082
317220,202301,405,1032,356,953,64,196,209,502,273,698
320010,202301,5926,16127,4526,13339,711,2305,2145,6027,2856,8332
320013,202301,2598,6463,1849,5075,309,910,839,2295,1148,3205
320016,202301,3533,8375,2724,7153,214,597,1799,4601,2013,5198
320020,202301,6176,14000,4784,11706,655,1912,2609,5916,3264,7828
320030,202301,2196,5521,1452,4067,195,623,656,1614,851,2237
320035,202301,2414,5806,2010,5170,336,1007,1175,2868,1511,3875
320040,202301,5678,14387,4746,12825,642,1853,2596,6549,3238,8402
320050,202301,2357,4799,2035,4356,209,596,1370,2643,1579,3239
320060,202301,18508,46068,13933,37484,2364,6815,6185,15074,8549,21889
320070,202301,2463,5821,1890,4807,205,677,1053,2302,1258,2979
320080,202301,7079,16529,5071,12801,852,2309,2165,4902,3017,7211
320090,202301,10460,25976,7151,19609,1468,4434,2533,6092,4001,10526
320100,202301,4299,9959,3536,8724,450,1260,2166,5040,2616,6300
320110,202301,2996,6140,2218,5020,255,690,1389,2805,1644,3495
320115,202301,2729,7808,2338,7185,743,2353,907,2893,1650,5246
320120,202301,33720,77327,24898,62603,3240,8968,12612,28714,15852,37682
320130,202301,75136,177834,62377,156835,7591,20953,38047,89780,45638,110733
320140,202301,5206,12731,3872,10244,541,1683,1921,4564,2462,6247
320150,202301,18171,43123,13325,34769,3075,9098,2316,4673,5391,13771
320160,202301,8209,20359,6173,16832,792,2409,3123,8010,3915,10419
320170,202301,2288,5890,1643,4693,420,1229,535,1582,955,2811
320180,202301,919,2684,719,2289,215,766,157,436,372,1202
320190,202301,3933,11291,2942,9233,603,2142,593,1591,1196,3733
320200,202301,1651,4183,1131,3243,224,701,304,852,528,1553
320210,202301,5861,13464,4571,11375,705,1921,2500,5719,3205,7640
320220,202301,4627,10608,3511,8854,706,1858,1519,3554,2225,5412
320225,202301,1916,5384,1314,4074,359,1248,289,850,648,2098
320230,202301,7106,17134,5397,14406,1278,3607,1493,4077,2771,7684
320240,202301,22632,52551,17184,44330,4273,12104,5197,12518,9470,24622
320245,202301,4096,11162,3004,8874,801,2543,402,1060,1203,3603
320250,202301,3597,8549,2495,6278,379,1048,1205,2586,1584,3634
320255,202301,2708,7255,2341,6630,375,1153,1522,4274,1897,5427
320260,202301,1800,4707,1185,3478,277,845,299,733,576,1578
320265,202301,2878,8223,2159,6792,803,2755,270,759,1073,3514
320270,202301,2835,7214,2142,5949,535,1694,662,1716,1197,3410
320280,202301,11015,25126,9118,22164,1027,2988,6110,13757,7137,16745
320290,202301,1643,4569,1086,3333,279,950,283,787,562,1737
320300,202301,5608,14881,4520,12899,1185,3769,1507,4060,2692,7829
320305,202301,6784,17138,5183,14261,924,2856,2418,6168,3342,9024
320310,202301,2623,6524,1909,5103,332,983,853,1984,1185,2967
320313,202301,3170,7156,2183,5426,412,1145,811,1671,1223,2816
320316,202301,1920,5036,1484,4324,220,643,797,2331,1017,2974
320320,202301,27868,68076,20717,56498,4908,14184,6987,18417,11895,32601
320330,202301,3713,8988,2919,7700,456,1234,1628,4266,2084,5500
320332,202301,10948,25932,8890,22552,1607,4484,4744,11280,6351,15764
320334,202301,2431,6293,1707,4932,299,1032,408,896,707,1928
320335,202301,2319,6130,1563,4520,305,1023,467,1193,772,2216
320340,202301,7223,15074,6079,13496,441,1123,4280,9186,4721,10309
320350,202301,6738,14792,4765,11508,503,1379,2651,5770,3154,7149
320360,202301,1713,4040,1224,3162,132,371,595,1399,727,1770
320370,202301,3650,9930,2859,8326,770,2553,1025,2701,1795,5254
320380,202301,3913,8599,3292,7609,247,764,2393,5054,2640,5818
320390,202301,10195,24388,7649,19636,1504,4101,3091,7227,4595,11328
320400,202301,4113,10746,3084,8676,815,2544,1120,2874,1935,5418
320405,202301,6769,15700,5164,13100,723,1966,2782,6651,3505,8617
320410,202301,5999,14379,4553,12163,776,2098,2201,5854,2977,7952
320420,202301,5334,11942,4141,10151,888,2337,1680,3845,2568,6182
320425,202301,2730,5800,2102,4840,144,360,1444,3093,1588,3453
320430,202301,3938,9159,3156,7888,432,1144,1910,4538,2342,5682
320435,202301,3028,8597,2441,7434,767,2568,802,2457,1569,5025
320440,202301,1917,4836,1448,3981,242,738,638,1531,880,2269
320450,202301,2766,6668,2238,5765,319,1042,1307,2955,1626,3997
320455,202301,5628,15878,3923,12113,867,3019,909,2322,1776,5341
320460,202301,2692,7409,2002,6053,557,1893,545,1447,1102,3340
320465,202301,1999,5141,1445,4124,343,1083,569,1583,912,2666
320470,202301,5427,13094,4090,10652,736,2173,1445,3253,2181,5426
320480,202301,3103,6679,2534,5789,270,642,1754,3812,2024,4454
320490,202301,33704,76657,25334,63061,4529,11474,11192,27187,15721,38661
320495,202301,1799,4491,1314,3594,298,940,234,470,532,1410
320500,202301,87802,204985,71554,178745,8245,23393,44172,101958,52417,125351
320501,202301,6309,16451,4649,13510,1276,4060,1141,3103,2417,7163
320503,202301,3248,8544,2252,6592,616,1990,595,1555,1211,3545
320506,202301,3461,9410,2641,7747,723,2361,585,1396,1308,3757
320510,202301,15823,37573,12651,32427,1772,4703,6910,16918,8682,21621
320515,202301,2292,5812,1699,4644,477,1398,520,1319,997,2717
320517,202301,2824,7556,2289,6527,639,1986,866,2354,1505,4340
320520,202301,61459,140344,48735,120168,6992,19200,24359,55516,31351,74716
320530,202301,46940,107273,37992,92936,2713,8279,25449,56589,28162,64868
330010,202301,36995,81394,31216,72635,2345,6322,23179,51139,25524,57461
330015,202301,2276,4741,1791,4015,220,622,1141,2316,1361,2938
330020,202301,30497,65505,26010,59212,2692,6993,18945,41393,21637,48386
330022,202301,2564,6334,1981,5411,376,1083,846,2235,1222,3318
330023,202301,9552,20074,7713,17385,1026,2603,4953,10418,5979,13021
330025,202301,10134,20594,7077,15887,1112,2773,3327,6682,4439,9455
330030,202301,15662,34997,12470,30178,912,2780,8704,19306,9616,22086
330040,202301,24887,55550,20987,49506,908,2806,16153,35486,17061,38292
330045,202301,148174,278661,127362,253517,5367,12113,109132,210829,114499,222942
330050,202301,4694,10438,3812,9101,573,1711,2387,4998,2960,6709
330060,202301,7917,17845,6151,15005,1103,3098,2562,5571,3665,8669
330070,202301,43217,90596,36617,81748,4333,10470,24837,53795,29170,64265
330080,202301,14559,29867,12447,27068,1511,3377,8569,18272,10080,21649
330090,202301,4566,8451,3376,6907,301,525,2290,4743,2591,5268
330093,202301,4066,8383,3136,7157,187,494,2515,5532,2702,6026
330095,202301,1947,4735,1547,4070,158,479,913,2185,1071,2664
330100,202301,106951,232738,94138,215419,4142,11747,76294,168279,80436,180026
330110,202301,3282,7631,2718,6745,273,815,1868,4284,2141,5099
330115,202301,3745,8001,2725,6465,423,1162,1566,3347,1989,4509
330120,202301,4841,9159,3784,7888,170,453,3024,5938,3194,6391
330130,202301,7469,17330,6251,15599,821,2138,3993,9609,4814,11747
330140,202301,6071,12004,5094,10754,186,578,4327,8657,4513,9235
330150,202301,3510,8009,2828,6980,458,1260,1577,3659,2035,4919
330160,202301,2183,5044,1736,4316,290,849,1012,2221,1302,3070
330170,202301,225230,433757,194358,394497,20746,45051,145825,287173,166571,332224
330180,202301,3091,6043,2554,5335,100,294,2074,4079,2174,4373
330185,202301,17241,33657,14840,30613,487,1386,12885,25499,13372,26885
330187,202301,8114,16933,6437,14420,763,2027,4269,8766,5032,10793
330190,202301,66622,128859,58333,118053,2462,6070,48861,95072,51323,101142
330200,202301,27597,57468,23105,51987,2821,6620,16608,36636,19429,43256
330205,202301,2986,6630,2295,5552,150,435,1566,3474,1716,3909
330210,202301,4400,9567,3311,7874,413,1087,1916,4149,2329,5236
330220,202301,20229,43177,15450,35828,2293,6129,7996,16404,10289,22533
330225,202301,6073,13345,4801,11532,348,963,3314,7548,3662,8511
330227,202301,29201,57632,25727,53517,545,1542,23237,46888,23782,48430
330230,202301,2468,5197,1680,4146,148,397,785,1903,933,2300
330240,202301,39900,86491,34252,78269,2844,7567,25296,54919,28140,62486
330245,202301,2192,4982,1388,3628,274,767,588,1350,862,2117
330250,202301,67545,137934,58174,125234,6195,14500,42630,88677,48825,103177
330260,202301,9110,18217,7431,16054,399,1035,5962,12348,6361,13383
330270,202301,47084,99832,31165,74774,3785,10182,16327,35781,20112,45963
330280,202301,3929,8323,3152,7146,182,537,2240,4623,2422,5160
330285,202301,44550,85184,37494,75753,1395,3743,31594,60479,32989,64222
330290,202301,6798,12979,5609,11481,301,876,4619,8819,4920,9695
330300,202301,8302,16563,6242,13789,436,1089,4651,9748,5087,10837
330310,202301,3831,7869,2936,6550,136,365,2211,4649,2347,5014
330320,202301,26545,52660,21467,46491,2344,4752,16060,34162,18404,38914
330330,202301,74572,141357,61944,125260,4286,9658,48784,94605,53070,104263
330340,202301,27769,57878,21525,48839,2734,7490,12750,25901,15484,33391
330350,202301,246870,460505,212885,420663,8012,17745,187847,362199,195859,379944
330360,202301,11018,21953,9656,20347,355,732,8498,17592,8853,18324
330370,202301,8016,18976,6466,16549,1123,3246,3339,7978,4462,11224
330380,202301,10306,22174,8460,19196,599,1751,6286,13200,6885,14951
330385,202301,6122,14403,5037,12861,799,2328,2749,6592,3548,8920
330390,202301,51178,111770,40634,94917,3717,10775,27781,58980,31498,69755
330395,202301,4954,10228,4145,9244,145,445,3334,7042,3479,7487
330400,202301,5059,11395,4271,10199,202,667,3293,7247,3495,7914
330410,202301,4730,10257,3622,8524,427,1277,2472,5245,2899,6522
330411,202301,3912,9440,3188,8247,186,619,2201,5244,2387,5863
330412,202301,2404,5616,2008,5023,154,464,1415,3270,1569,3734
330414,202301,35835,76753,30091,69180,1897,5001,23498,52073,25395,57074
330415,202301,6311,15094,4734,12493,440,1276,2791,6927,3231,8203
330420,202301,18110,40135,13840,33589,1385,3946,8328,18320,9713,22266
330430,202301,16107,30365,13862,27471,484,1195,11751,22297,12235,23492
330440,202301,4111,9242,3198,7781,308,926,2212,4913,2520,5839
330450,202301,2026,4864,1636,4256,128,376,1032,2497,1160,2873
330452,202301,29711,63819,24776,56754,2034,5775,18429,39536,20463,45311
330455,202301,1053240,2026282,891488,1811987,85212,188605,662188,1294281,747400,1482886
330460,202301,1706,3998,1343,3491,212,585,722,1817,934,2402
330470,202301,8130,17308,6095,14423,1317,3495,2523,5543,3840,9038
330475,202301,13493,29343,11043,26256,1408,3849,7425,16917,8833,20766
330480,202301,7959,17914,6802,16281,555,1434,4768,10758,5323,12192
330490,202301,170379,338013,143299,303267,11796,26784,108960,223191,120756,249975
330500,202301,11867,24954,10082,22654,591,1529,7897,17118,8488,18647
330510,202301,70914,147665,57686,130189,5155,13148,43164,93033,48319,106181
330513,202301,1799,3984,1461,3542,207,560,869,2040,1076,2600
330515,202301,4052,9278,3316,8271,444,1295,1873,4262,2317,5557
330520,202301,20942,45370,17870,41020,1538,4219,12838,27791,14376,32010
330530,202301,2265,4905,1639,3989,291,773,784,1846,1075,2619
330540,202301,4317,9904,3397,8427,707,1861,1621,3765,2328,5626
330550,202301,23686,46905,18257,39464,2335,5796,11935,24076,14270,29872
330555,202301,31132,53660,26646,48471,972,2040,22868,40883,23840,42923
330560,202301,5527,12330,4534,10832,629,1556,2936,6691,3565,8247
330570,202301,4405,9792,3890,9106,524,1445,2734,6171,3258,7616
330575,202301,9173,19200,8080,17436,306,863,6833,13878,7139,14741
330580,202301,33097,72645,27995,64410,3777,9349,17527,37207,21304,46556
330590,202301,2236,4888,1879,4451,233,539,1238,2948,1471,3487
330600,202301,18856,41320,15805,36738,849,2520,11630,25144,12479,27664
330610,202301,14226,31145,11838,27587,1035,2839,8294,18120,9329,20959
330615,202301,2998,6855,2485,6196,435,968,1594,4101,2029,5069
330620,202301,6270,14941,5147,13182,761,2239,2994,7064,3755,9303
330630,202301,44048,92814,34866,78847,1425,4386,26807,56478,28232,60864
350010,202301,2997,7237,1895,5082,338,984,495,1019,833,2003
350020,202301,880,2134,545,1515,77,230,191,461,268,691
350030,202301,4847,12012,3833,10356,780,2398,1896,4645,2676,7043
350040,202301,969,2582,607,1840,86,315,187,433,273,748
350050,202301,1942,4406,1355,3467,207,627,484,961,691,1588
350055,202301,1223,2737,978,2377,135,381,570,1226,705,1607
350060,202301,408,900,223,543,41,105,91,197,132,302
350070,202301,4655,11153,3309,8794,467,1386,1462,3349,1929,4735
350075,202301,873,2279,662,1902,208,598,122,356,330,954
350080,202301,849,2067,578,1562,48,155,304,705,352,860
350090,202301,819,1636,545,1244,73,204,333,675,406,879
350100,202301,3436,7943,2530,6503,154,531,1685,3904,1839,4435
350110,202301,646,1397,489,1139,17,48,355,778,372,826
350115,202301,1473,3984,1217,3500,196,637,584,1491,780,2128
350120,202301,822,1813,493,1269,43,129,267,630,310,759
350130,202301,4431,10529,3559,9027,426,1241,2060,4572,2486,5813
350140,202301,884,2240,638,1807,47,170,364,917,411,1087
350150,202301,581,1643,475,1444,91,309,158,402,249,711
350160,202301,16464,38591,12047,30665,1607,4550,7016,16400,8623,20950
350170,202301,3701,9150,3147,8032,481,1321,1740,4006,2221,5327
350180,202301,1273,2834,804,2041,97,266,433,992,530,1258
350190,202301,4900,12529,3688,9879,450,1503,2092,4685,2542,6188
350200,202301,707,1639,545,1365,39,105,342,776,381,881
350210,202301,8679,18055,6282,14399,453,1315,4445,9349,4898,10664
350220,202301,4065,10194,2962,8180,508,1519,1269,3061,1777,4580
350230,202301,1415,3217,1140,2855,151,457,667,1562,818,2019
350240,202301,750,1975,470,1351,76,219,130,306,206,525
350250,202301,4628,11471,3575,9827,915,2625,1109,2906,2024,5531
350260,202301,1095,2328,708,1714,83,227,417,901,500,1128
350270,202301,5740,13655,4655,11746,581,1652,2722,6245,3303,7897
350275,202301,3856,8987,3240,8116,219,718,2459,5764,2678,6482
350280,202301,24989,53213,16917,40636,2308,6039,8720,19010,11028,25049
350290,202301,4573,11490,3352,9159,557,1708,1497,3559,2054,5267
350300,202301,907,2077,715,1752,84,235,466,1032,550,1267
350310,202301,1249,3170,969,2668,140,451,463,1124,603,1575
350315,202301,772,1729,555,1407,27,100,335,728,362,828
350320,202301,22446,53051,17532,44734,2857,8265,8717,19832,11574,28097
350330,202301,18430,41282,13983,33448,1199,3330,9497,20875,10696,24205
350335,202301,458,1197,336,962,35,107,149,409,184,516
350340,202301,1743,4192,1103,2996,154,481,503,1193,657,1674
350350,202301,923,2103,731,1896,121,308,431,1119,552,1427
350360,202301,1536,3996,1266,3484,220,639,546,1416,766,2055
350370,202301,920,2065,679,1645,187,439,252,556,439,995
350380,202301,6197,15856,4623,12679,1001,2886,1625,4060,2626,6946
350390,202301,15108,35425,11946,30390,1492,4211,7251,16980,8743,21191
350395,202301,530,1244,276,782,28,85,97,236,125,321
350400,202301,11295,25805,8191,20785,2027,5579,2536,5962,4563,11541
350410,202301,14425,36668,11107,30725,2062,6296,4610,11652,6672,17948
350420,202301,1467,3476,1047,2729,183,480,376,820,559,1300
350430,202301,839,2007,667,1754,98,320,362,827,460,1147
350440,202301,2798,6173,2237,5333,129,395,1543,3358,1672,3753
350450,202301,9471,23664,7553,20480,1462,4520,3607,8752,5069,13272
350460,202301,2914,6894,1913,5087,285,834,887,2077,1172,2911
350470,202301,325,731,253,625,8,21,188,442,196,463
350480,202301,1208,2856,808,2170,182,557,183,421,365,978
350490,202301,2582,5893,1917,4904,298,882,939,2050,1237,2932
350500,202301,778,1939,556,1555,73,215,217,563,290,778
350510,202301,1559,3557,1204,2965,113,303,740,1671,853,1974
350520,202301,3114,8354,2483,7250,351,1126,1162,3058,1513,4184
350530,202301,4136,9545,3195,7838,250,731,1996,4406,2246,5137
350535,202301,1922,4629,1611,4203,228,657,1014,2507,1242,3164
350540,202301,2611,5211,2015,4397,208,572,1456,2873,1664,3445
350550,202301,12400,27964,8971,22421,838,2517,5408,12080,6246,14597
350560,202301,6038,13708,5108,12308,237,762,3975,8958,4212,9720
350570,202301,40987,101060,33963,88956,5214,15082,18461,44709,23675,59791
350580,202301,2858,6956,1895,5176,528,1629,546,1122,1074,2751
350590,202301,6781,16587,5194,13293,618,1814,3188,7372,3806,9186
350600,202301,43929,96604,29105,72080,4280,12198,13912,30443,18192,42641
350610,202301,9440,23262,7121,18938,807,2497,4139,9953,4946,12450
350620,202301,508,1234,341,975,38,119,191,504,229,623
350630,202301,2311,4883,1703,3911,105,313,1223,2540,1328,2853
350635,202301,14955,31916,11695,27097,1203,3117,8133,17696,9336,20813
350640,202301,1160,2903,646,1838,97,281,197,465,294,746
350650,202301,11343,27985,8476,22678,1415,4179,3694,8790,5109,12969
350660,202301,6572,14962,5200,12868,593,1469,3296,7887,3889,9356
350670,202301,2359,5835,1780,4855,290,843,900,2348,1190,3191
350680,202301,1471,3611,1009,2794,153,445,435,1066,588,1511
350690,202301,1879,4502,1411,3720,240,689,731,1810,971,2499
350700,202301,6772,15402,5304,13200,1027,3002,2897,6487,3924,9489
350710,202301,4072,9593,3436,8590,587,1711,1886,4264,2473,5975
350715,202301,921,2449,774,2194,161,536,367,881,528,1417
350720,202301,208,484,151,400,20,64,49,103,69,167
350730,202301,801,2139,615,1789,52,176,339,865,391,1041
350740,202301,2096,5105,1448,3830,239,687,499,1163,738,1850
350745,202301,785,1898,478,1328,40,136,227,568,267,704
350750,202301,15317,36280,12413,31628,2002,5943,6270,14263,8272,20206
350760,202301,24211,52606,18707,43720,2340,6692,11381,23309,13721,30001
350770,202301,1346,3005,890,2250,87,245,546,1268,633,1513
350775,202301,915,1927,619,1492,85,208,334,749,419,957
350780,202301,3045,6810,2254,5758,574,1359,858,2385,1432,3744
350790,202301,2737,6817,1781,5112,384,1107,441,1030,825,2137
350800,202301,4551,11503,3905,10465,379,1203,2579,6411,2958,7614
350810,202301,3759,8216,2815,6849,637,1627,1267,2857,1904,4484
350820,202301,1192,2562,750,1789,54,155,465,994,519,1149
350830,202301,1082,2676,648,1798,106,329,224,476,330,805
350840,202301,4701,12621,3687,10806,684,2244,1643,4292,2327,6536
350850,202301,11027,27225,8773,23396,1388,4079,4814,11855,6202,15934
350860,202301,5205,11920,4523,11014,416,1112,3171,7531,3587,8643
350870,202301,3549,8775,2608,7327,408,1204,1327,3550,1735,4754
350880,202301,2084,5140,1746,4530,429,1184,715,1606,1144,2790
350890,202301,647,1569,432,1153,70,192,135,305,205,497
350900,202301,12800,30524,9542,24285,1346,3890,5301,11989,6647,15879
350910,202301,1225,2596,1028,2321,92,220,774,1698,866,1918
350920,202301,16936,38095,14343,34092,633,1854,11360,25590,11993,27444
350925,202301,5694,13644,4251,11299,673,2038,2281,5319,2954,7357
350930,202301,1851,4501,1287,3455,97,287,688,1753,785,2040
350940,202301,3548,7995,2876,6965,233,679,2114,4731,2347,5410
350945,202301,1231,3100,909,2490,163,446,376,926,539,1372
350950,202301,131005,302394,103335,253758,12380,33691,63564,144719,75944,178410
350960,202301,9429,22799,7406,19109,1087,3182,3808,8871,4895,12053
350970,202301,5089,12961,3825,10711,968,3096,1259,2727,2227,5823
350980,202301,997,2277,827,2000,126,355,512,1116,638,1471
350990,202301,2753,6497,2174,5610,481,1455,1039,2391,1520,3846
350995,202301,1111,3042,1015,2870,70,262,701,1848,771,2110
351000,202301,3979,9971,2601,7264,542,1585,772,2023,1314,3608
351010,202301,505,1189,319,850,45,146,158,387,203,533
351015,202301,1275,3436,1057,3018,196,613,451,1094,647,1707
351020,202301,10860,26212,8375,22012,1513,4342,4305,10218,5818,14560
351030,202301,4009,10562,3235,9109,521,1681,1665,4330,2186,6011
351040,202301,7589,16110,6370,14326,237,667,5228,11180,5465,11847
351050,202301,23532,53055,18310,45449,2947,8021,10112,23542,13059,31563
351060,202301,66573,150907,52008,127314,4423,12516,35981,83057,40404,95573
351070,202301,1877,4359,1144,3151,288,867,226,523,514,1390
351080,202301,3708,8064,2826,7010,345,998,1796,4148,2141,5146
351090,202301,428,1077,328,907,63,173,123,323,186,496
351100,202301,3743,9181,2462,6684,465,1404,855,2132,1320,3536
351110,202301,7496,18191,5517,14693,850,2593,2896,7027,3746,9620
351120,202301,941,2254,654,1730,112,313,231,533,343,846
351130,202301,1433,3725,679,2010,117,374,159,379,276,753
351140,202301,2962,7448,2292,6284,465,1429,960,2284,1425,3713
351150,202301,3815,9784,2755,7735,413,1329,1075,2644,1488,3973
351160,202301,1781,5013,1279,3930,243,808,267,676,510,1484
351170,202301,2136,5081,1853,4610,139,441,1318,2988,1457,3429
351190,202301,1257,3265,883,2548,204,605,251,673,455,1278
351200,202301,2015,4589,1502,3842,150,428,966,2285,1116,2713
351210,202301,1967,4404,1325,3341,83,263,818,1855,901,2118
351220,202301,4981,11710,4289,10654,463,1108,2829,6799,3292,7907
351230,202301,2908,6768,2270,5740,410,1162,1046,2274,1456,3436
351240,202301,2947,7227,1910,5182,484,1322,450,1040,934,2362
351250,202301,1299,3293,780,2231,102,296,266,700,368,996
351260,202301,1052,2437,739,1899,148,375,284,676,432,1051
351270,202301,669,1684,482,1327,50,145,232,513,282,658
351280,202301,5135,12597,3941,10470,882,2445,1547,3729,2429,6174
351290,202301,1923,4191,1315,3188,117,329,930,2122,1047,2451
351300,202301,29488,71643,22189,58758,3899,11282,10790,26213,14689,37495
351310,202301,4942,10866,3867,9170,172,548,2893,6398,3065,6946
351320,202301,1010,2746,718,2185,117,374,196,512,313,886
351330,202301,456,1075,331,840,21,68,199,415,220,483
351340,202301,10797,24313,9153,21561,1507,4251,5796,12009,7303,16260
351350,202301,17761,39829,14818,35111,1044,2990,11360,25219,12404,28209
351360,202301,5226,12091,4322,10827,748,2193,2285,5116,3033,7309
351370,202301,2589,6708,1732,4996,396,1229,396,917,792,2146
351380,202301,62840,137228,46255,110476,4655,12395,29727,66337,34382,78732
351385,202301,469,1170,213,626,30,84,90,249,120,333
351390,202301,1825,4031,1295,3306,63,199,1043,2564,1106,2763
351400,202301,1501,3745,1222,3228,193,492,632,1589,825,2081
351410,202301,3449,8650,2622,7155,450,1329,1158,2895,1608,4224
351420,202301,628,1409,395,1033,46,124,237,559,283,683
351430,202301,1348,3094,1122,2748,72,204,842,1947,914,2151
351440,202301,4652,11187,3230,8495,553,1550,1017,2209,1570,3759
351450,202301,2166,5290,1508,4152,298,991,424,878,722,1869
351460,202301,1311,3069,1084,2731,155,415,665,1591,820,2006
351470,202301,1570,3664,1235,3124,80,237,802,1892,882,2129
351480,202301,3202,8158,2562,7186,405,1347,1297,3239,1702,4586
351490,202301,2931,7289,2549,6635,79,296,2028,5057,2107,5353
351492,202301,461,1071,394,949,8,26,313,712,321,738
351495,202301,287,701,233,605,26,56,132,327,158,383
351500,202301,58865,126328,46591,107548,5619,14509,31160,66876,36779,81385
351510,202301,18076,38977,13725,32113,1460,3845,9008,19798,10468,23643
351512,202301,593,1480,420,1123,85,234,132,319,217,553
351515,202301,4232,9190,2736,6707,521,1330,646,1611,1167,2941
351518,202301,2565,6218,1754,4796,293,904,716,1654,1009,2558
351519,202301,769,1971,478,1419,106,343,105,256,211,599
351520,202301,1500,3519,749,2101,83,284,341,828,424,1112
351530,202301,444,1090,281,775,48,126,116,262,164,388
351535,202301,2156,4929,1533,3885,236,641,670,1564,906,2205
351540,202301,3397,7566,2338,5790,232,697,1242,2655,1474,3352
351550,202301,9760,22280,6912,17415,801,2238,3832,8685,4633,10923
351560,202301,664,1768,520,1490,98,309,182,470,280,779
351565,202301,351,878,266,738,37,129,111,257,148,386
351570,202301,30622,72466,24540,61527,1937,5672,16742,39177,18679,44849
351580,202301,272,678,166,491,27,69,57,181,84,250
351590,202301,557,1235,302,797,23,68,159,371,182,439
351600,202301,1692,4196,1304,3464,212,605,598,1411,810,2016
351610,202301,846,1856,541,1349,53,150,295,666,348,816
351620,202301,31760,77765,24021,65493,3484,10991,11343,27862,14827,38853
351630,202301,38735,89192,31847,78527,2629,7598,22718,52532,25347,60130
351640,202301,26819,60514,21905,52609,1410,4137,16061,36027,17471,40164
351650,202301,476,1243,224,676,39,121,45,115,84,236
351660,202301,788,2087,545,1581,89,282,145,346,234,628
351670,202301,7938,19834,5329,14333,1094,2899,2242,5396,3336,8295
351680,202301,512,1335,352,1019,76,203,99,260,175,463
351685,202301,595,1529,470,1337,86,245,191,468,277,713
351690,202301,1500,3545,885,2400,96,315,378,905,474,1220
351700,202301,1742,3949,1307,3245,230,644,693,1537,923,2181
351710,202301,982,2330,746,1929,60,190,422,958,482,1148
351720,202301,1977,4725,1426,3801,250,672,656,1605,906,2277
351730,202301,1305,2970,1063,2615,73,203,667,1497,740,1700
351740,202301,4318,9990,3525,8649,461,1280,2082,4633,2543,5913
351750,202301,2363,5745,1507,4167,196,579,740,1870,936,2449
351760,202301,4237,10586,3277,8858,549,1746,1594,3793,2143,5539
351770,202301,2649,6406,2173,5587,568,1422,1117,2733,1685,4155
351780,202301,1409,3326,840,2256,104,314,343,842,447,1156
351790,202301,1994,4285,1536,3641,249,581,917,2096,1166,2677
351800,202301,555,1222,288,748,37,102,109,234,146,336
351810,202301,1438,3412,1183,3051,273,788,553,1292,826,2080
351820,202301,4055,9858,3075,8113,626,1816,1187,2701,1813,4517
351830,202301,6580,15073,5081,12686,393,1193,3445,7876,3838,9069
351840,202301,12472,30812,9912,26402,971,2940,6274,15239,7245,18179
351850,202301,1901,4961,1265,3731,203,676,391,898,594,1574
351860,202301,3494,9123,2763,7897,631,2026,1349,3534,1980,5560
351870,202301,36098,83475,28428,71334,5782,15248,13557,32817,19339,48065
351880,202301,224701,493390,179735,422302,24975,70195,114218,243441,139193,313636
351885,202301,1348,3056,1112,2714,53,171,828,1889,881,2060
351890,202301,1045,2533,676,1932,119,382,164,393,283,775
351900,202301,1592,3882,1221,3339,104,289,789,2099,893,2388
351905,202301,783,2053,590,1672,69,211,256,618,325,829
351907,202301,30335,72115,24091,61629,2547,7481,15456,36747,18003,44228
351910,202301,2201,5076,1634,4036,157,453,964,2035,1121,2488
351920,202301,1144,2769,890,2323,132,382,369,852,501,1234
351925,202301,1264,3056,1012,2643,98,314,582,1383,680,1697
351930,202301,5775,12753,5272,11951,505,1379,4218,9105,4723,10484
351940,202301,1395,3342,1031,2720,186,530,415,1072,601,1602
351950,202301,2120,4152,1631,3497,82,217,1196,2397,1278,2614
351960,202301,7169,16566,5512,13860,1280,3437,2327,5219,3607,8656
351970,202301,14021,33194,11800,29706,1368,4305,8004,18448,9372,22753
351980,202301,1369,3047,903,2305,129,375,443,1013,572,1388
351990,202301,1830,3996,1364,3360,59,204,753,1624,812,1828
352000,202301,3549,8749,3064,7819,259,794,2117,4971,2376,5765
352010,202301,3000,7194,2401,6271,684,1810,658,1715,1342,3525
352020,202301,2227,5208,1756,4430,245,739,998,2251,1243,2990
352030,202301,8167,18387,6663,16095,763,2228,4423,9910,5186,12138
352040,202301,5691,13289,4193,10638,682,1920,1644,3621,2326,5541
352042,202301,4874,10419,3455,8311,374,1019,2269,5223,2643,6242
352044,202301,2602,6419,1587,4553,231,752,374,843,605,1595
352050,202301,17154,42109,12012,32496,3336,9680,2715,5839,6051,15519
352060,202301,985,2373,750,1979,143,405,343,813,486,1218
352070,202301,1219,2399,826,1885,67,164,473,983,540,1147
352080,202301,567,1378,359,997,45,117,112,267,157,384
352090,202301,1988,5261,1645,4647,190,630,843,2100,1033,2730
352100,202301,4942,12607,3877,10689,637,2037,1755,4435,2392,6472
352110,202301,937,2386,702,1941,144,405,291,704,435,1109
352115,202301,636,1586,525,1437,130,411,265,632,395,1043
352120,202301,1063,2769,840,2346,78,226,520,1328,598,1554
352130,202301,2453,6421,1592,4365,214,615,722,1756,936,2371
352140,202301,1735,4297,1285,3429,254,684,522,1315,776,1999
352150,202301,1089,2619,808,2158,100,295,496,1245,596,1540
352160,202301,1203,2731,871,2205,93,259,429,1016,522,1275
352170,202301,3773,9383,2940,7741,461,1415,1410,3239,1871,4654
352180,202301,3550,8903,2770,7586,564,1650,1097,2734,1661,4384
352190,202301,2154,4876,1733,4249,309,813,922,2193,1231,3006
352200,202301,419,1234,309,1004,45,159,113,328,158,487
352210,202301,31354,62738,25313,54789,1355,3391,20405,42393,21760,45784
352215,202301,782,1912,606,1609,97,284,313,789,410,1073
352220,202301,37027,79162,28718,65995,3625,9690,18273,37721,21898,47411
352230,202301,20551,52899,16335,45579,4021,12388,6277,15216,10298,27604
352240,202301,14056,32799,11073,28176,1970,5609,5839,13284,7809,18893
352250,202301,32360,82993,27022,74350,3436,10413,17660,46415,21096,56828
352260,202301,6617,15322,4773,11855,748,2117,2591,5586,3339,7703
352265,202301,1111,2923,983,2743,167,505,558,1479,725,1984
352270,202301,2651,6864,2124,5840,390,1190,909,2224,1299,3414
352280,202301,3104,6892,2390,5861,324,911,1351,2974,1675,3885
352290,202301,1997,5021,1629,4348,190,563,927,2200,1117,2763
352300,202301,1226,2918,793,2061,84,227,412,964,496,1191
352310,202301,52904,127873,41528,110048,6386,18066,24918,63388,31304,81454
352320,202301,8983,20437,7198,17434,854,2485,4463,9448,5317,11933
352330,202301,3467,7691,2764,6735,264,841,1875,4150,2139,4991
352340,202301,9970,24070,7678,19969,1212,3519,4016,9307,5228,12826
352350,202301,3305,8037,2718,6898,140,428,1977,4748,2117,5176
352360,202301,2004,4673,1613,4018,151,392,1093,2535,1244,2927
352370,202301,1326,3379,1122,3049,47,148,843,2203,890,2351
352380,202301,1248,2929,953,2454,196,528,325,759,521,1287
352390,202301,18255,41962,13421,33495,1986,5704,7855,17727,9841,23431
352400,202301,4718,12353,3703,10464,881,2694,1257,3091,2138,5785
352410,202301,4955,11160,3895,9492,434,1133,2411,5488,2845,6621
352420,202301,1063,2488,727,1943,131,378,260,621,391,999
352430,202301,11746,25231,8977,20826,1170,3102,5194,11039,6364,14141
352440,202301,25608,63586,19894,53319,4402,12434,7230,18235,11632,30669
352450,202301,990,2340,573,1629,87,278,225,550,312,828
352460,202301,3441,8656,2582,7197,467,1449,1150,2885,1617,4334
352470,202301,3933,9571,3131,8310,258,831,2010,4859,2268,5690
352480,202301,5835,12750,4045,9734,521,1522,2105,4347,2626,5869
352490,202301,1075,2706,859,2348,174,519,352,901,526,1420
352500,202301,14549,34679,10308,27298,3639,11251,2214,3655,5853,14906
352510,202301,5841,13988,4711,12086,479,1441,3217,7663,3696,9104
352520,202301,3846,9369,2981,7962,523,1599,1602,3789,2125,5388
352530,202301,15469,36164,11142,28563,2162,6304,4137,8642,6299,14946
352540,202301,709,1826,531,1478,67,188,263,657,330,845
352550,202301,1272,3158,861,2457,165,560,330,796,495,1356
352560,202301,835,2005,699,1768,46,157,498,1156,544,1313
352570,202301,2654,6895,1780,5228,413,1408,276,442,689,1850
352580,202301,977,2193,823,1945,112,308,540,1166,652,1474
352585,202301,481,1227,357,1014,40,143,182,449,222,592
352590,202301,16878,41604,12684,34228,2338,7197,6851,16655,9189,23852
352600,202301,2533,6038,2084,5293,212,607,1391,3239,1603,3846
352610,202301,3792,9134,2926,7762,452,1402,1440,3466,1892,4868
352620,202301,7737,17128,5977,14692,1343,3483,2820,6666,4163,10149
352630,202301,1073,2423,813,2073,143,408,403,947,546,1355
352640,202301,4310,9937,3218,8047,297,845,1997,4519,2294,5364
352650,202301,700,1830,468,1357,75,227,177,462,252,689
352660,202301,1426,3668,1170,3206,104,362,777,1926,881,2288
352670,202301,14337,34078,10579,27210,1824,5200,4946,11200,6770,16400
352680,202301,4231,11295,3177,9039,603,2076,1533,3503,2136,5579
352690,202301,34663,80480,27713,69482,1230,3874,20423,48279,21653,52153
352700,202301,1026,2415,784,2022,110,301,385,917,495,1218
352710,202301,7100,16844,5284,13737,1303,3860,2208,5006,3511,8866
352720,202301,13309,30315,10939,26323,1646,4483,6271,13740,7917,18223
352725,202301,655,1447,381,989,18,50,227,531,245,581
352730,202301,5549,15647,5073,14625,635,2068,2455,5901,3090,7969
352740,202301,3032,6823,2307,5787,300,858,1179,2712,1479,3570
352750,202301,517,1214,343,938,36,110,156,375,192,485
352760,202301,2022,5095,1602,4370,201,553,852,2193,1053,2746
352770,202301,1190,2879,852,2281,117,326,433,1059,550,1385
352780,202301,801,2107,572,1657,134,370,160,446,294,816
352790,202301,509,1246,385,1012,50,126,163,369,213,495
352800,202301,1725,4742,1222,3663,237,747,226,474,463,1221
352810,202301,1481,3338,1010,2521,178,446,522,1239,700,1685
352820,202301,556,1473,415,1232,91,276,97,247,188,523
352830,202301,689,1647,355,989,29,82,119,286,148,368
352840,202301,4987,12941,4082,11392,936,2832,1789,4703,2725,7535
352850,202301,17371,37101,13047,30636,2345,6260,7165,14970,9510,21230
352860,202301,1476,3757,1122,3132,198,601,414,1054,612,1655
352870,202301,1052,2540,735,1916,80,234,438,1066,518,1300
352880,202301,2150,4782,1542,3751,244,631,629,1326,873,1957
352885,202301,463,1129,363,958,47,143,226,556,273,699
352890,202301,881,1919,610,1411,60,144,394,807,454,951
352900,202301,25146,60003,17619,46084,2834,7779,7152,17166,9986,24945
352910,202301,451,1119,254,736,18,57,101,250,119,307
352920,202301,3576,8316,2776,7007,142,444,2021,4781,2163,5225
352930,202301,7482,18083,5898,15024,882,2642,2938,6428,3820,9070
352940,202301,35620,86000,28919,73213,4165,11702,17433,40853,21598,52555
352950,202301,668,1685,432,1255,88,287,121,282,209,569
352960,202301,915,2281,551,1539,63,191,181,385,244,576
352965,202301,300,791,206,612,43,121,58,160,101,281
352970,202301,5085,9501,4222,8270,111,291,3665,6810,3776,7101
352980,202301,1871,4228,1468,3672,338,902,799,1898,1137,2800
352990,202301,5764,13446,4439,11375,740,2086,2426,5877,3166,7963
353000,202301,562,1420,322,910,42,134,117,275,159,409
353010,202301,3373,7700,2404,6001,425,1186,1128,2493,1553,3679
353020,202301,4144,9969,2615,7039,396,1224,1013,2417,1409,3641
353030,202301,6062,14371,4282,11408,1009,2900,1255,3055,2264,5955
353040,202301,959,2003,719,1656,77,204,484,1010,561,1214
353050,202301,6765,17498,4933,13912,820,2567,2514,6554,3334,9121
353060,202301,66230,150500,55252,133957,3266,9988,42081,95959,45347,105947
353070,202301,14506,36854,11010,29841,1748,5314,5257,12580,7005,17894
353080,202301,6625,16066,4747,12643,950,2853,1945,4321,2895,7174
353090,202301,736,2007,594,1748,56,179,339,956,395,1135
353100,202301,370,900,170,490,34,110,51,105,85,215
353110,202301,10654,24568,8629,21831,1956,4942,4260,11152,6216,16094
353120,202301,617,1455,476,1227,60,205,250,540,310,745
353130,202301,3889,8493,2691,6458,613,1642,1210,2484,1823,4126
353140,202301,3966,8636,3036,7198,285,848,2002,4359,2287,5207
353150,202301,2112,4874,1569,4028,318,887,651,1532,969,2419
353160,202301,786,1879,552,1488,71,226,251,560,322,786
353170,202301,820,1929,632,1663,76,222,345,854,421,1076
353180,202301,12342,28532,9799,24366,2281,6242,4384,9835,6665,16077
353190,202301,4460,10871,3494,9047,404,1185,1997,4675,2401,5860
353200,202301,2210,5533,1452,4106,196,645,561,1370,757,2015
353205,202301,594,1554,498,1354,43,145,284,673,327,818
353210,202301,1205,2370,795,1724,26,74,608,1215,634,1289
353215,202301,504,1234,397,1052,50,153,180,415,230,568
353220,202301,945,2439,669,1899,114,311,202,495,316,806
353230,202301,1047,2665,812,2293,204,665,209,526,413,1191
353240,202301,3264,7759,2741,6981,383,1107,1626,3857,2009,4964
353250,202301,1755,3567,1233,2774,162,394,738,1575,900,1969
353260,202301,1388,3001,795,2062,166,486,322,729,488,1215
353270,202301,1037,2383,853,2076,96,291,533,1156,629,1447
353280,202301,912,2230,678,1866,139,402,241,633,380,1035
353282,202301,2141,5502,1770,4844,147,474,1093,2766,1240,3240
353284,202301,446,1018,258,681,20,58,103,218,123,276
353286,202301,204,501,125,364,22,68,34,66,56,134
353290,202301,1546,3826,923,2590,167,443,251,651,418,1094
353300,202301,2780,6776,2061,5471,328,990,947,2109,1275,3099
353310,202301,513,1141,388,946,29,94,252,540,281,634
353320,202301,835,2026,688,1805,41,144,440,1045,481,1189
353325,202301,997,2573,724,2039,118,345,320,822,438,1167
353330,202301,809,1855,535,1381,74,215,264,585,338,800
353340,202301,4391,10999,3482,9342,524,1664,1910,4573,2434,6237
353350,202301,5626,12635,4194,10191,983,2557,1313,2767,2296,5324
353360,202301,879,2244,729,1981,74,261,456,1134,530,1395
353370,202301,742,1944,614,1744,49,156,391,1065,440,1221
353380,202301,381,972,306,843,40,136,168,405,208,541
353390,202301,8346,19231,6299,15987,528,1565,3853,8997,4381,10562
353400,202301,707,1721,545,1443,93,286,235,472,328,758
353410,202301,671,1605,499,1296,125,359,239,542,364,901
353420,202301,598,1418,416,1085,66,179,101,210,167,389
353430,202301,3002,7547,2424,6549,460,1314,1112,2788,1572,4102
353440,202301,100702,241923,77534,198349,9876,28828,47173,109377,57049,138205
353450,202301,488,1117,348,896,51,160,171,381,222,541
353460,202301,4211,10513,3059,8374,617,1931,736,1639,1353,3570
353470,202301,11972,28560,8995,23298,1454,4275,4188,9497,5642,13772
353475,202301,2044,4710,1416,3598,144,420,747,1655,891,2075
353480,202301,2064,4780,1725,4297,110,343,1222,2832,1332,3175
353490,202301,1347,3260,1016,2698,128,356,502,1209,630,1565
353500,202301,1554,3470,1137,2818,241,652,578,1303,819,1955
353510,202301,1269,3323,950,2644,170,497,342,778,512,1275
353520,202301,1366,3294,902,2489,125,383,390,907,515,1290
353530,202301,3296,7603,2684,6589,309,893,1644,3623,1953,4516
353540,202301,2735,6636,2247,5925,380,1078,1266,3154,1646,4232
353550,202301,8092,18196,6539,15749,998,2569,3926,8731,4924,11300
353560,202301,2996,7316,2382,6438,665,1937,852,1996,1517,3933
353570,202301,798,2007,523,1492,90,288,194,465,284,753
353580,202301,3142,7502,2508,6392,453,1133,1366,3333,1819,4466
353590,202301,940,2196,702,1822,87,228,396,970,483,1198
353600,202301,1960,4659,1444,3787,180,508,716,1785,896,2293
353610,202301,1019,2663,786,2224,115,347,356,905,471,1252
353620,202301,3800,8998,2774,7383,595,1688,888,2009,1483,3697
353625,202301,778,1793,459,1232,52,172,246,598,298,770
353630,202301,2002,5335,1716,4802,239,734,952,2407,1191,3141
353640,202301,1797,4242,1391,3556,183,473,879,2113,1062,2586
353650,202301,9349,23429,7380,20041,967,2895,4099,10212,5066,13107
353657,202301,460,1148,355,986,32,102,158,407,190,509
353660,202301,1731,3306,1234,2667,166,398,836,1704,1002,2102
353670,202301,5671,14123,4474,11957,808,2492,2136,5022,2944,7514
353680,202301,937,2184,701,1857,104,302,405,989,509,1291
353690,202301,548,1402,265,786,29,81,70,175,99,256
353700,202301,2800,6488,2304,5733,215,570,1543,3655,1758,4225
353710,202301,6243,13284,4033,9474,598,1403,2199,4485,2797,5888
353715,202301,522,1315,310,887,24,80,132,326,156,406
353720,202301,2542,6073,1974,5221,372,1086,926,2324,1298,3410
353730,202301,6549,15356,5208,13131,677,2016,3133,7186,3810,9202
353740,202301,2748,6573,2035,5356,366,1056,905,2127,1271,3183
353750,202301,1156,3211,872,2696,204,642,222,651,426,1293
353760,202301,19569,38964,15386,33700,2714,6538,8874,18535,11588,25073
353770,202301,792,2124,457,1430,60,227,61,149,121,376
353780,202301,9010,21118,7480,18524,1221,3369,4303,9899,5524,13268
353790,202301,3697,10098,2825,8409,638,2111,629,1504,1267,3615
353800,202301,24348,57714,19956,51125,2846,7655,11791,28713,14637,36368
353810,202301,1530,3700,1091,2852,186,510,452,1098,638,1608
353820,202301,2321,5675,1641,4443,433,1193,443,1023,876,2216
353830,202301,773,1784,584,1504,81,243,312,721,393,964
353850,202301,2050,5041,1599,4266,289,797,705,1718,994,2515
353860,202301,3552,8612,2740,7295,627,1968,1299,2926,1926,4894
353870,202301,38771,93032,28722,74845,3938,11315,14325,33164,18263,44479
353880,202301,3899,9641,3184,8372,235,773,2056,4926,2291,5699
353890,202301,4152,7954,2940,6200,182,480,2077,3898,2259,4378
353900,202301,909,2360,687,1954,86,286,280,698,366,984
353910,202301,4092,9552,3517,8715,246,710,2578,6156,2824,6866
353920,202301,2555,6391,1882,5214,529,1612,448,927,977,2539
353930,202301,7059,16789,5158,13305,940,2690,2270,5095,3210,7785
353940,202301,1666,4426,1215,3567,186,606,470,1199,656,1805
353950,202301,4507,10905,3509,9185,900,2593,1158,2624,2058,5217
353960,202301,961,2354,679,1863,163,424,162,423,325,847
353970,202301,849,1797,672,1547,62,173,493,1067,555,1240
353980,202301,22401,49927,17644,42382,779,2414,13485,30228,14264,32642
353990,202301,1242,2723,881,2147,170,442,485,1080,655,1522
354000,202301,3270,7449,1978,5113,344,933,687,1545,1031,2478
354010,202301,423,1024,321,864,54,176,181,450,235,626
354020,202301,5207,12303,4201,10494,793,2202,2008,4370,2801,6572
354025,202301,918,2347,620,1785,95,308,181,444,276,752
354030,202301,659,1391,365,914,58,150,172,397,230,547
354040,202301,1003,2113,688,1653,41,122,480,1053,521,1175
354050,202301,1350,3511,963,2867,173,603,396,1082,569,1685
354060,202301,5329,13341,4000,10639,624,1882,2041,4702,2665,6584
354070,202301,5289,12309,3750,9465,588,1664,1769,3847,2357,5511
354075,202301,3731,9304,3052,8195,475,1418,1806,4430,2281,5848
354080,202301,1875,4831,1323,3804,189,578,593,1507,782,2085
354085,202301,524,976,407,833,1,4,304,567,305,571
354090,202301,2223,5531,1914,4920,104,302,1473,3593,1577,3895
354100,202301,31422,77308,23295,64159,4385,13250,11209,28640,15594,41890
354105,202301,1608,3735,1188,3049,166,512,580,1309,746,1821
354110,202301,589,1536,464,1321,81,262,194,511,275,773
354120,202301,1836,4593,1262,3413,238,702,444,988,682,1690
354130,202301,7612,18204,5346,14037,1476,4013,1133,2412,2609,6425
354140,202301,24565,57155,18384,46134,2523,7124,9659,21413,12182,28537
354150,202301,3662,8129,2915,7022,726,1815,928,2167,1654,3982
354160,202301,3623,9399,2961,8249,687,2060,1248,3189,1935,5249
354165,202301,927,2452,741,2105,85,329,448,1113,533,1442
354170,202301,2548,6372,2085,5563,264,819,1084,2515,1348,3334
354180,202301,567,1445,450,1220,38,118,262,642,300,760
354190,202301,1948,5024,1410,3971,102,350,752,1931,854,2281
354200,202301,1171,2629,889,2190,89,264,563,1248,652,1512
354210,202301,1346,3206,1075,2769,95,286,682,1581,777,1867
354220,202301,4009,9676,3049,7958,538,1518,1426,3421,1964,4939
354230,202301,1029,2318,842,2090,40,119,631,1510,671,1629
354240,202301,2376,6099,1666,4679,293,857,621,1495,914,2352
354250,202301,799,1855,547,1450,121,320,192,452,313,772
354260,202301,11656,26572,9199,22664,1338,3605,4723,10845,6061,14450
354270,202301,1283,3415,1059,3016,159,485,506,1275,665,1760
354280,202301,1050,2311,871,2042,40,125,651,1373,691,1498
354290,202301,1210,3435,1005,3030,145,471,544,1566,689,2037
354300,202301,4301,11426,3641,10256,917,2601,1655,4473,2572,7074
354310,202301,1007,2592,867,2363,143,440,497,1240,640,1680
354320,202301,1217,2718,817,2093,126,333,384,829,510,1162
354323,202301,586,1296,378,942,41,111,187,404,228,515
354325,202301,1698,4798,1079,3358,191,597,169,461,360,1058
354330,202301,12951,29629,9481,23194,1046,2954,5832,12900,6878,15854
354340,202301,52700,120887,39549,99402,5342,14964,22881,53805,28223,68769
354350,202301,1490,3376,1197,2918,133,428,793,1702,926,2130
354360,202301,798,1776,506,1334,107,296,174,400,281,696
354370,202301,1260,3227,1040,2894,158,474,610,1603,768,2077
354380,202301,672,1634,504,1378,69,243,202,457,271,700
354390,202301,19936,44161,14183,34632,2025,5469,7669,16910,9694,22379
354400,202301,2101,6114,1661,5187,283,964,561,1617,844,2581
354410,202301,9201,21028,7303,17810,1056,2950,4222,9300,5278,12250
354420,202301,1840,4410,1316,3466,164,483,696,1620,860,2103
354425,202301,3674,8113,2725,6558,503,1270,1416,3210,1919,4480
354430,202301,2190,5122,1729,4417,141,424,1117,2618,1258,3042
354440,202301,742,1763,502,1318,57,169,254,577,311,746
354450,202301,612,1541,340,1024,53,174,105,246,158,420
354460,202301,1008,2444,689,1902,157,477,221,540,378,1017
354470,202301,511,1252,344,938,30,103,123,251,153,354
354480,202301,1709,3606,1165,2742,90,253,747,1605,837,1858
354490,202301,1027,2766,778,2253,150,436,349,923,499,1359
354500,202301,2935,7358,2357,6440,627,1845,804,1997,1431,3842
354510,202301,959,2427,763,2089,71,227,429,1033,500,1260
354515,202301,567,1496,392,1143,64,192,132,348,196,540
354520,202301,10649,26185,7983,20965,996,3036,4549,10673,5545,13709
354530,202301,6673,16488,5379,14197,1367,3613,2019,5019,3386,8632
354540,202301,1628,3930,1197,3202,203,589,535,1323,738,1912
354550,202301,719,1841,578,1592,77,240,296,732,373,972
354560,202301,2698,6026,1509,3900,160,444,873,2026,1033,2470
354570,202301,1179,2802,546,1531,99,274,87,230,186,504
354580,202301,11112,27815,7857,21763,1126,3511,4134,10476,5260,13987
354600,202301,2624,6396,2059,5391,310,816,1168,2890,1478,3706
354610,202301,561,1403,315,911,30,91,150,405,180,496
354620,202301,618,1614,392,1184,33,115,179,486,212,601
354625,202301,379,1018,227,726,24,79,73,224,97,303
354630,202301,3124,8062,2650,7239,764,2151,740,1813,1504,3964
354640,202301,5073,12711,4027,10775,481,1546,2159,5105,2640,6651
354650,202301,1097,2631,894,2311,189,454,438,1090,627,1544
354660,202301,4510,9907,2681,7054,325,1022,1172,2742,1497,3764
354670,202301,1462,3717,1052,2926,216,660,338,783,554,1443
354680,202301,8242,18653,6622,16175,1031,2782,3948,9106,4979,11888
354690,202301,670,1892,490,1516,74,234,193,541,267,775
354700,202301,1123,2720,814,2146,95,288,445,1048,540,1336
354710,202301,597,1465,397,1086,42,123,181,423,223,546
354720,202301,386,867,194,517,58,146,58,146,116,292
354730,202301,14645,38146,11748,32889,1606,4991,6914,18110,8520,23101
354740,202301,404,1043,185,552,34,106,29,65,63,171
354750,202301,3005,7256,2105,5566,329,983,903,2036,1232,3019
354760,202301,2836,6875,2108,5634,421,1223,760,1764,1181,2987
354765,202301,435,1101,202,602,17,63,70,163,87,226
354770,202301,3193,7285,2383,5865,447,1197,1076,2378,1523,3575
354780,202301,84033,186285,66467,154421,4468,12717,47564,100735,52032,113452
354790,202301,1166,2953,916,2564,77,243,571,1518,648,1761
354800,202301,3522,8318,2644,6900,575,1625,1039,2376,1614,4001
354805,202301,1809,3875,1348,3229,107,285,903,1938,1010,2223
354810,202301,710,1966,442,1421,74,275,128,345,202,620
354820,202301,1207,3185,882,2607,166,531,294,711,460,1242
354830,202301,679,1526,392,1021,77,215,144,310,221,525
354840,202301,1073,2606,655,1736,52,156,359,840,411,996
354850,202301,29754,67611,22170,55216,1930,5848,14928,33998,16858,39846
354860,202301,2148,5426,1433,4079,202,634,555,1389,757,2023
354870,202301,89162,201578,70904,170118,5448,15475,48646,106992,54094,122467
354880,202301,8058,18717,4644,11859,547,1603,2146,4335,2693,5938
354890,202301,24063,54278,19426,46593,2411,6729,11361,25301,13772,32030
354900,202301,467,1111,315,854,76,224,112,249,188,473
354910,202301,7821,19055,5009,14189,1100,3332,1412,3434,2512,6766
354920,202301,612,1550,327,983,40,128,83,194,123,322
354925,202301,355,960,207,650,22,68,45,125,67,193
354930,202301,451,1050,312,807,36,97,159,363,195,460
354940,202301,3329,8931,2588,7416,721,2224,945,2306,1666,4530
354950,202301,2021,4533,1671,4092,102,336,1217,2766,1319,3102
354960,202301,1053,2578,753,2102,89,311,336,813,425,1124
354970,202301,5655,14082,4546,12322,361,1241,3144,7986,3505,9227
354980,202301,46520,102182,33506,80826,3470,10136,21708,47348,25178,57484
354990,202301,103717,232174,77227,186912,5008,15067,53334,117509,58342,132576
354995,202301,4390,8247,3470,7104,149,375,2831,5530,2980,5905
355000,202301,1978,4486,1513,3822,234,709,778,1737,1012,2446
355010,202301,5256,13058,3610,9737,1152,3012,809,2085,1961,5097
355020,202301,4114,10913,3284,9540,751,2417,1332,3492,2083,5909
355030,202301,1794638,4070245,1370644,3311420,181580,489194,767252,1677633,948832,2166827
355040,202301,4650,10010,3699,8784,355,925,2744,6286,3099,7211
355050,202301,1417,2995,1053,2510,250,608,420,935,670,1543
355060,202301,8851,21639,6806,18099,1050,3182,3714,8944,4764,12126
355070,202301,14106,31999,11838,28586,1306,3704,7831,17444,9137,21148
355080,202301,1243,3281,812,2517,188,616,141,363,329,979
355090,202301,1777,4381,1444,3846,250,736,756,1806,1006,2542
355100,202301,39615,89954,33280,80835,3428,9554,23802,54555,27230,64109
355110,202301,1240,3122,897,2630,169,521,69,156,238,677
355120,202301,937,2256,664,1861,83,270,333,847,416,1117
355130,202301,1062,2146,628,1394,25,66,451,895,476,961
355140,202301,2966,5441,2567,4925,73,188,2266,4193,2339,4381
355150,202301,6380,14823,5245,12984,579,1578,3397,7935,3976,9513
355160,202301,3031,7574,2208,6224,496,1528,619,1540,1115,3068
355170,202301,15980,36417,12803,31336,2041,5613,7315,16676,9356,22289
355180,202301,3662,8458,2759,7133,516,1550,1395,3241,1911,4791
355190,202301,2370,5803,1884,5054,713,1977,559,1590,1272,3567
355200,202301,1108,3079,948,2838,270,920,317,874,587,1794
355210,202301,4176,10287,3230,8425,758,2023,1319,3192,2077,5215
355220,202301,70551,165962,58174,143909,7675,21750,34044,75740,41719,97490
355230,202301,1527,3657,854,2341,152,451,316,708,468,1159
355240,202301,32543,79342,24053,63716,2514,7466,14585,35678,17099,43144
355250,202301,53737,128502,42084,107520,8593,23725,20850,48527,29443,72252
355255,202301,791,1871,427,1225,52,138,131,350,183,488
355260,202301,2039,4301,1523,3545,117,350,1070,2267,1187,2617
355270,202301,1561,4156,1254,3589,289,832,508,1348,797,2180
355280,202301,43344,99267,32713,81018,3864,10593,18925,43071,22789,53664
355290,202301,1206,2924,956,2541,183,480,465,1140,648,1620
355300,202301,1803,4739,1493,4189,240,730,681,1688,921,2418
355310,202301,1172,2910,883,2420,114,337,495,1288,609,1625
355320,202301,718,1769,536,1435,115,357,207,445,322,802
355330,202301,3929,9046,3121,7702,138,444,2356,5409,2494,5853
355340,202301,5306,10991,4082,9436,775,1830,1954,4629,2729,6459
355350,202301,1819,4604,1405,3861,247,784,636,1545,883,2329
355360,202301,1651,3809,1289,3263,150,401,731,1673,881,2074
355365,202301,452,1056,252,727,42,125,77,189,119,314
355370,202301,7308,16922,5790,14622,1241,2831,2732,7120,3973,9951
355380,202301,3800,9198,2941,7726,577,1660,1124,2514,1701,4174
355385,202301,1780,4198,1455,3731,106,335,945,2197,1051,2532
355390,202301,1013,2581,759,2089,105,328,358,844,463,1172
355395,202301,2264,6023,1660,4850,264,869,667,1670,931,2539
355400,202301,12435,32351,10215,28285,2156,6806,4320,10473,6476,17279
355410,202301,32472,81691,22468,62264,4212,12912,8549,21484,12761,34396
355420,202301,775,2271,643,2033,133,477,207,598,340,1075
355430,202301,4755,10989,3743,9276,611,1668,2024,4708,2635,6376
355440,202301,917,2295,596,1682,98,280,130,301,228,581
355450,202301,4662,11082,3303,8587,457,1329,1612,3632,2069,4961
355460,202301,606,1417,415,1104,39,118,183,447,222,565
355465,202301,544,1298,440,1140,59,150,277,699,336,849
355470,202301,1498,3527,897,2395,233,686,309,727,542,1413
355475,202301,432,932,352,827,18,45,256,570,274,615
355480,202301,5473,13839,4375,12177,609,1956,2726,7228,3335,9184
355490,202301,1125,2852,653,1930,73,235,292,779,365,1014
355495,202301,1197,2936,887,2439,118,403,406,950,524,1353
355500,202301,9128,21348,6239,16142,813,2432,2901,6496,3714,8928
355510,202301,1723,3999,1182,3103,198,538,506,1178,704,1716
355520,202301,383,871,192,541,36,115,47,118,83,233
355530,202301,377,817,171,435,10,31,94,210,104,241
355535,202301,663,1669,536,1467,109,353,262,606,371,959
355540,202301,17465,37897,14805,34355,1522,3931,10665,23651,12187,27582
355550,202301,830,2229,717,2036,83,274,409,1032,492,1306
355560,202301,1388,3411,806,2316,168,519,35,113,203,632
355570,202301,360,883,205,570,48,142,55,133,103,275
355580,202301,1522,3483,902,2377,163,468,220,506,383,974
355590,202301,212,516,157,427,16,45,84,218,100,263
355600,202301,1699,4002,1113,2971,169,498,298,696,467,1194
355610,202301,2568,5867,1775,4519,275,770,959,2175,1234,2945
355620,202301,6597,16114,5155,13506,541,1719,3039,7102,3580,8821
355630,202301,3363,8171,2453,6528,269,800,1475,3543,1744,4343
355635,202301,1255,3342,916,2691,134,412,328,865,462,1277
355640,202301,4450,11351,3026,8699,725,2069,528,1500,1253,3569
355645,202301,4846,12508,3572,10297,513,1632,1914,5171,2427,6803
355650,202301,10181,24623,8344,21530,1623,4418,4195,9878,5818,14296
355660,202301,1708,4190,1134,3192,202,513,212,523,414,1036
355670,202301,5665,13795,4173,10781,523,1655,2155,4699,2678,6354
355680,202301,3447,8928,1803,5351,468,1503,131,344,599,1847
355690,202301,898,2453,624,1954,187,614,12,22,199,636
355695,202301,330,850,204,593,19,60,44,89,63,149
355700,202301,11067,27869,9435,24682,1122,3354,5813,14019,6935,17373
355710,202301,13149,28864,9276,22049,1244,3525,4912,9880,6156,13405
355715,202301,580,1497,335,959,91,258,63,164,154,422
355720,202301,1878,4689,1494,4057,243,734,804,1969,1047,2703
355730,202301,1357,3324,1101,2914,100,316,640,1543,740,1859
410010,202301,1517,3968,1150,3223,248,729,277,696,525,1425
410020,202301,1366,3601,1020,2902,292,818,258,661,550,1479
410030,202301,2141,5179,1791,4665,258,688,927,2376,1185,3064
410040,202301,18699,46941,14048,38718,2906,8571,4555,11280,7461,19851
410045,202301,901,2304,676,1855,140,413,187,434,327,847
410050,202301,2697,6528,1938,5294,313,962,675,1648,988,2610
410060,202301,2544,6653,2057,5817,508,1570,576,1457,1084,3027
410070,202301,2435,5725,1789,4612,333,953,694,1548,1027,2501
410080,202301,1658,4153,1213,3426,265,766,254,646,519,1412
410090,202301,1414,3109,1149,2748,149,324,543,1413,692,1737
410100,202301,2595,6876,1821,5232,314,984,158,408,472,1392
410105,202301,686,1555,458,1150,26,82,258,553,284,635
410110,202301,4067,9288,2967,7466,363,1045,1556,3493,1919,4538
410115,202301,673,1647,490,1331,63,193,185,430,248,623
410120,202301,4077,9531,3585,8813,588,1402,2309,5569,2897,6971
410130,202301,1634,3915,1440,3595,203,536,857,2058,1060,2594
410140,202301,21849,49848,14915,38106,2686,7530,4845,10974,7531,18504
410150,202301,20383,45901,11562,29650,1859,5247,3778,8109,5637,13356
410160,202301,3661,9629,2999,8528,643,2082,1087,2813,1730,4895
410165,202301,751,1924,591,1604,79,246,294,730,373,976
410170,202301,3594,8692,2231,5940,400,1153,362,781,762,1934
410180,202301,21978,55988,17342,47200,2792,8408,8462,20411,11254,28819
410185,202301,557,1494,420,1177,79,238,146,342,225,580
410190,202301,2707,6401,1975,5150,388,1040,508,1114,896,2154
410200,202301,7141,15297,4078,10342,797,2178,786,1712,1583,3890
410210,202301,3844,9158,2422,6711,366,1148,813,1881,1179,3029
410220,202301,655,1597,451,1234,95,270,148,356,243,626
410230,202301,2438,6075,1868,4986,285,864,780,1734,1065,2598
410240,202301,6206,15455,4385,12180,854,2759,714,1656,1568,4415
410250,202301,2804,6389,2067,5246,263,676,920,2221,1183,2897
410260,202301,2487,5610,1601,4051,308,806,790,1779,1098,2585
410270,202301,598,1481,430,1186,57,187,172,396,229,583
410275,202301,732,1891,506,1430,77,254,205,502,282,756
410280,202301,2891,7110,2000,5476,253,792,890,2136,1143,2928
410290,202301,3950,10204,2785,7929,897,2498,680,1877,1577,4375
410300,202301,849,1949,678,1699,69,207,357,774,426,981
410302,202301,406,968,250,697,29,95,107,274,136,369
410304,202301,1834,3967,1573,3565,165,400,1005,2216,1170,2616
410305,202301,2107,4673,1510,3834,158,449,963,2297,1121,2746
410310,202301,3862,8987,3206,7920,256,833,2154,4885,2410,5718
410315,202301,906,1913,582,1427,163,407,176,410,339,817
410320,202301,1165,3104,781,2368,94,307,120,305,214,612
410322,202301,777,1988,398,1146,52,152,130,304,182,456
410330,202301,1823,4175,1288,3244,208,531,436,982,644,1513
410335,202301,1026,2553,775,2117,136,391,271,664,407,1055
410337,202301,969,2300,677,1761,91,253,237,527,328,780
410340,202301,557,1480,382,1080,27,92,160,354,187,446
410345,202301,3356,8216,2132,5771,466,1268,786,1879,1252,3147
410347,202301,936,2277,696,1880,93,252,190,488,283,740
410350,202301,2047,4648,1481,3784,141,426,836,1869,977,2295
410360,202301,4857,11582,3605,9459,635,1735,1112,2723,1747,4458
410370,202301,17744,44502,11952,31728,1367,4143,5071,11004,6438,15147
410380,202301,2160,4907,1521,3868,211,613,533,1185,744,1798
410390,202301,3582,7953,2438,6152,493,1515,978,2037,1471,3552
410395,202301,1104,2924,867,2476,180,514,314,916,494,1430
410400,202301,9943,22719,7683,18848,858,2420,4778,10529,5636,12949
410405,202301,1112,2420,777,1948,113,320,383,863,496,1183
410410,202301,1963,4610,1718,4226,122,352,1155,2775,1277,3127
410420,202301,15450,37978,11867,31396,1904,5508,5351,12463,7255,17971
410425,202301,4641,11732,3272,9090,575,1703,1190,2897,1765,4600
410430,202301,16678,38717,12022,30822,1799,5139,4807,10847,6606,15986
410440,202301,2995,7751,2601,7067,404,1231,1440,3669,1844,4900
410442,202301,3070,8338,2467,7154,688,2072,597,1617,1285,3689
410445,202301,2761,7292,1900,5675,394,1285,255,795,649,2080
410450,202301,1892,4386,1413,3693,236,638,484,1165,720,1803
410460,202301,3011,6907,2192,5549,316,902,1067,2355,1383,3257
410465,202301,3695,9783,2843,8272,569,1675,888,2216,1457,3891
410470,202301,2967,7554,2138,6186,645,2106,190,524,835,2630
410480,202301,50500,114458,30072,80552,4244,12811,8972,19843,13216,32654
410490,202301,14761,37221,10963,29900,1768,5258,4933,11896,6701,17154
410500,202301,2250,5419,1489,4042,277,768,321,678,598,1446
410510,202301,2249,5238,1587,4135,337,848,484,1233,821,2081
410520,202301,3752,10597,3331,9856,1049,3311,1227,3520,2276,6831
410530,202301,1891,4435,939,2550,123,378,249,516,372,894
410540,202301,3463,8664,2447,6754,404,1279,1040,2536,1444,3815
410550,202301,9599,24060,6720,18303,1088,3315,2010,4474,3098,7789
410560,202301,1903,4613,1407,3680,299,868,392,813,691,1681
410570,202301,3332,8179,2372,6576,801,2581,230,564,1031,3145
410580,202301,36671,86387,28121,71777,4127,11901,14579,33641,18706,45542
410590,202301,2087,5371,1453,3980,187,541,443,960,630,1501
410600,202301,2247,5393,1764,4519,363,936,661,1600,1024,2536
410610,202301,852,2018,642,1659,58,172,324,735,382,907
410620,202301,3520,8753,2543,6773,624,1792,700,1599,1324,3391
410630,202301,3134,7536,2118,5664,400,1265,495,987,895,2252
410640,202301,6322,13865,4408,10708,939,2515,704,1664,1643,4179
410645,202301,1729,3954,1456,3629,139,386,1144,2790,1283,3176
410650,202301,3106,7790,2175,5996,426,1282,873,2090,1299,3372
410655,202301,1039,2377,726,1860,87,268,294,625,381,893
410657,202301,733,1863,476,1347,65,201,195,439,260,640
410660,202301,4625,10720,2887,7310,436,1188,1046,2258,1482,3446
410670,202301,1207,2855,747,1990,109,296,277,621,386,917
410680,202301,2897,8096,1970,5907,460,1406,372,1073,832,2479
410685,202301,638,1536,469,1246,103,310,193,458,296,768
410690,202301,180192,409114,128497,318941,19389,54802,56050,119465,75439,174267
410700,202301,2997,7139,2460,6352,566,1517,917,2172,1483,3689
410710,202301,1089,2594,706,1906,178,517,266,614,444,1131
410712,202301,824,2100,689,1861,101,284,371,953,472,1237
410715,202301,1063,2835,677,2036,71,242,282,762,353,1004
410720,202301,4752,10924,3922,9623,531,1607,1486,3326,2017,4933
410725,202301,1452,3325,902,2392,206,598,192,396,398,994
410730,202301,1020,2458,709,1904,101,324,158,406,259,730
410740,202301,1027,2705,783,2264,60,209,406,1136,466,1345
410750,202301,2432,5473,1917,4616,320,809,894,1974,1214,2783
410752,202301,483,1110,259,698,93,239,58,136,151,375
410753,202301,412,1109,295,877,31,103,90,224,121,327
410754,202301,1393,3240,1143,2883,83,213,821,2090,904,2303
410755,202301,684,1638,499,1325,63,181,228,524,291,705
410760,202301,4436,10873,3131,8600,781,2563,820,2023,1601,4586
410765,202301,22785,56787,18302,48920,3633,10812,6062,13598,9695,24410
410770,202301,1239,2792,856,2177,80,180,423,1053,503,1233
410773,202301,1630,3857,1393,3486,190,542,863,1993,1053,2535
410775,202301,2059,4252,1808,3924,41,106,1408,2873,1449,2979
410780,202301,760,1776,521,1357,93,258,162,377,255,635
410785,202301,983,2232,718,1830,102,307,316,750,418,1057
410790,202301,1321,3567,1081,3143,232,739,159,355,391,1094
410800,202301,4259,8425,3412,7276,66,189,2362,4726,2428,4915
410810,202301,553,1373,413,1118,46,165,212,484,258,649
410820,202301,1252,3293,730,2034,153,442,151,318,304,760
410830,202301,56976,124058,41607,99611,6354,17682,20628,43929,26982,61611
410832,202301,1359,3329,1116,2931,96,309,688,1615,784,1924
410840,202301,11328,26680,6765,18250,1301,3978,1915,3969,3216,7947
410845,202301,1487,3183,1179,2763,133,360,731,1557,864,1917
410850,202301,2631,6759,2276,6171,424,1308,1069,2644,1493,3952
410855,202301,857,2032,549,1454,66,202,265,584,331,786
410860,202301,6060,13090,4833,11169,215,676,3415,7178,3630,7854
410865,202301,1768,4610,1503,4156,217,646,785,2238,1002,2884
410870,202301,1454,3599,1155,3103,148,442,635,1612,783,2054
410880,202301,5872,14545,4047,11383,691,1962,716,1982,1407,3944
410890,202301,1421,3551,1137,3044,214,564,513,1286,727,1850
410895,202301,1216,3537,1007,3102,326,1125,252,653,578,1778
410900,202301,1029,2586,695,2009,108,319,148,312,256,631
410910,202301,532,1153,342,821,17,45,193,402,210,447
410920,202301,1137,2481,853,2062,100,276,474,1053,574,1329
410930,202301,2136,5105,1479,4050,374,1148,244,561,618,1709
410940,202301,31240,77525,23249,63969,4418,13634,9283,23041,13701,36675
410950,202301,2450,6229,2182,5818,201,507,1631,4288,1832,4795
410960,202301,10869,24103,7728,19255,2068,6010,2994,6580,5062,12590
410965,202301,1369,3310,862,2376,110,338,375,922,485,1260
410970,202301,5310,13335,3778,10448,923,3010,675,1390,1598,4400
410975,202301,1820,4022,1330,3257,194,531,583,1317,777,1848
410980,202301,9431,21706,6285,16353,655,1941,3079,7013,3734,8954
410990,202301,1844,4014,1282,3198,222,628,603,1417,825,2045
411000,202301,827,2121,587,1697,105,338,172,413,277,751
411005,202301,573,1349,365,956,44,123,143,309,187,432
411007,202301,3142,7695,2337,6346,464,1397,830,2003,1294,3400
411010,202301,5693,15212,4347,12631,1194,3569,757,1882,1951,5451
411020,202301,2899,7464,2379,6637,607,1799,737,1933,1344,3732
411030,202301,865,2044,600,1531,73,211,265,569,338,780
411040,202301,1240,2971,669,1810,124,330,181,411,305,741
411050,202301,2425,7052,1937,6108,400,1405,336,846,736,2251
411060,202301,2784,6882,1815,4985,327,939,547,1233,874,2172
411065,202301,464,1117,284,763,28,92,113,268,141,360
411070,202301,9782,22310,7773,19175,1056,3059,4236,9483,5292,12542
411080,202301,2465,6008,1984,5206,473,1432,597,1376,1070,2808
411090,202301,952,2444,596,1757,82,267,141,338,223,605
411095,202301,2968,6687,1749,4633,239,643,288,623,527,1266
411100,202301,1498,3605,1001,2715,125,406,365,901,490,1307
411110,202301,787,1982,379,1131,38,105,33,58,71,163
411120,202301,2014,4860,1655,4306,281,904,810,1854,1091,2758
411125,202301,6681,17705,5885,16366,1570,4544,2224,6145,3794,10689
411130,202301,903,2231,631,1723,176,466,166,456,342,922
411140,202301,2657,7579,2182,6626,522,1655,599,1822,1121,3477
411150,202301,4992,11820,3339,8679,673,1879,331,663,1004,2542
411155,202301,1336,3051,919,2333,113,347,469,973,582,1320
411160,202301,465,989,306,746,33,91,91,218,124,309
411170,202301,1004,2659,767,2190,167,532,319,845,486,1377
411180,202301,6645,15667,5453,13634,751,2136,3033,6777,3784,8913
411190,202301,2642,6332,2028,5301,268,781,921,2080,1189,2861
411200,202301,6289,15472,4824,12966,956,3005,1627,3498,2583,6503
411210,202301,4411,9284,3148,7257,391,1060,1467,3014,1858,4074
411220,202301,1202,2825,835,2194,165,454,288,674,453,1128
411230,202301,1031,2574,763,2080,167,488,239,589,406,1077
411240,202301,1918,4257,1361,3380,237,635,508,1144,745,1779
411250,202301,2811,6844,2031,5524,428,1286,564,1348,992,2634
411260,202301,388,949,256,699,42,137,103,238,145,375
411270,202301,2452,6090,1818,4922,283,832,835,1985,1118,2817
411275,202301,2012,4102,1443,3250,143,414,902,1783,1045,2197
411280,202301,1841,4569,1351,3682,299,887,427,991,726,1878
411290,202301,1041,2496,693,1849,77,258,356,853,433,1111
411295,202301,1562,3742,1154,3022,199,528,498,1174,697,1702
411300,202301,1216,2900,778,2112,86,254,284,595,370,849
411310,202301,1170,2392,918,2076,158,398,484,991,642,1389
411320,202301,7293,16800,5548,13883,789,2239,2751,5872,3540,8111
411325,202301,1830,4606,1479,3985,281,772,723,1988,1004,2760
411330,202301,3989,9965,3000,8321,707,2179,868,2210,1575,4389
411340,202301,994,2571,601,1744,89,269,181,437,270,706
411342,202301,1288,2948,708,1826,125,370,263,537,388,907
411345,202301,1494,3465,1082,2776,72,212,709,1736,781,1948
411350,202301,3662,9197,2441,6873,613,1857,358,847,971,2704
411360,202301,956,2093,712,1722,87,258,367,754,454,1012
411370,202301,73532,170130,54598,139552,4224,12937,32013,73741,36237,86678
411373,202301,1757,4066,1382,3531,159,427,661,1679,820,2106
411375,202301,1356,3208,932,2439,110,309,356,812,466,1121
411380,202301,1413,3040,963,2243,38,107,637,1340,675,1447
411390,202301,1925,4763,1502,3922,229,690,637,1348,866,2038
411400,202301,2905,6537,2208,5365,231,655,1228,2691,1459,3346
411410,202301,3629,9520,2713,7658,617,1939,670,1609,1287,3548
411420,202301,5168,12009,2855,7871,386,1183,525,1018,911,2201
411430,202301,5021,12022,3832,9956,729,2117,1345,2936,2074,5053
411435,202301,539,1358,312,906,43,131,68,155,111,286
411440,202301,3257,8222,2475,6814,507,1494,699,1675,1206,3169
411450,202301,3202,7756,2435,6540,354,935,1330,3540,1684,4475
411460,202301,5588,13572,3645,10029,517,1634,910,1993,1427,3627
411470,202301,1096,2518,852,2125,100,322,470,1015,570,1337
411480,202301,6693,16279,4883,13089,934,2961,1524,3394,2458,6355
411490,202301,2085,4839,1598,4131,201,600,732,1673,933,2273
411500,202301,1689,4172,1199,3195,201,584,272,536,473,1120
411510,202301,2833,6397,2211,5444,342,1012,677,1583,1019,2595
411520,202301,44954,103709,27465,70802,3159,9683,12111,26465,15270,36148
411530,202301,1142,2735,643,1822,87,276,126,317,213,593
411535,202301,629,1733,423,1294,45,142,121,327,166,469
411540,202301,3300,7418,2331,5757,132,344,1420,3304,1552,3648
411545,202301,1090,2896,917,2592,74,234,587,1614,661,1848
411550,202301,848,1976,645,1623,96,260,221,474,317,734
411560,202301,2378,6240,1328,4006,189,591,100,212,289,803
411570,202301,9591,20684,6823,16646,1527,4071,2258,4957,3785,9028
411573,202301,964,2385,776,2070,123,389,419,989,542,1378
411575,202301,2484,6120,1833,4938,328,944,585,1420,913,2364
411580,202301,5413,12423,3303,9003,450,1401,560,1127,1010,2528
411585,202301,729,2062,384,1224,61,191,53,150,114,341
411590,202301,572,1428,428,1156,44,142,228,545,272,687
411600,202301,423,984,276,753,42,111,111,263,153,374
411605,202301,1944,4155,1263,3134,154,442,602,1500,756,1942
411610,202301,3616,7339,2633,5715,64,208,1984,3890,2048,4098
411620,202301,3734,8760,3083,7791,549,1449,1474,3655,2023,5104
411630,202301,1052,2498,707,1914,106,359,285,638,391,997
411640,202301,559,1394,376,1019,48,132,130,289,178,421
411650,202301,236,645,153,475,25,82,38,98,63,180
411660,202301,1057,2494,741,1913,102,273,295,657,397,930
411670,202301,1887,4152,1273,3109,122,321,722,1575,844,1896
411680,202301,1742,4340,1303,3528,246,744,459,1097,705,1841
411690,202301,4916,11558,3637,9425,788,2042,1110,2857,1898,4899
411695,202301,775,2143,534,1565,49,153,232,610,281,763
411700,202301,1978,4874,1361,3733,317,919,302,741,619,1660
411705,202301,2996,7515,2531,6775,401,1120,1562,4179,1963,5299
411710,202301,2610,6187,1822,4795,380,1048,537,1212,917,2260
411720,202301,1272,2946,901,2303,134,348,310,707,444,1055
411721,202301,1193,2828,875,2270,148,393,265,618,413,1011
411722,202301,1155,3013,702,2007,121,361,250,572,371,933
411725,202301,1563,4150,1017,3099,231,766,234,621,465,1387
411727,202301,1710,4464,1127,3288,219,654,135,274,354,928
411729,202301,703,1702,417,1165,61,198,106,216,167,414
411730,202301,6850,16464,5273,13563,1072,3122,2182,5157,3254,8279
411740,202301,590,1473,329,941,76,196,69,154,145,350
411745,202301,950,2564,676,1987,95,310,158,342,253,652
411750,202301,7944,19159,5943,15564,761,2198,2971,7208,3732,9406
411760,202301,9295,22195,7027,18679,2079,5804,1471,3909,3550,9713
411770,202301,4004,10713,3001,8666,642,1978,661,1659,1303,3637
411780,202301,3231,8287,2743,7498,716,1987,920,2600,1636,4587
411790,202301,3891,8701,2457,6280,326,993,973,2035,1299,3028
411800,202301,1427,3818,1058,2985,191,598,259,563,450,1161
411810,202301,1888,4555,1398,3658,215,602,518,1166,733,1768
411820,202301,21054,50034,17861,44957,4005,10346,9328,22501,13333,32847
411830,202301,590,1437,431,1151,104,236,61,163,165,399
411840,202301,15689,38515,11198,29911,1656,4886,4190,9512,5846,14398
411845,202301,788,2078,498,1458,75,256,137,337,212,593
411850,202301,10070,23735,7083,18792,1854,5289,1374,3012,3228,8301
411860,202301,923,2420,693,1972,113,347,145,383,258,730
411870,202301,730,1971,543,1588,135,455,100,214,235,669
411880,202301,3003,6591,2170,5300,326,874,969,2127,1295,3001
411885,202301,1299,3231,936,2594,125,394,247,547,372,941
411890,202301,1834,4579,1335,3745,233,712,147,383,380,1095
411900,202301,1034,2619,645,1835,174,511,78,198,252,709
411910,202301,1343,3721,971,2974,189,670,305,813,494,1483
411915,202301,20533,47016,14489,36473,2121,5964,6256,13745,8377,19709
411920,202301,1458,3829,1198,3384,279,881,445,1104,724,1985
411925,202301,587,1418,396,1071,72,201,186,450,258,651
411930,202301,6294,17106,5364,15552,2607,7933,571,1785,3178,9718
411940,202301,4109,10897,3255,9259,741,2167,1153,2910,1894,5077
411950,202301,19623,47783,16526,42945,1890,5752,10421,25211,12311,30963
411960,202301,7365,17984,5826,15219,1058,3098,2302,5260,3360,8358
411965,202301,609,1554,444,1228,63,186,207,503,270,689
411970,202301,1433,2925,1109,2505,215,411,502,1324,717,1735
411980,202301,2069,4480,1527,3687,296,731,728,1618,1024,2349
411990,202301,50572,122154,34731,94995,6023,18213,14273,35407,20296,53620
411995,202301,6260,13964,4823,11830,1304,3601,1486,3311,2790,6912
412000,202301,2415,5030,1752,3968,40,120,1330,2757,1370,2877
412010,202301,741,2054,489,1517,58,205,118,266,176,471
412015,202301,631,1647,510,1428,81,239,258,705,339,944
412020,202301,567,1524,349,1081,51,182,106,290,157,472
412030,202301,778,2033,592,1704,81,248,272,704,353,952
412033,202301,1129,2781,794,2178,96,274,320,758,416,1032
412035,202301,842,2162,543,1630,94,298,242,683,336,981
412040,202301,865,2159,555,1566,85,258,143,312,228,570
412050,202301,1752,4139,1222,3239,303,905,240,593,543,1498
412060,202301,9038,23818,7357,20637,1921,6123,2013,5068,3934,11191
412065,202301,768,1922,553,1521,95,281,148,367,243,648
412070,202301,1605,3780,1253,3153,141,408,591,1240,732,1648
412080,202301,3323,7935,2486,6418,299,876,1279,2756,1578,3632
412085,202301,404,949,169,494,11,40,44,90,55,130
412090,202301,8016,18540,5956,15159,1258,3542,2557,6209,3815,9751
412100,202301,2286,5593,1693,4612,503,1495,399,1093,902,2588
412110,202301,1155,2857,718,1997,77,233,219,496,296,729
412120,202301,2859,7284,2230,6218,462,1471,682,1600,1144,3071
412125,202301,953,2479,576,1711,89,245,128,356,217,601
412130,202301,951,2251,633,1678,115,309,139,343,254,652
412135,202301,694,1762,349,1019,42,146,134,324,176,470
412140,202301,2461,5567,1776,4427,299,804,443,1052,742,1856
412150,202301,3423,8115,2849,7145,523,1503,1431,3136,1954,4639
412160,202301,1098,3278,588,1912,38,124,49,108,87,232
412170,202301,5722,13980,4793,12593,883,2535,2288,5350,3171,7885
412175,202301,1608,4277,1320,3770,309,915,436,1202,745,2117
412180,202301,2089,5366,1550,4420,216,707,604,1542,820,2249
412190,202301,3955,9353,2833,7411,352,1060,1179,2763,1531,3823
412200,202301,2355,6226,1559,4511,397,1262,304,748,701,2010
412210,202301,790,1790,492,1319,66,199,222,533,288,732
412215,202301,4112,10163,2950,7935,633,1803,1289,3405,1922,5208
412217,202301,1239,2861,1010,2481,16,55,771,1741,787,1796
412220,202301,7400,19960,5954,17346,1356,3973,1547,4338,2903,8311
412230,202301,3418,9168,2657,7801,384,1309,474,1156,858,2465
412240,202301,9942,24317,6669,18284,1163,3454,2078,4830,3241,8284
412250,202301,2368,5772,1732,4639,418,1207,341,732,759,1939
412260,202301,1669,3995,1271,3258,224,579,425,974,649,1553
412265,202301,1262,2969,1015,2598,122,353,639,1495,761,1848
412270,202301,1302,3374,891,2537,115,362,356,870,471,1232
412280,202301,508,1319,387,1108,81,230,86,208,167,438
412290,202301,1303,3027,964,2469,166,460,371,868,537,1328
412300,202301,2198,5233,1642,4339,279,780,525,1204,804,1984
412310,202301,796,2186,576,1746,98,362,158,387,256,749
412320,202301,892,2177,561,1529,52,192,185,457,237,649
412330,202301,1964,4802,1308,3654,255,773,336,866,591,1639
412340,202301,1465,3713,1041,2919,158,487,142,361,300,848
412350,202301,3897,9669,2579,7191,445,1353,698,1619,1143,2972
412360,202301,351,836,269,689,6,21,189,456,195,477
412370,202301,1388,3493,975,2740,198,572,230,599,428,1171
412380,202301,1821,4784,1321,3839,314,970,76,236,390,1206
412382,202301,612,1412,408,1090,45,158,208,445,253,603
412385,202301,2892,6925,2290,5860,636,1586,818,2142,1454,3728
412390,202301,3047,6891,2381,5845,440,1156,753,1731,1193,2887
412395,202301,923,2324,653,1775,87,239,323,807,410,1046
412400,202301,1149,2780,809,2162,138,400,256,574,394,974
412402,202301,2963,6813,2078,5435,453,1160,580,1508,1033,2668
412405,202301,3707,9345,2464,7143,670,1928,371,989,1041,2917
412410,202301,8010,19490,5929,16233,1058,3341,1912,4707,2970,8048
412420,202301,634,1492,404,1054,41,122,153,356,194,478
412430,202301,651,1584,360,997,51,133,135,350,186,483
412440,202301,3676,8858,2602,7080,579,1620,771,1971,1350,3591
412450,202301,646,1773,426,1266,52,162,42,77,94,239
412460,202301,1429,3237,1101,2727,205,552,488,1133,693,1685
412470,202301,1953,5563,1626,4893,385,1316,451,1198,836,2514
412480,202301,1657,3822,1144,2882,189,518,456,980,645,1498
412490,202301,1633,3681,1251,3058,82,241,741,1615,823,1856
412500,202301,2523,5858,1874,4752,309,861,617,1348,926,2209
412510,202301,2362,6609,1716,5120,448,1441,291,656,739,2097
412520,202301,1707,4088,1064,2869,205,544,152,365,357,909
412530,202301,836,2104,611,1699,109,309,142,351,251,660
412535,202301,972,2463,587,1699,83,257,72,146,155,403
412540,202301,1288,3142,917,2518,169,586,215,548,384,1134
412545,202301,889,2161,590,1597,101,292,194,493,295,785
412550,202301,46798,113945,34828,91998,4928,14415,16470,38258,21398,52673
412555,202301,354,856,244,637,27,90,81,150,108,240
412560,202301,6647,17188,5004,13794,1209,3706,1122,2605,2331,6311
412570,202301,5260,12233,3242,8622,537,1634,621,1284,1158,2918
412575,202301,1396,3135,1111,2682,253,591,517,1135,770,1726
412580,202301,1956,4551,1415,3635,124,358,784,1787,908,2145
412590,202301,547,1363,303,854,57,179,39,76,96,255
412600,202301,2110,4958,1679,4183,95,309,1104,2491,1199,2800
412610,202301,1016,2554,750,2023,98,272,335,773,433,1045
412620,202301,1563,3723,1224,3219,237,677,507,1200,744,1877
412625,202301,11674,29211,7958,22289,1533,4592,1174,2654,2707,7246
412627,202301,1398,3639,982,2861,237,773,198,513,435,1286
412630,202301,3359,9259,2375,7242,384,1288,549,1434,933,2722
412635,202301,561,1393,346,995,56,167,98,228,154,395
412640,202301,1196,3004,703,2006,104,297,125,271,229,568
412650,202301,2069,5277,1634,4431,268,816,630,1485,898,2301
412660,202301,3526,8264,2515,6458,291,831,966,2142,1257,2973
412665,202301,512,1204,395,1008,80,222,154,356,234,578
412667,202301,2049,5145,1505,4118,230,705,615,1573,845,2278
412670,202301,1161,2476,802,1931,139,398,331,647,470,1045
412680,202301,2556,6393,1748,4952,199,649,510,1166,709,1815
412690,202301,1413,3377,992,2604,180,524,361,809,541,1333
412700,202301,2284,5515,1887,4903,386,1112,882,2087,1268,3199
412710,202301,6869,18462,5177,15156,877,2816,1417,3311,2294,6127
412720,202301,1599,4263,1307,3710,196,615,412,890,608,1505
412730,202301,3369,8049,2508,6494,407,1210,1098,2451,1505,3661
412740,202301,2502,6503,1730,5102,314,1033,288,758,602,1791
412750,202301,4868,11921,3913,10469,495,1467,2173,5388,2668,6855
412760,202301,3906,9459,3243,8412,620,1865,1754,4160,2374,6025
412770,202301,15082,37084,8868,25448,1117,3469,2168,5018,3285,8487
412780,202301,1551,3734,1140,3050,267,798,363,845,630,1643
412785,202301,2722,5845,1900,4555,253,648,1221,2763,1474,3411
412788,202301,1702,4474,1378,3933,363,1065,499,1321,862,2386
412790,202301,1677,4088,1081,3008,166,522,423,953,589,1475
412795,202301,1493,3604,889,2487,134,402,215,518,349,920
412796,202301,2730,7269,2299,6569,507,1549,722,1844,1229,3393
412800,202301,5218,11289,3814,8913,375,1105,2141,4266,2516,5371
412810,202301,16464,39034,11297,29399,1255,3738,4848,10816,6103,14554
412820,202301,7820,20004,5605,15776,1363,4078,1495,3929,2858,8007
412830,202301,413,1091,318,912,35,98,87,222,122,320
412840,202301,2433,5268,1760,4075,139,406,1116,2243,1255,2649
412850,202301,3384,8204,2563,6935,277,894,1300,3140,1577,4034
412853,202301,2020,4551,1696,4035,204,570,976,1972,1180,2542
412855,202301,1656,4023,903,2496,120,357,203,431,323,788
412860,202301,911,2187,602,1693,105,325,229,555,334,880
412862,202301,793,1900,536,1479,96,256,216,542,312,798
412863,202301,1553,4199,1370,3874,284,901,666,1683,950,2584
412865,202301,822,2101,602,1673,153,444,152,385,305,829
412870,202301,1196,2856,858,2329,247,763,229,588,476,1351
412880,202301,1153,2927,852,2403,182,555,302,755,484,1310
420005,202301,548,1519,328,990,30,81,153,449,183,530
420010,202301,3944,8915,2630,6709,170,479,1905,4794,2075,5273
420020,202301,527,1549,375,1182,71,261,127,306,198,567
420030,202301,150,504,112,406,29,115,27,96,56,211
420040,202301,727,2118,455,1518,82,314,35,94,117,408
420050,202301,950,2168,658,1620,108,312,382,807,490,1119
420055,202301,209,591,127,395,20,79,52,138,72,217
420060,202301,236,622,175,490,25,76,85,215,110,291
420070,202301,1088,2969,865,2549,170,552,446,1214,616,1766
420075,202301,105,276,57,170,9,29,20,40,29,69
420080,202301,513,1416,367,1066,68,207,96,245,164,452
420090,202301,559,1635,369,1198,77,272,86,223,163,495
420100,202301,1859,4154,1517,3624,104,253,1121,2647,1225,2900
420110,202301,367,1084,312,966,46,163,173,510,219,673
420120,202301,790,2044,558,1570,73,236,268,677,341,913
420125,202301,459,1329,330,1040,67,212,101,294,168,506
420127,202301,403,1042,189,560,30,105,66,177,96,282
420130,202301,5992,15547,4610,13176,897,2925,1874,4556,2771,7481
420140,202301,5888,14724,4578,12514,1240,3786,1186,2832,2426,6618
420150,202301,872,2117,649,1769,54,169,357,923,411,1092
420160,202301,263,631,120,349,20,73,39,100,59,173
420165,202301,220,635,141,451,30,109,36,86,66,195
420170,202301,404,1133,316,934,51,166,140,348,191,514
420180,202301,192,595,109,394,16,73,28,89,44,162
420190,202301,262,742,161,496,30,92,49,136,79,228
420195,202301,2512,6101,1975,5242,471,1438,904,2140,1375,3578
420200,202301,9907,22089,6691,16368,818,2319,3265,6580,4083,8899
420205,202301,2757,6792,1908,5137,266,795,978,2433,1244,3228
420207,202301,2830,6800,1896,5094,335,1025,793,1863,1128,2888
420208,202301,435,1198,272,870,89,291,53,128,142,419
420209,202301,213,637,132,412,13,48,66,181,79,229
420210,202301,5506,13257,4027,10743,630,1903,2069,5032,2699,6935
420213,202301,1016,2802,823,2395,158,497,323,889,481,1386
420215,202301,300,844,212,656,53,169,61,177,114,346
420220,202301,436,1251,303,975,51,196,115,310,166,506
420230,202301,7766,19110,6178,16273,736,2241,3508,8415,4244,10656
420240,202301,20239,53088,13712,38488,1666,5435,6224,14482,7890,19917
420243,202301,597,1409,490,1218,79,226,314,742,393,968
420245,202301,2605,6070,2025,5110,169,500,1261,2927,1430,3427
420250,202301,807,1792,709,1658,47,152,565,1238,612,1390
420253,202301,592,1358,429,1121,39,100,257,660,296,760
420257,202301,213,518,149,406,26,83,69,182,95,265
420260,202301,1562,3599,1193,3106,91,290,888,2237,979,2527
420270,202301,726,1790,382,1011,40,113,167,387,207,500
420280,202301,1956,5242,1561,4421,198,667,743,1887,941,2554
420285,202301,198,543,119,349,18,67,35,69,53,136
420287,202301,592,1282,419,1045,74,200,182,429,256,629
420290,202301,7188,18904,5767,15992,804,2601,3307,8239,4111,10840
420300,202301,10061,26801,5996,17544,1078,3404,1788,4462,2866,7866
420310,202301,1062,2260,637,1563,64,180,331,719,395,899
420315,202301,1171,3004,764,2204,92,288,386,1020,478,1308
420320,202301,8077,20298,6201,17358,1730,5205,1890,4842,3620,10047
420325,202301,417,1121,297,881,41,142,114,286,155,428
420330,202301,1349,3740,882,2717,163,550,272,723,435,1273
420340,202301,1548,3693,1206,3117,275,755,479,1068,754,1823
420350,202301,1766,3898,1365,3223,152,401,912,2044,1064,2445
420360,202301,3749,9795,2109,6372,353,1154,179,480,532,1634
420370,202301,1748,4192,1422,3639,117,385,995,2342,1112,2727
420380,202301,5809,14246,4126,11248,741,2315,1813,4419,2554,6734
420390,202301,1402,3411,1020,2678,186,552,351,624,537,1176
420395,202301,1593,4177,1160,3382,165,534,224,472,389,1006
420400,202301,1487,3702,1075,2933,130,399,579,1449,709,1848
420410,202301,743,1837,547,1438,70,193,307,783,377,976
420415,202301,443,1192,319,908,62,194,137,369,199,563
420417,202301,787,2211,614,1842,142,411,277,862,419,1273
420419,202301,187,611,137,474,43,161,13,52,56,213
420420,202301,18811,46306,13417,36376,3275,10055,4529,10638,7804,20693
420425,202301,796,2095,562,1602,54,181,286,762,340,943
420430,202301,4291,10815,2812,7756,453,1428,1169,2716,1622,4144
420435,202301,450,1125,269,783,58,176,124,342,182,518
420440,202301,1080,2623,733,1913,245,596,239,606,484,1202
420445,202301,295,683,185,483,29,82,60,119,89,201
420450,202301,1097,3016,832,2455,147,525,331,818,478,1343
420455,202301,2685,5997,2004,4980,484,1205,786,1959,1270,3164
420460,202301,12759,31425,10077,26709,1348,4149,5667,13687,7015,17836
420470,202301,823,2078,476,1316,79,248,123,260,202,508
420475,202301,86,227,39,123,6,23,10,29,16,52
420480,202301,7241,16952,4828,12886,846,2395,2046,5142,2892,7537
420490,202301,495,1307,349,985,53,176,154,385,207,561
420500,202301,1725,4429,1166,3425,201,706,540,1428,741,2134
420510,202301,167,458,112,337,19,71,35,77,54,148
420515,202301,162,448,121,356,16,59,42,92,58,151
420517,202301,913,2194,767,1930,87,227,451,1111,538,1338
420519,202301,387,956,273,768,32,98,129,350,161,448
420520,202301,367,973,204,655,27,98,8,14,35,112
420530,202301,977,2807,683,2164,125,459,211,540,336,999
420535,202301,264,733,106,337,11,37,28,69,39,106
420540,202301,52683,119486,38116,95728,4993,14601,16351,34686,21344,49287
420543,202301,300,825,234,676,30,105,96,236,126,341
420545,202301,1917,5500,1463,4493,291,947,546,1500,837,2447
420550,202301,5504,13389,3616,10007,584,1744,1487,3814,2071,5558
420555,202301,429,1163,295,886,37,133,150,403,187,536
420560,202301,540,1199,392,996,54,145,215,533,269,678
420570,202301,3923,9383,2993,7736,472,1418,1592,3719,2064,5137
420580,202301,2239,5916,1590,4805,374,1242,471,1279,845,2521
420590,202301,3888,10015,2564,7231,396,1272,738,1645,1134,2917
420600,202301,1662,4208,1368,3681,108,399,894,2200,1002,2599
420610,202301,717,1866,498,1438,110,311,228,631,338,942
420620,202301,1066,2598,753,2073,134,402,296,773,430,1175
420630,202301,1322,3776,960,2910,152,519,420,1146,572,1665
420640,202301,606,1630,327,1043,79,256,18,44,97,300
420650,202301,4581,11321,3173,8521,447,1398,1410,3079,1857,4477
420660,202301,557,1360,352,926,58,162,67,138,125,300
420665,202301,917,2234,625,1733,103,321,276,647,379,968
420670,202301,1538,4181,929,2841,88,305,189,423,277,728
420675,202301,262,650,171,497,15,57,102,265,117,322
420680,202301,357,756,203,544,22,82,116,275,138,357
420690,202301,1192,3217,808,2336,113,357,266,624,379,981
420700,202301,4095,10092,3243,8612,269,823,2162,5400,2431,6223
420710,202301,1407,3809,1156,3289,154,520,645,1582,799,2102
420720,202301,1720,4377,1313,3650,198,609,770,1964,968,2573
420730,202301,4763,11566,3728,9876,632,1903,1893,4545,2525,6448
420740,202301,602,1661,356,1122,79,272,63,161,142,433
420750,202301,2777,7623,1911,5700,297,1078,717,1839,1014,2917
420757,202301,139,348,68,209,8,26,33,99,41,125
420760,202301,491,1345,269,774,43,127,82,192,125,319
420765,202301,715,1951,387,1142,57,193,196,552,253,745
420768,202301,1756,4443,1469,3933,177,467,1033,2725,1210,3192
420770,202301,401,1066,178,609,16,64,30,79,46,143
420775,202301,375,984,233,709,42,142,82,215,124,357
420780,202301,1242,3312,781,2288,143,401,131,345,274,746
420785,202301,281,689,207,546,17,50,92,182,109,232
420790,202301,1422,3796,1120,3176,213,748,634,1559,847,2307
420800,202301,970,2195,613,1550,149,399,311,721,460,1120
420810,202301,1921,5351,1602,4744,380,1336,740,1850,1120,3186
420820,202301,18418,43841,13915,36753,1976,5751,7150,17353,9126,23104
420830,202301,6484,15912,4969,13305,845,2586,2140,5254,2985,7840
420840,202301,755,2275,416,1434,72,272,37,117,109,389
420845,202301,3906,9451,2776,7529,528,1709,1213,2980,1741,4689
420850,202301,1328,3896,977,3049,176,606,296,770,472,1376
420860,202301,486,1244,303,912,79,247,79,209,158,456
420870,202301,1045,2767,723,2126,155,483,246,660,401,1143
420880,202301,1540,4292,1237,3708,254,837,503,1361,757,2198
420890,202301,9943,25774,6456,18608,916,2934,2172,5261,3088,8195
420895,202301,238,668,152,453,25,81,66,172,91,253
420900,202301,2078,4939,1312,3586,165,559,581,1300,746,1859
420910,202301,45993,114708,32378,90025,4812,15362,14345,34102,19157,49464
420915,202301,571,1933,461,1663,75,301,219,772,294,1073
420917,202301,609,1460,305,760,48,98,168,404,216,502
420920,202301,111,279,49,146,3,7,10,24,13,31
420930,202301,23512,55279,17783,45581,2424,7170,9790,22560,12214,29730
420940,202301,4599,10662,3076,8162,602,1837,890,1796,1492,3633
420945,202301,241,702,145,432,26,87,57,144,83,231
420950,202301,510,1355,341,989,58,199,98,228,156,427
420960,202301,1388,3281,1017,2676,161,495,443,997,604,1492
420970,202301,2933,7388,2054,5812,412,1214,643,1814,1055,3028
420980,202301,325,1070,271,944,88,325,56,184,144,509
420985,202301,481,1261,279,859,53,182,73,189,126,371
420990,202301,456,1302,288,907,50,163,60,150,110,313
421000,202301,724,2092,496,1581,107,353,94,236,201,589
421003,202301,548,1312,203,585,15,41,15,33,30,74
421005,202301,131,370,92,283,14,42,37,116,51,158
421010,202301,4803,12039,3553,9790,594,1940,1346,2970,1940,4910
421020,202301,506,1487,400,1278,57,224,208,605,265,829
421030,202301,1329,3496,1024,2893,218,683,398,1012,616,1695
421040,202301,866,1996,518,1424,56,168,317,818,373,986
421050,202301,1547,3977,1044,2857,165,519,381,820,546,1339
421055,202301,208,565,127,390,20,71,53,135,73,206
421060,202301,927,2467,682,1944,118,387,305,734,423,1121
421070,202301,828,2275,519,1526,96,313,225,566,321,879
421080,202301,666,1833,534,1573,85,302,227,603,312,905
421085,202301,424,1168,198,647,23,76,33,90,56,166
421090,202301,380,949,225,607,21,77,92,194,113,271
421100,202301,1097,2326,520,1400,83,236,136,310,219,546
421105,202301,1986,4992,1443,3994,273,793,592,1508,865,2301
421110,202301,1672,3934,1406,3561,127,390,913,2225,1040,2615
421120,202301,1395,3972,1012,3156,131,448,327,861,458,1309
421125,202301,487,1172,352,881,90,239,145,333,235,572
421130,202301,8105,21362,6808,18894,1255,3856,3560,9074,4815,12930
421140,202301,455,1196,311,909,76,217,112,294,188,511
421145,202301,518,1327,353,997,93,292,101,233,194,525
421150,202301,978,2603,683,1993,125,412,278,673,403,1085
421160,202301,817,2112,645,1775,88,292,399,991,487,1283
421165,202301,292,819,185,549,31,91,60,143,91,234
421170,202301,1519,3741,1311,3421,119,327,964,2472,1083,2799
421175,202301,1345,3371,822,2442,155,531,328,901,483,1432
421180,202301,503,1226,292,815,33,110,145,339,178,449
421185,202301,404,988,289,767,43,126,136,311,179,437
421187,202301,331,990,214,701,39,121,73,235,112,356
421189,202301,502,1358,387,1136,56,188,157,405,213,593
421190,202301,18173,45815,13850,37650,2282,7114,6364,15138,8646,22252
421200,202301,1000,2572,776,2136,100,324,423,1091,523,1415
421205,202301,298,757,232,646,47,141,88,230,135,371
421210,202301,1406,3399,806,2346,171,485,264,714,435,1199
421220,202301,1809,4935,1445,4213,377,1175,482,1253,859,2428
421223,202301,512,1247,345,959,67,203,189,487,256,690
421225,202301,1347,3514,1173,3243,133,453,779,2075,912,2528
421227,202301,898,2378,585,1731,118,373,228,651,346,1024
421230,202301,803,2006,560,1574,105,327,202,525,307,852
421240,202301,329,936,160,536,22,98,33,85,55,183
421250,202301,3296,7875,2498,6598,403,1065,1445,3618,1848,4683
421260,202301,331,1014,97,310,17,55,11,23,28,78
421265,202301,1210,2701,1044,2475,89,203,847,1983,936,2186
421270,202301,480,1254,251,785,60,204,87,250,147,454
421280,202301,3293,8095,2544,6853,389,1190,1308,3258,1697,4448
421290,202301,1411,3654,705,2002,110,331,141,339,251,670
421300,202301,409,1068,208,643,29,95,35,94,64,189
421310,202301,301,805,206,606,65,196,74,190,139,386
421315,202301,375,942,236,655,49,144,78,192,127,336
421320,202301,795,2407,459,1469,39,122,60,99,99,221
421330,202301,767,2140,514,1579,104,337,148,407,252,744
421335,202301,505,1446,407,1259,61,210,198,577,259,787
421340,202301,1811,4793,1282,3853,203,677,521,1431,724,2108
421350,202301,2178,5160,1475,4010,289,830,536,1400,825,2230
421360,202301,2808,7095,1734,4982,431,1445,549,1175,980,2620
421370,202301,960,2909,629,2055,104,381,195,510,299,891
421380,202301,1102,2573,968,2375,86,261,673,1555,759,1816
421390,202301,203,541,89,294,25,86,22,62,47,148
421400,202301,808,2062,554,1569,95,306,253,633,348,939
421410,202301,236,656,133,440,35,101,31,135,66,236
421415,202301,254,660,184,497,20,60,67,159,87,219
421420,202301,775,2043,566,1586,69,213,275,695,344,908
421430,202301,119,347,81,254,11,34,14,30,25,64
421440,202301,855,2227,534,1604,105,314,208,589,313,903
421450,202301,557,1597,365,1162,46,155,43,136,89,291
421460,202301,431,1281,243,855,14,46,19,49,33,95
421470,202301,467,1254,341,1021,46,144,109,323,155,467
421480,202301,4091,10329,2912,7991,381,1237,1287,3109,1668,4346
421490,202301,146,453,95,322,13,52,22,63,35,115
421500,202301,3054,8253,2202,6509,444,1504,649,1541,1093,3045
421505,202301,400,996,332,894,33,108,206,534,239,642
421507,202301,536,1371,330,937,51,158,140,348,191,506
421510,202301,521,1372,354,996,45,152,153,337,198,489
421520,202301,561,1461,327,910,49,132,110,253,159,385
421530,202301,419,1224,253,855,34,152,51,118,85,270
421535,202301,561,1413,356,986,48,144,190,475,238,619
421540,202301,447,1002,271,723,23,77,107,264,130,341
421545,202301,852,2372,653,2007,126,444,296,818,422,1262
421550,202301,2870,7191,2219,6044,356,1055,1156,2958,1512,4013
421555,202301,274,750,83,259,12,40,15,25,27,65
421560,202301,123,388,75,256,14,55,22,56,36,111
421565,202301,1276,3114,930,2548,215,653,374,923,589,1576
421567,202301,634,1839,473,1412,135,435,123,349,258,784
421568,202301,388,1097,213,665,40,147,63,175,103,322
421569,202301,196,538,91,270,11,40,46,116,57,156
421570,202301,1999,5239,1459,4112,269,850,594,1411,863,2261
421575,202301,404,1099,300,831,37,129,156,374,193,503
421580,202301,6275,16026,4150,11572,583,1867,1720,3992,2303,5859
421590,202301,232,620,179,512,40,127,78,206,118,333
421600,202301,759,1879,511,1375,83,254,192,417,275,671
421605,202301,875,2195,640,1812,111,306,256,721,367,1027
421610,202301,1268,3194,892,2500,173,550,342,865,515,1415
421620,202301,5001,12441,3496,9797,656,2119,1468,3631,2124,5750
421625,202301,157,441,85,259,11,30,22,55,33,85
421630,202301,3660,9122,2471,6907,405,1286,832,1978,1237,3264
421635,202301,558,1418,381,1061,30,109,223,525,253,634
421640,202301,904,2251,663,1888,161,459,316,855,477,1314
421650,202301,3475,8730,2416,6892,480,1575,784,1921,1264,3496
421660,202301,16096,41297,12158,33874,1655,5369,6153,15145,7808,20514
421670,202301,1169,3088,821,2259,154,474,343,815,497,1289
421680,202301,2274,4517,1897,3951,121,334,1500,2887,1621,3221
421690,202301,1906,5192,1356,4084,253,817,358,979,611,1796
421700,202301,795,2236,526,1601,85,280,147,359,232,639
421710,202301,268,810,154,486,17,57,64,180,81,237
421715,202301,209,518,158,395,27,84,95,207,122,291
421720,202301,2682,6951,1633,4743,342,1099,460,1091,802,2190
421725,202301,374,893,212,589,30,90,94,214,124,304
421730,202301,685,1911,464,1315,74,213,207,524,281,737
421740,202301,1081,2872,756,2213,131,417,292,705,423,1122
421750,202301,1224,2840,681,1866,146,439,212,520,358,959
421755,202301,216,583,123,359,20,67,43,103,63,170
421760,202301,1374,3383,907,2549,169,541,331,795,500,1336
421770,202301,3234,7938,2338,6406,422,1185,902,2315,1324,3500
421775,202301,262,680,162,474,18,59,51,112,69,171
421780,202301,1205,3176,827,2417,142,440,357,911,499,1351
421790,202301,1152,2963,635,1947,124,388,189,505,313,893
421795,202301,261,739,178,537,29,98,52,132,81,230
421800,202301,4250,10750,3209,8856,508,1548,1561,3925,2069,5473
421810,202301,741,1911,508,1484,60,179,248,703,308,882
421820,202301,1428,3901,990,2911,174,603,308,737,482,1340
421825,202301,2042,4603,1717,4113,121,325,1247,2903,1368,3228
421830,202301,2425,6662,1816,5416,384,1239,411,1131,795,2370
421835,202301,323,740,229,583,30,82,133,323,163,405
421840,202301,438,1312,350,1108,73,266,98,277,171,543
421850,202301,490,1379,289,971,52,178,51,131,103,309
421860,202301,313,800,176,531,24,85,61,134,85,219
421870,202301,6779,15890,5184,12922,574,1790,3121,6750,3695,8540
421875,202301,394,1149,170,531,24,76,36,95,60,171
421880,202301,847,2284,570,1676,113,315,145,389,258,704
421885,202301,360,966,212,616,33,94,73,185,106,279
421890,202301,1322,3401,988,2773,143,504,590,1502,733,2006
421895,202301,534,1287,461,1171,52,110,294,773,346,883
421900,202301,1393,3497,1026,2704,123,388,485,1052,608,1440
421910,202301,419,1230,228,755,32,139,44,110,76,249
421915,202301,497,1330,307,888,72,225,57,123,129,348
421917,202301,799,1764,459,1275,110,327,105,289,215,616
421920,202301,523,1499,362,1151,110,362,102,315,212,677
421930,202301,4162,9946,2506,6912,453,1362,846,1979,1299,3341
421935,202301,539,1501,439,1303,106,296,235,700,341,996
421940,202301,444,1256,224,680,36,115,66,165,102,280
421950,202301,4202,10233,2577,7157,457,1407,741,1676,1198,3083
421960,202301,192,463,111,322,14,38,38,94,52,132
421970,202301,2615,6451,1673,4517,301,943,687,1564,988,2507
421985,202301,405,1063,284,813,31,98,137,361,168,459
422000,202301,2554,5954,2029,5196,167,523,1390,3440,1557,3963
430003,202301,752,1871,536,1505,90,276,264,713,354,989
430005,202301,442,1012,334,838,15,47,236,538,251,585
430010,202301,2318,4917,1732,4052,332,755,905,2117,1237,2872
430020,202301,701,1514,523,1269,60,174,326,727,386,901
430030,202301,1323,2915,781,1948,111,293,432,983,543,1276
430040,202301,12391,27164,8080,20256,2079,5595,2199,4924,4278,10519
430045,202301,687,1509,511,1222,28,84,378,858,406,942
430047,202301,295,634,120,311,19,49,40,101,59,150
430050,202301,1035,2409,647,1692,118,326,290,695,408,1021
430055,202301,326,742,162,423,14,40,80,176,94,216
430057,202301,118,259,59,155,18,46,14,37,32,83
430060,202301,27653,65397,22368,57531,3706,10419,12122,29666,15828,40085
430063,202301,913,2332,763,2059,146,389,427,1132,573,1521
430064,202301,1437,3551,1052,2856,183,530,552,1433,735,1963
430066,202301,133,288,104,240,8,26,84,182,92,208
430070,202301,779,1951,187,568,31,103,28,68,59,171
430080,202301,1157,2730,687,1812,96,308,356,791,452,1099
430085,202301,1160,2285,704,1605,111,289,312,666,423,955
430087,202301,1146,2577,942,2312,82,247,620,1451,702,1698
430090,202301,548,1366,221,696,38,130,47,123,85,253
430100,202301,1314,2975,784,2009,125,353,285,607,410,960
430105,202301,1824,4254,1299,3397,182,569,683,1641,865,2210
430107,202301,202,551,107,311,16,44,29,71,45,115
430110,202301,2755,6264,2096,5293,335,947,1011,2379,1346,3326
430120,202301,1593,4148,1119,3049,188,503,496,1248,684,1751
430130,202301,4414,9171,3296,7678,1133,2616,674,1868,1807,4484
430140,202301,1291,3096,924,2467,150,439,445,1103,595,1542
430150,202301,686,1691,387,1105,75,247,107,267,182,514
430155,202301,285,680,133,383,20,60,23,44,43,104
430160,202301,27596,56252,22426,49388,1721,4489,15971,33250,17692,37739
430163,202301,4393,8744,3163,7029,69,234,2559,5404,2628,5638
430165,202301,400,983,152,464,14,37,22,55,36,92
430170,202301,1126,2803,410,1326,81,313,58,140,139,453
430175,202301,1067,2442,928,2192,166,390,532,1220,698,1610
430180,202301,841,1966,617,1579,129,321,257,641,386,962
430185,202301,776,1897,405,1137,96,291,76,171,172,462
430187,202301,1064,2045,796,1733,89,186,554,1188,643,1374
430190,202301,1842,4234,1447,3637,265,674,671,1577,936,2251
430192,202301,137,353,65,184,12,34,19,43,31,77
430195,202301,523,1436,90,284,7,22,15,35,22,57
430200,202301,1405,3668,1115,3171,308,906,263,778,571,1684
430205,202301,678,1324,632,1242,10,30,593,1131,603,1161
430210,202301,8903,21649,5492,14498,731,2088,1557,3129,2288,5217
430215,202301,417,956,262,665,38,107,117,274,155,381
430220,202301,705,1678,244,734,30,101,80,187,110,288
430222,202301,294,746,202,572,36,104,72,188,108,292
430223,202301,339,813,260,684,27,79,156,384,183,463
430225,202301,37,79,28,64,2,3,17,33,19,36
430230,202301,2568,6124,2162,5565,112,325,1732,4377,1844,4702
430235,202301,549,1393,366,1035,50,151,98,221,148,372
430237,202301,660,1351,500,1113,25,71,398,842,423,913
430240,202301,1682,3732,968,2501,120,366,449,1014,569,1380
430245,202301,942,2255,761,1938,144,348,439,1149,583,1497
430250,202301,1272,2860,932,2322,298,799,237,510,535,1309
430258,202301,157,392,122,331,11,33,55,144,66,177
430260,202301,872,2023,582,1513,65,197,330,820,395,1017
430265,202301,288,780,201,627,26,88,76,233,102,321
430270,202301,4230,8718,3448,7612,381,993,2456,5067,2837,6060
430280,202301,6446,13543,4733,10852,749,1804,2432,5200,3181,7004
430290,202301,2747,5638,2242,5034,172,436,1696,3639,1868,4075
430300,202301,13540,29805,10503,24972,1284,3547,6363,13940,7647,17487
430310,202301,17323,39333,12853,31650,1557,4254,7340,16560,8897,20814
430320,202301,1120,2659,652,1782,61,166,352,919,413,1085
430330,202301,799,1836,486,1246,84,222,164,364,248,586
430340,202301,788,1670,547,1301,77,186,353,797,430,983
430350,202301,10876,24164,8489,20344,1091,2829,5106,11466,6197,14295
430355,202301,407,1064,168,520,31,88,18,45,49,133
430360,202301,1087,2467,680,1791,153,450,198,453,351,903
430367,202301,429,876,275,641,36,115,167,339,203,454
430370,202301,580,1510,251,741,51,153,59,133,110,286
430380,202301,771,1808,411,1180,80,242,95,242,175,484
430390,202301,4406,10130,2986,7707,592,1630,375,725,967,2355
430400,202301,1319,2540,979,2096,136,351,569,1093,705,1444
430410,202301,683,1458,507,1201,46,125,368,833,414,958
430420,202301,3855,8812,3028,7251,383,1100,1877,3978,2260,5078
430430,202301,621,1494,284,829,48,154,47,121,95,275
430435,202301,2228,5024,1663,4076,278,731,818,1916,1096,2647
430440,202301,5851,13727,4816,12126,512,1461,3131,7487,3643,8948
430450,202301,9651,20527,7926,17788,1261,3298,4522,9302,5783,12600
430460,202301,50313,113544,37356,93064,5024,13938,20681,48117,25705,62055
430461,202301,256,651,104,303,20,67,37,88,57,155
430462,202301,380,931,199,574,34,102,56,135,90,237
430463,202301,9201,22062,6883,17981,1324,3902,3168,7639,4492,11541
430465,202301,709,1602,477,1194,78,219,261,623,339,842
430466,202301,6125,13728,4970,12073,808,2156,2868,6380,3676,8536
430467,202301,639,1429,478,1194,48,140,287,656,335,796
430468,202301,1818,4004,1487,3540,96,298,1139,2575,1235,2873
430469,202301,720,1938,147,455,16,46,43,98,59,144
430470,202301,7260,17268,4940,13346,1255,3877,1275,2928,2530,6805
430471,202301,949,2269,816,2052,102,311,554,1272,656,1583
430480,202301,745,1950,485,1413,71,227,149,327,220,554
430485,202301,203,499,105,281,23,50,22,59,45,109
430490,202301,536,1280,316,856,36,103,153,345,189,448
430495,202301,470,1223,324,955,49,158,157,434,206,592
430500,202301,1204,2880,859,2333,273,842,236,537,509,1379
430510,202301,34993,84497,25927,68071,4511,13314,11468,26522,15979,39836
430511,202301,398,1066,159,493,21,57,22,52,43,109
430512,202301,1281,2627,1036,2285,224,538,441,930,665,1468
430513,202301,951,2135,490,1227,62,185,272,586,334,771
430515,202301,470,1188,340,941,41,128,154,390,195,518
430517,202301,1717,4313,1326,3526,215,560,737,1920,952,2480
430520,202301,1617,3854,938,2486,140,390,232,542,372,932
430530,202301,1144,2714,492,1384,78,224,133,341,211,565
430535,202301,4552,10631,3325,8552,470,1274,1675,4051,2145,5325
430537,202301,678,1489,603,1356,63,126,452,989,515,1115
430540,202301,699,1609,431,1171,64,183,228,588,292,771
430543,202301,1321,2225,830,1660,201,376,227,507,428,883
430544,202301,828,2198,557,1627,136,430,178,504,314,934
430545,202301,3204,7381,2456,6305,403,1077,1352,3361,1755,4438
430550,202301,453,1171,335,944,95,254,92,248,187,502
430558,202301,181,395,77,193,3,7,39,89,42,96
430560,202301,352,782,184,521,25,81,61,144,86,225
430570,202301,1023,2299,731,1801,148,461,338,650,486,1111
430580,202301,984,2303,721,1912,171,451,270,754,441,1205
430583,202301,212,517,49,138,5,18,12,19,17,37
430585,202301,250,570,138,357,27,80,43,89,70,169
430587,202301,245,626,186,533,21,67,81,225,102,292
430590,202301,1656,3700,1312,3169,138,350,869,2036,1007,2386
430593,202301,39,107,32,86,6,20,15,31,21,51
430595,202301,488,1197,138,420,16,43,20,34,36,77
430597,202301,543,1282,288,787,25,62,85,172,110,234
430600,202301,2351,5845,1050,2894,154,446,218,514,372,960
430605,202301,1639,3902,1205,3178,172,471,531,1333,703,1804
430607,202301,831,1751,558,1289,41,103,353,769,394,872
430610,202301,7814,16570,5706,13543,1365,3861,2222,4475,3587,8336
430613,202301,305,681,92,258,9,26,25,55,34,81
430620,202301,982,2167,752,1782,145,404,380,749,525,1153
430630,202301,519,1357,177,506,26,74,53,128,79,202
430632,202301,514,1284,224,617,37,103,80,197,117,300
430635,202301,704,1448,519,1141,50,101,369,800,419,901
430637,202301,622,1386,467,1154,40,118,301,685,341,803
430640,202301,1373,3533,952,2721,143,434,350,864,493,1298
430642,202301,437,1159,274,784,42,135,106,270,148,405
430645,202301,197,441,102,247,16,43,34,59,50,102
430650,202301,2271,5550,1706,4676,515,1358,629,1900,1144,3258
430655,202301,380,856,232,576,27,84,134,277,161,361
430660,202301,6664,15166,5139,12814,842,2323,2677,6228,3519,8551
430670,202301,732,1651,531,1312,97,230,232,545,329,775
430673,202301,615,1323,295,781,60,154,107,253,167,407
430675,202301,280,789,67,225,11,39,8,30,19,69
430676,202301,7354,16606,5902,14393,924,2334,3539,8286,4463,10620
430680,202301,1470,3505,980,2584,294,833,334,675,628,1508
430690,202301,4076,9432,3271,8102,987,2527,1286,3080,2273,5607
430692,202301,246,684,198,605,11,32,154,468,165,500
430693,202301,1160,2878,724,2061,155,482,190,493,345,975
430695,202301,467,1053,290,716,50,127,130,284,180,411
430697,202301,630,1421,496,1241,72,193,314,778,386,971
430700,202301,10090,23012,6622,17041,1361,3869,1647,3486,3008,7355
430705,202301,436,966,221,593,25,70,88,207,113,277
430710,202301,2379,4225,1628,3264,79,215,1283,2407,1362,2622
430720,202301,962,2205,520,1436,61,189,271,677,332,866
430730,202301,1147,2918,805,2267,117,337,334,873,451,1210
430740,202301,824,2082,455,1309,78,259,132,332,210,591
430745,202301,607,1332,447,1041,54,184,272,507,326,691
430750,202301,2082,4694,1393,3504,358,907,551,1282,909,2189
430755,202301,562,1299,414,1020,34,103,247,540,281,643
430760,202301,3147,7082,2478,6087,503,1328,1202,2730,1705,4058
430770,202301,9534,21166,7600,18373,842,2340,4943,11348,5785,13688
430780,202301,2652,6102,1813,4747,303,861,893,2196,1196,3057
430781,202301,754,1767,511,1262,163,430,190,382,353,812
430783,202301,425,910,279,693,60,163,138,322,198,485
430786,202301,41,121,27,91,5,15,4,9,9,24
430790,202301,6126,13784,4602,11284,451,1380,2844,6266,3295,7646
430800,202301,1075,2105,825,1774,50,126,634,1285,684,1411
430805,202301,502,1102,355,827,11,38,276,593,287,631
430807,202301,725,1659,438,1134,61,191,185,392,246,583
430810,202301,917,2071,479,1254,67,200,185,401,252,601
430820,202301,1651,4310,990,2931,155,466,295,768,450,1234
430825,202301,308,704,128,308,19,45,49,100,68,145
430830,202301,2500,5640,2083,4922,128,323,1578,3534,1706,3857
430840,202301,1482,3202,1014,2466,139,335,629,1468,768,1803
430843,202301,218,512,101,277,9,22,38,94,47,116
430845,202301,635,1340,430,1009,60,160,258,530,318,690
430850,202301,2937,7187,2050,5597,561,1612,534,1390,1095,3002
430860,202301,1425,3308,758,2037,118,379,308,687,426,1066
430865,202301,689,1613,426,1150,101,309,129,262,230,571
430870,202301,634,1622,287,871,52,160,52,135,104,295
430880,202301,1882,3824,1355,3016,151,408,908,1877,1059,2285
430885,202301,210,534,133,380,14,33,85,244,99,277
430890,202301,1356,3177,882,2391,162,531,104,217,266,748
430900,202301,4045,7682,2864,6084,137,407,2115,4127,2252,4534
430905,202301,1162,2698,803,2077,144,398,315,730,459,1128
430910,202301,2775,6968,2119,5656,322,1026,989,2222,1311,3248
430912,202301,622,1633,405,1184,59,163,222,653,281,816
430915,202301,648,1716,421,1239,115,365,107,307,222,672
430920,202301,34716,78532,28092,68226,3250,8831,18117,41658,21367,50489
430925,202301,108,225,56,140,7,19,26,64,33,83
430930,202301,15413,32362,11508,26769,1307,3389,7191,15582,8498,18971
430940,202301,1560,3721,1081,2820,229,643,429,965,658,1608
430950,202301,1087,2123,732,1573,53,155,532,1026,585,1181
430955,202301,507,1255,145,395,24,66,39,88,63,154
430957,202301,244,699,216,640,40,119,118,354,158,473
430960,202301,1735,3896,1043,2704,253,689,346,800,599,1489
430965,202301,1935,4058,1551,3506,65,150,1214,2726,1279,2876
430970,202301,459,1060,266,715,40,113,123,306,163,419
430975,202301,605,1595,467,1306,76,250,173,419,249,669
430980,202301,526,1145,305,775,39,113,143,308,182,421
430990,202301,763,1900,537,1450,77,233,260,652,337,885
430995,202301,686,1543,502,1257,81,209,273,632,354,841
431000,202301,1680,3790,762,2099,118,332,71,152,189,484
431010,202301,3326,8023,2403,6482,429,1319,894,2014,1323,3333
431020,202301,10834,22310,6591,15801,1013,2895,3109,6350,4122,9245
431030,202301,395,1038,207,649,38,133,28,83,66,216
431033,202301,5197,11322,3574,8819,763,1901,1350,3182,2113,5083
431036,202301,357,769,85,251,5,11,27,62,32,73
431040,202301,1100,2510,727,1919,79,271,416,980,495,1251
431041,202301,512,1112,355,868,61,165,163,339,224,504
431043,202301,462,1109,320,830,27,97,201,450,228,547
431046,202301,124,308,57,159,8,22,11,23,19,45
431050,202301,1574,3427,1146,2785,190,446,631,1508,821,1954
431053,202301,851,2040,467,1319,92,274,152,336,244,610
431055,202301,721,1620,564,1370,54,142,382,931,436,1073
431057,202301,254,712,164,515,32,110,58,159,90,269
431060,202301,7114,16031,5039,12778,1147,3204,1932,4364,3079,7568
431065,202301,579,1328,384,1009,52,152,201,503,253,655
431070,202301,512,1278,319,880,64,190,86,226,150,416
431075,202301,340,838,193,523,35,121,90,190,125,311
431080,202301,783,2051,560,1602,86,258,177,435,263,693
431085,202301,950,2299,521,1368,58,172,225,562,283,734
431087,202301,509,1267,415,1091,52,141,251,634,303,775
431090,202301,488,1102,199,578,33,96,41,112,74,208
431100,202301,5471,10476,4029,8689,359,885,2787,5626,3146,6511
431110,202301,1818,3848,1300,2972,177,456,685,1381,862,1837
431112,202301,796,1870,664,1644,84,233,431,1019,515,1252
431113,202301,632,1486,498,1247,113,296,276,643,389,939
431115,202301,1266,3157,991,2683,112,382,662,1662,774,2044
431120,202301,3367,7850,2311,5944,514,1476,886,1968,1400,3444
431123,202301,427,1038,281,757,46,123,140,362,186,485
431125,202301,1451,3397,1041,2670,283,728,516,1314,799,2042
431127,202301,246,639,76,231,8,29,15,33,23,62
431130,202301,4124,9273,3217,7910,525,1415,1679,3875,2204,5290
431140,202301,7382,16636,4645,11695,575,1621,2101,4400,2676,6021
431142,202301,804,1742,611,1451,83,229,403,913,486,1142
431150,202301,1252,3032,919,2468,133,389,480,1214,613,1603
431160,202301,814,2021,547,1505,140,409,170,418,310,827
431162,202301,687,1609,487,1256,42,145,286,662,328,807
431164,202301,202,460,58,174,5,14,11,25,16,39
431170,202301,569,1416,427,1143,114,292,94,228,208,520
431171,202301,1129,2217,953,2005,164,340,691,1431,855,1771
431173,202301,563,1344,402,1120,117,386,127,296,244,682
431175,202301,1599,3490,1001,2484,143,342,450,1048,593,1390
431177,202301,1165,2724,882,2297,164,475,487,1208,651,1683
431179,202301,384,833,130,370,26,75,39,104,65,179
431180,202301,2942,7144,1858,5076,410,1115,394,898,804,2013
431190,202301,708,1698,306,858,28,85,66,128,94,213
431198,202301,497,1339,407,1171,91,267,166,478,257,745
431200,202301,388,950,121,327,23,57,17,44,40,101
431205,202301,290,716,162,451,48,131,49,128,97,259
431210,202301,790,1697,632,1461,128,305,318,744,446,1049
431213,202301,337,816,256,670,22,63,130,304,152,367
431215,202301,732,1685,383,1064,44,138,175,444,219,582
431217,202301,213,506,145,375,28,81,63,143,91,224
431220,202301,727,1691,465,1225,97,273,232,539,329,812
431225,202301,1942,4010,1512,3365,160,384,1024,2212,1184,2596
431230,202301,896,2264,675,1783,132,409,329,725,461,1134
431235,202301,201,547,32,108,0,0,6,20,6,20
431237,202301,449,1257,347,1050,48,165,177,508,225,673
431238,202301,47,152,39,134,9,38,18,50,27,88
431240,202301,6758,14890,5521,12996,584,1693,3578,7747,4162,9440
431242,202301,385,855,312,720,43,114,187,396,230,510
431244,202301,477,1084,261,644,40,100,117,248,157,348
431245,202301,1590,3468,1059,2587,105,259,527,1187,632,1446
431247,202301,346,789,229,580,36,108,103,212,139,320
431250,202301,2405,5315,1863,4602,418,1005,930,2328,1348,3333
431260,202301,390,994,238,690,23,89,95,247,118,336
431261,202301,336,916,277,814,26,96,158,420,184,516
431262,202301,328,896,177,562,31,113,87,263,118,376
431265,202301,1873,4240,761,2084,130,402,215,469,345,871
431267,202301,303,712,194,511,22,68,116,280,138,348
431270,202301,3528,7250,1930,4645,445,1162,670,1474,1115,2636
431275,202301,187,472,125,333,21,68,70,160,91,228
431280,202301,332,899,155,482,29,90,36,99,65,189
431290,202301,442,1256,299,926,54,178,51,136,105,314
431295,202301,90,222,38,107,10,31,11,27,21,58
431300,202301,352,897,102,293,12,46,34,74,46,120
431301,202301,311,842,89,275,13,40,10,25,23,65
431303,202301,805,1882,493,1293,34,106,218,471,252,577
431306,202301,2821,6312,1784,4598,229,663,747,1642,976,2305
431308,202301,49,136,40,114,15,44,15,38,30,82
431310,202301,649,1568,443,1165,70,175,210,513,280,688
431320,202301,849,2201,526,1565,81,261,167,421,248,682
431330,202301,2321,5165,1323,3449,156,460,667,1522,823,1982
431333,202301,249,639,143,415,23,69,42,111,65,180
431335,202301,42,115,26,84,9,29,1,4,10,33
431337,202301,5130,10619,4328,9487,229,729,3577,7361,3806,8090
431339,202301,549,1290,378,1001,96,241,140,375,236,616
431340,202301,23954,54251,17585,43931,2409,6820,9237,21058,11646,27878
431342,202301,487,1055,361,857,50,127,240,555,290,682
431344,202301,425,1033,242,680,37,100,129,343,166,443
431346,202301,251,600,93,278,18,57,23,54,41,111
431349,202301,1195,2521,810,1797,123,301,480,981,603,1282
431350,202301,6115,13845,4802,11838,620,1721,2912,6654,3532,8375
431360,202301,690,1550,359,936,100,287,104,230,204,517
431365,202301,2996,5890,2373,5080,123,334,1954,3990,2077,4324
431370,202301,6315,13573,4739,11210,851,2250,2603,5759,3454,8009
431380,202301,1143,2789,918,2433,196,546,507,1312,703,1858
431390,202301,3367,7737,2216,5821,224,707,1196,2712,1420,3419
431395,202301,2230,4517,1741,3828,165,386,1228,2567,1393,2953
431400,202301,381,1013,224,662,38,115,44,108,82,223
431402,202301,1117,2272,833,1866,97,239,556,1169,653,1408
431403,202301,236,637,185,540,42,146,67,168,109,314
431405,202301,7160,16944,5654,14514,934,2758,2806,6519,3740,9277
431406,202301,698,1759,466,1280,116,293,152,451,268,744
431407,202301,643,1618,423,1167,68,175,190,498,258,673
431410,202301,24363,54879,17687,44178,2277,6679,10433,23407,12710,30086
431413,202301,294,796,76,231,6,19,25,60,31,79
431415,202301,901,2092,612,1607,114,349,257,581,371,930
431417,202301,658,1342,421,973,63,174,235,514,298,688
431420,202301,2101,4240,1601,3600,120,324,1086,2284,1206,2608
431430,202301,680,1633,355,1009,52,156,116,295,168,451
431440,202301,48097,99603,37203,84035,5562,14566,20822,41570,26384,56136
431442,202301,194,526,96,301,13,44,12,36,25,80
431445,202301,415,1135,134,430,13,44,24,62,37,106
431446,202301,356,951,285,820,30,96,152,416,182,512
431447,202301,920,2218,524,1452,86,234,166,451,252,685
431449,202301,971,2256,651,1677,95,256,333,768,428,1024
431450,202301,3153,5520,2485,4650,204,322,1929,3485,2133,3807
431454,202301,54,170,45,148,9,34,23,71,32,105
431455,202301,662,1481,354,890,35,83,179,404,214,487
431460,202301,3894,8224,2591,6058,517,1299,1071,2315,1588,3614
431470,202301,1708,4288,1247,3403,244,716,461,1177,705,1893
431475,202301,307,808,65,216,3,12,8,14,11,26
431477,202301,573,1352,326,885,80,191,103,259,183,450
431478,202301,254,680,59,187,10,27,6,14,16,41
431480,202301,4219,10017,3361,8704,797,2106,1336,3367,2133,5473
431490,202301,169160,350968,133217,298094,7459,21217,101346,211957,108805,233174
431500,202301,589,1377,444,1123,66,169,225,535,291,704
431505,202301,310,691,215,552,21,50,147,377,168,427
431507,202301,359,833,146,419,39,120,22,52,61,172
431510,202301,2107,4983,1446,3728,473,1232,373,952,846,2184
431513,202301,260,553,144,363,29,91,42,70,71,161
431514,202301,154,367,126,323,4,13,82,185,86,198
431515,202301,675,1453,515,1183,117,286,274,594,391,880
431517,202301,84,235,68,204,8,30,29,83,37,113
431520,202301,445,1047,191,532,27,97,82,177,109,274
431530,202301,6594,13580,4055,9788,892,2249,1716,3865,2608,6114
431531,202301,266,599,157,401,31,77,53,134,84,211
431532,202301,740,1546,438,1033,70,177,208,467,278,644
431535,202301,349,879,167,486,28,80,34,86,62,166
431540,202301,2208,6055,2002,5784,104,321,1533,4476,1637,4797
431545,202301,419,978,103,248,16,32,40,88,56,120
431550,202301,2737,6323,1953,4910,245,708,1050,2443,1295,3151
431555,202301,851,1775,513,1223,45,116,290,675,335,791
431560,202301,32473,72401,22706,57581,4202,10441,9222,23290,13424,33731
431570,202301,7040,13584,6081,12269,363,943,5055,9573,5418,10516
431575,202301,479,1040,413,938,76,164,249,525,325,689
431580,202301,832,1981,569,1490,67,223,328,756,395,979
431590,202301,940,2390,671,1836,159,465,241,571,400,1036
431595,202301,446,1112,293,810,58,169,101,250,159,419
431600,202301,2285,5146,1633,4148,291,824,702,1598,993,2422
431610,202301,1785,3942,1176,2906,211,509,467,1240,678,1749
431620,202301,562,1331,304,787,58,186,162,338,220,524
431630,202301,1577,3678,750,2075,166,507,230,548,396,1055
431640,202301,8857,17919,7405,16054,882,2154,4993,10362,5875,12516
431642,202301,803,1690,502,1172,95,211,235,502,330,713
431643,202301,437,1020,215,582,21,51,80,195,101,246
431645,202301,3084,5381,2469,4622,38,93,2177,3936,2215,4029
431647,202301,369,842,127,359,13,32,26,64,39,96
431650,202301,183,488,136,410,19,64,61,153,80,217
431660,202301,1099,2718,562,1653,87,308,137,332,224,640
431670,202301,1503,3383,909,2337,139,380,438,1000,577,1380
431673,202301,256,656,106,343,12,43,32,87,44,130
431675,202301,432,1070,120,399,14,49,18,40,32,89
431680,202301,12569,27728,9568,22659,1801,4878,4904,10362,6705,15240
431690,202301,34756,76701,25602,61323,3801,10668,14417,31440,18218,42108
431695,202301,280,633,174,443,25,99,99,204,124,303
431697,202301,565,1222,434,1026,79,186,245,571,324,757
431700,202301,1829,4026,1435,3382,232,485,750,1787,982,2272
431710,202301,19187,39040,14367,32643,1694,4344,9185,19778,10879,24122
431720,202301,8717,19493,5379,13799,1305,3565,1161,2417,2466,5982
431725,202301,43,106,31,84,9,31,14,32,23,63
431730,202301,5751,12293,3911,9618,712,1939,1948,4394,2660,6333
431740,202301,6565,14616,4496,11329,1000,2840,1383,3023,2383,5863
431750,202301,10765,25017,7824,20370,1830,5079,2744,6740,4574,11819
431755,202301,377,993,105,332,11,40,25,68,36,108
431760,202301,6753,14156,4755,11030,514,1451,2880,5995,3394,7446
431770,202301,2576,5274,1957,4456,348,755,1228,2789,1576,3544
431775,202301,263,636,145,406,34,107,38,85,72,192
431780,202301,2628,5896,1738,4367,307,828,570,1338,877,2166
431790,202301,935,2340,650,1791,138,396,278,728,416,1124
431795,202301,320,762,158,450,23,64,45,110,68,174
431800,202301,10501,23072,6898,17638,1892,5716,854,1788,2746,7504
431805,202301,314,782,70,246,3,5,2,3,5,8
431810,202301,4060,8489,2660,6124,386,1005,1495,3102,1881,4107
431820,202301,2748,6513,2110,5572,478,1428,920,2269,1398,3697
431830,202301,10948,22674,8029,18790,2345,6243,1269,2969,3614,9212
431840,202301,3645,8114,2944,7085,452,1190,1762,4107,2214,5297
431842,202301,590,1395,208,596,41,127,45,109,86,236
431843,202301,366,938,246,683,60,188,102,248,162,436
431844,202301,209,561,79,257,17,56,15,47,32,103
431845,202301,593,1415,390,1025,34,100,233,588,267,688
431846,202301,374,809,325,740,13,35,292,649,305,684
431848,202301,190,472,107,306,11,36,28,61,39,97
431849,202301,430,1033,87,244,11,33,14,30,25,63
431850,202301,5413,13232,4158,10969,1021,2910,1262,3072,2283,5982
431860,202301,801,1757,463,1145,64,181,282,651,346,832
431861,202301,123,313,79,218,17,53,26,57,43,110
431862,202301,613,1795,504,1611,97,367,233,686,330,1053
431870,202301,30265,67738,24438,59164,2339,6584,16085,36383,18424,42967
431880,202301,5074,11802,3752,9605,476,1446,2059,4846,2535,6292
431890,202301,6253,14345,4077,10381,1117,2948,1047,2525,2164,5473
431900,202301,1315,3078,869,2313,142,434,408,946,550,1380
431910,202301,923,2079,369,964,52,150,100,202,152,352
431912,202301,682,1525,563,1341,80,199,361,835,441,1034
431915,202301,1444,2980,1170,2579,69,175,930,1966,999,2141
431920,202301,1651,3190,1353,2829,34,78,1198,2444,1232,2522
431930,202301,909,2137,624,1642,214,563,197,505,411,1068
431935,202301,103,257,77,214,10,27,14,29,24,56
431936,202301,377,952,215,577,40,113,114,290,154,403
431937,202301,194,477,129,358,31,76,43,113,74,189
431940,202301,3741,8008,2479,5887,168,470,1601,3524,1769,3994
431950,202301,2797,6407,2190,5459,520,1378,904,2114,1424,3492
431960,202301,3748,8369,2825,6820,799,2025,736,1699,1535,3724
431970,202301,513,1235,255,680,47,143,78,169,125,312
431971,202301,97,242,51,152,12,36,13,35,25,71
431973,202301,709,1951,490,1513,46,147,338,1042,384,1189
431975,202301,133,268,43,110,10,29,12,22,22,51
431980,202301,1577,3351,1250,2874,130,394,852,1738,982,2132
431990,202301,8742,18755,6244,15353,409,1247,4126,9638,4535,10885
432000,202301,19853,41464,15196,34664,1759,4704,9992,21002,11751,25706
432010,202301,3449,7443,2364,5791,542,1346,810,1826,1352,3172
432020,202301,1950,4851,1252,3447,368,1061,238,617,606,1678
432023,202301,648,1433,323,841,40,101,142,317,182,418
432026,202301,1256,3072,976,2557,283,749,351,953,634,1702
432030,202301,537,1198,319,838,24,63,184,441,208,504
432032,202301,409,987,274,726,24,72,141,321,165,393
432035,202301,874,2224,733,1992,174,446,338,934,512,1380
432040,202301,1115,2631,537,1513,54,178,237,565,291,743
432045,202301,222,562,136,391,19,65,57,148,76,213
432050,202301,693,1583,515,1291,65,198,258,614,323,812
432055,202301,859,1993,585,1510,178,442,154,408,332,850
432057,202301,183,455,157,398,11,28,103,234,114,262
432060,202301,517,1201,156,476,17,66,33,85,50,151
432065,202301,280,691,218,570,51,153,104,248,155,401
432067,202301,1015,2531,850,2193,93,250,551,1383,644,1633
432070,202301,2066,4724,1540,3824,228,637,777,1727,1005,2364
432080,202301,6404,13361,4795,11017,810,2241,2343,4810,3153,7051
432085,202301,506,1250,395,1080,84,254,195,478,279,732
432090,202301,3422,7963,2102,5541,468,1159,851,2059,1319,3218
432100,202301,1143,2727,573,1674,92,266,102,228,194,494
432110,202301,2782,6459,2063,5278,451,1280,591,1255,1042,2535
432120,202301,4593,11189,3746,9841,617,1871,1892,4510,2509,6381
432130,202301,3518,7814,2919,6997,516,1249,1458,3487,1974,4736
432132,202301,320,802,176,490,25,83,83,195,108,278
432135,202301,1265,2618,879,2002,101,222,554,1278,655,1500
432140,202301,2426,5946,1966,5149,232,696,1289,3201,1521,3897
432143,202301,1926,4579,1448,3846,122,362,894,2290,1016,2652
432145,202301,2213,5468,1476,4051,237,721,474,1032,711,1753
432146,202301,165,423,135,388,45,146,36,95,81,241
432147,202301,679,1744,374,1089,119,359,64,181,183,540
432149,202301,601,1355,284,734,32,81,119,270,151,351
432150,202301,5202,11698,3981,9782,755,2166,2036,4385,2791,6551
432160,202301,8318,18814,6373,15977,1535,4129,2461,5865,3996,9994
432162,202301,229,503,40,116,7,21,9,14,16,35
432163,202301,204,487,43,123,2,6,7,9,9,15
432166,202301,813,2065,659,1790,118,362,245,570,363,932
432170,202301,1918,4812,1353,3817,232,709,528,1316,760,2025
432180,202301,3590,7945,1909,4923,275,813,859,1877,1134,2690
432183,202301,483,1265,377,1048,73,252,181,449,254,701
432185,202301,1071,2509,660,1751,132,396,306,729,438,1125
432190,202301,2810,6110,2060,4993,181,539,1383,3049,1564,3588
432195,202301,1223,2947,775,2128,138,393,252,673,390,1066
432200,202301,4760,10475,3677,8891,276,736,2618,6043,2894,6779
432210,202301,528,1233,365,946,48,138,199,452,247,590
432215,202301,788,1970,670,1773,79,188,375,1011,454,1199
432218,202301,270,621,128,342,17,50,43,89,60,139
432220,202301,4552,9718,3319,7785,543,1341,1853,4079,2396,5420
432225,202301,201,497,141,384,21,54,60,162,81,216
432230,202301,931,2117,449,1218,64,209,170,371,234,580
432232,202301,604,1391,384,1022,73,205,173,414,246,619
432234,202301,349,831,188,520,35,87,46,110,81,197
432235,202301,61,152,34,84,6,18,16,31,22,49
432237,202301,375,891,325,810,11,28,270,653,281,681
432240,202301,22075,47251,16568,40176,1556,3715,11265,26861,12821,30576
432250,202301,8766,21451,6703,17566,1182,3475,3591,8670,4773,12145
432252,202301,579,1292,381,931,49,139,195,425,244,564
432253,202301,1141,2997,810,2226,225,665,199,473,424,1138
432254,202301,747,1693,236,661,27,86,44,90,71,176
432255,202301,127,310,81,220,9,27,42,100,51,127
432260,202301,7462,16838,5648,13690,1059,2914,2902,6233,3961,9147
432270,202301,2863,6817,2335,5922,694,1816,784,1920,1478,3736
432280,202301,1545,3705,841,2389,130,411,258,594,388,1005
432285,202301,159,476,32,97,3,9,9,25,12,34
432290,202301,431,1062,280,752,62,193,94,196,156,389
432300,202301,40191,88029,31507,75062,2659,7824,22075,48962,24734,56786
432310,202301,1320,2800,1020,2321,123,255,777,1778,900,2033
432320,202301,245,541,119,314,15,43,44,90,59,133
432330,202301,250,542,88,265,17,51,15,46,32,97
432335,202301,195,556,77,269,9,27,10,27,19,54
432340,202301,380,926,191,575,29,97,70,198,99,295
432345,202301,1057,1956,907,1781,12,31,803,1534,815,1565
432350,202301,387,913,206,585,39,123,62,141,101,264
432360,202301,259,750,57,187,4,13,17,51,21,64
432370,202301,430,972,244,660,25,74,130,338,155,412
432375,202301,635,1455,441,1092,135,355,134,331,269,686
432377,202301,193,574,47,165,4,14,11,30,15,44
432380,202301,2473,6341,1743,5021,282,899,844,2314,1126,3213
500020,202301,4345,9663,3061,7726,299,924,2027,4879,2326,5803
500025,202301,1400,3225,909,2354,110,295,499,1228,609,1523
500060,202301,10418,26170,7511,20437,917,2720,4301,11341,5218,14061
500070,202301,6364,14436,4630,11697,833,2284,2235,5405,3068,7689
500080,202301,1920,4404,1202,3170,199,592,466,1062,665,1654
500085,202301,2508,5792,1765,4535,440,1229,661,1511,1101,2740
500090,202301,2547,6160,1758,4892,278,830,511,1507,789,2337
500100,202301,4860,11319,3660,9474,600,1693,1459,3482,2059,5175
500110,202301,13311,29762,9239,23555,1765,4870,4415,10873,6180,15743
500124,202301,2765,6994,2236,6211,345,927,1357,3801,1702,4728
500150,202301,1948,4013,1373,3254,227,619,752,1609,979,2228
500190,202301,6322,15137,4208,11296,873,2443,1414,3419,2287,5862
500200,202301,3389,7200,2281,5447,201,507,1410,3159,1611,3666
500210,202301,6450,13540,4663,11297,1246,3175,2313,5394,3559,8569
500215,202301,1768,4448,1318,3705,143,433,715,1965,858,2398
500220,202301,4253,10394,3171,8650,435,1250,1675,4215,2110,5465
500230,202301,2635,5643,2037,4833,279,726,1274,2860,1553,3586
500240,202301,5230,13975,3857,11273,538,1706,1583,4584,2121,6290
500260,202301,4070,8114,2616,6146,274,720,1581,3455,1855,4175
500270,202301,189969,414349,126167,314894,16681,47707,58937,130130,75618,177837
500280,202301,1718,3965,1134,3098,174,478,622,1688,796,2166
500290,202301,4647,10542,2875,7618,430,1338,1076,2488,1506,3826
500295,202301,5215,11593,3546,8839,573,1641,1539,3284,2112,4925
500310,202301,1307,2422,867,1885,112,190,488,1057,600,1247
500315,202301,6162,13079,5112,11705,306,798,4251,9423,4557,10221
500320,202301,25967,62968,18189,50597,4431,12260,7316,21104,11747,33364
500325,202301,7599,15393,5425,12513,629,1615,3397,7414,4026,9029
500330,202301,8624,18147,5752,14081,551,1420,3268,7890,3819,9310
500345,202301,2750,6314,1885,4953,321,891,684,1639,1005,2530
500348,202301,2956,6793,2264,5685,180,511,1549,3775,1729,4286
500350,202301,1473,3804,867,2567,102,332,297,796,399,1128
500370,202301,35415,85319,26339,71086,3478,10690,12878,32981,16356,43671
500375,202301,3223,7916,2056,5643,269,799,765,1807,1034,2606
500380,202301,4452,10357,3135,8258,866,2305,514,1367,1380,3672
500390,202301,858,1659,525,1266,79,219,325,779,404,998
500400,202301,1986,4772,1341,3573,220,657,498,1161,718,1818
500410,202301,2996,6510,2105,5262,240,588,1149,2970,1389,3558
500430,202301,3539,8130,2445,6542,385,1028,954,2749,1339,3777
500440,202301,2009,4496,1124,3004,194,539,426,1137,620,1676
500450,202301,2425,5659,1537,4218,294,826,384,983,678,1809
500460,202301,4811,11739,3005,8377,516,1587,671,1703,1187,3290
500470,202301,3484,8779,2356,6586,545,1687,670,1548,1215,3235
500480,202301,2386,6896,1957,6224,213,724,1358,4352,1571,5076
500490,202301,1450,3207,891,2366,169,526,220,572,389,1098
500500,202301,5122,12591,3435,10044,1060,3553,360,1093,1420,4646
500510,202301,890,2101,607,1608,42,144,384,902,426,1046
500515,202301,2054,4883,1561,4141,223,642,832,2155,1055,2797
500520,202301,4319,11267,3319,9625,721,2075,1587,4707,2308,6782
500525,202301,1241,3314,999,2960,138,440,579,1650,717,2090
500540,202301,6555,16076,4031,11708,1071,3489,649,1548,1720,5037
500560,202301,7087,16814,5725,15130,254,772,4704,12383,4958,13155
500568,202301,5846,11900,3704,8745,744,1827,1582,3339,2326,5166
500570,202301,11130,23819,7818,18629,1015,2866,4423,9420,5438,12286
500580,202301,3906,9299,2833,7503,711,1939,1162,3013,1873,4952
500600,202301,4634,10817,3383,8894,766,2135,956,2407,1722,4542
500620,202301,10351,24840,7315,19380,1058,3029,3683,8993,4741,12022
500625,202301,696,1745,488,1351,73,230,211,520,284,750
500627,202301,968,2471,613,1855,101,321,178,491,279,812
500630,202301,9789,20547,5922,14568,1222,3301,1880,4200,3102,7501
500635,202301,3269,9792,2415,8588,286,927,1569,6103,1855,7030
500640,202301,2206,4416,1484,3494,67,169,1025,2286,1092,2455
500660,202301,26632,60523,18451,49034,5357,14814,6285,16518,11642,31332
500690,202301,3411,8061,2324,6359,744,2216,797,2075,1541,4291
500710,202301,4180,10215,3017,8264,695,2104,864,2210,1559,4314
500720,202301,6323,15232,4270,11913,811,2455,1361,3544,2172,5999
500730,202301,1300,2965,733,1977,145,372,231,613,376,985
500740,202301,5821,13007,3723,9829,861,2327,1402,3553,2263,5880
500750,202301,1427,3272,1017,2612,135,395,469,1054,604,1449
500755,202301,1414,3415,901,2490,152,465,254,591,406,1056
500769,202301,6489,15084,3679,10095,897,2508,465,1121,1362,3629
500770,202301,1748,4368,1226,3543,234,710,411,1132,645,1842
500780,202301,1585,3712,1032,2784,176,540,257,545,433,1085
500790,202301,9405,23339,6847,18881,1330,4009,2423,6451,3753,10460
500793,202301,2652,6218,1914,4978,364,1028,781,1806,1145,2834
500795,202301,3800,7944,3083,7029,183,415,2546,5819,2729,6234
500797,202301,1012,2368,693,1803,210,603,209,496,419,1099
500800,202301,4408,9408,2808,7067,700,1995,681,1665,1381,3660
500830,202301,26502,60717,17902,45813,3730,10206,6434,15022,10164,25228
500840,202301,1777,4021,1134,2841,125,336,555,1237,680,1573
510010,202301,2229,4498,1598,3719,202,457,1064,2463,1266,2920
510020,202301,5127,12323,2870,8083,487,1403,733,1828,1220,3231
510025,202301,9445,21224,6227,16294,665,1893,3449,8465,4114,10358
510030,202301,3893,7960,2568,5988,253,643,1286,2892,1539,3535
510035,202301,1368,3445,886,2671,242,741,304,998,546,1739
510040,202301,3036,6220,2292,5305,295,635,1417,3369,1712,4004
510050,202301,2847,5362,2008,4329,221,573,1437,2936,1658,3509
510060,202301,1934,4595,1337,3554,307,870,283,579,590,1449
510080,202301,1945,4671,1285,3618,205,643,516,1317,721,1960
510100,202301,875,1831,634,1486,71,193,389,835,460,1028
510120,202301,331,564,195,407,10,19,155,310,165,329
510125,202301,2579,6143,1972,5206,241,758,940,2218,1181,2976
510130,202301,2064,4722,1477,3848,303,874,717,1727,1020,2601
510140,202301,3783,9339,2605,7805,1014,3310,752,2301,1766,5611
510160,202301,2473,5230,1942,4575,43,125,1754,4082,1797,4207
510170,202301,6351,15033,4851,12719,892,2587,2321,5773,3213,8360
510180,202301,19036,38817,13087,30756,2011,5175,6692,15624,8703,20799
510185,202301,2169,5310,1427,4249,533,1663,386,1333,919,2996
510190,202301,3049,7838,1943,6063,477,1620,421,1300,898,2920
510250,202301,22330,50805,16715,42722,2447,6852,9423,23713,11870,30565
510260,202301,2246,9027,1887,8433,277,1208,1102,5595,1379,6803
510263,202301,4813,12547,3271,9606,554,1785,759,1865,1313,3650
510267,202301,7106,19191,4281,13002,715,2296,809,2089,1524,4385
510268,202301,1537,3792,1085,3048,306,916,226,507,532,1423
510269,202301,1170,2974,773,2266,144,467,329,887,473,1354
510270,202301,3702,9823,2602,7980,394,1350,1072,3155,1466,4505
510279,202301,2243,5459,1307,3793,189,597,387,983,576,1580
510285,202301,1307,3218,849,2439,218,696,268,664,486,1360
510300,202301,5206,11461,3953,9838,264,699,2926,7196,3190,7895
510305,202301,1850,4718,1255,3694,265,798,387,1123,652,1921
510310,202301,1316,3036,943,2465,242,611,350,952,592,1563
510320,202301,5097,11520,3503,9019,768,2216,1072,2396,1840,4612
510325,202301,5543,15181,3810,11873,870,2885,809,2450,1679,5335
510330,202301,3252,8499,2190,6777,529,1794,841,2541,1370,4335
510335,202301,6185,16200,4726,13911,874,2802,2412,6976,3286,9778
510336,202301,637,1657,463,1400,71,198,245,801,316,999
510337,202301,1870,4971,1233,3865,425,1466,302,865,727,2331
510340,202301,125671,262572,87617,210157,17345,48042,38734,83392,56079,131434
510343,202301,1551,3468,1051,2686,133,386,566,1344,699,1730
510345,202301,1662,4071,1266,3374,234,664,654,1544,888,2208
510350,202301,4024,9447,2714,7420,764,2157,642,1703,1406,3860
510360,202301,2459,4535,1482,3422,62,120,1081,2588,1143,2708
510370,202301,2207,5765,1686,4984,279,802,986,2999,1265,3801
510380,202301,676,1535,400,1085,52,168,160,410,212,578
510385,202301,1528,4705,1153,4045,105,433,775,2783,880,3216
510390,202301,1806,3971,1250,3336,235,672,762,1994,997,2666
510395,202301,871,1758,587,1364,33,70,423,989,456,1059
510410,202301,6650,16169,5005,13542,696,1958,3149,8458,3845,10416
510420,202301,3286,5955,2288,4674,70,159,1828,3629,1898,3788
510450,202301,658,1495,396,1070,89,236,131,325,220,561
510452,202301,1140,2965,855,2430,126,386,467,1289,593,1675
510454,202301,1506,3641,1045,2880,182,470,585,1738,767,2208
510455,202301,1136,2855,745,2132,148,475,283,726,431,1201
510460,202301,2470,5787,1754,4729,629,1978,497,921,1126,2899
510480,202301,6058,13776,4022,10170,707,1976,1718,3865,2425,5841
510490,202301,2149,4891,1617,4225,263,702,1002,2639,1265,3341
510500,202301,1831,4212,1116,3119,265,798,277,735,542,1533
510510,202301,4965,12783,3481,10352,1032,3342,1010,2934,2042,6276
510515,202301,6855,16631,4787,13159,892,2643,1818,4566,2710,7209
510517,202301,1961,4687,1368,3836,512,1597,352,846,864,2443
510520,202301,2826,5491,1542,3835,160,433,677,1726,837,2159
510523,202301,1460,3202,1040,2583,147,386,619,1459,766,1845
510525,202301,10360,26637,7667,21565,1427,4325,2835,7245,4262,11570
510530,202301,697,1646,529,1418,46,133,363,967,409,1100
510550,202301,3241,8547,2457,7257,495,1559,1200,3427,1695,4986
510558,202301,2792,7044,2059,5955,272,746,1052,3234,1324,3980
510560,202301,2332,6181,1519,4651,359,1160,301,948,660,2108
510562,202301,7581,16570,5671,13490,885,2222,2978,6599,3863,8821
510590,202301,4030,9048,2946,7706,279,773,2097,5460,2376,6233
510600,202301,1520,3024,1086,2436,138,375,629,1259,767,1634
510610,202301,3472,7608,2433,6244,339,1020,1443,3520,1782,4540
510615,202301,3565,8252,2509,6646,377,1053,1432,3745,1809,4798
510617,202301,1307,3544,1045,3161,135,444,733,2285,868,2729
510618,202301,1614,3893,1159,3203,216,704,601,1552,817,2256
510619,202301,908,2199,529,1525,107,318,105,231,212,549
510620,202301,1638,3516,832,2260,310,943,65,125,375,1068
510621,202301,1962,4941,1206,3584,263,819,323,834,586,1653
510622,202301,6952,17872,4480,12915,1238,3833,610,1476,1848,5309
510623,202301,3473,7909,2499,6449,516,1443,980,2424,1496,3867
510624,202301,2033,5057,1106,3386,117,398,216,576,333,974
510625,202301,4456,10059,2773,7230,515,1466,936,2372,1451,3838
510626,202301,1722,4073,1166,3220,280,865,291,777,571,1642
510627,202301,776,1886,443,1275,112,338,119,353,231,691
510628,202301,1834,3815,1169,2982,368,1067,425,977,793,2044
510629,202301,2181,5633,1429,4259,305,1007,361,1022,666,2029
510630,202301,4235,10856,2729,8254,621,1944,657,2111,1278,4055
510631,202301,737,1585,565,1349,22,43,438,1057,460,1100
510637,202301,4535,9866,3213,8044,810,2295,1154,2703,1964,4998
510642,202301,7364,18524,5711,16196,990,3228,3331,9085,4321,12313
510645,202301,1248,2320,758,1709,176,389,341,778,517,1167
510650,202301,9386,20520,7427,18397,984,1572,5339,14628,6323,16200
510665,202301,2118,4349,1352,3193,293,634,533,1352,826,1986
510670,202301,523,1067,319,800,33,80,166,414,199,494
510675,202301,8316,21250,5700,16513,1379,4476,1114,2808,2493,7284
510677,202301,2776,6621,1989,5478,350,1067,1081,2906,1431,3973
510680,202301,870,2085,495,1434,89,276,133,323,222,599
510682,202301,2163,5656,1616,4806,519,1730,539,1512,1058,3242
510685,202301,657,1707,483,1393,49,129,277,803,326,932
510700,202301,5422,11771,3772,9501,365,1061,2567,6225,2932,7286
510704,202301,14234,31540,9701,24319,2253,6054,2976,6603,5229,12657
510706,202301,3036,8251,2115,6722,385,1262,833,2844,1218,4106
510710,202301,3691,8502,2316,6040,596,1533,598,1428,1194,2961
510715,202301,786,1559,510,1194,57,159,305,664,362,823
510718,202301,2810,6152,1737,4732,359,1005,780,2364,1139,3369
510719,202301,583,1170,340,838,38,116,165,340,203,456
510720,202301,1132,2422,755,1903,165,476,316,711,481,1187
510724,202301,1093,2924,742,2254,105,366,320,882,425,1248
510726,202301,1109,2002,651,1460,70,155,368,805,438,960
510729,202301,720,1588,332,890,35,113,104,269,139,382
510730,202301,3671,8258,2531,6583,355,1084,1358,3209,1713,4293
510735,202301,1604,4095,1295,3660,107,273,1035,2954,1142,3227
510740,202301,1205,2699,837,2095,83,249,514,1138,597,1387
510757,202301,646,1937,509,1712,138,520,211,653,349,1173
510760,202301,57227,118189,36110,87865,7078,19692,13783,29326,20861,49018
510770,202301,5238,10558,3718,8675,260,556,2584,6172,2844,6728
510774,202301,494,1197,348,979,65,181,186,546,251,727
510775,202301,835,2003,525,1523,114,353,140,369,254,722
510776,202301,894,2150,616,1623,111,321,289,730,400,1051
510777,202301,1726,4315,1243,3701,239,845,739,2037,978,2882
510779,202301,991,2485,736,2073,82,216,460,1352,542,1568
510780,202301,5422,12240,3921,10093,725,1778,1972,5421,2697,7199
510785,202301,2561,6233,1504,4380,337,1041,413,1184,750,2225
510787,202301,4304,11288,2964,8754,1033,3143,294,760,1327,3903
510788,202301,662,1441,440,1120,68,163,192,555,260,718
510790,202301,24592,60156,15758,44941,3135,9833,1559,3819,4694,13652
510792,202301,13238,34540,8674,26021,1979,6489,1816,4641,3795,11130
510794,202301,1608,4131,1145,3397,342,1159,210,497,552,1656
510795,202301,13604,32171,9710,25704,2115,6265,3363,7945,5478,14210
510800,202301,1818,4614,1258,3704,343,1117,156,325,499,1442
510805,202301,1869,4838,1203,3640,237,780,450,1240,687,2020
510810,202301,834,1593,544,1218,167,332,262,622,429,954
510820,202301,956,1736,553,1247,26,64,368,789,394,853
510830,202301,1084,2373,827,2048,87,221,546,1384,633,1605
510835,202301,764,1648,490,1271,58,168,299,738,357,906
510840,202301,79276,153518,57888,127965,9116,19721,34940,77482,44056,97203
510850,202301,2200,5307,1442,4155,494,1636,88,127,582,1763
510860,202301,3294,8038,2196,6371,745,2341,410,1190,1155,3531
510880,202301,896,2396,650,1970,181,556,143,417,324,973
510885,202301,754,1789,491,1377,92,238,117,326,209,564
510890,202301,1037,2713,739,2192,220,710,194,534,414,1244
510895,202301,1851,4373,1239,3356,206,657,577,1380,783,2037
520005,202301,4643,11085,3720,9890,1108,2587,1474,4700,2582,7287
520010,202301,3593,8777,2703,7173,570,1674,1081,2453,1651,4127
520013,202301,4402,10322,2892,7657,725,1929,769,2142,1494,4071
520015,202301,637,1500,466,1250,103,271,163,466,266,737
520017,202301,1494,3484,1040,2780,186,568,439,1032,625,1600
520020,202301,695,1250,539,1072,53,106,410,797,463,903
520025,202301,49515,119960,42390,110167,6098,16704,26953,68680,33051,85384
520030,202301,8943,18837,7451,16868,583,1288,5658,12597,6241,13885
520050,202301,492,1128,282,739,54,129,116,301,170,430
520055,202301,2100,4898,1303,3317,199,487,554,1313,753,1800
520060,202301,2380,5634,1621,4362,290,863,401,1043,691,1906
520080,202301,2334,5431,1788,4720,358,900,881,2421,1239,3321
520082,202301,1004,2396,703,1890,125,351,296,835,421,1186
520085,202301,1263,2899,1013,2569,236,594,474,1166,710,1760
520090,202301,1131,2024,830,1703,113,150,635,1375,748,1525
520110,202301,55829,137058,38570,108876,10108,30692,3182,7857,13290,38549
520120,202301,305,687,164,440,23,78,69,163,92,241
520130,202301,4843,10714,3740,9061,712,1810,1542,3559,2254,5369
520140,202301,64136,156982,45156,125769,14529,43306,5723,15740,20252,59046
520145,202301,733,1569,473,1201,104,272,167,382,271,654
520150,202301,854,1900,646,1639,79,198,360,873,439,1071
520160,202301,1078,2431,736,1842,138,315,295,750,433,1065
520170,202301,5880,11503,3894,9129,466,1146,2552,5803,3018,6949
520180,202301,3450,7979,2806,7088,363,1079,1808,4351,2171,5430
520215,202301,2244,4929,1659,4101,207,579,986,2310,1193,2889
520235,202301,938,1868,625,1443,99,248,372,813,471,1061
520250,202301,2135,4987,1571,4145,584,1643,257,801,841,2444
520260,202301,919,2027,563,1463,104,268,199,503,303,771
520280,202301,1060,2196,830,1860,167,373,428,946,595,1319
520310,202301,1254,2519,836,1916,188,509,383,835,571,1344
520320,202301,2464,5882,1883,5008,240,635,990,2671,1230,3306
520330,202301,6360,14880,4939,12611,704,2159,2888,6722,3592,8881
520340,202301,2793,5707,1652,4108,175,388,834,2151,1009,2539
520350,202301,3856,8756,2756,7114,888,2393,824,2116,1712,4509
520355,202301,2389,6026,1749,4869,503,1485,280,668,783,2153
520357,202301,1086,2323,791,1914,29,74,635,1511,664,1585
520360,202301,1006,2320,787,1985,129,376,371,850,500,1226
520380,202301,1705,4029,1030,2823,163,479,320,752,483,1231
520390,202301,1489,3260,948,2531,246,741,205,574,451,1315
520393,202301,858,1837,584,1438,80,213,264,589,344,802
520396,202301,1102,2514,925,2251,61,147,641,1480,702,1627
520400,202301,1995,4368,1548,3788,98,253,1138,2766,1236,3019
520410,202301,2786,5636,1922,4418,272,719,1090,2308,1362,3027
520420,202301,469,978,366,824,22,60,273,584,295,644
520425,202301,1875,4336,1059,2834,274,794,212,469,486,1263
520430,202301,3092,6778,1873,4775,394,1017,342,792,736,1809
520440,202301,3714,8512,2166,5777,434,1302,465,1143,899,2445
520450,202301,17853,39860,12405,31499,3158,8352,3450,8550,6608,16902
520455,202301,1000,2415,702,1977,198,573,205,588,403,1161
520460,202301,1315,2865,1013,2464,209,451,590,1519,799,1970
520465,202301,1120,2433,915,2170,55,168,703,1623,758,1791
520470,202301,2907,6517,2248,5706,592,1598,977,2528,1569,4126
520480,202301,1215,3058,904,2545,206,598,370,985,576,1583
520485,202301,1836,5100,1446,4498,262,880,642,1896,904,2776
520490,202301,5401,12787,4151,10921,638,1823,2450,6221,3088,8044
520495,202301,2051,3921,1551,3268,114,245,1141,2368,1255,2613
520500,202301,2216,4954,1671,4079,189,548,982,2187,1171,2735
520505,202301,1213,2262,951,1948,101,176,721,1463,822,1639
520510,202301,12588,28260,9560,23825,1582,4637,4687,10650,6269,15287
520520,202301,1456,3393,1126,2914,299,831,449,1119,748,1950
520530,202301,3116,7647,2271,6193,419,1134,1068,3084,1487,4218
520540,202301,3825,9293,2590,7033,441,1285,809,1908,1250,3193
520545,202301,1835,4116,1429,3519,349,857,639,1543,988,2400
520547,202301,1698,4046,1323,3421,268,690,668,1697,936,2387
520549,202301,21399,49417,17833,44465,2151,6007,11901,28281,14052,34288
520551,202301,6416,14585,5372,13129,465,1411,4027,9313,4492,10724
520552,202301,1185,2816,922,2436,181,471,473,1290,654,1761
520570,202301,666,1408,422,1038,69,148,183,445,252,593
520580,202301,2711,5585,2056,4827,378,841,1173,2793,1551,3634
520590,202301,1714,3942,1185,3102,278,753,437,1085,715,1838
520620,202301,12220,28500,9900,25297,1786,4960,5408,13360,7194,18320
520630,202301,1100,2542,780,2041,94,262,358,892,452,1154
520640,202301,2866,6494,2145,5271,532,1310,644,1634,1176,2944
520650,202301,1340,2638,986,2169,212,418,488,1136,700,1554
520660,202301,648,1542,382,1088,75,234,101,284,176,518
520670,202301,1213,2857,998,2544,100,233,673,1684,773,1917
520680,202301,1042,2246,837,1967,124,250,521,1236,645,1486
520690,202301,418,968,284,757,86,218,75,187,161,405
520710,202301,552,1229,379,954,22,58,247,582,269,640
520725,202301,1743,3863,1176,2953,201,563,565,1350,766,1913
520735,202301,1145,2502,779,1937,221,512,246,614,467,1126
520740,202301,3154,6620,2286,5489,489,1177,1045,2498,1534,3675
520750,202301,926,1942,667,1580,94,236,382,853,476,1089
520753,202301,1636,3916,1241,3253,225,672,581,1390,806,2062
520760,202301,1829,3482,1540,3145,32,65,1416,2893,1448,2958
520780,202301,1890,4222,1384,3504,196,500,694,1677,890,2177
520790,202301,3941,8725,2709,6787,434,998,1381,3642,1815,4640
520800,202301,23484,53630,18492,46475,3147,8093,10468,26278,13615,34371
520810,202301,1500,2964,1114,2521,256,574,555,1367,811,1941
520815,202301,729,2078,536,1665,98,312,158,471,256,783
520830,202301,2198,4352,1582,3622,99,232,1204,2702,1303,2934
520840,202301,3675,8953,2950,7988,821,2448,1010,2695,1831,5143
520850,202301,1138,2270,864,1898,175,450,441,909,616,1359
520860,202301,11753,28577,8699,23441,2045,5760,3172,8189,5217,13949
520870,202301,192034,408049,140230,332142,25767,64928,64935,142742,90702,207670
520880,202301,12066,31447,9714,27332,2019,5840,4001,10837,6020,16677
520890,202301,6093,12495,4329,9906,653,1765,2317,4890,2970,6655
520910,202301,5985,13832,3938,10438,782,2212,1078,2542,1860,4754
520915,202301,998,2424,671,1796,125,378,271,660,396,1038
520920,202301,5825,11749,4267,9888,807,1722,2330,5557,3137,7279
520929,202301,798,1774,606,1492,111,221,264,695,375,916
520940,202301,1188,2889,928,2504,76,249,702,1832,778,2081
520945,202301,575,1189,420,983,32,71,257,581,289,652
520960,202301,1418,2938,1093,2487,385,830,384,958,769,1788
520970,202301,4510,10671,3406,8982,1159,3092,687,1916,1846,5008
520980,202301,974,2057,708,1720,102,256,345,782,447,1038
520990,202301,3897,8543,3185,7685,510,1089,2165,5358,2675,6447
520993,202301,1534,3516,1015,2596,220,592,371,895,591,1487
520995,202301,3169,7332,2348,6103,566,1434,617,1700,1183,3134
521000,202301,12096,28836,8129,21746,1263,3511,2627,6395,3890,9906
521010,202301,5028,11701,3694,9475,543,1565,1942,4628,2485,6193
521015,202301,977,2236,684,1732,46,128,444,1048,490,1176
521020,202301,5433,12485,3373,8856,729,2028,860,2119,1589,4147
521030,202301,991,1690,775,1408,22,50,671,1171,693,1221
521040,202301,10684,24385,7848,20084,1898,4872,2491,6705,4389,11577
521056,202301,1274,3095,886,2442,258,692,194,574,452,1266
521060,202301,1241,3024,865,2336,173,509,306,793,479,1302
521080,202301,1295,2626,704,1743,121,309,288,663,409,972
521090,202301,3915,9853,2659,7402,624,1887,293,739,917,2626
521100,202301,2457,5011,1840,4193,243,593,1160,2615,1403,3208
521120,202301,6334,13991,4783,12052,1001,2264,1713,5048,2714,7312
521130,202301,1222,2694,578,1539,56,157,304,806,360,963
521140,202301,2039,4674,1492,3749,192,491,840,1975,1032,2466
521150,202301,17669,36818,11619,28203,2776,7400,4729,10907,7505,18307
521160,202301,1035,1972,656,1401,68,135,426,870,494,1005
521170,202301,1361,2929,989,2381,153,399,452,994,605,1393
521180,202301,10922,25951,8494,22065,1627,4543,3904,9828,5531,14371
521190,202301,14574,33852,9505,25791,2204,6456,2793,7052,4997,13508
521200,202301,883,2008,600,1563,82,234,275,652,357,886
521205,202301,761,1660,584,1395,27,67,458,1045,485,1112
521210,202301,1027,2578,625,1753,139,424,148,304,287,728
521220,202301,4884,10596,3259,8101,828,2308,1217,2679,2045,4987
521225,202301,546,1042,410,895,33,74,318,693,351,767
521230,202301,1806,4152,1501,3753,635,1655,452,1112,1087,2767
521250,202301,47978,108745,39216,97024,8862,23716,21474,50725,30336,74441
521260,202301,646,1369,481,1139,68,193,273,588,341,781
521270,202301,2673,5683,2233,5139,229,459,1610,3786,1839,4245
521280,202301,2307,5688,1737,4790,347,1022,697,1898,1044,2920
521290,202301,716,1501,487,1211,45,121,298,701,343,822
521295,202301,1487,2999,1124,2536,160,317,701,1565,861,1882
521300,202301,2290,5189,1735,4385,334,804,908,2329,1242,3133
521305,202301,823,1773,564,1414,55,156,349,840,404,996
521308,202301,6031,14571,4219,11378,375,1120,2578,6561,2953,7681
521310,202301,13734,31771,9551,24639,1855,5273,3864,9098,5719,14371
521340,202301,501,1061,341,844,28,70,191,448,219,518
521350,202301,2382,5618,1804,4758,129,382,1277,3248,1406,3630
521370,202301,1566,3803,1012,2909,309,969,173,511,482,1480
521375,202301,1963,4749,1330,3680,264,720,318,949,582,1669
521377,202301,1685,3322,1223,2747,136,250,881,2108,1017,2358
521380,202301,7919,19654,5151,14776,791,2383,994,2902,1785,5285
521385,202301,861,1886,647,1608,94,212,343,897,437,1109
521390,202301,852,2060,575,1617,142,457,103,268,245,725
521400,202301,3751,8058,2964,7052,401,1002,1788,4141,2189,5143
521405,202301,1688,4148,1133,3112,131,387,558,1437,689,1824
521410,202301,1168,2570,924,2216,225,477,473,1192,698,1669
521440,202301,1837,4128,1407,3511,424,1002,593,1540,1017,2542
521450,202301,5252,14230,3939,11793,998,3036,854,2584,1852,5620
521460,202301,7723,18191,5560,14438,1401,3830,1876,4648,3277,8478
521470,202301,1041,2401,720,1836,126,296,323,772,449,1068
521480,202301,642,1349,441,1027,63,155,232,465,295,620
521483,202301,2925,6539,2118,5368,565,1393,790,2046,1355,3439
521486,202301,2186,4848,1677,4124,156,289,1082,2666,1238,2955
521487,202301,595,1274,434,1063,79,185,265,651,344,836
521490,202301,1058,2560,783,2129,34,123,560,1419,594,1542
521500,202301,2591,6173,1966,5312,191,705,1158,2881,1349,3586
521520,202301,1038,2191,810,1895,124,259,474,1111,598,1370
521523,202301,18405,49052,15201,44097,4434,13382,5441,15198,9875,28580
521525,202301,1325,2906,1005,2452,91,278,658,1510,749,1788
521530,202301,2811,6863,1786,4889,331,926,482,1201,813,2127
521540,202301,997,2357,721,1920,167,503,287,702,454,1205
521550,202301,2115,5013,1117,3067,207,603,257,731,464,1334
521560,202301,7109,16507,5194,13936,1460,3939,2104,5879,3564,9818
521565,202301,831,1920,572,1498,100,262,251,646,351,908
521570,202301,5193,12915,3645,10153,713,2211,460,1240,1173,3451
521580,202301,678,1460,451,1095,80,206,180,390,260,596
521590,202301,1080,2167,779,1755,92,218,477,1009,569,1227
521600,202301,534,1297,334,927,59,171,163,406,222,577
521630,202301,2132,4314,1328,3186,407,1003,338,748,745,1751
521640,202301,2446,5410,1561,4081,332,991,466,1123,798,2114
521645,202301,644,1568,386,1104,159,451,19,35,178,486
521680,202301,1791,4443,1394,3825,354,999,539,1440,893,2439
521690,202301,656,1519,546,1375,84,229,311,757,395,986
521710,202301,4399,9890,2931,7513,506,1457,810,1740,1316,3197
521720,202301,3103,6447,2006,4839,254,662,1113,2603,1367,3265
521730,202301,5109,12757,3763,10542,993,3135,875,2018,1868,5153
521740,202301,5852,13572,4620,11822,1397,3893,1487,3413,2884,7306
521760,202301,24287,55482,19879,49482,3818,10845,11352,26592,15170,37437
521770,202301,4140,9031,2690,6827,535,1406,611,1504,1146,2910
521800,202301,8869,21179,6356,17151,1878,5163,1765,5212,3643,10375
521805,202301,1415,2680,931,2066,196,393,460,1097,656,1490
521810,202301,920,1972,667,1632,126,302,364,909,490,1211
521830,202301,7608,18458,6169,16281,494,1515,4409,11208,4903,12723
521839,202301,1133,2382,867,1975,76,203,614,1289,690,1492
521850,202301,9050,19453,5655,14407,1697,4260,675,1644,2372,5904
521860,202301,2051,5196,1420,4056,241,748,429,1109,670,1857
521870,202301,868,2213,636,1801,112,359,230,545,342,904
521878,202301,1021,2492,666,1790,57,161,337,831,394,992
521880,202301,30149,68117,21934,55738,4566,12472,9609,22866,14175,35338
521890,202301,4267,10030,2913,7761,755,2010,772,1921,1527,3931
521900,202301,1693,3759,905,2436,233,524,17,46,250,570
521910,202301,1785,3611,1270,2980,297,665,521,1206,818,1871
521920,202301,697,1644,544,1410,65,201,337,810,402,1011
521925,202301,1001,2375,739,1989,144,427,311,789,455,1216
521930,202301,6824,15376,4622,12166,1354,2992,1750,5105,3104,8097
521935,202301,1256,2830,869,2189,78,211,515,1217,593,1428
521940,202301,1663,3372,1106,2607,185,484,580,1304,765,1788
521945,202301,815,1895,569,1473,86,222,299,754,385,976
521950,202301,919,2016,643,1598,100,252,303,737,403,989
521960,202301,836,2028,575,1547,53,185,333,804,386,989
521970,202301,3505,7258,2660,6231,245,487,1977,4779,2222,5266
521971,202301,938,2136,645,1680,156,401,169,409,325,810
521973,202301,2041,4870,1517,4004,174,452,921,2362,1095,2814
521975,202301,17509,40529,14315,36095,2404,6645,8441,20490,10845,27135
521980,202301,2858,6135,2142,5199,147,369,1610,3860,1757,4229
521990,202301,1818,3999,1539,3612,264,700,952,2199,1216,2899
522000,202301,3421,8158,2646,7167,866,2461,1020,2874,1886,5335
522005,202301,476,1016,311,780,53,140,113,276,166,416
522010,202301,5794,13314,4125,10634,880,2413,1472,3531,2352,5944
522015,202301,1341,3193,999,2681,268,737,407,1052,675,1789
522020,202301,6821,14801,4596,11490,940,2440,2009,4984,2949,7424
522026,202301,939,2280,605,1704,94,320,174,397,268,717
522028,202301,638,1438,445,1115,70,213,225,496,295,709
522040,202301,4760,9435,3338,7556,367,940,2152,4477,2519,5417
522045,202301,26141,65424,19775,55116,4291,12706,5108,13485,9399,26191
522050,202301,1504,3570,1075,2856,193,576,465,1068,658,1644
522060,202301,3811,9300,2794,7717,499,1313,1238,3446,1737,4759
522068,202301,2329,4992,1873,4466,115,228,1507,3632,1622,3860
522070,202301,1041,2008,853,1744,22,41,748,1492,770,1533
522100,202301,1116,2588,727,1933,104,282,326,814,430,1096
522108,202301,1424,2891,1115,2479,52,134,877,1865,929,1999
522119,202301,2490,5256,1990,4650,352,705,1177,2817,1529,3522
522130,202301,663,1467,507,1262,45,93,376,961,421,1054
522140,202301,31220,73819,22168,58171,4672,13028,6728,16019,11400,29047
522145,202301,974,2165,691,1755,139,398,369,905,508,1303
522150,202301,1389,3044,929,2335,210,544,275,665,485,1209
522155,202301,1256,2998,960,2545,142,337,553,1477,695,1814
522157,202301,913,1820,740,1619,43,88,567,1241,610,1329
522160,202301,7754,18292,5047,13687,1295,3792,518,1478,1813,5270
522170,202301,3386,8021,2611,6886,356,940,1582,4158,1938,5098
522180,202301,932,1984,625,1446,111,267,188,446,299,713
522185,202301,30760,69133,22775,58697,8994,25193,4264,11598,13258,36791
522190,202301,1003,2093,690,1626,145,350,298,633,443,983
522200,202301,2574,6503,1926,5406,492,1376,649,1796,1141,3172
522205,202301,2006,4561,1458,3743,460,1242,391,942,851,2184
522220,202301,1459,3200,1074,2694,134,322,632,1643,766,1965
522230,202301,1661,3661,1297,3137,188,516,781,1818,969,2334
530010,202301,329219,777040,277988,701765,38656,106454,167172,401064,205828,507518
